литые	литые
обновить	обновить
накорми	накорми
вносить	вносить
ночные	ночные
занятые	занятые
теснился	теснился
пребывали	пребывали
искупить	искупить
зле	зле
возвратили	возвратили
построили	построили
напоила	напоила
насади	насади
покрой	покрой
бесноватый	бесноватый
пригласите	пригласите
целое	целое
малом	малом
уцелело	уцелело
наполнили	наполнили
обитать	обитать
согласные	согласные
виден	виден
продолжай	продолжай
отвратили	отвратили
чужом	чужом
проходите	проходите
мертво	мертво
производили	производили
вдовою	вдовою
худо	худо
наполнить	наполнить
приходите	приходите
иссохло	иссохло
истребите	истребите
просите	просите
снега	снега
учите	учите
снегу	снегу
тысячами	тысячами
мешке	мешке
затворите	затворите
управляй	управляй
голубого	голубого
матерь	матерь
мухе	мухе
твердым	твердым
языку	языку
благовествуй	благовествуй
блудили	блудили
божество	божество
старейшинах	старейшинах
языков	языков
слышим	слышим
теста	теста
били	били
мечу	мечу
морскою	морскою
находился	находился
сокрушен	сокрушен
зеленого	зеленого
Будете	Будете
наполни	наполни
Раба	Раба
совершила	совершила
сделала	сделала
умертвила	умертвила
вопрошающий	вопрошающий
мала	мала
произносила	произносила
отворили	отворили
прибыла	прибыла
приступили	приступили
сторожам	сторожам
переходит	переходит
удержи	удержи
обитали	обитали
исполним	исполним
освети	освети
счету	счету
объясни	объясни
исследуйте	исследуйте
пою	пою
думать	думать
налагали	налагали
научите	научите
обитая	обитая
располагает	располагает
огорчили	огорчили
разные	разные
страшных	страшных
духи	духи
испытывайте	испытывайте
отними	отними
понесли	понесли
возлегли	возлегли
пронзить	пронзить
выносите	выносите
главные	главные
отворила	отворила
научить	научить
великую	великую
наши	наши
родят	родят
умерли	умерли
называй	называй
животного	животного
пророчествуйте	пророчествуйте
исходят	исходят
признайте	признайте
добре	добре
соблазнить	соблазнить
устраните	устраните
голодного	голодного
протоках	протоках
посадить	посадить
Галилейской	Галилейской
птенцов	птенцов
возвысили	возвысили
поверили	поверили
раскрытую	раскрытую
страдающий	страдающий
блаженных	блаженных
выбросить	выбросить
переменить	переменить
слушающий	слушающий
разбросайте	разбросайте
свободные	свободные
исцели	исцели
открой	открой
жабами	жабами
тысяч	тысяч
животное	животное
скрывай	скрывай
звезды	звезды
прямою	прямою
будет	будет
погуби	погуби
медлить	медлить
свари	свари
унывали	унывали
новорожденные	новорожденные
вытрут	вытрут
злословили	злословили
выполняйте	выполняйте
госпоже	госпоже
оскудела	оскудела
отдели	отдели
тельцу	тельцу
Слушайте	Слушайте
губи	губи
медлили	медлили
грабили	грабили
мех	мех
вдовы	вдовы
изливали	изливали
имели	имели
возмутить	возмутить
дорогою	дорогою
наложили	наложили
обветшали	обветшали
крылом	крылом
напасти	напасти
скалу	скалу
согласился	согласился
вызывали	вызывали
красота	красота
онемеешь	онемеешь
сотвори	сотвори
проводит	проводит
приучила	приучила
уходит	уходит
поступили	поступили
узнаешь	узнаешь
пасли	пасли
красные	красные
переспим	переспим
осудили	осудили
воле	воле
выговори	выговори
привалив	привалив
испортите	испортите
гордою	гордою
сироту	сироту
носили	носили
Хочет	Хочет
образуем	образуем
тайною	тайною
святые	святые
открытом	открытом
судите	судите
жертва	жертва
крестишь	крестишь
людях	людях
напоены	напоены
блуди	блуди
бедные	бедные
похули	похули
Знаем	Знаем
жди	жди
погубить	погубить
простирал	простирал
отправляли	отправляли
подложили	подложили
подарила	подарила
отдать	отдать
помни	помни
повредили	повредили
поноси	поноси
продолжали	продолжали
считать	считать
рак	рак
учить	учить
налагать	налагать
имуществом	имуществом
избили	избили
возлюбила	возлюбила
закрою	закрою
признаю	признаю
сосчитали	сосчитали
отпустите	отпустите
пожалело	пожалело
окончили	окончили
новых	новых
твердая	твердая
мертвые	мертвые
жилы	жилы
воссиять	воссиять
Дан	Дан
говорить	говорить
неверующая	неверующая
одержимого	одержимого
разрешить	разрешить
выносили	выносили
требуй	требуй
сладкою	сладкою
хромого	хромого
шипов	шипов
забытая	забытая
любимое	любимое
молите	молите
отошли	отошли
глухие	глухие
убитый	убитый
ночного	ночного
письмом	письмом
всходили	всходили
постыди	постыди
поразите	поразите
ждите	ждите
избранное	избранное
предавайте	предавайте
славословили	славословили
разрушен	разрушен
кончили	кончили
удерживайте	удерживайте
пленила	пленила
испытывали	испытывали
пары	пары
знакомого	знакомого
сотворите	сотворите
прямых	прямых
благотворить	благотворить
купи	купи
жилища	жилища
запрети	запрети
чудные	чудные
молился	молился
лишили	лишили
богам	богам
отпускать	отпускать
убитою	убитою
жертвами	жертвами
правые	правые
принят	принят
целых	целых
выдавать	выдавать
вороные	вороные
душа	душа
пленили	пленили
обложи	обложи
скрывать	скрывать
скрепите	скрепите
налагала	налагала
одолела	одолела
хромой	хромой
худом	худом
распознаем	распознаем
стояли	стояли
называли	называли
возьмут	возьмут
носильщиками	носильщиками
страхе	страхе
богатые	богатые
помышляли	помышляли
ворон	ворон
блаженный	блаженный
половину	половину
прости	прости
помышляйте	помышляйте
твердо	твердо
разводное	разводное
замеси	замеси
потекли	потекли
завещаю	завещаю
рубили	рубили
сходим	сходим
каплют	каплют
изгоняйте	изгоняйте
бесовской	бесовской
имеешь	имеешь
главных	главных
точиле	точиле
божествах	божествах
отведите	отведите
чудное	чудное
слеп	слеп
хвалился	хвалился
своя	своя
жала	жала
прочитать	прочитать
аспида	аспида
долга	долга
напоить	напоить
возноси	возноси
воздать	воздать
положили	положили
проходит	проходит
вторых	вторых
бил	бил
возьми	возьми
переходите	переходите
покровом	покровом
налагайте	налагайте
расположите	расположите
выбросите	выбросите
избранных	избранных
созрели	созрели
отсекли	отсекли
взяли	взяли
взял	взял
яви	яви
подносят	подносят
принеси	принеси
познаю	познаю
заплатили	заплатили
почти	почти
смешанною	смешанною
птенцах	птенцах
желающий	желающий
ходили	ходили
поразить	поразить
жилищами	жилищами
сосчитайте	сосчитайте
затворила	затворила
открывай	открывай
утаили	утаили
почитайте	почитайте
жребии	жребии
поступите	поступите
неверных	неверных
получите	получите
дополните	дополните
весах	весах
доставляй	доставляй
посвятила	посвятила
обходили	обходили
палит	палит
поносить	поносить
Моем	Моем
расти	расти
ослепила	ослепила
последовало	последовало
постанови	постанови
сокрытую	сокрытую
соблюдите	соблюдите
проводить	проводить
предложи	предложи
ином	ином
затыкает	затыкает
поникло	поникло
сходили	сходили
оказывать	оказывать
благословляйте	благословляйте
Ханаанскую	Ханаанскую
сверкающий	сверкающий
сделанным	сделанным
возбудить	возбудить
свекровь	свекровь
заключен	заключен
половины	половины
Иудиной	Иудиной
страшные	страшные
возлегло	возлегло
откормленных	откормленных
веруйте	веруйте
умирать	умирать
помните	помните
упоминайте	упоминайте
ищи	ищи
сладкие	сладкие
воспоминайте	воспоминайте
утвердить	утвердить
поднимите	поднимите
открытое	открытое
расспросите	расспросите
Богами	Богами
лежите	лежите
молодого	молодого
города	города
твердом	твердом
брак	брак
встретить	встретить
левши	левши
хочет	хочет
помет	помет
имейте	имейте
принимала	принимала
собирала	собирала
слепых	слепых
устроила	устроила
освятите	освятите
управлять	управлять
растили	растили
засохли	засохли
одетые	одетые
молили	молили
созывать	созывать
возливать	возливать
прославить	прославить
погрешите	погрешите
весу	весу
тысячах	тысячах
раскрыла	раскрыла
горькою	горькою
приклонить	приклонить
запретили	запретили
изгоняли	изгоняли
последовать	последовать
спросить	спросить
привалили	привалили
честным	честным
почитать	почитать
ступите	ступите
открытым	открытым
река	река
возбудите	возбудите
жаб	жаб
убогие	убогие
купить	купить
хромые	хромые
помнили	помнили
свитке	свитке
молчите	молчите
чад	чад
иного	иного
навыком	навыком
заговоришь	заговоришь
приводили	приводили
находит	находит
прикрепила	прикрепила
вводить	вводить
отходить	отходить
мучить	мучить
вороной	вороной
простираешь	простираешь
устав	устав
чудных	чудных
точил	точил
налагай	налагай
померкли	померкли
чудовище	чудовище
отсчитай	отсчитай
победить	победить
возлюбленную	возлюбленную
наполняй	наполняй
дозволяйте	дозволяйте
убийстве	убийстве
дворами	дворами
нечисты	нечисты
уступили	уступили
вопрошать	вопрошать
владели	владели
кормили	кормили
считает	считает
проходи	проходи
смели	смели
похороните	похороните
произносите	произносите
Жертвы	Жертвы
побили	побили
осмоли	осмоли
зла	зла
отнимите	отнимите
усилили	усилили
делили	делили
дорогой	дорогой
скотом	скотом
страж	страж
выливайте	выливайте
варили	варили
родившая	родившая
возлюбленной	возлюбленной
верить	верить
погрешили	погрешили
поручи	поручи
сказывать	сказывать
рабах	рабах
строить	строить
кадите	кадите
окончи	окончи
жилищам	жилищам
ослабевать	ослабевать
унизили	унизили
переменили	переменили
ударила	ударила
замерло	замерло
познайте	познайте
пожалуйте	пожалуйте
признаешь	признаешь
опусти	опусти
находила	находила
управляем	управляем
побила	побила
овнами	овнами
тесните	тесните
благословить	благословить
бесчестили	бесчестили
умножить	умножить
отсеки	отсеки
заходить	заходить
прислуги	прислуги
помета	помета
объявите	объявите
нечистоту	нечистоту
имущества	имущества
сироты	сироты
пару	пару
бедным	бедным
утверди	утверди
померкло	померкло
провозгласи	провозгласи
воспитывали	воспитывали
подумал	подумал
выводить	выводить
живых	живых
заключите	заключите
молодом	молодом
Тиром	Тиром
столе	столе
поставили	поставили
варите	варите
язвами	язвами
другие	другие
безумным	безумным
жилищ	жилищ
отпусти	отпусти
убийцы	убийцы
поцелуй	поцелуй
Христа	Христа
словом	словом
утих	утих
сухая	сухая
исходили	исходили
заплатить	заплатить
нечистой	нечистой
выходить	выходить
держи	держи
совершили	совершили
серебре	серебре
жертвы	жертвы
Слове	Слове
срамить	срамить
собранные	собранные
сверкали	сверкали
приноси	приноси
аспидов	аспидов
восполнить	восполнить
великою	великою
велик	велик
служанке	служанке
остановить	остановить
граду	граду
избранные	избранные
золотой	золотой
известить	известить
исправили	исправили
вопросите	вопросите
духов	духов
сестрою	сестрою
узнаете	узнаете
благословили	благословили
поговорив	поговорив
принимай	принимай
выпал	выпал
убить	убить
разбить	разбить
проклятую	проклятую
мечи	мечи
объяви	объяви
вложили	вложили
немалую	немалую
водить	водить
замечать	замечать
сознает	сознает
кричите	кричите
мозгом	мозгом
бесовскую	бесовскую
восстановим	восстановим
пролили	пролили
приносила	приносила
голоса	голоса
глухою	глухою
красоту	красоту
молотили	молотили
поручили	поручили
завладел	завладел
внимали	внимали
явили	явили
язва	язва
твердую	твердую
отходят	отходят
спросили	спросили
обходите	обходите
Мои	Мои
опустили	опустили
главного	главного
совершите	совершите
душу	душу
накормить	накормить
желали	желали
имеет	имеет
выстрелили	выстрелили
уходите	уходите
положи	положи
ревнуйте	ревнуйте
разбирайте	разбирайте
сделанный	сделанный
родных	родных
любимая	любимая
поместила	поместила
управляющий	управляющий
говори	говори
льстить	льстить
жабы	жабы
дщерь	дщерь
рассказывай	рассказывай
духу	духу
возвестить	возвестить
смертным	смертным
мысли	мысли
выступив	выступив
Духом	Духом
возгласи	возгласи
поцелую	поцелую
вороти	вороти
срубить	срубить
вызывать	вызывать
возносите	возносите
выводили	выводили
мучила	мучила
творить	творить
согрешили	согрешили
веке	веке
лицах	лицах
заклятого	заклятого
выдавай	выдавай
погасили	погасили
одру	одру
окружить	окружить
воротился	воротился
творите	творите
огорчить	огорчить
находят	находят
вложить	вложить
возносили	возносили
жертву	жертву
скалах	скалах
проходила	проходила
затворить	затворить
вели	вели
утвердили	утвердили
успокоили	успокоили
строят	строят
выходит	выходит
поразили	поразили
Знайте	Знайте
тысяче	тысяче
стоите	стоите
ударить	ударить
горькой	горькой
черный	черный
замедлить	замедлить
страшился	страшился
выдавали	выдавали
рубить	рубить
проток	проток
дворах	дворах
твердой	твердой
отступить	отступить
проводив	проводив
богах	богах
аспид	аспид
родным	родным
рассеянный	рассеянный
большая	большая
меньшие	меньшие
хром	хром
соблазнили	соблазнили
кормить	кормить
образе	образе
стража	стража
осадить	осадить
стану	стану
поправить	поправить
выходи	выходи
охраняющий	охраняющий
наступив	наступив
потекло	потекло
переноси	переноси
малое	малое
приняла	приняла
восходите	восходите
любить	любить
почитаю	почитаю
берете	берете
ничтожество	ничтожество
отцов	отцов
пересчитайте	пересчитайте
живою	живою
празднуй	празднуй
удерживали	удерживали
черви	черви
узнают	узнают
соедини	соедини
чести	чести
стражам	стражам
поручен	поручен
половиною	половиною
Жертва	Жертва
искушай	искушай
Хвалите	Хвалите
начинай	начинай
вечером	вечером
вступите	вступите
положите	положите
превозмогло	превозмогло
устройством	устройством
выросли	выросли
Богу	Богу
наследуешь	наследуешь
родился	родился
гордо	гордо
ночных	ночных
невежд	невежд
разгласили	разгласили
Христе	Христе
родословных	родословных
хотите	хотите
скрывала	скрывала
потаенных	потаенных
познай	познай
посылать	посылать
полюби	полюби
чтить	чтить
скованного	скованного
душе	душе
совершить	совершить
имеющий	имеющий
презирайте	презирайте
протоки	протоки
заразою	заразою
значила	значила
умерщвляйте	умерщвляйте
кругом	кругом
траве	траве
бывшую	бывшую
выдайте	выдайте
ставили	ставили
первые	первые
отяготить	отяготить
камня	камня
свои	свои
простертая	простертая
грешить	грешить
ели	ели
большою	большою
захватили	захватили
целую	целую
покоился	покоился
черного	черного
пьяный	пьяный
созывайте	созывайте
пила	пила
цвет	цвет
странствующий	странствующий
познаем	познаем
лукавый	лукавый
проклинайте	проклинайте
сохранили	сохранили
живые	живые
убитой	убитой
убитого	убитого
заменили	заменили
порядке	порядке
добыч	добыч
знаком	знаком
раздражен	раздражен
нечистых	нечистых
войска	войска
Святым	Святым
нечист	нечист
отвалит	отвалит
пощадили	пощадили
расслабленный	расслабленный
рта	рта
носила	носила
вылитых	вылитых
сбереги	сбереги
ворону	ворону
разложите	разложите
коленом	коленом
отврати	отврати
прямой	прямой
презирать	презирать
устроен	устроен
удерживай	удерживай
век	век
обманывай	обманывай
воссияло	воссияло
вывело	вывело
наступили	наступили
разбросали	разбросали
тварь	тварь
разделить	разделить
счет	счет
расслабленных	расслабленных
переходить	переходить
пьем	пьем
отправлять	отправлять
добыче	добыче
известили	известили
разорите	разорите
возбудили	возбудили
отдала	отдала
переносят	переносят
согласного	согласного
посетить	посетить
оставила	оставила
благо	благо
выпали	выпали
сложили	сложили
мстите	мстите
выдавайте	выдавайте
Аду	Аду
осени	осени
святых	святых
слове	слове
поглотили	поглотили
множестве	множестве
ищем	ищем
раздирать	раздирать
судить	судить
прикрепи	прикрепи
временное	временное
носильщиков	носильщиков
поправили	поправили
начале	начале
правого	правого
большого	большого
замедли	замедли
затворили	затворили
подходите	подходите
повторили	повторили
погребен	погребен
исчислите	исчислите
иных	иных
провозгласите	провозгласите
произноси	произноси
сей	сей
приучили	приучили
жертвам	жертвам
член	член
жертвою	жертвою
простирает	простирает
отпустили	отпустили
навык	навык
восходили	восходили
заходи	заходи
верхом	верхом
перебить	перебить
отпускайте	отпускайте
злом	злом
узнаем	узнаем
венца	венца
красоты	красоты
хромым	хромым
судив	судив
сними	сними
темным	темным
сходят	сходят
помнила	помнила
гусеница	гусеница
разных	разных
защищать	защищать
пчелы	пчелы
могут	могут
жертве	жертве
предложила	предложила
заключить	заключить
победили	победили
осудить	осудить
похулили	похулили
смешанной	смешанной
всходить	всходить
ослабело	ослабело
Будут	Будут
голубой	голубой
вымой	вымой
золото	золото
проезжал	проезжал
посвяти	посвяти
горды	горды
воспитанный	воспитанный
желчь	желчь
доставили	доставили
влекла	влекла
утихло	утихло
добра	добра
проводят	проводят
любили	любили
вступили	вступили
убийца	убийца
выдать	выдать
трубили	трубили
свободный	свободный
узнает	узнает
раскрыли	раскрыли
могли	могли
языком	языком
золотою	золотою
Теми	Теми
козлов	козлов
одержимая	одержимая
времени	времени
рога	рога
находим	находим
мучился	мучился
призванных	призванных
заключили	заключили
ставить	ставить
крыле	крыле
тайна	тайна
злодействе	злодействе
простите	простите
козлу	козлу
смири	смири
останови	останови
населенные	населенные
молока	молока
убийц	убийц
доводите	доводите
Мало	Мало
приносили	приносили
был	был
Иудину	Иудину
мстить	мстить
Благословите	Благословите
мужчинах	мужчинах
случая	случая
Святого	Святого
имеем	имеем
благословите	благословите
обществом	обществом
началом	началом
уставом	уставом
спорите	спорите
вечере	вечере
преданным	преданным
чужие	чужие
испытанного	испытанного
предавай	предавай
проклятою	проклятою
цвете	цвете
бог	бог
отведи	отведи
скрытых	скрытых
связанные	связанные
последуй	последуй
переходили	переходили
приводите	приводите
расслабленные	расслабленные
направить	направить
восхвалите	восхвалите
ждали	ждали
любимой	любимой
открывайте	открывайте
порядку	порядку
убит	убит
поставить	поставить
принесем	принесем
любимы	любимы
Духу	Духу
приступить	приступить
отменить	отменить
немого	немого
беременных	беременных
молодым	молодым
благую	благую
подражали	подражали
научи	научи
долгом	долгом
находить	находить
освободить	освободить
послужить	послужить
поникли	поникли
скрытая	скрытая
построить	построить
страшить	страшить
оном	оном
соляною	соляною
белы	белы
заключи	заключи
Свои	Свои
осмолила	осмолила
округ	округ
расположи	расположи
моря	моря
родишь	родишь
скверною	скверною
оказывали	оказывали
растворить	растворить
освятили	освятили
встретили	встретили
Царя	Царя
засохло	засохло
злодейством	злодейством
язву	язву
бывшая	бывшая
богу	богу
оставляй	оставляй
захватила	захватила
озером	озером
жребием	жребием
гусенице	гусенице
учи	учи
хотят	хотят
убийцу	убийцу
украсить	украсить
червь	червь
воскури	воскури
черту	черту
носите	носите
бока	бока
бабки	бабки
померк	померк
точила	точила
мало	мало
духа	духа
платить	платить
будем	будем
восходить	восходить
лиц	лиц
берегу	берегу
избавлять	избавлять
вопроси	вопроси
сатаны	сатаны
сади	сади
затворит	затворит
обманывайте	обманывайте
спит	спит
царскою	царскою
платили	платили
жилищах	жилищах
сохраните	сохраните
благодарив	благодарив
горд	горд
рулем	рулем
воронам	воронам
бесноватых	бесноватых
вышло	вышло
подвигли	подвигли
попускал	попускал
белые	белые
выступите	выступите
выливай	выливай
богатого	богатого
утаить	утаить
приложить	приложить
возложила	возложила
воспитанные	воспитанные
поворотить	поворотить
разделила	разделила
запрудите	запрудите
просила	просила
почитай	почитай
скорую	скорую
рассудите	рассудите
прямым	прямым
сруби	сруби
вес	вес
плече	плече
трава	трава
градом	градом
поглотила	поглотила
восстановили	восстановили
сотворила	сотворила
Силе	Силе
вредили	вредили
принимать	принимать
выи	выи
Кому	Кому
дало	дало
поспешили	поспешили
сердечной	сердечной
храни	храни
подходили	подходили
спустили	спустили
новорожденного	новорожденного
считал	считал
разбила	разбила
умертвите	умертвите
свободного	свободного
растила	растила
божества	божества
Мою	Мою
заставить	заставить
дщери	дщери
стояла	стояла
развалинами	развалинами
ожесточили	ожесточили
подумайте	подумайте
ухом	ухом
содержите	содержите
крестит	крестит
можем	можем
овце	овце
избранным	избранным
возвестите	возвестите
верх	верх
весами	весами
бичом	бичом
образ	образ
рассмотрите	рассмотрите
новом	новом
золоте	золоте
посети	посети
Рабы	Рабы
воспойте	воспойте
признали	признали
выведи	выведи
благовествуйте	благовествуйте
выходишь	выходишь
исполняйте	исполняйте
одолели	одолели
страсть	страсть
благотворите	благотворите
оробели	оробели
сказывайте	сказывайте
выкупи	выкупи
левою	левою
чужая	чужая
красоте	красоте
утром	утром
отяжелело	отяжелело
принять	принять
стеснен	стеснен
проезжая	проезжая
садился	садился
узнали	узнали
прямые	прямые
Начало	Начало
произносили	произносили
охраняй	охраняй
морскую	морскую
Начала	Начала
изменили	изменили
могло	могло
ходи	ходи
объявили	объявили
числе	числе
дереве	дереве
жабам	жабам
отошлите	отошлите
призрак	призрак
воздали	воздали
вспомнили	вспомнили
головах	головах
малым	малым
рождали	рождали
Может	Может
попускаете	попускаете
дал	дал
Буду	Буду
разбирать	разбирать
открывать	открывать
отходили	отходили
проклинать	проклинать
изливай	изливай
меча	меча
обличи	обличи
обгорела	обгорела
восстать	восстать
граде	граде
ворона	ворона
сокрушить	сокрушить
благословляли	благословляли
оставлять	оставлять
петля	петля
страсти	страсти
труби	труби
унывайте	унывайте
Приветствуй	Приветствуй
истукану	истукану
снисходить	снисходить
пронзили	пронзили
утихли	утихли
заставили	заставили
покрывать	покрывать
заменим	заменим
закрой	закрой
свекрови	свекрови
обольстили	обольстили
соблюди	соблюди
больного	больного
познаете	познаете
пьяным	пьяным
оказывайте	оказывайте
беременным	беременным
рассмотри	рассмотри
приводить	приводить
белом	белом
нашу	нашу
снохе	снохе
приготовила	приготовила
беременные	беременные
отворить	отворить
блага	блага
тьма	тьма
молоке	молоке
зло	зло
бедный	бедный
вопросили	вопросили
провозгласили	провозгласили
браните	браните
желало	желало
перебили	перебили
вороны	вороны
Адам	Адам
держу	держу
обвини	обвини
головами	головами
последовали	последовали
пояса	пояса
пой	пой
начало	начало
родила	родила
торжествующий	торжествующий
жали	жали
знакомых	знакомых
котлов	котлов
наступите	наступите
возросли	возросли
Велики	Велики
покрывали	покрывали
проклинали	проклинали
поразила	поразила
низложи	низложи
постановить	постановить
ожесточите	ожесточите
вы	вы
носился	носился
снабди	снабди
вечера	вечера
посвятили	посвятили
порти	порти
пернатые	пернатые
покров	покров
отложили	отложили
духовные	духовные
воздух	воздух
отправили	отправили
повредить	повредить
тельцами	тельцами
первого	первого
завладеть	завладеть
бедного	бедного
богов	богов
истреби	истреби
заключила	заключила
терпим	терпим
осветила	осветила
срамили	срамили
предложить	предложить
печи	печи
сохрани	сохрани
выстроили	выстроили
рогом	рогом
губили	губили
язвах	язвах
послужили	послужили
другом	другом
служанкою	служанкою
удалите	удалите
воплю	воплю
тьмою	тьмою
сказать	сказать
отправить	отправить
новой	новой
обложили	обложили
скрывайте	скрывайте
созрела	созрела
соорудили	соорудили
могу	могу
талант	талант
уведомили	уведомили
разить	разить
смутить	смутить
покрывало	покрывало
отступив	отступив
онемеют	онемеют
томился	томился
переспит	переспит
пишем	пишем
саранча	саранча
уповать	уповать
проводили	проводили
плачем	плачем
остановили	остановили
леса	леса
вопрошали	вопрошали
бросила	бросила
жилищу	жилищу
поддерживала	поддерживала
страже	страже
поступи	поступи
почитал	почитал
Апостолом	Апостолом
смертные	смертные
проходят	проходят
выросло	выросло
сказывай	сказывай
случай	случай
перебило	перебило
матерях	матерях
красного	красного
очистите	очистите
брака	брака
похоронен	похоронен
пленный	пленный
прикрепили	прикрепили
поешь	поешь
составить	составить
переходишь	переходишь
ехидна	ехидна
удержали	удержали
засохла	засохла
Боге	Боге
повторите	повторите
пило	пило
внимать	внимать
простирали	простирали
сокрытый	сокрытый
восклицать	восклицать
научили	научили
окружите	окружите
Святых	Святых
горькие	горькие
подносили	подносили
торжествуй	торжествуй
одушевленное	одушевленное
саранчу	саранчу
души	души
построила	построила
пленных	пленных
малого	малого
поставила	поставила
возвестим	возвестим
наполните	наполните
ожесточи	ожесточи
обложила	обложила
посрамить	посрамить
Соляную	Соляную
Матери	Матери
очистим	очистим
засевайте	засевайте
известите	известите
голодные	голодные
венцом	венцом
бесноватого	бесноватого
Словом	Словом
влекли	влекли
поверить	поверить
приняты	приняты
осенила	осенила
утопает	утопает
погубите	погубите
учился	учился
ком	ком
завещал	завещал
кропили	кропили
отвори	отвори
отсчитайте	отсчитайте
затрубили	затрубили
обгорело	обгорело
сходила	сходила
отделили	отделили
познали	познали
тельца	тельца
золотом	золотом
верили	верили
принято	принято
осади	осади
объяснить	объяснить
возмутили	возмутили
оных	оных
тьме	тьме
устранить	устранить
одержимый	одержимый
подкрепили	подкрепили
немые	немые
пиши	пиши
разводить	разводить
спаси	спаси
подтвердили	подтвердили
будь	будь
саранче	саранче
Хвали	Хвали
Воздай	Воздай
исполни	исполни
наш	наш
воздай	воздай
поддерживать	поддерживать
последуйте	последуйте
безумные	безумные
хулили	хулили
рассудить	рассудить
изнеженных	изнеженных
отмени	отмени
святой	святой
веса	веса
возливала	возливала
узнайте	узнайте
выступили	выступили
тысячи	тысячи
родит	родит
соединить	соединить
ехидны	ехидны
любимый	любимый
принудить	принудить
разбит	разбит
мехе	мехе
избранной	избранной
легкие	легкие
литых	литых
человеческой	человеческой
искушать	искушать
камнях	камнях
вступить	вступить
хотим	хотим
лесах	лесах
потускли	потускли
управляли	управляли
считаете	считаете
ступили	ступили
духе	духе
избило	избило
познают	познают
легкое	легкое
убили	убили
сердечные	сердечные
сокруши	сокруши
мертвых	мертвых
положен	положен
повисла	повисла
твори	твори
святая	святая
любимым	любимым
лукавого	лукавого
хвалите	хвалите
населенного	населенного
смирить	смирить
сходить	сходить
наг	наг
напоминай	напоминай
низринут	низринут
язвы	язвы
богами	богами
умножила	умножила
деревом	деревом
бери	бери
дать	дать
вела	вела
возьмете	возьмете
признает	признает
варить	варить
заколи	заколи
расслабленным	расслабленным
умертвить	умертвить
небе	небе
связанных	связанных
невеждам	невеждам
напоили	напоили
унизить	унизить
отложите	отложите
слепые	слепые
жили	жили
наполняло	наполняло
раздирайте	раздирайте
уходить	уходить
прям	прям
спроси	спроси
светили	светили
посадите	посадите
тленным	тленным
усилить	усилить
темных	темных
голодный	голодный
просили	просили
манною	манною
онемело	онемело
слушай	слушай
вкусили	вкусили
болоте	болоте
одинокую	одинокую
вывели	вывели
отсчитать	отсчитать
взывали	взывали
спорили	спорили
сердечною	сердечною
втором	втором
истребить	истребить
занято	занято
выбрасывать	выбрасывать
отдай	отдай
сложи	сложи
зеленых	зеленых
обладайте	обладайте
Израилевой	Израилевой
внуши	внуши
роста	роста
сокрой	сокрой
бесчестить	бесчестить
думали	думали
бога	бога
почетного	почетного
злословить	злословить
госпожи	госпожи
лицо	лицо
преуспевать	преуспевать
Сене	Сене
посмотрите	посмотрите
простертым	простертым
пример	пример
злак	злак
Слушай	Слушай
празднуйте	празднуйте
умертвили	умертвили
дороге	дороге
выводи	выводи
называйте	называйте
мучили	мучили
пощади	пощади
пролить	пролить
царски	царски
составили	составили
строит	строит
оставляли	оставляли
нечистые	нечистые
овладел	овладел
сокрыт	сокрыт
овладеть	овладеть
доносят	доносят
осквернить	осквернить
судили	судили
страшным	страшным
белым	белым
вытащить	вытащить
большом	большом
обитаем	обитаем
предавали	предавали
колене	колене
будете	будете
желчи	желчи
видите	видите
выстрели	выстрели
лица	лица
лев	лев
постигла	постигла
удалить	удалить
реши	реши
рассеянных	рассеянных
завладели	завладели
фараоном	фараоном
права	права
почетном	почетном
выпало	выпало
голодных	голодных
блаженным	блаженным
добром	добром
выводит	выводит
взяла	взяла
посвятить	посвятить
преступили	преступили
литое	литое
решите	решите
поручите	поручите
сирот	сирот
подражать	подражать
побить	побить
повреди	повреди
призванный	призванный
развалинах	развалинах
посадили	посадили
уменьши	уменьши
похвалить	похвалить
схватите	схватите
жернова	жернова
окропили	окропили
подпали	подпали
владейте	владейте
небольшую	небольшую
град	град
страдать	страдать
кадили	кадили
хочешь	хочешь
исчислить	исчислить
левый	левый
боком	боком
собранный	собранный
беременную	беременную
рождала	рождала
вари	вари
мертвого	мертвого
немых	немых
переносить	переносить
прилагать	прилагать
лесом	лесом
выкупить	выкупить
вылитая	вылитая
внуки	внуки
будешь	будешь
Возлюбленном	Возлюбленном
уходи	уходи
славословить	славословить
пух	пух
рассказывайте	рассказывайте
рождайте	рождайте
открыто	открыто
поглотить	поглотить
мой	мой
счета	счета
рассудили	рассудили
портить	портить
гумне	гумне
жив	жив
доставить	доставить
преданного	преданного
была	была
изнеженный	изнеженный
невежды	невежды
уведомить	уведомить
обратите	обратите
пропасти	пропасти
возвестила	возвестила
обгорелою	обгорелою
привалите	привалите
сокрушите	сокрушите
преступите	преступите
Белы	Белы
лицом	лицом
кому	кому
обветшало	обветшало
возложи	возложи
таланту	таланту
открытых	открытых
покрывал	покрывал
животных	животных
крестить	крестить
посетили	посетили
благодарили	благодарили
выполним	выполним
отринут	отринут
исходила	исходила
кричали	кричали
ревнуй	ревнуй
грабить	грабить
сходишь	сходишь
берем	берем
строила	строила
откормленный	откормленный
купила	купила
постигли	постигли
плечом	плечом
приклоните	приклоните
одолело	одолело
начинали	начинали
окропи	окропи
Велика	Велика
смертного	смертного
сохраняла	сохраняла
напоминайте	напоминайте
низкою	низкою
скверны	скверны
встретила	встретила
обнажен	обнажен
скоте	скоте
лишен	лишен
принесла	принесла
иное	иное
терпи	терпи
твердою	твердою
правым	правым
твердые	твердые
скоту	скоту
приносить	приносить
Приветствуйте	Приветствуйте
дала	дала
подложи	подложи
Свой	Свой
образа	образа
крыло	крыло
берег	берег
преследуй	преследуй
зимой	зимой
убедила	убедила
упоминать	упоминать
войском	войском
сейте	сейте
одинокая	одинокая
собирали	собирали
соорудить	соорудить
напасть	напасть
потаенные	потаенные
оставили	оставили
доставляла	доставляла
богатый	богатый
приходить	приходить
рассеянным	рассеянным
наклонили	наклонили
спросила	спросила
пророчестве	пророчестве
уповали	уповали
приложите	приложите
поддерживайте	поддерживайте
вспомнила	вспомнила
входите	входите
похорони	похорони
восстановить	восстановить
производить	производить
сирота	сирота
манна	манна
затыкали	затыкали
явить	явить
проклятые	проклятые
путем	путем
Можете	Можете
гусеницы	гусеницы
смотри	смотри
Мал	Мал
освятить	освятить
поносили	поносили
сказали	сказали
заплати	заплати
уходят	уходят
почитает	почитает
ходите	ходите
пчеле	пчеле
исцелить	исцелить
святою	святою
выбросили	выбросили
призраку	призраку
берет	берет
обратить	обратить
вскорми	вскорми
презирали	презирали
бабке	бабке
доносили	доносили
подняла	подняла
схватили	схватили
соляным	соляным
избавить	избавить
кормите	кормите
утре	утре
вина	вина
новым	новым
тельцов	тельцов
оценили	оценили
чада	чада
постигло	постигло
сатану	сатану
страшного	страшного
разделите	разделите
искусили	искусили
умер	умер
входили	входили
сокрытой	сокрытой
мстили	мстили
нашем	нашем
посох	посох
узнала	узнала
голодным	голодным
человеческую	человеческую
прилагай	прилагай
невежда	невежда
проходили	проходили
сестры	сестры
дай	дай
благи	благи
отвозят	отвозят
право	право
уговорить	уговорить
тайны	тайны
предавать	предавать
славила	славила
скала	скала
утомленный	утомленный
петли	петли
сынов	сынов
торга	торга
саранчою	саранчою
аспидом	аспидом
отводит	отводит
Богов	Богов
доставляло	доставляло
воспой	воспой
приветствующий	приветствующий
окончить	окончить
отяжелели	отяжелели
возросло	возросло
затворив	затворив
принимайте	принимайте
строим	строим
восхвалили	восхвалили
подносить	подносить
Было	Было
рассуди	рассуди
заняты	заняты
поселили	поселили
Будь	Будь
правых	правых
сатаною	сатаною
камнем	камнем
возложили	возложили
рассеянного	рассеянного
преуспевайте	преуспевайте
Израильскою	Израильскою
возвестили	возвестили
исполнить	исполнить
простирать	простирать
уха	уха
беременной	беременной
подняли	подняли
срубите	срубите
навестить	навестить
прибыл	прибыл
поникла	поникла
превозносили	превозносили
сделать	сделать
любимую	любимую
чтили	чтили
причинить	причинить
вызывающий	вызывающий
повис	повис
лгали	лгали
тысяча	тысяча
взывайте	взывайте
замолчали	замолчали
развалинам	развалинам
выходите	выходите
оскверните	оскверните
открытого	открытого
благословлять	благословлять
фараоне	фараоне
любимых	любимых
немой	немой
положить	положить
обгорел	обгорел
озере	озере
чужого	чужого
можете	можете
спите	спите
святым	святым
воспоминать	воспоминать
ужина	ужина
имело	имело
беременною	беременною
пили	пили
больным	больным
истукан	истукан
заколите	заколите
глухой	глухой
рассказывали	рассказывали
Христов	Христов
половинах	половинах
откормленного	откормленного
Будет	Будет
болотом	болотом
мозгов	мозгов
прогони	прогони
грешили	грешили
возьму	возьму
Соляной	Соляной
язвам	язвам
утвердите	утвердите
столпом	столпом
горькую	горькую
уговори	уговори
больных	больных
сторожу	сторожу
фараонов	фараонов
разгласите	разгласите
отвратите	отвратите
намерены	намерены
язве	язве
покрою	покрою
исцеляйте	исцеляйте
старейшины	старейшины
строили	строили
садить	садить
мужчины	мужчины
внукам	внукам
новое	новое
манны	манны
вскормила	вскормила
попускаешь	попускаешь
котлом	котлом
наследует	наследует
округа	округа
овладейте	овладейте
пронзила	пронзила
большой	большой
скрытые	скрытые
жило	жило
наушника	наушника
подражайте	подражайте
почитали	почитали
молодые	молодые
рождать	рождать
собирайте	собирайте
сокрытые	сокрытые
осквернили	осквернили
смешанный	смешанный
изменишь	изменишь
хранили	хранили
желала	желала
вином	вином
поселить	поселить
называть	называть
челе	челе
распознать	распознать
облегчить	облегчить
второе	второе
Нового	Нового
овну	овну
Возлюбленный	Возлюбленный
убийством	убийством
воссиял	воссиял
заклятое	заклятое
трубить	трубить
навести	навести
головою	головою
ставила	ставила
поту	поту
главным	главным
отвозили	отвозили
изгонять	изгонять
язвою	язвою
испортили	испортили
прогоните	прогоните
обольстить	обольстить
отлучите	отлучите
царю	царю
томить	томить
Духа	Духа
поместить	поместить
благом	благом
превозносить	превозносить
рада	рада
пожалуй	пожалуй
стражами	стражами
известила	известила
саранчи	саранчи
головы	головы
спасу	спасу
целые	целые
одолеть	одолеть
переходят	переходят
воспитывала	воспитывала
доброю	доброю
уменьшить	уменьшить
призванным	призванным
исцеляла	исцеляла
возгласите	возгласите
ослабела	ослабела
слушали	слушали
язв	язв
уступи	уступи
наполнила	наполнила
ослепить	ослепить
пьяного	пьяного
вопросить	вопросить
умерло	умерло
низком	низком
избить	избить
преследуйте	преследуйте
раскрытая	раскрытая
голов	голов
сынах	сынах
успокоить	успокоить
козлы	козлы
познаешь	познаешь
второю	второю
огорчен	огорчен
схватила	схватила
простертою	простертою
пали	пали
сохраняйте	сохраняйте
укрепи	укрепи
обнови	обнови
теснили	теснили
производите	производите
пустую	пустую
быть	быть
возливайте	возливайте
возлюбленные	возлюбленные
золота	золота
избранный	избранный
спешить	спешить
расслабленного	расслабленного
рули	рули
похитила	похитила
выслушать	выслушать
сладкое	сладкое
нечистоте	нечистоте
почитают	почитают
заплатите	заплатите
искушайте	искушайте
получили	получили
тверда	тверда
Иудин	Иудин
лукавые	лукавые
возлюбленного	возлюбленного
проклятого	проклятого
строишь	строишь
смертный	смертный
Приветствует	Приветствует
громом	громом
Дина	Дина
ослабеть	ослабеть
чужою	чужою
Благослови	Благослови
глазом	глазом
покрывала	покрывала
порядка	порядка
воплем	воплем
неверующие	неверующие
сухою	сухою
заклятым	заклятым
вину	вину
раздражите	раздражите
серебром	серебром
разделили	разделили
передвигай	передвигай
намерен	намерен
Израилеву	Израилеву
помнить	помнить
посылайте	посылайте
доводит	доводит
родили	родили
глазу	глазу
освяти	освяти
мутить	мутить
поясом	поясом
доходили	доходили
трубите	трубите
уразумейте	уразумейте
цари	цари
выбрасывайте	выбрасывайте
добыча	добыча
образу	образу
Дине	Дине
заходит	заходит
помышлять	помышлять
облаком	облаком
тельцам	тельцам
открытый	открытый
вноси	вноси
черные	черные
уповайте	уповайте
связанного	связанного
восстали	восстали
было	было
окончила	окончила
хочу	хочу
попросите	попросите
потаенного	потаенного
велите	велите
целого	целого
приклонили	приклонили
возврати	возврати
изменила	изменила
накормили	накормили
услышали	услышали
исчислили	исчислили
соверши	соверши
заразы	заразы
гола	гола
бесчести	бесчести
расположен	расположен
вредить	вредить
вытащили	вытащили
мутите	мутите
звездам	звездам
твари	твари
разори	разори
великой	великой
благодарить	благодарить
ослепили	ослепили
собирать	собирать
вытру	вытру
превратить	превратить
раздражили	раздражили
подарили	подарили
убитых	убитых
сохранить	сохранить
нового	нового
одинокою	одинокою
сказывали	сказывали
засевай	засевай
Царю	Царю
исполнили	исполнили
тьмы	тьмы
грешите	грешите
второй	второй
открытой	открытой
считай	считай
кропить	кропить
учили	учили
взывать	взывать
мог	мог
отступите	отступите
снохи	снохи
помилуй	помилуй
собранным	собранным
подкрепи	подкрепи
подкрепить	подкрепить
нечистою	нечистою
языческую	языческую
Христом	Христом
принудили	принудили
полированной	полированной
содержали	содержали
черным	черным
поступив	поступив
возвести	возвести
странствуйте	странствуйте
малых	малых
святого	святого
отыщите	отыщите
разорили	разорили
смешанные	смешанные
дворе	дворе
нарушили	нарушили
стоим	стоим
терпите	терпите
рака	рака
протоками	протоками
небольшой	небольшой
мухи	мухи
допустили	допустили
спорить	спорить
всходите	всходите
унывать	унывать
простертого	простертого
садите	садите
силе	силе
Тире	Тире
осадили	осадили
уцелел	уцелел
неверен	неверен
причинили	причинили
переходи	переходи
среду	среду
доходила	доходила
Душа	Душа
служи	служи
выслушайте	выслушайте
обольстила	обольстила
гвозди	гвозди
отпустим	отпустим
крестился	крестился
истуканом	истуканом
служили	служили
вело	вело
верующий	верующий
жилами	жилами
полюбила	полюбила
Дину	Дину
сухие	сухие
свободных	свободных
пленным	пленным
вспомни	вспомни
очистили	очистили
славить	славить
подкрепите	подкрепите
попросили	попросили
устроить	устроить
очисти	очисти
познает	познает
лицами	лицами
пара	пара
поя	поя
раздели	раздели
семейством	семейством
ослабели	ослабели
выходим	выходим
переносит	переносит
примером	примером
городом	городом
волах	волах
наставить	наставить
начинайте	начинайте
владеть	владеть
разложили	разложили
передвигают	передвигают
Силом	Силом
отличить	отличить
Матерь	Матерь
проклят	проклят
образом	образом
похоронить	похоронить
утопать	утопать
живым	живым
отринь	отринь
злою	злою
счете	счете
буду	буду
чудовища	чудовища
бич	бич
белого	белого
отличен	отличен
сходит	сходит
пересчитай	пересчитай
поворотили	поворотили
пророчеством	пророчеством
наушник	наушник
возлег	возлег
имевшая	имевшая
пьяные	пьяные
сделай	сделай
бить	бить
Святом	Святом
может	может
повороти	повороти
домом	домом
обратила	обратила
слушало	слушало
будут	будут
выходили	выходили
приносите	приносите
исходит	исходит
сознаю	сознаю
белою	белою
отходите	отходите
животные	животные
провозгласить	провозгласить
стеснили	стеснили
звезд	звезд
призывали	призывали
принесли	принесли
обнажи	обнажи
перехватили	перехватили
приветствуют	приветствуют
поем	поем
значить	значить
жабах	жабах
рыдать	рыдать
смешанное	смешанное
глухого	глухого
честные	честные
пухли	пухли
молодая	молодая
умирали	умирали
звезду	звезду
разрушить	разрушить
вине	вине
выполнить	выполнить
громов	громов
сравните	сравните
дух	дух
меньше	меньше
мертвый	мертвый
путевой	путевой
объявить	объявить
отдайте	отдайте
уверен	уверен
понесло	понесло
Галилейскую	Галилейскую
столпе	столпе
защищайте	защищайте
получила	получила
пригласи	пригласи
раба	раба
сироте	сироте
нем	нем
поднял	поднял
проповедуй	проповедуй
сосчитай	сосчитай
напоен	напоен
козлах	козлах
порази	порази
разрешите	разрешите
золотого	золотого
разорить	разорить
возвратите	возвратите
прилагайте	прилагайте
узнай	узнай
узнаю	узнаю
тень	тень
низринь	низринь
объявила	объявила
тьму	тьму
малы	малы
пойте	пойте
замечайте	замечайте
пухла	пухла
призывать	призывать
запретить	запретить
строился	строился
похоронили	похоронили
жару	жару
вин	вин
искушали	искушали
лежали	лежали
первое	первое
строите	строите
фараону	фараону
изнеженная	изнеженная
приветствуй	приветствуй
лесу	лесу
даруй	даруй
родившие	родившие
бросили	бросили
утру	утру
велико	велико
гумном	гумном
погасить	погасить
духовным	духовным
стоит	стоит
придворным	придворным
травы	травы
располагал	располагал
направили	направили
посохом	посохом
больше	больше
лицу	лицу
скованный	скованный
телом	телом
наступить	наступить
принадлежащую	принадлежащую
разграбили	разграбили
изливать	изливать
наполняла	наполняла
целом	целом
внимайте	внимайте
подтвердить	подтвердить
множеством	множеством
проходишь	проходишь
замолчи	замолчи
утомленного	утомленного
другой	другой
тысячу	тысячу
возлюбили	возлюбили
неверные	неверные
оставить	оставить
теле	теле
пища	пища
вкусите	вкусите
живого	живого
языке	языке
ртом	ртом
призванные	призванные
уразуметь	уразуметь
первом	первом
проводите	проводите
избранная	избранная
Рев	Рев
спешила	спешила
Апостол	Апостол
разрушили	разрушили
уразумел	уразумел
Богом	Богом
согрешить	согрешить
вырос	вырос
сосчитать	сосчитать
разбили	разбили
превозмогла	превозмогла
пола	пола
поддерживали	поддерживали
дали	дали
восклицайте	восклицайте
первых	первых
снабдили	снабдили
худа	худа
стоишь	стоишь
превозносился	превозносился
возложить	возложить
вторым	вторым
желать	желать
исследуй	исследуй
подняло	подняло
преданный	преданный
жила	жила
слепым	слепым
протянут	протянут
приходили	приходили
сокрушили	сокрушили
хвалить	хвалить
велишь	велишь
внушили	внушили
давили	давили
открыт	открыт
отыщи	отыщи
погубили	погубили
светить	светить
Бела	Бела
мою	мою
оробел	оробел
познала	познала
сторож	сторож
украсила	украсила
похитили	похитили
держали	держали
подними	подними
поспешив	поспешив
Израильской	Израильской
скот	скот
хулите	хулите
черта	черта
убеди	убеди
лице	лице
смирен	смирен
завладейте	завладейте
призывайте	призывайте
юноше	юноше
бросить	бросить
чужое	чужое
возлюбите	возлюбите
признают	признают
думайте	думайте
очистить	очистить
восстал	восстал
носить	носить
затрубите	затрубите
одетого	одетого
положила	положила
смел	смел
другого	другого
весом	весом
камню	камню
Новы	Новы
уходили	уходили
осквернила	осквернила
червю	червю
прислугу	прислугу
разным	разным
отвален	отвален
подтверди	подтверди
Велик	Велик
твердых	твердых
приложили	приложили
допустила	допустила
сказало	сказало
убедили	убедили
искали	искали
окружила	окружила
принята	принята
обладать	обладать
торжествуйте	торжествуйте
Тем	Тем
дрогнуло	дрогнуло
творили	творили
голосом	голосом
восстановите	восстановите
тысячам	тысячам
населенный	населенный
онемел	онемел
определили	определили
бела	бела
продолжала	продолжала
скорым	скорым
объясним	объясним
горькая	горькая
похвалили	похвалили
внука	внука
взяло	взяло
било	било
Ханаанскою	Ханаанскою
воздала	воздала
простираете	простираете
смело	смело
чтите	чтите
выдай	выдай
правою	правою
приняло	приняло
возвратить	возвратить
постыдить	постыдить
отложи	отложи
располагая	располагая
шипа	шипа
каплет	каплет
покрова	покрова
пожалеть	пожалеть
иные	иные
нагой	нагой
возложите	возложите
предсказывайте	предсказывайте
пророчествуй	пророчествуй
Сеном	Сеном
овцою	овцою
садили	садили
истребила	истребила
блудить	блудить
страдали	страдали
шестой	шестой
духами	духами
считают	считают
рад	рад
укрепили	укрепили
спешите	спешите
обходить	обходить
потаенном	потаенном
придворных	придворных
скрытое	скрытое
Благ	Благ
посмотри	посмотри
ослабевайте	ослабевайте
нечистота	нечистота
язычески	язычески
жало	жало
смешанных	смешанных
избавили	избавили
скал	скал
пернатых	пернатых
исчисли	исчисли
пригласили	пригласили
голове	голове
столп	столп
теснить	теснить
левша	левша
возьмем	возьмем
восклицали	восклицали
лукавым	лукавым
месте	месте
покоить	покоить
оценить	оценить
отступили	отступили
подпал	подпал
богом	богом
замесила	замесила
хулить	хулить
выходят	выходят
вышли	вышли
безумных	безумных
святом	святом
берега	берега
страхом	страхом
забытых	забытых
погреби	погреби
наполняйте	наполняйте
половине	половине
белый	белый
доходит	доходит
ничтожества	ничтожества
развалиною	развалиною
возносить	возносить
почтили	почтили
снегом	снегом
Цари	Цари
второго	второго
свободным	свободным
родословные	родословные
одушевленных	одушевленных
животным	животным
святую	святую
простить	простить
твердое	твердое
мал	мал
молодой	молодой
входить	входить
отдало	отдало
чудным	чудным
козлам	козлам
жилой	жилой
козлом	козлом
считаешь	считаешь
наложите	наложите
фараона	фараона
купили	купили
повод	повод
реке	реке
пьющий	пьющий
стоят	стоят
благодарите	благодарите
опустошен	опустошен
дозволяй	дозволяй
потускло	потускло
считайте	считайте
нарушить	нарушить
убогого	убогого
подвиг	подвиг
влекло	влекло
видим	видим
Даном	Даном
добро	добро
иссох	иссох
возвысить	возвысить
рабою	рабою
щади	щади
скрепить	скрепить
страшное	страшное
живой	живой
сокройте	сокройте
почтить	почтить
тверди	тверди
долги	долги
принимали	принимали
уверить	уверить
почетных	почетных
пленные	пленные
сварите	сварите
щадите	щадите
почитаете	почитаете
сварили	сварили
звезде	звезде
убитым	убитым
устроили	устроили
проси	проси
мытарь	мытарь
меха	меха
хранить	хранить
наследуйте	наследуйте
постиг	постиг
венце	венце
аспиды	аспиды
обрати	обрати
отцах	отцах
свитком	свитком
истребили	истребили
века	века
превозмогли	превозмогли
звезда	звезда
звездах	звездах
предложили	предложили
попроси	попроси
образует	образует
победит	победит
выслушай	выслушай
царя	царя
убила	убила
воронов	воронов
приветствуйте	приветствуйте
молоти	молоти
любим	любим
перемените	перемените
удалили	удалили
откройте	откройте
смешанная	смешанная
слушать	слушать
сделайте	сделайте
брани	брани
отделить	отделить
пить	пить
сберегите	сберегите
принятые	принятые
Реву	Реву
изнеженную	изнеженную
войске	войске
столах	столах
бесноватым	бесноватым
немало	немало
вымойте	вымойте
признать	признать
оставляйте	оставляйте
насадила	насадила
храните	храните
слепого	слепого
исправить	исправить
вложи	вложи
проповедуйте	проповедуйте
перехватите	перехватите
Ком	Ком
мертвою	мертвою
Был	Был
прославили	прославили
лукавых	лукавых
молотить	молотить
пребывать	пребывать
жернов	жернов
рубите	рубите
путевые	путевые
проходить	проходить
уразумели	уразумели
красный	красный
увеличили	увеличили
испытанных	испытанных
пустою	пустою
ходить	ходить
купите	купите
раздражить	раздражить
люди	люди
оскудели	оскудели
предавала	предавала
спали	спали
пол	пол
верху	верху
гвоздем	гвоздем
отправляйте	отправляйте
отделите	отделите
дома	дома
кругу	кругу
посылали	посылали
избавляйте	избавляйте
цветами	цветами
Свою	Свою
отдали	отдали
умирающий	умирающий
увеличить	увеличить
подходить	подходить
града	града
суди	суди
плачу	плачу
станом	станом
кадить	кадить
спросите	спросите
искупи	искупи
приветствуете	приветствуете
сделанной	сделанной
получить	получить
сатане	сатане
отходила	отходила
предсказывали	предсказывали
траву	траву
открывали	открывали
поводом	поводом
возлюбленным	возлюбленным
слышали	слышали
устройстве	устройстве
превратили	превратили
выговорить	выговорить
устрашить	устрашить
Своем	Своем
прочитайте	прочитайте
пути	пути
смутили	смутили
нагою	нагою
умерщвляй	умерщвляй
одетый	одетый
бабкам	бабкам
вносите	вносите
меньшая	меньшая
пожалели	пожалели
возлюбленный	возлюбленный
дайте	дайте
ведите	ведите
приклони	приклони
смирите	смирите
возрос	возрос
тленного	тленного
хвали	хвали
возлюбленных	возлюбленных
умножили	умножили
раздирающий	раздирающий
сказала	сказала
растить	растить
возлюбленною	возлюбленною
сухую	сухую
искало	искало
моем	моем
торгу	торгу
протяни	протяни
местом	местом
воздухе	воздухе
одержимых	одержимых
послужив	послужив
слушайте	слушайте
посрами	посрами
внушить	внушить
жертв	жертв
отлучить	отлучить
язык	язык
даруешь	даруешь
искала	искала
силу	силу
искусить	искусить
рыдайте	рыдайте
устрашили	устрашили
верха	верха
мешка	мешка
старые	старые
платите	платите
изливайте	изливайте
посвятите	посвятите
укрепить	укрепить
исполните	исполните
сатана	сатана
желай	желай
служить	служить
Души	Души
сказывала	сказывала
познать	познать
почиет	почиет
бесноватые	бесноватые
духом	духом
выкупите	выкупите
любила	любила
опьянейте	опьянейте
временные	временные
растворила	растворила
божеству	божеству
языческой	языческой
говорили	говорили
мыслите	мыслите
красных	красных
выполняла	выполняла
литого	литого
вспомните	вспомните
Дух	Дух
замер	замер
предупреди	предупреди
матери	матери
Моя	Моя
одре	одре
опустошили	опустошили
немым	немым
похитить	похитить
противоречить	противоречить
разреши	разреши
Мой	Мой
мытаря	мытаря
определить	определить
нечиста	нечиста
возлюби	возлюби
жары	жары
ужин	ужин
убийце	убийце
воздайте	воздайте
выстроить	выстроить
членом	членом
царях	царях
тверды	тверды
страх	страх
скале	скале
выходила	выходила
человеческою	человеческою
цвета	цвета
потом	потом
творила	творила
опустошить	опустошить
старое	старое
восполнили	восполнили
наставили	наставили
живом	живом
отяготили	отяготили
смотрите	смотрите
морем	морем
научен	научен
принесло	принесло
козлами	козлами
страху	страху
обличить	обличить
сторожа	сторожа
узнать	узнать
малые	малые
моя	моя
фараон	фараон
разводите	разводите
пар	пар
умертви	умертви
жемчугом	жемчугом
проклинай	проклинай
стражу	стражу
яму	яму
защитить	защитить
вытащи	вытащи
обветшала	обветшала
служила	служила
выведите	выведите
расспроси	расспроси
благ	благ
знакомые	знакомые
своем	своем
продолжало	продолжало
убитые	убитые
преуспевали	преуспевали
богатых	богатых
небом	небом
неверным	неверным
вкусить	вкусить
иным	иным
стражи	стражи
давить	давить
рои	рои
находили	находили
наложить	наложить
судился	судился
простирай	простирай
предупредили	предупредили
голою	голою
молила	молила
сладкого	сладкого
кормила	кормила
приняли	приняли
блаженного	блаженного
возливали	возливали
рабу	рабу
восстанови	восстанови
больные	больные
имеют	имеют
отвратить	отвратить
отвалят	отвалят
овладели	овладели
стояло	стояло
юношах	юношах
Бог	Бог
черных	черных
принадлежащие	принадлежащие
извести	извести
среды	среды
жертвах	жертвах
имея	имея
освободи	освободи
дополнить	дополнить
молодых	молодых
пребывайте	пребывайте
отделен	отделен
Хочешь	Хочешь
возливай	возливай
одет	одет
счетом	счетом
просить	просить
открытою	открытою
открытую	открытую
удерживать	удерживать
взять	взять
защити	защити
были	были
светила	светила
Благо	Благо
води	води
согрешив	согрешив
откормленные	откормленные
ночное	ночное
челах	челах
духовных	духовных
пожалел	пожалел
тверд	тверд
слушала	слушала
расположили	расположили
противоречили	противоречили
славили	славили
приготовили	приготовили
запрудили	запрудили
сходи	сходи
блудила	блудила
подумали	подумали
рой	рой
одетым	одетым
обратили	обратили
веди	веди
добычу	добычу
пьяною	пьяною
возьмет	возьмет
прибыли	прибыли
молчали	молчали
ростом	ростом
бедных	бедных
льстили	льстили
духам	духам
старого	старого
злаков	злаков
сложить	сложить
мои	мои
сердечным	сердечным
оказывай	оказывай
спустила	спустила
губить	губить
проклятых	проклятых
рабе	рабе
исполняй	исполняй
требуйте	требуйте
держите	держите
весе	весе
пищи	пищи
любите	любите
кадила	кадила
велят	велят
Духе	Духе
тестом	тестом
медлите	медлите
имевшие	имевшие
первым	первым
снисходите	снисходите
беременная	беременная
сухой	сухой
испытанный	испытанный
искать	искать
правый	правый
сравнить	сравнить
разит	разит
распознает	распознает
возлюбленном	возлюбленном
посылала	посылала
пропасть	пропасть
рабы	рабы
шестом	шестом
камни	камни
отводили	отводили
облегчи	облегчи
могла	могла
жемчуга	жемчуга
объяснили	объяснили
отсек	отсек
устранили	устранили
изменит	изменит
поднять	поднять
морю	морю
Приветствуют	Приветствуют
выступить	выступить
реки	реки
Можешь	Можешь
родить	родить
пас	пас
отходит	отходит
паре	паре
обществе	обществе
выслушали	выслушали
напоминать	напоминать
замолчу	замолчу
передвигает	передвигает
дрогнули	дрогнули
Возлюбленного	Возлюбленного
наклони	наклони
лгите	лгите
печь	печь
зиму	зиму
делить	делить
чужую	чужую
семействе	семействе
глаза	глаза
возьмешь	возьмешь
двором	двором
Силу	Силу
отпустить	отпустить
мыслить	мыслить
снимите	снимите
исполнила	исполнила
отпустила	отпустила
простертой	простертой
рыдали	рыдали
покройте	покройте
Христу	Христу
яме	яме
пьяных	пьяных
согрешите	согрешите
точило	точило
опьянел	опьянел
белых	белых
окружили	окружили
смешанного	смешанного
доводить	доводить
прочитай	прочитай
нага	нага
чужой	чужой
имеете	имеете
люби	люби
произносить	произносить
старых	старых
услышите	услышите
большую	большую
мешки	мешки
помилуйте	помилуйте
превозносите	превозносите
остановила	остановила
говорила	говорила
разграбить	разграбить
приступив	приступив
молоком	молоком
сделало	сделало
заговорит	заговорит
срубили	срубили
избранного	избранного
страха	страха
старою	старою
вводите	вводите
последовала	последовала
изменить	изменить
наги	наги
поговорить	поговорить
воскурить	воскурить
возбуди	возбуди
схватить	схватить
полированную	полированную
можешь	можешь
кончен	кончен
заходят	заходят
приготовить	приготовить
тени	тени
собирай	собирай
Бога	Бога
нечистым	нечистым
овнов	овнов
числом	числом
бел	бел
захватить	захватить
благословила	благословила
живая	живая
обвинить	обвинить
благослови	благослови
хромых	хромых
служите	служите
бесчестите	бесчестите
сестре	сестре
преступить	преступить
худ	худ
выносит	выносит
молодую	молодую
богатым	богатым
пил	пил
вводили	вводили
слепой	слепой
низложить	низложить
охраняйте	охраняйте
сходите	сходите
мечом	мечом
палить	палить
письме	письме
имущество	имущество
восстало	восстало
половина	половина
ела	ела
облаке	облаке
утомленных	утомленных
чадо	чадо
лишить	лишить
поспешите	поспешите
жил	жил
спешит	спешит
воспитывайте	воспитывайте
переносим	переносим
укрепите	укрепите
благе	благе
мертвым	мертвым
сотворили	сотворили
сделали	сделали
скалами	скалами
поступить	поступить
простирала	простирала
благословляй	благословляй
иссохли	иссохли
Воздайте	Воздайте
новые	новые
малый	малый
почиешь	почиешь
столом	столом
говорите	говорите
