Verwundeten	Verwundeten
Bundesgebiet	Bundesgebiet
beschottre	beschottre
ausgereckt	ausgereckt
entsündigen	entsündigen
tunet	tunet
widmet	widmet
schätzte	schätzte
schnitten	schnitten
Managementsystemen	Managementsystemen
springst	springst
Schaffnerinnen	Schaffnerinnen
Glaubet	Glaubet
erlaube	erlaube
lege	lege
schneidend	schneidend
Dezernat	Dezernat
verabschiedetet	verabschiedetet
Ionenaustauscher	Ionenaustauscher
Portal	Portal
Adenosin	Adenosin
gerne	gerne
vermahnt	vermahnt
Libellen	Libellen
löse	löse
Ion	Ion
meinte	meinte
schaffen	schaffen
grübelte	grübelte
vertilge	vertilge
quietschest	quietschest
streiten	streiten
Selbstsicherheit	Selbstsicherheit
recycelten	recycelten
sedimentiert	sedimentiert
Streife	Streife
WebHook	WebHook
bewies	bewies
knautsche	knautsche
fahret	fahret
zerschlaget	zerschlaget
verweise	verweise
verwahrt	verwahrt
Heiratsgut	Heiratsgut
eiterte	eiterte
konsumieren	konsumieren
Deutung	Deutung
verglühte	verglühte
Fußballweltmeisterschaftsqualifikationsspielen	Fußballweltmeisterschaftsqualifikationsspielen
naschten	naschten
Leichnamen	Leichnamen
verspäteten	verspäteten
verlötest	verlötest
Heben	Heben
Urheimaten	Urheimaten
Messies	Messies
concessionieren	concessionieren
Herrn	Herrn
Ei	Ei
mangeln	mangeln
mineralisierten	mineralisierten
anrichtet	anrichtet
tatet	tatet
Gelobt	Gelobt
Schau	Schau
gelangt	gelangt
Ängsten	Ängsten
Schickse	Schickse
Grüßet	Grüßet
losten	losten
Helmen	Helmen
beschottert	beschottert
unsres	unsres
klumpt	klumpt
malträtiert	malträtiert
bedingten	bedingten
emittierte	emittierte
torpediert	torpediert
ersparte	ersparte
Hacker	Hacker
konnotieret	konnotieret
weinen	weinen
malten	malten
vandaliere	vandaliere
zentrifugieren	zentrifugieren
billigen	billigen
Wadenbein	Wadenbein
Rückweg	Rückweg
lose	lose
schlabbere	schlabbere
mißverstehet	mißverstehet
anhanget	anhanget
arm	arm
verbitterte	verbitterte
weinet	weinet
Smaragdkehlkolibris	Smaragdkehlkolibris
producieret	producieret
dramatisieren	dramatisieren
Vipernatter	Vipernatter
Rücktritt	Rücktritt
faschieren	faschieren
Technetaten	Technetaten
preise	preise
Abbindebeschleuniger	Abbindebeschleuniger
Kupferkiese	Kupferkiese
Feinde	Feinde
überfällst	überfällst
kommest	kommest
stickt	stickt
Acetaten	Acetaten
Ränken	Ränken
Physikerinnen	Physikerinnen
mußt	mußt
beschwören	beschwören
habet	habet
Muster	Muster
Fanmeilen	Fanmeilen
Amokläuferinnen	Amokläuferinnen
besänne	besänne
Maultieren	Maultieren
Trotzkisten	Trotzkisten
konvertieren	konvertieren
skypet	skypet
Schnipseln	Schnipseln
Pforten	Pforten
urteilen	urteilen
meinet	meinet
Molybdite	Molybdite
bölkte	bölkte
Erstlinge	Erstlinge
Alle	Alle
besucht	besucht
Locken	Locken
Basilisken	Basilisken
breche	breche
schenkte	schenkte
bombardiert	bombardiert
erwürgest	erwürgest
steigerten	steigerten
besorgend	besorgend
erlasset	erlasset
Wasserbädern	Wasserbädern
Pflanzenstoff	Pflanzenstoff
verseift	verseift
letzten	letzten
grien	grien
Privatsachen	Privatsachen
Händedruck	Händedruck
watet	watet
jappen	jappen
webet	webet
Farbstoffe	Farbstoffe
Gegebenheit	Gegebenheit
Rückumschlages	Rückumschlages
Küchenmaschinen	Küchenmaschinen
Schwermetallion	Schwermetallion
verliere	verliere
Kassettenrekorder	Kassettenrekorder
Sagen	Sagen
Teilen	Teilen
Saget	Saget
erstehet	erstehet
Aromastoffen	Aromastoffen
reanimiere	reanimiere
brillieren	brillieren
stand	stand
vernehmest	vernehmest
Gaunern	Gaunern
Möbelstoffen	Möbelstoffen
springen	springen
spielen	spielen
Fluoratome	Fluoratome
beeinflusst	beeinflusst
Raute	Raute
Rutheniumkomplexen	Rutheniumkomplexen
bricht	bricht
reifte	reifte
Bäche	Bäche
Schober	Schober
Einfältigkeiten	Einfältigkeiten
offenbare	offenbare
verringerten	verringerten
Sehne	Sehne
erfüllst	erfüllst
schenke	schenke
segeln	segeln
zeugte	zeugte
gebietet	gebietet
defragmentierten	defragmentierten
Fröschen	Fröschen
dankte	dankte
Monden	Monden
stoppte	stoppte
Geräte	Geräte
besäen	besäen
ihrem	ihrem
Remisen	Remisen
grause	grause
evaluiert	evaluiert
Fellhandschuhen	Fellhandschuhen
Wasserbades	Wasserbades
verrosteten	verrosteten
verschont	verschont
Rekursion	Rekursion
liege	liege
erntest	erntest
Füchse	Füchse
viele	viele
Keine	Keine
Rückumschlägen	Rückumschlägen
Teppiche	Teppiche
Anliegen	Anliegen
schweigst	schweigst
Trägergasen	Trägergasen
Ångström	Ångström
bücktest	bücktest
Ha	Ha
Zeug	Zeug
aufstehet	aufstehet
Anfechtungen	Anfechtungen
bombardiere	bombardiere
Hahnenkämme	Hahnenkämme
Schicksen	Schicksen
besprichst	besprichst
Magier	Magier
parfümierte	parfümierte
foppst	foppst
grünte	grünte
Linguisten	Linguisten
Gebete	Gebete
gelobend	gelobend
Gemeinde	Gemeinde
Orgel	Orgel
pflegst	pflegst
trägt	trägt
Alkali	Alkali
erniedrigst	erniedrigst
kupieren	kupieren
verbirgst	verbirgst
hastete	hastete
verschlimmerte	verschlimmerte
hatte	hatte
Geigerzähler	Geigerzähler
vertilgen	vertilgen
glühenden	glühenden
reparierten	reparierten
gereicht	gereicht
Finanzministern	Finanzministern
selber	selber
funktionierte	funktionierte
Sollten	Sollten
nahte	nahte
Leugnungen	Leugnungen
verwerten	verwerten
schweigen	schweigen
Amnestie	Amnestie
Werkzeugen	Werkzeugen
verselbständigst	verselbständigst
verpufftest	verpufftest
Urologe	Urologe
zerfielen	zerfielen
Wandergewerbe	Wandergewerbe
harren	harren
rufst	rufst
bemächtigte	bemächtigte
lügst	lügst
nahest	nahest
velarisiert	velarisiert
zupfte	zupfte
sage	sage
ungeistlich	ungeistlich
speiset	speiset
harmoniert	harmoniert
Konifere	Konifere
Assistentinnen	Assistentinnen
verklärest	verklärest
rühmte	rühmte
Kraftfahrzeugen	Kraftfahrzeugen
Fluorkohlenwasserstoffe	Fluorkohlenwasserstoffe
wegen	wegen
malträtierte	malträtierte
verschaffte	verschaffte
fülle	fülle
dolmetschst	dolmetschst
Ebene	Ebene
dissentierten	dissentierten
entrümpelest	entrümpelest
loben	loben
Gefangene	Gefangene
verprügelte	verprügelte
klagte	klagte
Borkenkäfer	Borkenkäfer
Flöte	Flöte
Berufe	Berufe
Gigapascal	Gigapascal
plärrtest	plärrtest
Zwergschwanes	Zwergschwanes
Füchsin	Füchsin
Beilen	Beilen
Bettler	Bettler
Thioacetal	Thioacetal
wiederkamt	wiederkamt
mischt	mischt
verbärgen	verbärgen
hebst	hebst
entfachten	entfachten
oxidierst	oxidierst
frappierte	frappierte
Hubschrauber	Hubschrauber
Streichen	Streichen
Worten	Worten
dividiert	dividiert
verbüßest	verbüßest
Zur-Schau-Stellen	Zur-Schau-Stellen
leiden	leiden
Linguist	Linguist
Könige	Könige
nähe	nähe
Satzungen	Satzungen
Ausländer	Ausländer
reagiert	reagiert
rolltet	rolltet
ausziehst	ausziehst
Landwirt	Landwirt
Gläubige	Gläubige
lesen	lesen
erzeige	erzeige
kichern	kichern
ausgereckte	ausgereckte
privatisierest	privatisierest
Mitwisserschaft	Mitwisserschaft
Sexte	Sexte
malochet	malochet
eingehet	eingehet
Führet	Führet
erben	erben
buddelten	buddelten
fegst	fegst
Binde	Binde
scheu	scheu
straften	straften
schummelst	schummelst
Langeweile	Langeweile
beunruhigte	beunruhigte
knüpfen	knüpfen
widerstanden	widerstanden
feire	feire
weissagst	weissagst
schmettern	schmettern
Steiget	Steiget
plagen	plagen
plagest	plagest
interpretierten	interpretierten
nimmst	nimmst
Türklingeln	Türklingeln
begrabe	begrabe
Trotzkist	Trotzkist
erlösen	erlösen
kabelst	kabelst
meißeltest	meißeltest
aase	aase
Zensus	Zensus
Strontiumamalgams	Strontiumamalgams
Autoklav	Autoklav
Unglauben	Unglauben
bewässerest	bewässerest
Polierstählen	Polierstählen
Deckenzapfen	Deckenzapfen
klemmt	klemmt
kaufte	kaufte
blondiert	blondiert
entzögen	entzögen
addieren	addieren
Jahre	Jahre
schlaft	schlaft
lügt	lügt
idealisierten	idealisierten
Galoppen	Galoppen
duckt	duckt
berühret	berühret
Bilderstürmers	Bilderstürmers
Reiterschwertern	Reiterschwertern
Sportlerin	Sportlerin
schrecken	schrecken
Panamaer	Panamaer
verbluteten	verbluteten
dotierst	dotierst
bräunen	bräunen
treibest	treibest
warnt	warnt
sicherst	sicherst
analysieret	analysieret
Ente	Ente
Anzeichen	Anzeichen
Busen	Busen
Genie	Genie
Wisset	Wisset
rote	rote
Noseanen	Noseanen
Zwangsarbeiterin	Zwangsarbeiterin
applizirst	applizirst
tyrannisierte	tyrannisierte
ratet	ratet
schenkst	schenkst
nehmet	nehmet
verdammet	verdammet
verkapselten	verkapselten
wechseln	wechseln
Bademantel	Bademantel
Anfänger	Anfänger
hievst	hievst
gereichte	gereichte
Füchsen	Füchsen
schautest	schautest
einerntest	einerntest
hassest	hassest
Afrikaner	Afrikaner
wurden	wurden
wässerten	wässerten
Schwarzseherin	Schwarzseherin
ritze	ritze
Jagdbomber	Jagdbomber
Buben	Buben
Elementarzelle	Elementarzelle
Gründungsprivileg	Gründungsprivileg
Schreiben	Schreiben
frikassierend	frikassierend
Konfitüren	Konfitüren
liehen	liehen
downloadete	downloadete
Leisten	Leisten
geahnt	geahnt
Stiefvater	Stiefvater
füllst	füllst
wehret	wehret
ritzten	ritzten
erkälteten	erkälteten
widmeten	widmeten
Bifurkationen	Bifurkationen
reichtest	reichtest
Werden	Werden
malt	malt
Buchfink	Buchfink
Deuteriums	Deuteriums
boß	boß
ungefälschter	ungefälschter
Kerzenfischen	Kerzenfischen
pfände	pfände
entschädiget	entschädiget
gehet	gehet
Preisanstiegen	Preisanstiegen
Wachen	Wachen
gestikuliere	gestikuliere
amenagierst	amenagierst
klonet	klonet
Darlehen	Darlehen
Malaysier	Malaysier
beteuerten	beteuerten
Kriegsschauplatz	Kriegsschauplatz
rundest	rundest
Linken	Linken
Falltürme	Falltürme
Erste	Erste
Säcke	Säcke
verderbet	verderbet
WebHooks	WebHooks
lebet	lebet
Außenministerium	Außenministerium
NAND-Gatter	NAND-Gatter
still	still
Erzeugung	Erzeugung
Honigbären	Honigbären
zerrissen	zerrissen
zerstreut	zerstreut
entsetzt	entsetzt
Name	Name
streite	streite
Ansteckern	Ansteckern
Rast	Rast
heischten	heischten
motivieren	motivieren
wohnst	wohnst
hänget	hänget
knusperten	knusperten
verkürzt	verkürzt
kühle	kühle
ermahnet	ermahnet
Rücktrittes	Rücktrittes
reichst	reichst
bauet	bauet
Denkmünzen	Denkmünzen
arbeiten	arbeiten
austilgest	austilgest
lösten	lösten
handhaben	handhaben
werte	werte
schau	schau
verkündigest	verkündigest
verhalte	verhalte
Kontraindikationen	Kontraindikationen
bestellt	bestellt
zanket	zanket
lebst	lebst
Gepäckträger	Gepäckträger
verdrängen	verdrängen
Weinberge	Weinberge
fritierten	fritierten
Lüsten	Lüsten
zeltest	zeltest
scheuchtest	scheuchtest
Empfängnisverhütungen	Empfängnisverhütungen
Erfahrung	Erfahrung
Arsenbergwerken	Arsenbergwerken
Regiert	Regiert
Meinem	Meinem
Gästen	Gästen
zittertest	zittertest
Deuterium	Deuterium
möget	möget
blitzen	blitzen
egalisierten	egalisierten
Polierstahl	Polierstahl
Buntwaschmittel	Buntwaschmittel
grünen	grünen
Exzentriker	Exzentriker
gelang	gelang
berührt	berührt
grienest	grienest
Brite	Brite
Sprichwörtern	Sprichwörtern
abweichet	abweichet
verselbstständige	verselbstständige
wachse	wachse
beantragt	beantragt
tust	tust
sorgte	sorgte
duzen	duzen
schwadroniert	schwadroniert
lehrst	lehrst
kramst	kramst
lachet	lachet
sedimentieret	sedimentieret
zerstücken	zerstücken
Artischocken	Artischocken
Fette	Fette
heißest	heißest
repräsentieret	repräsentieret
Mensch	Mensch
überreichen	überreichen
spezialisiere	spezialisiere
Kassiteriten	Kassiteriten
dümpelte	dümpelte
Kleptokratien	Kleptokratien
verkauft	verkauft
brause	brause
Schlager	Schlager
Zehnt	Zehnt
Gedicht	Gedicht
verbaselte	verbaselte
kranken	kranken
Sigle	Sigle
Prozedur	Prozedur
lehret	lehret
Pentaboraten	Pentaboraten
kickend	kickend
scheuchten	scheuchten
Stätte	Stätte
freiwillige	freiwillige
Europameistern	Europameistern
hebräisch	hebräisch
Fusseln	Fusseln
Stilllegungen	Stilllegungen
Gasflasche	Gasflasche
bitten	bitten
verkleinern	verkleinern
seist	seist
Ratsherr	Ratsherr
Oheim	Oheim
Geschwindigkeitsmesser	Geschwindigkeitsmesser
sabbre	sabbre
fingiere	fingiere
übersteht	übersteht
Bombardierungen	Bombardierungen
Dürren	Dürren
kasernierte	kasernierte
kristallisiertest	kristallisiertest
Gemüseläden	Gemüseläden
hantierte	hantierte
Bildschirmfotos	Bildschirmfotos
ehre	ehre
Unter	Unter
Silberdrahts	Silberdrahts
Blumensträußen	Blumensträußen
sollten	sollten
Halogenatomen	Halogenatomen
Gallanen	Gallanen
Joche	Joche
fluppen	fluppen
Kopfsalaten	Kopfsalaten
Küsserei	Küsserei
beäugen	beäugen
wehrten	wehrten
Last	Last
Kalb	Kalb
fallest	fallest
Sprachraum	Sprachraum
puste	puste
Stadtbezirke	Stadtbezirke
vergibt	vergibt
Eilande	Eilande
belohnten	belohnten
Tiefschutzen	Tiefschutzen
allem	allem
willst	willst
Patres	Patres
grüße	grüße
Steuerberatern	Steuerberatern
erkennest	erkennest
zürntet	zürntet
Kein	Kein
Gewürze	Gewürze
jauchzt	jauchzt
entrümpelst	entrümpelst
auflegst	auflegst
Helden	Helden
konvergierest	konvergierest
herrschen	herrschen
reizt	reizt
dringst	dringst
reizte	reizte
fließt	fließt
Adelungen	Adelungen
egge	egge
mühte	mühte
Biene	Biene
fabulierest	fabulierest
Märtyrern	Märtyrern
Halleluja	Halleluja
mache	mache
Hehlern	Hehlern
desensibilisierte	desensibilisierte
bimmelten	bimmelten
leuchtete	leuchtete
verschränkest	verschränkest
Gläubiger	Gläubiger
vermutet	vermutet
höhnest	höhnest
konnte	konnte
Gefängnisse	Gefängnisse
Reinelemente	Reinelemente
Laufen	Laufen
verspielest	verspielest
scherzt	scherzt
äussern	äussern
bereitete	bereitete
Toren	Toren
querte	querte
Eutern	Eutern
notlandet	notlandet
grabble	grabble
Rechtsruck	Rechtsruck
Kruste	Kruste
Generation	Generation
Jünglinge	Jünglinge
Atombomben	Atombomben
Almanache	Almanache
ankern	ankern
arbeit	arbeit
fraget	fraget
begehr	begehr
hattest	hattest
unterstützet	unterstützet
erzeigte	erzeigte
sehet	sehet
erzeigen	erzeigen
Zapfhähnen	Zapfhähnen
schnell	schnell
zählte	zählte
Kuckucke	Kuckucke
Narkotikum	Narkotikum
Wadenbeines	Wadenbeines
brandet	brandet
Shortcuts	Shortcuts
Zitronensaft	Zitronensaft
Festons	Festons
denaturiert	denaturiert
Worte	Worte
sagte	sagte
hieltest	hieltest
schmuggele	schmuggele
Klüfte	Klüfte
drillte	drillte
Kutter	Kutter
enttäuschtest	enttäuschtest
weichst	weichst
massierend	massierend
Atemgasen	Atemgasen
befördert	befördert
Finanzminister	Finanzminister
Speeren	Speeren
kreierten	kreierten
Blockflöte	Blockflöte
Tetraiodiden	Tetraiodiden
Volkslehre	Volkslehre
revoltieren	revoltieren
sagt	sagt
Zerfällen	Zerfällen
skypst	skypst
Pudern	Pudern
Anlass	Anlass
raten	raten
glaubt	glaubt
zappten	zappten
tappst	tappst
schauest	schauest
Bagger	Bagger
verlautet	verlautet
verselbstständigest	verselbstständigest
Pfunde	Pfunde
emailliert	emailliert
Lärche	Lärche
Städte	Städte
Dachdecker	Dachdecker
letzte	letzte
Aktienkurs	Aktienkurs
empörte	empörte
träumte	träumte
Autoklaven	Autoklaven
vertonet	vertonet
vertagt	vertagt
Schlägst	Schlägst
all	all
fritiert	fritiert
hadere	hadere
denen	denen
musizierte	musizierte
Asylrechten	Asylrechten
umarbeitest	umarbeitest
verstört	verstört
eng	eng
Tun	Tun
Blitze	Blitze
erzürnet	erzürnet
Meine	Meine
taufst	taufst
spezialisierst	spezialisierst
unterstützten	unterstützten
Anachronismus	Anachronismus
duschten	duschten
murmeln	murmeln
habe	habe
außer	außer
Decket	Decket
verkröchet	verkröchet
Vorstädte	Vorstädte
inszeniere	inszeniere
benütztest	benütztest
stürzen	stürzen
fladern	fladern
beschrifte	beschrifte
fluche	fluche
Retter	Retter
beneidest	beneidest
entstände	entstände
fingieret	fingieret
Libelle	Libelle
ausrufen	ausrufen
Sucht	Sucht
mopsend	mopsend
kabbelnd	kabbelnd
Gehirnwelle	Gehirnwelle
offenbarten	offenbarten
Fett	Fett
überführen	überführen
Taschenwörterbuches	Taschenwörterbuches
Atommasse	Atommasse
aufwacht	aufwacht
Fischotter	Fischotter
Anachronismen	Anachronismen
näht	näht
zerstreute	zerstreute
regiertest	regiertest
Dinge	Dinge
bewiesen	bewiesen
Erfahrungen	Erfahrungen
beneidete	beneidete
Gehorsams	Gehorsams
hänge	hänge
Augengläsern	Augengläsern
beklage	beklage
Aufpralle	Aufpralle
Piratensendern	Piratensendern
verfanget	verfanget
flense	flense
motivierten	motivierten
Beiblätter	Beiblätter
Fieberanfall	Fieberanfall
sündigst	sündigst
Plüschtier	Plüschtier
protokollieren	protokollieren
Leichenschauhäusern	Leichenschauhäusern
fabulierte	fabulierte
gefällst	gefällst
Kerfe	Kerfe
Kompromissen	Kompromissen
entschleiert	entschleiert
besuchen	besuchen
glühende	glühende
Bärte	Bärte
Hast	Hast
ermordeten	ermordeten
scheucht	scheucht
Beziehungen	Beziehungen
verkündigte	verkündigte
imitiert	imitiert
verstehet	verstehet
ihnen	ihnen
Toypudeln	Toypudeln
imkeret	imkeret
fahrest	fahrest
stimmet	stimmet
Dudelsäcken	Dudelsäcken
verdamm	verdamm
Aspartamen	Aspartamen
Metonymie	Metonymie
Laken	Laken
Flussbett	Flussbett
Silbersulfidbelag	Silbersulfidbelag
steckte	steckte
füllte	füllte
Nanosatellit	Nanosatellit
Blattgewebe	Blattgewebe
höret	höret
hobt	hobt
bandagierte	bandagierte
begäben	begäben
reinigst	reinigst
Rheumatismus	Rheumatismus
verknüpfet	verknüpfet
Irrtumes	Irrtumes
Unterwerfungen	Unterwerfungen
erstehen	erstehen
Gewinnungen	Gewinnungen
Küstenwachen	Küstenwachen
stäupten	stäupten
greifet	greifet
zelte	zelte
besitzet	besitzet
entheilige	entheilige
scheltet	scheltet
Fremde	Fremde
Lautwandeln	Lautwandeln
Einbrecher	Einbrecher
bestrafe	bestrafe
Druckfehlern	Druckfehlern
verdinglichest	verdinglichest
Schlot	Schlot
punkten	punkten
Säcken	Säcken
Märkten	Märkten
Gebern	Gebern
Malaysiers	Malaysiers
Herabsetzung	Herabsetzung
drosselt	drosselt
Höhlen	Höhlen
Asteroide	Asteroide
verarbeite	verarbeite
ehrst	ehrst
Fremden	Fremden
Stäben	Stäben
Mopp	Mopp
Bergen	Bergen
Kanzlei	Kanzlei
protestierst	protestierst
Argentits	Argentits
henket	henket
errötest	errötest
auflegte	auflegte
Alltag	Alltag
Deckenfarbe	Deckenfarbe
Karikaturistinnen	Karikaturistinnen
drifte	drifte
Aerosolen	Aerosolen
zerrüttet	zerrüttet
urbanisier	urbanisier
Stufen	Stufen
Gebirgen	Gebirgen
Plüschtiere	Plüschtiere
verdammend	verdammend
Abkömmling	Abkömmling
dringen	dringen
Kehre	Kehre
erpresst	erpresst
Kosten	Kosten
tabuisierten	tabuisierten
folget	folget
Begünstigung	Begünstigung
prahlte	prahlte
Bluff	Bluff
Abtrünnige	Abtrünnige
besetzest	besetzest
Grabbeltisch	Grabbeltisch
partitionierten	partitionierten
Solcher	Solcher
Einwirkungen	Einwirkungen
läutetet	läutetet
gehst	gehst
Wurzelwachstum	Wurzelwachstum
verlöteten	verlöteten
Idolatrien	Idolatrien
heiligem	heiligem
entgehe	entgehe
neidest	neidest
Maße	Maße
stärke	stärke
offenbart	offenbart
Tier	Tier
kein	kein
Diethylether	Diethylether
musizieret	musizieret
Arresten	Arresten
verhungert	verhungert
fabuliere	fabuliere
Auszügen	Auszügen
Verdachtes	Verdachtes
begrub	begrub
posiert	posiert
Paillette	Paillette
nachwandelst	nachwandelst
Überziehens	Überziehens
seines	seines
alarmieren	alarmieren
Spannt	Spannt
frevler	frevler
Denen	Denen
nächsten	nächsten
addierte	addierte
bezahlst	bezahlst
traget	traget
könnt	könnt
Epidemien	Epidemien
blätteret	blätteret
schenkest	schenkest
schnappet	schnappet
Antitranspirante	Antitranspirante
Kardinäle	Kardinäle
dürftet	dürftet
Stimme	Stimme
Hypochlorit	Hypochlorit
einen	einen
vandalieren	vandalieren
Trübsale	Trübsale
überschnitten	überschnitten
Huflattich	Huflattich
prostituierte	prostituierte
Bäusche	Bäusche
buddeln	buddeln
Schneepflüge	Schneepflüge
erscheine	erscheine
suche	suche
bückest	bückest
ungefälschtem	ungefälschtem
brauchst	brauchst
Maut	Maut
Königreiche	Königreiche
widmest	widmest
unterrichtet	unterrichtet
Stiefmütterchen	Stiefmütterchen
lackieren	lackieren
Bromidquelle	Bromidquelle
Ösophagospasmus	Ösophagospasmus
besprenget	besprenget
schaffest	schaffest
umkämen	umkämen
Geboten	Geboten
Kalifeldspate	Kalifeldspate
Füchsinnen	Füchsinnen
Telefonverkäufer	Telefonverkäufer
Fussel	Fussel
Einrädern	Einrädern
Empörungen	Empörungen
erbest	erbest
Ärztin	Ärztin
Pflanzung	Pflanzung
übersiehst	übersiehst
bezieht	bezieht
Geringschätzung	Geringschätzung
Habt	Habt
Euphemismus	Euphemismus
pflanze	pflanze
Nadel	Nadel
erzeigten	erzeigten
pendelt	pendelt
kremierten	kremierten
erweckest	erweckest
fragen	fragen
bekriegt	bekriegt
außen	außen
vertraget	vertraget
koste	koste
stammeln	stammeln
Pi	Pi
möchtest	möchtest
trüge	trüge
wälzet	wälzet
Essen	Essen
verunglimpfte	verunglimpfte
griechischen	griechischen
replizierten	replizierten
evaluierten	evaluierten
Gummibäumen	Gummibäumen
verdunsten	verdunsten
aufstand	aufstand
ziert	ziert
Telefonnummer	Telefonnummer
bange	bange
babbelt	babbelt
pfänden	pfänden
säusele	säusele
Sollst	Sollst
bezichtigt	bezichtigt
Entmachtung	Entmachtung
lohnten	lohnten
Sonderberichte	Sonderberichte
scheinen	scheinen
gebieten	gebieten
ratschlaget	ratschlaget
Hirnstämmen	Hirnstämmen
idealisieret	idealisieret
exmatrikulierte	exmatrikulierte
verfinstere	verfinstere
losen	losen
offenbar	offenbar
prahlet	prahlet
Ecken	Ecken
Renegat	Renegat
kosten	kosten
Klassenzimmer	Klassenzimmer
Buchfinken	Buchfinken
Milchflasche	Milchflasche
verhörest	verhörest
bracht	bracht
verachte	verachte
gebot	gebot
Beile	Beile
Krankenscheinen	Krankenscheinen
Anspielungen	Anspielungen
schreiet	schreiet
toten	toten
schmierte	schmierte
inspirierten	inspirierten
Membran	Membran
desertierst	desertierst
köderte	köderte
charakterisierend	charakterisierend
kupiert	kupiert
Myriade	Myriade
Decken	Decken
verunglimpftet	verunglimpftet
manövrierte	manövrierte
downloadet	downloadet
mühe	mühe
Ich	Ich
suchen	suchen
zuppt	zuppt
Garten	Garten
Abfahrtslisten	Abfahrtslisten
filtern	filtern
lehrest	lehrest
inspirierest	inspirierest
Beteiligten	Beteiligten
laden	laden
Obszönität	Obszönität
tätowiertet	tätowiertet
Donnerstagabenden	Donnerstagabenden
Böreks	Böreks
Färsen	Färsen
vierten	vierten
Flenser	Flenser
warst	warst
glawbte	glawbte
Tauben	Tauben
Astats	Astats
zeugest	zeugest
speisend	speisend
erkennet	erkennet
Freeganer	Freeganer
Abschreckungen	Abschreckungen
verwechselet	verwechselet
Traggasen	Traggasen
Malaysierin	Malaysierin
Spirale	Spirale
lebte	lebte
Schiffe	Schiffe
Hainbuche	Hainbuche
Palästen	Palästen
werfet	werfet
schaust	schaust
säumen	säumen
erbrütet	erbrütet
Stearat	Stearat
dehydrierten	dehydrierten
knutschest	knutschest
Radfahrern	Radfahrern
verführtest	verführtest
bürsten	bürsten
Stücken	Stücken
belüftet	belüftet
dekoriere	dekoriere
handhabest	handhabest
Kirchhof	Kirchhof
Werte	Werte
Schlüchte	Schlüchte
erlöset	erlöset
Ausbeuter	Ausbeuter
entkäme	entkäme
Überfamilie	Überfamilie
kontaktiere	kontaktiere
Entsetzen	Entsetzen
Solche	Solche
Katz-und-Maus-Spielen	Katz-und-Maus-Spielen
gestatteten	gestatteten
protokollierst	protokollierst
Lopariten	Lopariten
zweifelte	zweifelte
Setzet	Setzet
entständen	entständen
spannen	spannen
anzeigest	anzeigest
behütetest	behütetest
genehmigt	genehmigt
Berge	Berge
borgte	borgte
dienest	dienest
Entsetzt	Entsetzt
Zwingburg	Zwingburg
simulierst	simulierst
schwangt	schwangt
Mutagenen	Mutagenen
verklagst	verklagst
irgendein	irgendein
besänftiget	besänftiget
Hirnstämme	Hirnstämme
Primatologen	Primatologen
Pater	Pater
Beziehung	Beziehung
auflöste	auflöste
gabelst	gabelst
erwachet	erwachet
Berber	Berber
sabbere	sabbere
Krustentier	Krustentier
Machet	Machet
Rutheniumkomplex	Rutheniumkomplex
schmuste	schmuste
konstatiertest	konstatiertest
Perlen	Perlen
vermahne	vermahne
hinterzögen	hinterzögen
Sage	Sage
ausgereckten	ausgereckten
Bube	Bube
Würze	Würze
deren	deren
bauten	bauten
decket	decket
batet	batet
halten	halten
Qualifikationen	Qualifikationen
schlachten	schlachten
überdenkend	überdenkend
Milchflaschen	Milchflaschen
grünten	grünten
jede	jede
Freizeitzentrum	Freizeitzentrum
spielte	spielte
tagten	tagten
Reiterschwert	Reiterschwert
rebellieren	rebellieren
Heteroatome	Heteroatome
heiliget	heiliget
Stempeluhren	Stempeluhren
pharyngalisierst	pharyngalisierst
gewünscht	gewünscht
Klaue	Klaue
Auszüge	Auszüge
Menschen	Menschen
kategorisierte	kategorisierte
steigen	steigen
verschicket	verschicket
warten	warten
wert	wert
Weihe	Weihe
schleim	schleim
nützt	nützt
verforme	verforme
parkierten	parkierten
Zapfhahn	Zapfhahn
Seehechten	Seehechten
fragst	fragst
Trübsal	Trübsal
gratuliere	gratuliere
kategorisierst	kategorisierst
Amputierte	Amputierte
scheinet	scheinet
bezahlt	bezahlt
ölt	ölt
Schenke	Schenke
auszogen	auszogen
unterschiede	unterschiede
Entsetzet	Entsetzet
schießen	schießen
Kälber	Kälber
protestierest	protestierest
gleite	gleite
Nährmedien	Nährmedien
Epiker	Epiker
Gibt	Gibt
Rehbock	Rehbock
trinkst	trinkst
Atomphysikern	Atomphysikern
Wogen	Wogen
Schönrednern	Schönrednern
Ass	Ass
Einer	Einer
Samarskite	Samarskite
Holzquirl	Holzquirl
anrührte	anrührte
verscheißert	verscheißert
Laubholz	Laubholz
Abfertigungsschalters	Abfertigungsschalters
vermöge	vermöge
reden	reden
Sphären	Sphären
geleitest	geleitest
weisest	weisest
glänzte	glänzte
Halsabschneidern	Halsabschneidern
Mopps	Mopps
Hypochlorite	Hypochlorite
Bienen	Bienen
formulieren	formulieren
radierte	radierte
Gepäckträgern	Gepäckträgern
brauche	brauche
porträtiere	porträtiere
Uranerz	Uranerz
Düfte	Düfte
wünschtest	wünschtest
Californium	Californium
verlaß	verlaß
enterten	enterten
Geber	Geber
halbierte	halbierte
schmeicheln	schmeicheln
mampfte	mampfte
Düften	Düften
langweilst	langweilst
Drachenblut	Drachenblut
gehorcht	gehorcht
drängest	drängest
Schobern	Schobern
anhangen	anhangen
Dorsche	Dorsche
behauptest	behauptest
Anwendungsgebiete	Anwendungsgebiete
amenagier	amenagier
klage	klage
säumet	säumet
entsetzten	entsetzten
dividiere	dividiere
Gigapascaln	Gigapascaln
angehöret	angehöret
Mache	Mache
forschen	forschen
behaltest	behaltest
jaget	jaget
Leset	Leset
lehre	lehre
nahe	nahe
privilegiere	privilegiere
diesen	diesen
Drillinge	Drillinge
schon	schon
Anhängseln	Anhängseln
unterfordern	unterfordern
Erzherzogshüte	Erzherzogshüte
gewähr	gewähr
Atemlüfte	Atemlüfte
gehorchte	gehorchte
Gipfeltreffen	Gipfeltreffen
gefällt	gefällt
Bildpunkt	Bildpunkt
bewahrheitete	bewahrheitete
hupet	hupet
geloben	geloben
Brauhaus	Brauhaus
Hubschraubern	Hubschraubern
Schnittlauche	Schnittlauche
Einöden	Einöden
nippend	nippend
gefügt	gefügt
Fiesling	Fiesling
Katz-und-Maus-Spiele	Katz-und-Maus-Spiele
erwachend	erwachend
Decks	Decks
machte	machte
möge	möge
beanspruchet	beanspruchet
Letzten	Letzten
stellen	stellen
Besteck	Besteck
Abartigkeiten	Abartigkeiten
heilte	heilte
Scherzes	Scherzes
bereiten	bereiten
Besuchen	Besuchen
Fokus	Fokus
Mischelement	Mischelement
Aussätzigen	Aussätzigen
anrichten	anrichten
Abschirmungen	Abschirmungen
Harpune	Harpune
helle	helle
unterwerft	unterwerft
Lautschrift	Lautschrift
schauend	schauend
heiligte	heiligte
fastetet	fastetet
Meinen	Meinen
klickte	klickte
rufen	rufen
Zeitplanes	Zeitplanes
verwaisten	verwaisten
Hode	Hode
Amen	Amen
Isobars	Isobars
überschneidet	überschneidet
Biokraftstoffes	Biokraftstoffes
Drillingen	Drillingen
rekrutiere	rekrutiere
Bebauungsplänen	Bebauungsplänen
heißet	heißet
dienet	dienet
Schneepflügen	Schneepflügen
Leiche	Leiche
Fetten	Fetten
Musters	Musters
wünschte	wünschte
Kraftfahrzeuges	Kraftfahrzeuges
Achsel	Achsel
Städten	Städten
koordinieret	koordinieret
ziehest	ziehest
verwirrte	verwirrte
Fledermaus	Fledermaus
Hadith	Hadith
verkriechet	verkriechet
Nehmet	Nehmet
überstehst	überstehst
Wänden	Wänden
punktest	punktest
plumpse	plumpse
vernickelte	vernickelte
Kehret	Kehret
blamierten	blamierten
ärgere	ärgere
Ihre	Ihre
Tiefschutz	Tiefschutz
pulsiert	pulsiert
gezügelt	gezügelt
essen	essen
Türkenbünden	Türkenbünden
Hektare	Hektare
Suchanfrage	Suchanfrage
Ärzteblättern	Ärzteblättern
Äxten	Äxten
betrübend	betrübend
Pausbacken	Pausbacken
hüte	hüte
rüstete	rüstete
Preis	Preis
Sippe	Sippe
prophezeiet	prophezeiet
fertig	fertig
flirtest	flirtest
Aktivist	Aktivist
Metallspiegel	Metallspiegel
Kassettenrekordern	Kassettenrekordern
rede	rede
ihr	ihr
Streite	Streite
gebündelt	gebündelt
schicke	schicke
Alibi	Alibi
blondierten	blondierten
Geschichtsbücher	Geschichtsbücher
Päderast	Päderast
Planer	Planer
Drang	Drang
Numerus	Numerus
referenziere	referenziere
Türme	Türme
fastete	fastete
frische	frische
wispern	wispern
Katamaran	Katamaran
entgehst	entgehst
steinigte	steinigte
Unterseite	Unterseite
Rubinen	Rubinen
Laubbläsern	Laubbläsern
willen	willen
erwischten	erwischten
Mäusespeck	Mäusespeck
duzet	duzet
Selbstversuchen	Selbstversuchen
Argyroditen	Argyroditen
Jahr	Jahr
schäme	schäme
feiere	feiere
Weg	Weg
wisperten	wisperten
grabest	grabest
verteidigt	verteidigt
vergleichet	vergleichet
eggten	eggten
pensionierest	pensionierest
vernichtest	vernichtest
erntet	erntet
heiligest	heiligest
injiziert	injiziert
Korrosionsschutz	Korrosionsschutz
Republikflucht	Republikflucht
Hallen	Hallen
separieret	separieret
verlähmt	verlähmt
Staatsanleihe	Staatsanleihe
Spiralen	Spiralen
kramen	kramen
verwechselst	verwechselst
fehlte	fehlte
Fischer	Fischer
keine	keine
blondieret	blondieret
moppet	moppet
verließet	verließet
Treibhausgase	Treibhausgase
spracht	spracht
besprachen	besprachen
schnüren	schnüren
Träumers	Träumers
fallet	fallet
verunglimpfen	verunglimpfen
schleißt	schleißt
wehte	wehte
lachen	lachen
streiften	streiften
erkannte	erkannte
betrieben	betrieben
Arsenolithen	Arsenolithen
Lobgesängen	Lobgesängen
unsre	unsre
umarmet	umarmet
Steuerborden	Steuerborden
Oberbegriff	Oberbegriff
Höfe	Höfe
grüßet	grüßet
Fetzens	Fetzens
reif	reif
Großfürsten	Großfürsten
Esset	Esset
trauerten	trauerten
gelost	gelost
flötete	flötete
Fusselbärten	Fusselbärten
Elementarzellen	Elementarzellen
Einheimischen	Einheimischen
verlobte	verlobte
instrumentalisierest	instrumentalisierest
verkürze	verkürze
schlaget	schlaget
Kaktusfeige	Kaktusfeige
Kadavergehorsam	Kadavergehorsam
schnelle	schnelle
Ächselchen	Ächselchen
blitzet	blitzet
sterbt	sterbt
frohlocke	frohlocke
wurdest	wurdest
Held	Held
amputiere	amputiere
härte	härte
Kaufkraft	Kaufkraft
faltest	faltest
Zeugnissen	Zeugnissen
gedächte	gedächte
enttäuschet	enttäuschet
gleiche	gleiche
brechen	brechen
bereue	bereue
trinken	trinken
irgendeine	irgendeine
überführt	überführt
Abschirmung	Abschirmung
Beschuldigungen	Beschuldigungen
Gefäße	Gefäße
teilte	teilte
Asiatin	Asiatin
Fahlflanken-Ameisenwürgern	Fahlflanken-Ameisenwürgern
foppte	foppte
weiche	weiche
Feldzug	Feldzug
jenen	jenen
vereinbarten	vereinbarten
Puder	Puder
zeuge	zeuge
Bildpunkten	Bildpunkten
krieget	krieget
spannte	spannte
anfingst	anfingst
Denunziationen	Denunziationen
knistern	knistern
ander	ander
Brieföffners	Brieföffners
Körpergeruches	Körpergeruches
stiegen	stiegen
Gruftis	Gruftis
meinen	meinen
Finanzministerien	Finanzministerien
lobet	lobet
Oxalaten	Oxalaten
leere	leere
Schlaraffenlandes	Schlaraffenlandes
funkelet	funkelet
siehst	siehst
erlöse	erlöse
posiertet	posiertet
Letzte	Letzte
erliegest	erliegest
bedürft	bedürft
Metaphern	Metaphern
Äther	Äther
säte	säte
Töpfe	Töpfe
Sekte	Sekte
Tiere	Tiere
Totgeburten	Totgeburten
Gasgemisch	Gasgemisch
führen	führen
schmelzt	schmelzt
Bademäntel	Bademäntel
substituierest	substituierest
Flamen	Flamen
greinen	greinen
Fiasko	Fiasko
bekannte	bekannte
Hadithe	Hadithe
tatteret	tatteret
appellierte	appellierte
erstehst	erstehst
trage	trage
entzweiest	entzweiest
abziehen	abziehen
haste	haste
erfahrt	erfahrt
fasset	fasset
Heuhaufen	Heuhaufen
eures	eures
wiederholten	wiederholten
süsse	süsse
Silbergeschirr	Silbergeschirr
häufe	häufe
Judenrat	Judenrat
vermahnet	vermahnet
bedenket	bedenket
Neuigkeiten	Neuigkeiten
Karer	Karer
Anarchisten	Anarchisten
Badezimmer	Badezimmer
Hanse	Hanse
Zeitschlitzen	Zeitschlitzen
explodierten	explodierten
strullerst	strullerst
gewöhnte	gewöhnte
Gesamtmenge	Gesamtmenge
Hardwareentwicklerin	Hardwareentwicklerin
bediene	bediene
folgend	folgend
Psi	Psi
faschierst	faschierst
klicket	klicket
Kaliumdichromat	Kaliumdichromat
Band	Band
blitztet	blitztet
Baisers	Baisers
Butike	Butike
süsst	süsst
Schanktisch	Schanktisch
reizest	reizest
zentriert	zentriert
Rundbriefen	Rundbriefen
gebet	gebet
Apportierhunde	Apportierhunde
Bleigehalt	Bleigehalt
leiste	leiste
Quellflüssen	Quellflüssen
kämpfet	kämpfet
Den	Den
Gewinnung	Gewinnung
überdenkest	überdenkest
verklagt	verklagt
Konzentrat	Konzentrat
Ölspur	Ölspur
kichert	kichert
Krankenschein	Krankenschein
Eisstein	Eisstein
bekennet	bekennet
Verselbstständigung	Verselbstständigung
Metallquirle	Metallquirle
Kriegsenden	Kriegsenden
Introjektion	Introjektion
Sekten	Sekten
verschlungen	verschlungen
Naturen	Naturen
Amtsträger	Amtsträger
schmelzen	schmelzen
beider	beider
leid	leid
Bedenken	Bedenken
assimilieret	assimilieret
wach	wach
verwechsele	verwechsele
Stärket	Stärket
lügen	lügen
Sphäre	Sphäre
beunruhige	beunruhige
annektierst	annektierst
ducktest	ducktest
Kriege	Kriege
grüble	grüble
recycele	recycele
hörest	hörest
Spektralbereich	Spektralbereich
erfüllt	erfüllt
Sichelzellenanämien	Sichelzellenanämien
glaube	glaube
langweiltest	langweiltest
erkalten	erkalten
nähte	nähte
verallgemeinerst	verallgemeinerst
Handbuch	Handbuch
installierten	installierten
Flamme	Flamme
überprüfte	überprüfte
optimierte	optimierte
übersehest	übersehest
Imperialismen	Imperialismen
Homodimeren	Homodimeren
Anmelder	Anmelder
verkürzten	verkürzten
verführe	verführe
merkte	merkte
brichst	brichst
malträtiere	malträtiere
motivierte	motivierte
zersetzet	zersetzet
Zehe	Zehe
fegte	fegte
einigte	einigte
pflanzest	pflanzest
Schreiet	Schreiet
besprengen	besprengen
bollerte	bollerte
weh	weh
gewöhnt	gewöhnt
grau	grau
Adhäsionen	Adhäsionen
Eutektikum	Eutektikum
Pedanten	Pedanten
Zeithorizonte	Zeithorizonte
Maßen	Maßen
Eiszapfens	Eiszapfens
bestimmst	bestimmst
Werde	Werde
aufkommen	aufkommen
hegten	hegten
vertiefet	vertiefet
verunziere	verunziere
wallte	wallte
Zainen	Zainen
verwirft	verwirft
Kerf	Kerf
Seetauchers	Seetauchers
schwadronierten	schwadronierten
Provinz	Provinz
untertreten	untertreten
Betainen	Betainen
rangierst	rangierst
Schönredner	Schönredner
besetzen	besetzen
überreicht	überreicht
setzten	setzten
verbündete	verbündete
ahne	ahne
Bazziten	Bazziten
überweis	überweis
Petersfisch	Petersfisch
dissentierte	dissentierte
Reststoff	Reststoff
Effekt	Effekt
spekuliere	spekuliere
nötigte	nötigte
Klauen	Klauen
Kühe	Kühe
Stoffwechselwegen	Stoffwechselwegen
Weichloten	Weichloten
verringert	verringert
jedem	jedem
Pardelkatze	Pardelkatze
Noseans	Noseans
ach	ach
Fingerhüte	Fingerhüte
Scheißkerl	Scheißkerl
verdeckt	verdeckt
Bete	Bete
fertige	fertige
Vorhäute	Vorhäute
fügt	fügt
raubet	raubet
lauschte	lauschte
zeugtest	zeugtest
lüge	lüge
trinket	trinket
steinigst	steinigst
Glatteis	Glatteis
bringet	bringet
helfet	helfet
vernichtete	vernichtete
legt	legt
Paragraphenreiter	Paragraphenreiter
billige	billige
links	links
formirend	formirend
schäumtest	schäumtest
zuteil	zuteil
reichen	reichen
zürnst	zürnst
höbe	höbe
Junge	Junge
Halter	Halter
euren	euren
Ersten	Ersten
stäupte	stäupte
Kortholt	Kortholt
Schreibtischtätern	Schreibtischtätern
sprachen	sprachen
Atommodellen	Atommodellen
grünest	grünest
mogelest	mogelest
Strohhälmchen	Strohhälmchen
Schätzen	Schätzen
sintertest	sintertest
Hummel	Hummel
Komponistin	Komponistin
ruhte	ruhte
verstrahlten	verstrahlten
Lesen	Lesen
achten	achten
verkehrten	verkehrten
Abkürzungsverzeichnis	Abkürzungsverzeichnis
vereinbaren	vereinbaren
verkündet	verkündet
hauen	hauen
Hochsommer	Hochsommer
Betten	Betten
kurze	kurze
Vorstoß	Vorstoß
kehren	kehren
Stoffwechselweg	Stoffwechselweg
grüßen	grüßen
knacktest	knacktest
Scheißkerlen	Scheißkerlen
klettert	klettert
Schreibern	Schreibern
lavierte	lavierte
Pfahl	Pfahl
Berylle	Berylle
regieren	regieren
mischst	mischst
Loparite	Loparite
Azubi	Azubi
verantwortetest	verantwortetest
Ärzten	Ärzten
Backenbärten	Backenbärten
weissagten	weissagten
Eisenkräutern	Eisenkräutern
schiebest	schiebest
umbrächten	umbrächten
verlautete	verlautete
Wachet	Wachet
taufte	taufte
Beine	Beine
halbierest	halbierest
heftete	heftete
deutete	deutete
erdachten	erdachten
surrst	surrst
Amputierten	Amputierten
schauspielert	schauspielert
liebet	liebet
wenden	wenden
manövrieret	manövrieret
Gase	Gase
aufheben	aufheben
War	War
reinstitutionalisierten	reinstitutionalisierten
produzierte	produzierte
griffen	griffen
versteckt	versteckt
Für	Für
oxidierte	oxidierte
entkämen	entkämen
Tannen	Tannen
weich	weich
bemerken	bemerken
Fischzucht	Fischzucht
zwang	zwang
initiieret	initiieret
zerbräche	zerbräche
verteidigte	verteidigte
Weißt	Weißt
Rotgusses	Rotgusses
Götze	Götze
Meinet	Meinet
Ihren	Ihren
Pfählen	Pfählen
inhalierest	inhalierest
regiert	regiert
verschärftet	verschärftet
Sprachräumen	Sprachräumen
fluchet	fluchet
lehren	lehren
demütige	demütige
Leichen	Leichen
Badezimmers	Badezimmers
Tischen	Tischen
besichtigt	besichtigt
Arsch	Arsch
tastet	tastet
Trockendocks	Trockendocks
verbündest	verbündest
verschafft	verschafft
Raucherin	Raucherin
Stühle	Stühle
Domäne	Domäne
betrübte	betrübte
solcher	solcher
bekennt	bekennt
erliegst	erliegst
Geflecktheiten	Geflecktheiten
bereitet	bereitet
Blitzen	Blitzen
Ihr	Ihr
sondern	sondern
entwendete	entwendete
erlösest	erlösest
Eiland	Eiland
Korrosionsschutzen	Korrosionsschutzen
Prophet	Prophet
gähne	gähne
veranstaltest	veranstaltest
bekannt	bekannt
Judenräte	Judenräte
versklavte	versklavte
Gehorsam	Gehorsam
Lautschriften	Lautschriften
hoben	hoben
seufzt	seufzt
Töpfen	Töpfen
fluktuierte	fluktuierte
vereinigt	vereinigt
beklagte	beklagte
linstest	linstest
Steuerwagens	Steuerwagens
entheiligten	entheiligten
fehle	fehle
Dampfschiffen	Dampfschiffen
hasset	hasset
blenden	blenden
Wehe	Wehe
Schal	Schal
backt	backt
Gehilfen	Gehilfen
Vordenkern	Vordenkern
Welpen	Welpen
dunkelt	dunkelt
verfehle	verfehle
Schneidern	Schneidern
Germanist	Germanist
erfreu	erfreu
lavierend	lavierend
fluchten	fluchten
ehret	ehret
erziehen	erziehen
klone	klone
häufte	häufte
Türkise	Türkise
Grieche	Grieche
spaltete	spaltete
reglementiert	reglementiert
entgegenkamen	entgegenkamen
gestalten	gestalten
Bezeugungen	Bezeugungen
Bankettes	Bankettes
schmuggelte	schmuggelte
Büsche	Büsche
ruhe	ruhe
kitzeln	kitzeln
anzeige	anzeige
soll	soll
bestraft	bestraft
Zirkelschluss	Zirkelschluss
vertrage	vertrage
Managementsystem	Managementsystem
Stämme	Stämme
Zwetschge	Zwetschge
Einem	Einem
Senkungen	Senkungen
eskaliert	eskaliert
Aacheners	Aacheners
fromme	fromme
präsentier	präsentier
läuten	läuten
umbrächte	umbrächte
Agoraphobien	Agoraphobien
Rechnung	Rechnung
fokussierten	fokussierten
habt	habt
zerschlagt	zerschlagt
löstest	löstest
Teufel	Teufel
opfern	opfern
entsündigte	entsündigte
erlauben	erlauben
Ältesten	Ältesten
Reinelementen	Reinelementen
Besuch	Besuch
Ruß	Ruß
Abgaskatalysatoren	Abgaskatalysatoren
attackieren	attackieren
gleich	gleich
ringst	ringst
heil	heil
Kronsbeeren	Kronsbeeren
vibrierend	vibrierend
Laiben	Laiben
Hochhäuser	Hochhäuser
Linien	Linien
erntete	erntete
unsere	unsere
Lichte	Lichte
Rhabarber	Rhabarber
kritzelet	kritzelet
Anlässe	Anlässe
keulst	keulst
Bären	Bären
Golfplätzen	Golfplätzen
Kairiner	Kairiner
rebellieret	rebellieret
Überweisung	Überweisung
quietsche	quietsche
Erzherzogshüten	Erzherzogshüten
Aromastoffe	Aromastoffe
gelobte	gelobte
verkehrte	verkehrte
Darlegungen	Darlegungen
heilet	heilet
Arbeitsunfähigkeit	Arbeitsunfähigkeit
Vogelscheuche	Vogelscheuche
entschädigte	entschädigte
Streich	Streich
Feste	Feste
reiftet	reiftet
Skorpionen	Skorpionen
verstehest	verstehest
Vergrößerungen	Vergrößerungen
möchten	möchten
scheuchen	scheuchen
Geldautomaten	Geldautomaten
salz	salz
parametrisierst	parametrisierst
ermächtige	ermächtige
Kaufhäuser	Kaufhäuser
spukest	spukest
Halbmond	Halbmond
Mageninhalt	Mageninhalt
Zeitungsenten	Zeitungsenten
dehydrierte	dehydrierte
zähle	zähle
deine	deine
Prüfbericht	Prüfbericht
bleibst	bleibst
zensierten	zensierten
merket	merket
verdeckte	verdeckte
möppertet	möppertet
Marjellchen	Marjellchen
scheiterst	scheiterst
zerfetzte	zerfetzte
pflanzet	pflanzet
legten	legten
Bergsteiger	Bergsteiger
zerstreuten	zerstreuten
taten	taten
Dunkelkammern	Dunkelkammern
lade	lade
Konzentrate	Konzentrate
brecht	brecht
hadertet	hadertet
kapiertet	kapiertet
Fäusten	Fäusten
Mähnenwölfen	Mähnenwölfen
unterrichten	unterrichten
wache	wache
schläft	schläft
Backpflaumen	Backpflaumen
funzt	funzt
Akkadierinnen	Akkadierinnen
Penis	Penis
löst	löst
widerlegte	widerlegte
Landstreichereien	Landstreichereien
Tut	Tut
sinke	sinke
fladerten	fladerten
Gegebenheiten	Gegebenheiten
Rotscheitelreiher	Rotscheitelreiher
grübelt	grübelt
Langschwanzpinguin	Langschwanzpinguin
Märkte	Märkte
Zahnfleischentzündungen	Zahnfleischentzündungen
fluppten	fluppten
härtet	härtet
Fremdwort	Fremdwort
zerstreust	zerstreust
impfte	impfte
gründen	gründen
gezählt	gezählt
Nachteilen	Nachteilen
machet	machet
Eiszapfen	Eiszapfen
googelest	googelest
Ärgernissen	Ärgernissen
Dudelsack	Dudelsack
wurstelten	wurstelten
Unserer	Unserer
erforscht	erforscht
Somiten	Somiten
sprüht	sprüht
Einsätzen	Einsätzen
Prüfberichten	Prüfberichten
replizieret	replizieret
aufrichtest	aufrichtest
Lobgesänge	Lobgesänge
Gänge	Gänge
hüpfest	hüpfest
überstehend	überstehend
dekompilierten	dekompilierten
Mobilfunknetze	Mobilfunknetze
durchläutert	durchläutert
höhnte	höhnte
Samarskit	Samarskit
lochten	lochten
Knechten	Knechten
imkernd	imkernd
hintertreibt	hintertreibt
einführt	einführt
balkanisierte	balkanisierte
alle	alle
verstecken	verstecken
Tukans	Tukans
tobend	tobend
köderet	köderet
Ranzigkeit	Ranzigkeit
infizieret	infizieret
verließen	verließen
Monarchie	Monarchie
verdammt	verdammt
Ding	Ding
gehört	gehört
hättet	hättet
amputierten	amputierten
Hornunges	Hornunges
Thioacetalen	Thioacetalen
gedenkest	gedenkest
anzögen	anzögen
zupftet	zupftet
Ölfasses	Ölfasses
vergiften	vergiften
Primärenergien	Primärenergien
untersagest	untersagest
lispelt	lispelt
erwachte	erwachte
blitz	blitz
geniertest	geniertest
Kriegen	Kriegen
fallt	fallt
jedes	jedes
gedachte	gedachte
verschmelzen	verschmelzen
seufzest	seufzest
Alkalien	Alkalien
verspätete	verspätete
werden	werden
verringertet	verringertet
merken	merken
solle	solle
Portale	Portale
Lunisolarkalender	Lunisolarkalender
pulsiere	pulsiere
Fehden	Fehden
Kriegsknechte	Kriegsknechte
gravierst	gravierst
Landesverräterinnen	Landesverräterinnen
Kakadu	Kakadu
pflüget	pflüget
Ackerschachtelhalm	Ackerschachtelhalm
waren	waren
beantrage	beantrage
besänftigtest	besänftigtest
Wehr	Wehr
Würzen	Würzen
wehr	wehr
Referenzen	Referenzen
brandeten	brandeten
substituieren	substituieren
Urbaren	Urbaren
erstarre	erstarre
Isolatoren	Isolatoren
herrschten	herrschten
schämte	schämte
Reinstoffen	Reinstoffen
desensibilisierten	desensibilisierten
bezahlest	bezahlest
zerstreuet	zerstreuet
Kettenraucher	Kettenraucher
Ingredienzen	Ingredienzen
erlöst	erlöst
dritte	dritte
Höfen	Höfen
drangen	drangen
öle	öle
fladerest	fladerest
punkteten	punkteten
wiederkamen	wiederkamen
Affenbrotbäumen	Affenbrotbäumen
Uterus	Uterus
Vogelscheuchen	Vogelscheuchen
Metallothioneinen	Metallothioneinen
bedrückest	bedrückest
zensiere	zensiere
Harpunen	Harpunen
lösen	lösen
gelobtet	gelobtet
Gemüt	Gemüt
konjugiere	konjugiere
entkörperlichte	entkörperlichte
dechiffriere	dechiffriere
Jagdhund	Jagdhund
Grenze	Grenze
hingehet	hingehet
Wimpertierchen	Wimpertierchen
Nukleinsäuren	Nukleinsäuren
rinnt	rinnt
Gerücht	Gerücht
Acetat	Acetat
Geckos	Geckos
bauest	bauest
flambiert	flambiert
Arbeitsleistung	Arbeitsleistung
Sprecher	Sprecher
Waldbränden	Waldbränden
füllen	füllen
Stall	Stall
Operationssaal	Operationssaal
reizen	reizen
spritzet	spritzet
Füße	Füße
aller	aller
Selbstversuch	Selbstversuch
Neuigkeit	Neuigkeit
zentrierest	zentrierest
Däumlingen	Däumlingen
bemühst	bemühst
Gewichten	Gewichten
Grieße	Grieße
Pfleglinge	Pfleglinge
Beobachtung	Beobachtung
charakterisiert	charakterisiert
allen	allen
leben	leben
argumentierest	argumentierest
hurst	hurst
Dolde	Dolde
verifizieret	verifizieret
Biokraftstoff	Biokraftstoff
preiset	preiset
kräusle	kräusle
produzierest	produzierest
bemühten	bemühten
Bonzen	Bonzen
jeden	jeden
treibst	treibst
Zain	Zain
Wollt	Wollt
Robe	Robe
frappiere	frappiere
widerlegest	widerlegest
betrete	betrete
unterbrächest	unterbrächest
Rasterkraftmikroskop	Rasterkraftmikroskop
Banketten	Banketten
steigeret	steigeret
nachwandelte	nachwandelte
elfte	elfte
haschiert	haschiert
Talismanen	Talismanen
wallfahrteten	wallfahrteten
Kristalle	Kristalle
kugelten	kugelten
reimte	reimte
gedenkst	gedenkst
jagst	jagst
Impedanz	Impedanz
glaubten	glaubten
Hurriter	Hurriter
Zehen	Zehen
Wechselstube	Wechselstube
dirigieret	dirigieret
Maxima	Maxima
erkaltest	erkaltest
Pfandgeld	Pfandgeld
Bunde	Bunde
versagt	versagt
stiftete	stiftete
Herkunft	Herkunft
zählten	zählten
Dürre	Dürre
obfuskieren	obfuskieren
Wespen	Wespen
Achatschnecken	Achatschnecken
gratuliert	gratuliert
geschämt	geschämt
gelobtest	gelobtest
tappten	tappten
More	More
Buchhalterinnen	Buchhalterinnen
beziehen	beziehen
neiden	neiden
Seehechte	Seehechte
malet	malet
stirbt	stirbt
Anführern	Anführern
Tukanen	Tukanen
Grizzlybären	Grizzlybären
fresse	fresse
Füllfederhalter	Füllfederhalter
flirtete	flirtete
sagtest	sagtest
hatten	hatten
Cholesterin	Cholesterin
wärme	wärme
weise	weise
drescht	drescht
elften	elften
lösest	lösest
Quellfluss	Quellfluss
Fellachin	Fellachin
verewigt	verewigt
Höhle	Höhle
gepuddelt	gepuddelt
flehte	flehte
protestieret	protestieret
schreiben	schreiben
Erstlingen	Erstlingen
verbleibet	verbleibet
diversifiziert	diversifiziert
zirpe	zirpe
Gesetze	Gesetze
Botokuden	Botokuden
Flaschenhälsen	Flaschenhälsen
zertifizierst	zertifizierst
Wiederauferstehungen	Wiederauferstehungen
schwöret	schwöret
würdest	würdest
Extrems	Extrems
regelet	regelet
Orten	Orten
lancierst	lancierst
innere	innere
wehrt	wehrt
Warte	Warte
Siglen	Siglen
Farbstoffen	Farbstoffen
Datentypen	Datentypen
Skorpione	Skorpione
Komponistinnen	Komponistinnen
streutet	streutet
Augenglases	Augenglases
rekonstruieret	rekonstruieret
vielen	vielen
Pfründe	Pfründe
verschickte	verschickte
saht	saht
Ehre	Ehre
zerbricht	zerbricht
Kopfverletzungen	Kopfverletzungen
überschatteten	überschatteten
Fettes	Fettes
Maultier	Maultier
respektieren	respektieren
notlande	notlande
verlasse	verlasse
verführen	verführen
Möbiusbändern	Möbiusbändern
erstaunte	erstaunte
Weile	Weile
verkaufte	verkaufte
vertrauten	vertrauten
Generationen	Generationen
zertifiziertest	zertifiziertest
feierst	feierst
bewahrheitetet	bewahrheitetet
Fremdwörter	Fremdwörter
verdinglichtest	verdinglichtest
Mähnenwolfes	Mähnenwolfes
Beschuldigung	Beschuldigung
nagelest	nagelest
tattert	tattert
erbringst	erbringst
brachen	brachen
verfange	verfange
stutzt	stutzt
spaltetest	spaltetest
Arm	Arm
knistert	knistert
stiftest	stiftest
Seine	Seine
fällt	fällt
Hüfte	Hüfte
ihre	ihre
rechten	rechten
ermordetest	ermordetest
Bajonetten	Bajonetten
Flammen	Flammen
naschst	naschst
plagte	plagte
Chronisten	Chronisten
illustriere	illustriere
Spektroskopie	Spektroskopie
grausten	grausten
bereiteten	bereiteten
besorgest	besorgest
triebe	triebe
anzeigen	anzeigen
diskutierst	diskutierst
Euren	Euren
Schwester	Schwester
Schauet	Schauet
scheiterest	scheiterest
Abschiedsbrief	Abschiedsbrief
setzet	setzet
Dilettanten	Dilettanten
Fellen	Fellen
erzürnt	erzürnt
angehöre	angehöre
strafst	strafst
Satzung	Satzung
einst	einst
Einsatz	Einsatz
murmelten	murmelten
kehrst	kehrst
lögen	lögen
Erbsen	Erbsen
Jünglingen	Jünglingen
putzte	putzte
Heringen	Heringen
Rhodochrosite	Rhodochrosite
Kürasse	Kürasse
Kräften	Kräften
Jude	Jude
achte	achte
Kaufleuten	Kaufleuten
drängte	drängte
überbewertet	überbewertet
Adamsäpfeln	Adamsäpfeln
Füßen	Füßen
ortete	ortete
Klärungen	Klärungen
auszöge	auszöge
Freibergit	Freibergit
Hehler	Hehler
gehorchten	gehorchten
Wasserquellen	Wasserquellen
Effekten	Effekten
Soge	Soge
lehnte	lehnte
Brieftaubenzüchter	Brieftaubenzüchter
lispelten	lispelten
Petersfischen	Petersfischen
heiß	heiß
Geschäfte	Geschäfte
Automatikgetrieben	Automatikgetrieben
Innenministerien	Innenministerien
verfolgst	verfolgst
vertreibe	vertreibe
extemporieret	extemporieret
spanne	spanne
ausgeht	ausgeht
schütze	schütze
schmuggelest	schmuggelest
assimiliertest	assimiliertest
bündelet	bündelet
leide	leide
übrigbleiben	übrigbleiben
mußten	mußten
vernickele	vernickele
Palisade	Palisade
verdammten	verdammten
Tatsachenbeschöniger	Tatsachenbeschöniger
predig	predig
designiertet	designiertet
Dreieinigkeit	Dreieinigkeit
keulte	keulte
Zöpfe	Zöpfe
separieren	separieren
schaue	schaue
Hälmchen	Hälmchen
Schneider	Schneider
denaturierten	denaturierten
Sizilianer	Sizilianer
lehrte	lehrte
Schalen	Schalen
beleidigst	beleidigst
Kriegsknechten	Kriegsknechten
drücke	drücke
Einheimische	Einheimische
Falle	Falle
Lautwandel	Lautwandel
verkündige	verkündige
Borhydride	Borhydride
Kohlenstoffgehalt	Kohlenstoffgehalt
pflücktet	pflücktet
revoltiert	revoltiert
Playlist	Playlist
stürzt	stürzt
Stadtbezirken	Stadtbezirken
Ankern	Ankern
kürzest	kürzest
Crescendos	Crescendos
gehorchet	gehorchet
Stücke	Stücke
dringest	dringest
Mauten	Mauten
baten	baten
prostete	prostete
taufe	taufe
sezierst	sezierst
gehorchst	gehorchst
erlabe	erlabe
betrübtet	betrübtet
scherze	scherze
assimilierte	assimilierte
überweiset	überweiset
geleiteten	geleiteten
trübe	trübe
googelten	googelten
Androiden	Androiden
verformen	verformen
gabelt	gabelt
segmentierten	segmentierten
rauben	rauben
schreist	schreist
überquerst	überquerst
blättertet	blättertet
losest	losest
eigenen	eigenen
ratschlagt	ratschlagt
gewärtigt	gewärtigt
knüpfet	knüpfet
Schwirrvögel	Schwirrvögel
arrivieren	arrivieren
gut	gut
jammern	jammern
Buche	Buche
hilft	hilft
Bist	Bist
Sündern	Sündern
Proton	Proton
kollidierten	kollidierten
erhörst	erhörst
strafend	strafend
eingeht	eingeht
säet	säet
Überziehen	Überziehen
raubest	raubest
stoßt	stoßt
Energiespeicher	Energiespeicher
tragt	tragt
aufhebest	aufhebest
Am	Am
zürnest	zürnest
sorgen	sorgen
Gedächtnisse	Gedächtnisse
aufnahmt	aufnahmt
Hornung	Hornung
glänzt	glänzt
Gegenleistungen	Gegenleistungen
Felsboden	Felsboden
Ypecaharallen	Ypecaharallen
hinterlege	hinterlege
Efeu	Efeu
Keile	Keile
holte	holte
Mittelaltermarktes	Mittelaltermarktes
kämpfen	kämpfen
Unrecht	Unrecht
liebten	liebten
liebt	liebt
Heteroatom	Heteroatom
Bilderstürmer	Bilderstürmer
tote	tote
Provinzen	Provinzen
Selbstversuche	Selbstversuche
meinem	meinem
Leichenschauhäuser	Leichenschauhäuser
Gehilfe	Gehilfe
rekrutierest	rekrutierest
idealisierest	idealisierest
Leichtmetalle	Leichtmetalle
Silbererzen	Silbererzen
Eingeweide	Eingeweide
Martyrologium	Martyrologium
begruben	begruben
Vergeltungen	Vergeltungen
Alles	Alles
flenstet	flenstet
schwebe	schwebe
Heringe	Heringe
aufsteht	aufsteht
liebend	liebend
Liebchen	Liebchen
Krokus	Krokus
erlassen	erlassen
Arreste	Arreste
Armen	Armen
erzwangt	erzwangt
spielet	spielet
Gaschromatographie	Gaschromatographie
reinige	reinige
gekröst	gekröst
zeigst	zeigst
befestigt	befestigt
gewinne	gewinne
versteckte	versteckte
leider	leider
sei	sei
enträtselten	enträtselten
ärgerte	ärgerte
feiert	feiert
Werke	Werke
Nanokondensatoren	Nanokondensatoren
haben	haben
Hunden	Hunden
lobte	lobte
segelte	segelte
Leuchtkäfern	Leuchtkäfern
Baiser	Baiser
hydrogentartrat	hydrogentartrat
Zirkelschlüssen	Zirkelschlüssen
unterbrächen	unterbrächen
verbündend	verbündend
Serverzugriffe	Serverzugriffe
trüb	trüb
radiertest	radiertest
nehmt	nehmt
Fiebermitteln	Fiebermitteln
Pedant	Pedant
glauben	glauben
könne	könne
verkaufe	verkaufe
Hummer	Hummer
Weste	Weste
Schlössern	Schlössern
referenzierte	referenzierte
Thioester	Thioester
handhabt	handhabt
krösest	krösest
ehe	ehe
reichtet	reichtet
Schlagzeuger	Schlagzeuger
Aussätzige	Aussätzige
feierten	feierten
Arsenite	Arsenite
Stierkämpfe	Stierkämpfe
Füllfeder	Füllfeder
Fallen	Fallen
offenbartest	offenbartest
koexistierte	koexistierte
blitzt	blitzt
chloroformiere	chloroformiere
konvertiere	konvertiere
parametrisierten	parametrisierten
Organisation	Organisation
reparieret	reparieret
ausfuhren	ausfuhren
verleumdete	verleumdete
Königen	Königen
Literaturen	Literaturen
scheitern	scheitern
extemporiere	extemporiere
dürfen	dürfen
besser	besser
zwölfte	zwölfte
verbot	verbot
bemüht	bemüht
Sonnenfinsternissen	Sonnenfinsternissen
kritzelst	kritzelst
entflieht	entflieht
bewürben	bewürben
Chinakohl	Chinakohl
Schaffet	Schaffet
Gründungsprivilegien	Gründungsprivilegien
batest	batest
bröckelten	bröckelten
türmen	türmen
Körpergeruch	Körpergeruch
macht	macht
Landwirte	Landwirte
kaufest	kaufest
protestiere	protestiere
ritt	ritt
preist	preist
Bertrandite	Bertrandite
Reichweiten	Reichweiten
Germanisten	Germanisten
planschtest	planschtest
emendierte	emendierte
danke	danke
müsse	müsse
Gedanke	Gedanke
gelobet	gelobet
Zapfen	Zapfen
Atombombe	Atombombe
folterst	folterst
Kost	Kost
meuternd	meuternd
Armband	Armband
Erlösungen	Erlösungen
lang	lang
Sollte	Sollte
Kalifeldspat	Kalifeldspat
pharyngalisierten	pharyngalisierten
schälte	schälte
Gram	Gram
übrigbleibe	übrigbleibe
begehren	begehren
Abarten	Abarten
Ellen	Ellen
Alten	Alten
pflügten	pflügten
wilde	wilde
stifte	stifte
trefft	trefft
Hirten	Hirten
zeugen	zeugen
betrübten	betrübten
gedurft	gedurft
surre	surre
Fragen	Fragen
Minimierung	Minimierung
arrivierst	arrivierst
Notstand	Notstand
Abfertigungsschalter	Abfertigungsschalter
schwebte	schwebte
bewahrest	bewahrest
seit	seit
Koniferen	Koniferen
besorgt	besorgt
folgte	folgte
betätigest	betätigest
wegführe	wegführe
möpperst	möpperst
sehn	sehn
Carbiden	Carbiden
fluppt	fluppt
Chlorat	Chlorat
verunzierte	verunzierte
befestigten	befestigten
Zeitplan	Zeitplan
prostituieret	prostituieret
Atmosphäre	Atmosphäre
Gebeine	Gebeine
begehre	begehre
Kontrollboxen	Kontrollboxen
Aerosole	Aerosole
wehren	wehren
Gallan	Gallan
anrührt	anrührt
Hüftgelenken	Hüftgelenken
verkleinerest	verkleinerest
Politologen	Politologen
changiere	changiere
entfolgst	entfolgst
Mammut	Mammut
Zäume	Zäume
kollidierte	kollidierte
murmelst	murmelst
Stärke	Stärke
bollerest	bollerest
bekriegtet	bekriegtet
Bärenfellen	Bärenfellen
Anrufbeantworter	Anrufbeantworter
jungen	jungen
Rechten	Rechten
wehrtest	wehrtest
angehören	angehören
schließe	schließe
tränke	tränke
Dödeln	Dödeln
Sterne	Sterne
Blässe	Blässe
Ställen	Ställen
zittere	zittere
murmelte	murmelte
schnatternd	schnatternd
Nukleinsäure	Nukleinsäure
Bächen	Bächen
vertagest	vertagest
verführt	verführt
Kontraindikation	Kontraindikation
unterdrücke	unterdrücke
schneidet	schneidet
Verkehrsflugzeug	Verkehrsflugzeug
verringeret	verringeret
zerbrechest	zerbrechest
decke	decke
mußte	mußte
Tumulten	Tumulten
Transportwegen	Transportwegen
Steuerwagen	Steuerwagen
gewähret	gewähret
Blicksilber	Blicksilber
harrest	harrest
gedenket	gedenket
Reststoffen	Reststoffen
Schwänzen	Schwänzen
anruft	anruft
wirfst	wirfst
Sabotagen	Sabotagen
Oxonium	Oxonium
pensionierten	pensionierten
Spende	Spende
harrtest	harrtest
Komponisten	Komponisten
Neumonden	Neumonden
zerbrechen	zerbrechen
strömt	strömt
vertuest	vertuest
höbet	höbet
Safrane	Safrane
bekehrten	bekehrten
Puffersystem	Puffersystem
Dominicanerin	Dominicanerin
Drache	Drache
Schiffen	Schiffen
Kuttern	Kuttern
wechselwirkt	wechselwirkt
Stämmen	Stämmen
Barbareien	Barbareien
wälzt	wälzt
fehlen	fehlen
manche	manche
Schulleiterin	Schulleiterin
fliehe	fliehe
Rhabarbern	Rhabarbern
leertet	leertet
Ausländern	Ausländern
vertreibt	vertreibt
schlage	schlage
Juden	Juden
speicherten	speicherten
Leichname	Leichname
pflügest	pflügest
kabelten	kabelten
Glaubst	Glaubst
Galeere	Galeere
Fettsäcken	Fettsäcken
keines	keines
fremden	fremden
Wachtel	Wachtel
Tyrann	Tyrann
tobte	tobte
Firnisse	Firnisse
lostet	lostet
erbet	erbet
Sinnen	Sinnen
Räten	Räten
könnet	könnet
verbaseln	verbaseln
attackieret	attackieret
Gummibaumes	Gummibaumes
mobilisierten	mobilisierten
Aachener	Aachener
gehören	gehören
Kannen	Kannen
Indianer	Indianer
Notizen	Notizen
Kopfsalat	Kopfsalat
Temperaturanstieg	Temperaturanstieg
darfst	darfst
gebäret	gebäret
Verbindungsdrähten	Verbindungsdrähten
erbrüte	erbrüte
Adeliepinguins	Adeliepinguins
Mähnenwolf	Mähnenwolf
Bittersüß	Bittersüß
Blättchen	Blättchen
löste	löste
benähmen	benähmen
Frösche	Frösche
lodertet	lodertet
schwächend	schwächend
begebet	begebet
Fallet	Fallet
bescheißt	bescheißt
kühlen	kühlen
kürzt	kürzt
Nahrungsbestandteilen	Nahrungsbestandteilen
Animation	Animation
klönen	klönen
Metallquirlen	Metallquirlen
manchen	manchen
diskutiere	diskutiere
bewieset	bewieset
verkündigten	verkündigten
Telefonnummern	Telefonnummern
dringt	dringt
Chlorid	Chlorid
zuhörte	zuhörte
gesellt	gesellt
weinte	weinte
anzöge	anzöge
Strahlentierchens	Strahlentierchens
wünschen	wünschen
Serverzugriffen	Serverzugriffen
Orte	Orte
ärgertest	ärgertest
pressierten	pressierten
deklarierten	deklarierten
Weihen	Weihen
verdammte	verdammte
erliegen	erliegen
Haarverlusten	Haarverlusten
weist	weist
würden	würden
liebtet	liebtet
sucht	sucht
Gewalttäter	Gewalttäter
Stör	Stör
untersagtest	untersagtest
Frieden	Frieden
wässerst	wässerst
Schwebfliegen	Schwebfliegen
nippst	nippst
Fußmatte	Fußmatte
Päckchens	Päckchens
hängte	hängte
erniedrigt	erniedrigt
verspätest	verspätest
Arsenbergwerk	Arsenbergwerk
boykottierst	boykottierst
schichtet	schichtet
Suffix	Suffix
liebst	liebst
sahet	sahet
behütet	behütet
bräunst	bräunst
konsolidierest	konsolidierest
säume	säume
betrügen	betrügen
Girls	Girls
Kandidaturen	Kandidaturen
straftet	straftet
Sitzfleisches	Sitzfleisches
gebt	gebt
Wille	Wille
misstrauet	misstrauet
Schilde	Schilde
grünet	grünet
Testamente	Testamente
bleibet	bleibet
leget	leget
sedimentierte	sedimentierte
eggte	eggte
enttäusche	enttäusche
unseres	unseres
ersparet	ersparet
Schnitzeljagd	Schnitzeljagd
Ansteckers	Ansteckers
lös	lös
Futtermittel	Futtermittel
Möbiusbänder	Möbiusbänder
griff	griff
Kleinodien	Kleinodien
Bausch	Bausch
Schanktischen	Schanktischen
Zitronensäften	Zitronensäften
Fische	Fische
Kacke	Kacke
Hirschen	Hirschen
vermagst	vermagst
Geburtsnamen	Geburtsnamen
enge	enge
pustet	pustet
Aderhäuten	Aderhäuten
ackerest	ackerest
vertilgte	vertilgte
bimmelte	bimmelte
wahr	wahr
vergliche	vergliche
schaffte	schaffte
Rekursionen	Rekursionen
faul	faul
Überschüssen	Überschüssen
herrschst	herrschst
destabilisierst	destabilisierst
hätte	hätte
duschte	duschte
föchten	föchten
mästest	mästest
wärst	wärst
erfüllet	erfüllet
Euter	Euter
fällte	fällte
Halte	Halte
grauten	grauten
Gebirge	Gebirge
Trichter	Trichter
Freitagnachmittagen	Freitagnachmittagen
suchst	suchst
Pflaumen	Pflaumen
redetest	redetest
revoltierte	revoltierte
Anfechtung	Anfechtung
kabelte	kabelte
Halsabschneider	Halsabschneider
spekulieren	spekulieren
Fäuste	Fäuste
Nagellackentferner	Nagellackentferner
begehrest	begehrest
tragest	tragest
Carbid	Carbid
ältesten	ältesten
aasend	aasend
Aller	Aller
Krieg	Krieg
bebte	bebte
trompetete	trompetete
strafet	strafet
steig	steig
veranstalten	veranstalten
Erdboden	Erdboden
Fahret	Fahret
generalisiere	generalisiere
tragen	tragen
beschert	beschert
Membranen	Membranen
siegte	siegte
erlabet	erlabet
vermeßest	vermeßest
überfallen	überfallen
Grießen	Grießen
Lebenskräften	Lebenskräften
Tiefe	Tiefe
kram	kram
seien	seien
Montagmittag	Montagmittag
hell	hell
Döner	Döner
bewiese	bewiese
Abhängen	Abhängen
Nigger	Nigger
verdeckten	verdeckten
thematisierte	thematisierte
Anmeldern	Anmeldern
Massenanteil	Massenanteil
Rußen	Rußen
pflanzte	pflanzte
bejubelst	bejubelst
versklavt	versklavt
Galeeren	Galeeren
Trioxid	Trioxid
Überschüsse	Überschüsse
Weinet	Weinet
Gauner	Gauner
predigt	predigt
grübelten	grübelten
Hie	Hie
meine	meine
jaule	jaule
verkapselt	verkapselt
Homodimere	Homodimere
Male	Male
Suchet	Suchet
Gammastrahl	Gammastrahl
lest	lest
berufe	berufe
wehrend	wehrend
schweiget	schweiget
auszogst	auszogst
Störe	Störe
gibst	gibst
lauten	lauten
beweist	beweist
Katalanen	Katalanen
rüste	rüste
beanspruchest	beanspruchest
blende	blende
widmend	widmend
Taufe	Taufe
Freibergits	Freibergits
folterte	folterte
beweisen	beweisen
verfügten	verfügten
überliefere	überliefere
mikrominiaturisierten	mikrominiaturisierten
Unternehmung	Unternehmung
forschte	forschte
colorierten	colorierten
verberge	verberge
Stierkämpfen	Stierkämpfen
redete	redete
predigend	predigend
respektierten	respektierten
Halbzeit	Halbzeit
Edelsteine	Edelsteine
ruckelst	ruckelst
begrabest	begrabest
schöpfest	schöpfest
rammte	rammte
verknüpft	verknüpft
Keilen	Keilen
beherrschest	beherrschest
deckte	deckte
Roben	Roben
versucht	versucht
weinest	weinest
substituierend	substituierend
durchwacht	durchwacht
Lob	Lob
versteckten	versteckten
Aktenkoffer	Aktenkoffer
Politologe	Politologe
vergaset	vergaset
rufe	rufe
wechselwirkte	wechselwirkte
Nussknacker	Nussknacker
Ludwigsburger	Ludwigsburger
erstürmt	erstürmt
heulet	heulet
schaut	schaut
höbest	höbest
Wechselstuben	Wechselstuben
Fellhandschuh	Fellhandschuh
Philerast	Philerast
hinterlegt	hinterlegt
abalienierest	abalienierest
schaute	schaute
tagest	tagest
Broten	Broten
diente	diente
begehret	begehret
versuchest	versuchest
abzieht	abzieht
heilige	heilige
Palme	Palme
finanzieret	finanzieret
kürze	kürze
Festen	Festen
Hälsen	Hälsen
erkanntet	erkanntet
interpretiert	interpretiert
zuppen	zuppen
belohnte	belohnte
schützt	schützt
setzte	setzte
arme	arme
wurdet	wurdet
Massagen	Massagen
Krume	Krume
lobe	lobe
Bleigehalten	Bleigehalten
Hummern	Hummern
reich	reich
feiertest	feiertest
flitzte	flitzte
Brotkästen	Brotkästen
sitzet	sitzet
betrübest	betrübest
bezichtigten	bezichtigten
leset	leset
zwingst	zwingst
reformieren	reformieren
verglühest	verglühest
pflügte	pflügte
dürften	dürften
Kautschuken	Kautschuken
erweckt	erweckt
schämet	schämet
setzt	setzt
schlachtet	schlachtet
Woge	Woge
ausgereckter	ausgereckter
Epidemie	Epidemie
knusperst	knusperst
Bauwerken	Bauwerken
hämmerst	hämmerst
einer	einer
prostet	prostet
ankerst	ankerst
Ringeltauben	Ringeltauben
besäet	besäet
Assistentin	Assistentin
Technetate	Technetate
Dochten	Dochten
Indianern	Indianern
schenken	schenken
Bleiglanzes	Bleiglanzes
Otaviten	Otaviten
labe	labe
desertiertet	desertiertet
besichtiget	besichtiget
Sabbate	Sabbate
verwertete	verwertete
Huren	Huren
Zipfelmützen	Zipfelmützen
prophezeie	prophezeie
bummeltet	bummeltet
ausführte	ausführte
Kreise	Kreise
streifte	streifte
stolz	stolz
essest	essest
inneren	inneren
verstecktet	verstecktet
Bettlers	Bettlers
peiltest	peiltest
besichert	besichert
punktetest	punktetest
hickste	hickste
niemand	niemand
stiften	stiften
entflöhen	entflöhen
Türkis	Türkis
Meldezettel	Meldezettel
verwaiset	verwaiset
plissiere	plissiere
Hinterwäldlern	Hinterwäldlern
dein	dein
gewinnen	gewinnen
Heere	Heere
sündiget	sündiget
schlängelt	schlängelt
kämpfte	kämpfte
frohlockten	frohlockten
ertönst	ertönst
rächest	rächest
Trinkgefäße	Trinkgefäße
strandeten	strandeten
Mischung	Mischung
vertreiben	vertreiben
Sauberfrau	Sauberfrau
panaschieret	panaschieret
blockiert	blockiert
Aase	Aase
Lärchen	Lärchen
bis	bis
versagen	versagen
Schnarchralle	Schnarchralle
Abnahme	Abnahme
Kurkumen	Kurkumen
steiget	steiget
Tanne	Tanne
Gehorcht	Gehorcht
wähnet	wähnet
verbirgt	verbirgt
Türklingel	Türklingel
schnattert	schnattert
Pinguinen	Pinguinen
rüstetest	rüstetest
sagen	sagen
beförderet	beförderet
Gefügen	Gefügen
vergrabest	vergrabest
narret	narret
Genetikerin	Genetikerin
Kohlrübe	Kohlrübe
täuschte	täuschte
verbrauchte	verbrauchte
vergiftet	vergiftet
Dithiolan	Dithiolan
Dorngesträuchen	Dorngesträuchen
dotiere	dotiere
Dienstgrad	Dienstgrad
verfinstert	verfinstert
täuschet	täuschet
tiefe	tiefe
anders	anders
stoßest	stoßest
Gnaden	Gnaden
fasse	fasse
begehrte	begehrte
Pinguin	Pinguin
Hackern	Hackern
Verwaltungsakten	Verwaltungsakten
wohnest	wohnest
Füllet	Füllet
Kirgisin	Kirgisin
Mutagen	Mutagen
verderben	verderben
sündigte	sündigte
Lusitaner	Lusitaner
Suchanfragen	Suchanfragen
benützt	benützt
gedolmetscht	gedolmetscht
umgaben	umgaben
Halle	Halle
reanimierten	reanimierten
Pflicht	Pflicht
Trinket	Trinket
Verwaltungsakte	Verwaltungsakte
Grüße	Grüße
Röcken	Röcken
Fusselbart	Fusselbart
föchte	föchte
malochte	malochte
lärmte	lärmte
unterwerfest	unterwerfest
bestand	bestand
gaffest	gaffest
bröckeln	bröckeln
Schnipsel	Schnipsel
gibt	gibt
Gemütes	Gemütes
Tasten	Tasten
nähert	nähert
Kassiterits	Kassiterits
Katamarane	Katamarane
Inder	Inder
bleibest	bleibest
Aluminaten	Aluminaten
verdrehet	verdrehet
Küchenmaschine	Küchenmaschine
überwiese	überwiese
gravierten	gravierten
Blockflöten	Blockflöten
Nadelbäume	Nadelbäume
verwirkliche	verwirkliche
belauere	belauere
entfachet	entfachet
ziehet	ziehet
Zementen	Zementen
Schwächungen	Schwächungen
Affenbrotbaum	Affenbrotbaum
meldet	meldet
Volkslehren	Volkslehren
funktionalisiertest	funktionalisiertest
bitte	bitte
verführten	verführten
begehrst	begehrst
Stilllegung	Stilllegung
zuppe	zuppe
Campingplätzen	Campingplätzen
Grizzlybär	Grizzlybär
versuchst	versuchst
haltet	haltet
besitzest	besitzest
sichere	sichere
ausführt	ausführt
Friede	Friede
vermahnten	vermahnten
wart	wart
Orgeln	Orgeln
brauste	brauste
glaubtet	glaubtet
haarten	haarten
Spieße	Spieße
stammelest	stammelest
karikierten	karikierten
reagierte	reagierte
Fahrzeugkatalysator	Fahrzeugkatalysator
bescheiße	bescheiße
mehr	mehr
Solches	Solches
verantwortet	verantwortet
Leuchtstoffen	Leuchtstoffen
dressierten	dressierten
gehetzt	gehetzt
werft	werft
dekompiliertest	dekompiliertest
ackerst	ackerst
knurrt	knurrt
Stätten	Stätten
geliebt	geliebt
Bazzit	Bazzit
Kriegsschauplätze	Kriegsschauplätze
Pentaborat	Pentaborat
Als	Als
ausfuhr	ausfuhr
salzen	salzen
Bevölkerungsdichten	Bevölkerungsdichten
Eine	Eine
trompete	trompete
Rufen	Rufen
Knechte	Knechte
Gehörst	Gehörst
sponsertest	sponsertest
geschlummert	geschlummert
betreten	betreten
erhebet	erhebet
stimmen	stimmen
rechte	rechte
Untier	Untier
kauern	kauern
stapfst	stapfst
Träumer	Träumer
Gerichte	Gerichte
liegen	liegen
Hände	Hände
erwähnet	erwähnet
Wucher	Wucher
Bruchstrich	Bruchstrich
unsrer	unsrer
flitzen	flitzen
Metapher	Metapher
dampfst	dampfst
ein	ein
Wege	Wege
Klappertopf	Klappertopf
Wehre	Wehre
drillest	drillest
Ausbeutern	Ausbeutern
Monate	Monate
bildest	bildest
Sachen	Sachen
verachtet	verachtet
Knüppels	Knüppels
zeichnet	zeichnet
wehrte	wehrte
Campingplatzes	Campingplatzes
vermahnen	vermahnen
liebte	liebte
widerstand	widerstand
späht	späht
würdet	würdet
entfolgte	entfolgte
Werkzeuge	Werkzeuge
Rückumlauten	Rückumlauten
massakrierten	massakrierten
liste	liste
schreibst	schreibst
bringst	bringst
streuen	streuen
Küstenwache	Küstenwache
Geschreis	Geschreis
grabe	grabe
konntet	konntet
wärt	wärt
stürzest	stürzest
flehst	flehst
hämmerte	hämmerte
erfreuen	erfreuen
bequemest	bequemest
Reiseleiter	Reiseleiter
vierte	vierte
bewähret	bewähret
Tote	Tote
angehört	angehört
zügelten	zügelten
versuchten	versuchten
predigte	predigte
verdammtet	verdammtet
Kapitalverkehr	Kapitalverkehr
billigte	billigte
mopst	mopst
trotze	trotze
stärket	stärket
Fadenlauf	Fadenlauf
christianisiere	christianisiere
Ambiguität	Ambiguität
ihn	ihn
Lasten	Lasten
lange	lange
Zwetschgen	Zwetschgen
schiesst	schiesst
beliefen	beliefen
Genies	Genies
sprechet	sprechet
absagen	absagen
Gasflaschen	Gasflaschen
Kupferkiesen	Kupferkiesen
Dattel	Dattel
Trickbetrügern	Trickbetrügern
Fetzen	Fetzen
Wolle	Wolle
flöteten	flöteten
Irrtümern	Irrtümern
zwänget	zwänget
Excimerlaser	Excimerlaser
Präservativen	Präservativen
anfinge	anfinge
begeben	begeben
Planern	Planern
Sonnenfinsternis	Sonnenfinsternis
ernteten	ernteten
koordinierte	koordinierte
eines	eines
verwiesen	verwiesen
Beteiligte	Beteiligte
Königreichen	Königreichen
Würfen	Würfen
Butzemänner	Butzemänner
wünschst	wünschst
zieren	zieren
Asylrechte	Asylrechte
gelobten	gelobten
Substanzen	Substanzen
glänzen	glänzen
Lümmeltüte	Lümmeltüte
bemächtigest	bemächtigest
Traubenlese	Traubenlese
ringe	ringe
lachte	lachte
bewährt	bewährt
mögest	mögest
dümpelt	dümpelt
entdecket	entdecket
möchtet	möchtet
strömte	strömte
äusserst	äusserst
evakuierte	evakuierte
Pfarrerinnen	Pfarrerinnen
wollest	wollest
löstet	löstet
verschonet	verschonet
Paläste	Paläste
Solchen	Solchen
gewährtest	gewährtest
Gebäcken	Gebäcken
Schreiber	Schreiber
anrufen	anrufen
schneide	schneide
zerrüttete	zerrüttete
Reißnagel	Reißnagel
Aktienkursen	Aktienkursen
Desserts	Desserts
Gewicht	Gewicht
Geldautomat	Geldautomat
verschmelze	verschmelze
Übertretung	Übertretung
rauschen	rauschen
wild	wild
Wären	Wären
zwängtet	zwängtet
Metallspiegeln	Metallspiegeln
ermutigte	ermutigte
gehöre	gehöre
zählend	zählend
schenket	schenket
Handbüchern	Handbüchern
Sanatorien	Sanatorien
Drohkulisse	Drohkulisse
abtrünnigen	abtrünnigen
ersparten	ersparten
aber	aber
fahrt	fahrt
Dochte	Dochte
Kompromiss	Kompromiss
Eure	Eure
stürze	stürze
rufest	rufest
verifizierten	verifizierten
versuchte	versuchte
Heuschrecke	Heuschrecke
Freunde	Freunde
thematisierten	thematisierten
Seines	Seines
maßen	maßen
strecken	strecken
begraben	begraben
Kaffeelöffel	Kaffeelöffel
Reisebüro	Reisebüro
konsumiere	konsumiere
boßte	boßte
verbesserten	verbesserten
beweiset	beweiset
anzeigte	anzeigte
Spitze	Spitze
junge	junge
schlängelest	schlängelest
pilgerte	pilgerte
applizirte	applizirte
Thioestere	Thioestere
mißversteht	mißversteht
Bärenfelle	Bärenfelle
Kardinal	Kardinal
Zäumen	Zäumen
verbluten	verbluten
schämest	schämest
werdet	werdet
gönnst	gönnst
demütiget	demütiget
respektiere	respektiere
Genkinit	Genkinit
kommst	kommst
bewässern	bewässern
umhüll	umhüll
Toypudel	Toypudel
flambierten	flambierten
Abkömmlingen	Abkömmlingen
Grufti	Grufti
fotzte	fotzte
durchzuckest	durchzuckest
ertraget	ertraget
Prozeduren	Prozeduren
schautet	schautet
driftete	driftete
restaurierten	restaurierten
geherrscht	geherrscht
Heide	Heide
Unterschlagungen	Unterschlagungen
lackiere	lackiere
Hobby	Hobby
Zeitschlitze	Zeitschlitze
Wegen	Wegen
Indern	Indern
Raucherinnen	Raucherinnen
Dingen	Dingen
verurteile	verurteile
webte	webte
tendierst	tendierst
emendieret	emendieret
Referenz	Referenz
Donor	Donor
Peptids	Peptids
stapele	stapele
aufhebt	aufhebt
haderte	haderte
räumet	räumet
verziehen	verziehen
falle	falle
halltet	halltet
wachen	wachen
Trioxiden	Trioxiden
eggt	eggt
urbanisiert	urbanisiert
verziehe	verziehe
bequemte	bequemte
endlagern	endlagern
bestellte	bestellte
Graphem	Graphem
gewarnt	gewarnt
gedachten	gedachten
Trümmersprachen	Trümmersprachen
zerstückt	zerstückt
Schafe	Schafe
fünfte	fünfte
referenzierst	referenzierst
Nehmt	Nehmt
Drehtüren	Drehtüren
sollte	sollte
schaffet	schaffet
Unwahrheiten	Unwahrheiten
Mikrometer	Mikrometer
Halbgott	Halbgott
Teekesseln	Teekesseln
kostet	kostet
Büstenhalters	Büstenhalters
pflügen	pflügen
eure	eure
fladerst	fladerst
aufkommt	aufkommt
fluchte	fluchte
Denn	Denn
Erdkruste	Erdkruste
liehe	liehe
Fluoratom	Fluoratom
Türkenbund	Türkenbund
begleicht	begleicht
Magiern	Magiern
Fußballweltmeisterschaftsqualifikationsspiel	Fußballweltmeisterschaftsqualifikationsspiel
erfreute	erfreute
wünscht	wünscht
Toten	Toten
Zebrahai	Zebrahai
kickst	kickst
hydrolysierend	hydrolysierend
führest	führest
Gelobet	Gelobet
Wembley-Toren	Wembley-Toren
Hat	Hat
betätigtet	betätigtet
huren	huren
Crescendo	Crescendo
Knöllchen	Knöllchen
Flitzer	Flitzer
Augen	Augen
amen	amen
Dewargefäß	Dewargefäß
ersten	ersten
Brötchen	Brötchen
Trinker	Trinker
Iberers	Iberers
wachset	wachset
Kaufleute	Kaufleute
Seilen	Seilen
rebelliertet	rebelliertet
Panzerschrecke	Panzerschrecke
erwärmst	erwärmst
umgäben	umgäben
Treibhausgasen	Treibhausgasen
dürfest	dürfest
Quellen	Quellen
verachtend	verachtend
fertigte	fertigte
nähret	nähret
ungehorsam	ungehorsam
Nanotesla	Nanotesla
Regenwald	Regenwald
Kerzenlichtern	Kerzenlichtern
piesackest	piesackest
löset	löset
herrschest	herrschest
kugele	kugele
entgegenkamst	entgegenkamst
generalisiert	generalisiert
saget	saget
Gängen	Gängen
Propheten	Propheten
absolviere	absolviere
stimmte	stimmte
Nachruf	Nachruf
bedient	bedient
gebührt	gebührt
Premieren	Premieren
Kerzenfische	Kerzenfische
Deutungen	Deutungen
blase	blase
bekannten	bekannten
besäest	besäest
Jahren	Jahren
Arbeitsgruppen	Arbeitsgruppen
prangest	prangest
Anhängsel	Anhängsel
erkannten	erkannten
Wäre	Wäre
Dobermännern	Dobermännern
sprühend	sprühend
Pimmel	Pimmel
Ahnen	Ahnen
panaschieren	panaschieren
Sternen	Sternen
Maß	Maß
verdammst	verdammst
behauptete	behauptete
hebräischen	hebräischen
baust	baust
Briketten	Briketten
Kürass	Kürass
Abnahmen	Abnahmen
verführte	verführte
Argyrodite	Argyrodite
irren	irren
aufrichten	aufrichten
sterilisierte	sterilisierte
welche	welche
belüftete	belüftete
Fahrt	Fahrt
geknautscht	geknautscht
Rotzinkerzen	Rotzinkerzen
Zehnten	Zehnten
Remis	Remis
ruhest	ruhest
ringele	ringele
Gewalttätern	Gewalttätern
leiten	leiten
liebtest	liebtest
glänzten	glänzten
Gurt	Gurt
stille	stille
dingt	dingt
Pest	Pest
schauspieleren	schauspieleren
sterbet	sterbet
Playlists	Playlists
Kochfeldern	Kochfeldern
Platte	Platte
Charakteristika	Charakteristika
trinkest	trinkest
erweckst	erweckst
Rooibos	Rooibos
Paragraphenreitern	Paragraphenreitern
überfischte	überfischte
tief	tief
Licht	Licht
Fittiche	Fittiche
Riegel	Riegel
Aha-Erlebnis	Aha-Erlebnis
Anwendungsgebiet	Anwendungsgebiet
verstecke	verstecke
Schlagzeugern	Schlagzeugern
überlieferten	überlieferten
heben	heben
Domänen	Domänen
tätowierest	tätowierest
dirigiert	dirigiert
Begünstigungen	Begünstigungen
erhört	erhört
lockerte	lockerte
aufstanden	aufstanden
Diamantringen	Diamantringen
Zwingburgen	Zwingburgen
Signal	Signal
Mittelaltermarkt	Mittelaltermarkt
tendiertet	tendiertet
teil	teil
entsündigt	entsündigt
Blechen	Blechen
Borhydrid	Borhydrid
sagten	sagten
versteigerest	versteigerest
begnadigst	begnadigst
wähnt	wähnt
harmoniere	harmoniere
Aphasien	Aphasien
zerrisset	zerrisset
schmusen	schmusen
Seit	Seit
regiere	regiere
schmetterst	schmetterst
beißt	beißt
regierte	regierte
Abschiedsbriefe	Abschiedsbriefe
Werken	Werken
parkierst	parkierst
schaben	schaben
Vanadaten	Vanadaten
nagelte	nagelte
schlafe	schlafe
babbeltet	babbeltet
weichet	weichet
löge	löge
Bertrandit	Bertrandit
verlasset	verlasset
Schneepflug	Schneepflug
funktioniertest	funktioniertest
Inkarnationen	Inkarnationen
Lümmeltüten	Lümmeltüten
deponiere	deponiere
boykottierten	boykottierten
verkleidete	verkleidete
kritzele	kritzele
rännen	rännen
Leichtmetallen	Leichtmetallen
Aufträgen	Aufträgen
spiele	spiele
entwickelten	entwickelten
implodier	implodier
deklarierte	deklarierte
gebären	gebären
Aha-Erlebnisse	Aha-Erlebnisse
Fortsetzungen	Fortsetzungen
Kristallen	Kristallen
Abartigkeit	Abartigkeit
betrüben	betrüben
Haarverlust	Haarverlust
einem	einem
Klärung	Klärung
Massenanteilen	Massenanteilen
zürntest	zürntest
Weinstöcken	Weinstöcken
Knaben	Knaben
stillte	stillte
erstände	erstände
unschuldige	unschuldige
Notständen	Notständen
Feldbett	Feldbett
Kleinoden	Kleinoden
touchierte	touchierte
glaubte	glaubte
imitiertet	imitiertet
entdeckst	entdeckst
massakrierte	massakrierte
Spießen	Spießen
endlagerten	endlagerten
Herzchen	Herzchen
Tausch	Tausch
werten	werten
klappen	klappen
Ösophagospasmen	Ösophagospasmen
Videoaufzeichnung	Videoaufzeichnung
ummantelten	ummantelten
Ölfässern	Ölfässern
hingehst	hingehst
Bushaltestellen	Bushaltestellen
ausgerecktem	ausgerecktem
führe	führe
Haarshampoos	Haarshampoos
reifst	reifst
Leitkegeln	Leitkegeln
emigrieret	emigrieret
bat	bat
wärmet	wärmet
Heptamolybdat	Heptamolybdat
Dann	Dann
Lammfellhandschuhs	Lammfellhandschuhs
Isobar	Isobar
durfte	durfte
Wunde	Wunde
wollte	wollte
erschrickt	erschrickt
lebest	lebest
Schild	Schild
gesagt	gesagt
Schwächung	Schwächung
fritierst	fritierst
tagen	tagen
gewährte	gewährte
kaserniert	kaserniert
warnet	warnet
Zeithorizonten	Zeithorizonten
Kleptokratie	Kleptokratie
appellierst	appellierst
gebäre	gebäre
aufwachte	aufwachte
Adamsapfel	Adamsapfel
Solch	Solch
Tetraiodide	Tetraiodide
sitzen	sitzen
frottier	frottier
besät	besät
Zinkionen	Zinkionen
Grenzen	Grenzen
Dezernaten	Dezernaten
Milzen	Milzen
Beschleuniger	Beschleuniger
vertilgst	vertilgst
meißelt	meißelt
weisen	weisen
schmuggle	schmuggle
vier	vier
erzeigt	erzeigt
Gehirnwellen	Gehirnwellen
legst	legst
Hochsommern	Hochsommern
Kohlenstoffgehalten	Kohlenstoffgehalten
beschrifteten	beschrifteten
Abkürzungsverzeichnisse	Abkürzungsverzeichnisse
beseht	beseht
eskalieret	eskalieret
exmatrikuliertet	exmatrikuliertet
dümpelest	dümpelest
zankte	zankte
schlagt	schlagt
erwürgtest	erwürgtest
Trickbetrüger	Trickbetrüger
Bauwerke	Bauwerke
dümpelst	dümpelst
schimmerest	schimmerest
Leid	Leid
lüftet	lüftet
beißet	beißet
Großstädter	Großstädter
Klassenzimmern	Klassenzimmern
Citrat	Citrat
vollendete	vollendete
Spielen	Spielen
vertonten	vertonten
zeichnest	zeichnest
Astat	Astat
Eisenkraut	Eisenkraut
Funkfeuer	Funkfeuer
dekorieren	dekorieren
Rechenbrett	Rechenbrett
Pflanzenwachstum	Pflanzenwachstum
berufen	berufen
Mein	Mein
verzweigst	verzweigst
simuliertet	simuliertet
plissieren	plissieren
Zahnfleischentzündung	Zahnfleischentzündung
Somite	Somite
gehörten	gehörten
Sexten	Sexten
Signalen	Signalen
Ruße	Ruße
quantisierte	quantisierte
Aspartame	Aspartame
schnorrest	schnorrest
Kräfte	Kräfte
Tintenfisch	Tintenfisch
zweiten	zweiten
Wahnen	Wahnen
Einstufung	Einstufung
Würfelspiele	Würfelspiele
henken	henken
Glühwürmchen	Glühwürmchen
Stiefvätern	Stiefvätern
Tintenklecks	Tintenklecks
schonte	schonte
Fischotters	Fischotters
schlag	schlag
wachsen	wachsen
verkürzte	verkürzte
lüg	lüg
Bevölkerungsdichte	Bevölkerungsdichte
Hure	Hure
geraten	geraten
ferne	ferne
Verbrechen	Verbrechen
Schuhen	Schuhen
Mischelementen	Mischelementen
auflöst	auflöst
zählet	zählet
Marokkaners	Marokkaners
hinterfragst	hinterfragst
legte	legte
warntest	warntest
tanze	tanze
zagest	zagest
Filzläusen	Filzläusen
verrostet	verrostet
entsetzte	entsetzte
Weinen	Weinen
Namen	Namen
Pflichten	Pflichten
Fettsack	Fettsack
Kerls	Kerls
Wolfesgrube	Wolfesgrube
Aphasie	Aphasie
Dödel	Dödel
Apotheose	Apotheose
ziere	ziere
entsetzen	entsetzen
Eingaben	Eingaben
Kommst	Kommst
begrübe	begrübe
diversifiziere	diversifiziere
raffiniere	raffiniere
kurbelte	kurbelte
Seelöwen	Seelöwen
schreien	schreien
Neumonde	Neumonde
vertäte	vertäte
Pferden	Pferden
teilet	teilet
Halt	Halt
Putschisten	Putschisten
borgst	borgst
grüßend	grüßend
tage	tage
Hirte	Hirte
verzeigt	verzeigt
entmineralisieret	entmineralisieret
babbelst	babbelst
Gespenstern	Gespenstern
Geliebte	Geliebte
gestatte	gestatte
Chemikerinnen	Chemikerinnen
Ausnahme	Ausnahme
Diese	Diese
finanziert	finanziert
Ochsen	Ochsen
helfest	helfest
Rotzinkerz	Rotzinkerz
müssest	müssest
begnügte	begnügte
speisen	speisen
schnorrtet	schnorrtet
begehrt	begehrt
Stühlen	Stühlen
interagiert	interagiert
Edelsteinen	Edelsteinen
Ach	Ach
überreichend	überreichend
bessere	bessere
posierst	posierst
Durchbruch	Durchbruch
drücken	drücken
Fällen	Fällen
zeugten	zeugten
griechisch	griechisch
unehret	unehret
Nanoteslan	Nanoteslan
Bombardierung	Bombardierung
konnotierst	konnotierst
bewässerst	bewässerst
erhöhet	erhöhet
bedurftest	bedurftest
überschattete	überschattete
besorg	besorg
anrichte	anrichte
Blutgefäß	Blutgefäß
Normdaten	Normdaten
Pflaume	Pflaume
Sauberfrauen	Sauberfrauen
gewitterest	gewitterest
rühmet	rühmet
heparinisierten	heparinisierten
Temperaturanstiege	Temperaturanstiege
geleite	geleite
lieben	lieben
drängten	drängten
wohnte	wohnte
Transportweg	Transportweg
Lobet	Lobet
Herden	Herden
entwischten	entwischten
stelle	stelle
verdreht	verdreht
wischt	wischt
entmineralisierst	entmineralisierst
Streiten	Streiten
Antimusters	Antimusters
verprügelet	verprügelet
transportiere	transportiere
deinen	deinen
illustriertet	illustriertet
aufhoben	aufhoben
räumen	räumen
glaubest	glaubest
zuteilte	zuteilte
Schwestern	Schwestern
erwärmte	erwärmte
erhörest	erhörest
gedächten	gedächten
verschränken	verschränken
zuppte	zuppte
stapften	stapften
wünsche	wünsche
Lehrkörpern	Lehrkörpern
bummelet	bummelet
Radsätzen	Radsätzen
bewahrt	bewahrt
ratschlagten	ratschlagten
dechiffrierend	dechiffrierend
aufrichtet	aufrichtet
glaubet	glaubet
Unglaube	Unglaube
Felle	Felle
Fischen	Fischen
Tintenklecksen	Tintenklecksen
baggerte	baggerte
beeindruckt	beeindruckt
Stäbe	Stäbe
verwirrt	verwirrt
Buchstabe	Buchstabe
Flame	Flame
trieben	trieben
brechet	brechet
unserem	unserem
Spitzen	Spitzen
Funkfeuern	Funkfeuern
Arbeitsbereich	Arbeitsbereich
Breiten	Breiten
lostest	lostest
Wehret	Wehret
Galopps	Galopps
velarisierend	velarisierend
Zinkat	Zinkat
nachwandeln	nachwandeln
Räte	Räte
verschlimmere	verschlimmere
Arbeitsbereichen	Arbeitsbereichen
Coventrisierung	Coventrisierung
Optimisten	Optimisten
Sprüche	Sprüche
eingehest	eingehest
gelangte	gelangte
verschärfst	verschärfst
Einfältigkeit	Einfältigkeit
Bienenzüchter	Bienenzüchter
überdenkst	überdenkst
begehrten	begehrten
speisest	speisest
bewiest	bewiest
Stolze	Stolze
Halogenatom	Halogenatom
produzierten	produzierten
Entrées	Entrées
zentrifugierst	zentrifugierst
erhebest	erhebest
lockerst	lockerst
überprüftest	überprüftest
pflanzt	pflanzt
Collagen	Collagen
substituierten	substituierten
hegt	hegt
laut	laut
Großfürst	Großfürst
Eselsohren	Eselsohren
Fokusse	Fokusse
stellte	stellte
liegst	liegst
wären	wären
schichteten	schichteten
spricht	spricht
Kompassen	Kompassen
Zäune	Zäune
hebet	hebet
Insulaner	Insulaner
Türmen	Türmen
Traubenlesen	Traubenlesen
einführen	einführen
Langschwanzpinguinen	Langschwanzpinguinen
puddelst	puddelst
Kommet	Kommet
Prostylos	Prostylos
verkürztet	verkürztet
Gebote	Gebote
Öfchen	Öfchen
ermordet	ermordet
Kakaos	Kakaos
gebühren	gebühren
Schaden	Schaden
Abfertigungsgebäuden	Abfertigungsgebäuden
kabbelet	kabbelet
Klotz	Klotz
schnitt	schnitt
Höhe	Höhe
Eines	Eines
verlieren	verlieren
wacht	wacht
Karern	Karern
erklinge	erklinge
unserer	unserer
folgst	folgst
Märchenbüchern	Märchenbüchern
verschreibt	verschreibt
Abbild	Abbild
bequemtet	bequemtet
Version	Version
Wandergesellen	Wandergesellen
Hebet	Hebet
fetten	fetten
verzieht	verzieht
wollt	wollt
deaktivierst	deaktivierst
binde	binde
Blaumeisen	Blaumeisen
quasselten	quasselten
Vesper	Vesper
läutet	läutet
Arbeitskreis	Arbeitskreis
Zerfall	Zerfall
Beobachtungen	Beobachtungen
Dieben	Dieben
taufet	taufet
verspielte	verspielte
Empörung	Empörung
Gedrängen	Gedrängen
fritieret	fritieret
Taube	Taube
seine	seine
Trichtern	Trichtern
wogen	wogen
legend	legend
neige	neige
Reliquiare	Reliquiare
Ansichtskarte	Ansichtskarte
spannt	spannt
Kompass	Kompass
zuppst	zuppst
hasse	hasse
schauten	schauten
Frommen	Frommen
beichteten	beichteten
jemanden	jemanden
sinkest	sinkest
Gefangenen	Gefangenen
bemühet	bemühet
Kühen	Kühen
ihres	ihres
Alkine	Alkine
Sprödmetallen	Sprödmetallen
Reizt	Reizt
halte	halte
Schläge	Schläge
vergrubt	vergrubt
Extremen	Extremen
Bär	Bär
verzeichnete	verzeichnete
tut	tut
konsolidierend	konsolidierend
Boten	Boten
möchte	möchte
Gesamtmengen	Gesamtmengen
Seiten	Seiten
konvergiere	konvergiere
begrübest	begrübest
schwenkt	schwenkt
durchläuterte	durchläuterte
Darlegung	Darlegung
Laufringe	Laufringe
erforschet	erforschet
eiterten	eiterten
erziehst	erziehst
Geschwindigkeitsmessern	Geschwindigkeitsmessern
parliere	parliere
schaffst	schaffst
versüßtet	versüßtet
auflegt	auflegt
verzieh	verzieh
abalieniertest	abalieniertest
setzest	setzest
Weiblein	Weiblein
gewinnet	gewinnet
er	er
Steuerbord	Steuerbord
solche	solche
Führe	Führe
glaubend	glaubend
Zankapfels	Zankapfels
Eissteinen	Eissteinen
Gurten	Gurten
Schlüchten	Schlüchten
entmineralisieren	entmineralisieren
verleumdetest	verleumdetest
Laufet	Laufet
sannen	sannen
Glauben	Glauben
liebest	liebest
vermeße	vermeße
gedenke	gedenke
Sogen	Sogen
Talisman	Talisman
rundet	rundet
rächte	rächte
Fußmatten	Fußmatten
Heeren	Heeren
Geliebten	Geliebten
schöpfte	schöpfte
Silberdrähten	Silberdrähten
begnadigte	begnadigte
Langzeichen	Langzeichen
Barschaften	Barschaften
bromiertet	bromiertet
beweisest	beweisest
predige	predige
gelobest	gelobest
Schätze	Schätze
braust	braust
emaillieret	emaillieret
zürnten	zürnten
Flensern	Flensern
keiner	keiner
opferte	opferte
Schwirrvogel	Schwirrvogel
polymerisier	polymerisier
aßet	aßet
Marjellchens	Marjellchens
Stechpalmen	Stechpalmen
verbrauchet	verbrauchet
Kleinode	Kleinode
verkürztest	verkürztest
Schleppern	Schleppern
träumen	träumen
Brettspielen	Brettspielen
verblutete	verblutete
Fanmeile	Fanmeile
folgt	folgt
aufrichte	aufrichte
stützet	stützet
Totenglocke	Totenglocke
Garben	Garben
fällst	fällst
Geschichtsbüchern	Geschichtsbüchern
bestimmten	bestimmten
Herkünften	Herkünften
erklingt	erklingt
verhungerte	verhungerte
Trägerwellen	Trägerwellen
Schlägen	Schlägen
Sorge	Sorge
querest	querest
heile	heile
Abszisse	Abszisse
reformierten	reformierten
Auge	Auge
restaurieret	restaurieret
Hüllenelektronen	Hüllenelektronen
stoppten	stoppten
vermahnte	vermahnte
knufften	knufften
reiche	reiche
Samstagnachmittagen	Samstagnachmittagen
Halbmonden	Halbmonden
balkanisierten	balkanisierten
leihe	leihe
Apfelbäumen	Apfelbäumen
Büschen	Büschen
klingt	klingt
stationierten	stationierten
führet	führet
bedürftet	bedürftet
erriet	erriet
kauten	kauten
Martyrologien	Martyrologien
ermordetet	ermordetet
ärgernd	ärgernd
regierst	regierst
zeug	zeug
heiße	heiße
verkündigt	verkündigt
Apostel	Apostel
dürfte	dürfte
Anzeichens	Anzeichens
schleiß	schleiß
Apportierhund	Apportierhund
Schlaraffenländern	Schlaraffenländern
schätze	schätze
verblieben	verblieben
schluchzte	schluchzte
kochte	kochte
erhöht	erhöht
Knüppeln	Knüppeln
Ebenen	Ebenen
Griechen	Griechen
Vorstädten	Vorstädten
überwachten	überwachten
Menschenhandel	Menschenhandel
privilegierst	privilegierst
Abschußringe	Abschußringe
kontaktieret	kontaktieret
brillierest	brillierest
zerstückte	zerstückte
tabuisiert	tabuisiert
warte	warte
gedacht	gedacht
Bis	Bis
Zement	Zement
quantisiere	quantisiere
brenne	brenne
colorierend	colorierend
Sonderbericht	Sonderbericht
Münzsammlungen	Münzsammlungen
begründetest	begründetest
heißt	heißt
Strahlentierchen	Strahlentierchen
Gangster	Gangster
Uranerzen	Uranerzen
Älteste	Älteste
Säuen	Säuen
Achseln	Achseln
Ratet	Ratet
fünften	fünften
suchte	suchte
heiligten	heiligten
überweise	überweise
stellst	stellst
verkündigst	verkündigst
Schlange	Schlange
dürft	dürft
stapelten	stapelten
unterwirft	unterwirft
übrigbleibt	übrigbleibt
zeugst	zeugst
emigriert	emigriert
schmeichelest	schmeichelest
Seinen	Seinen
fistete	fistete
solch	solch
Stufe	Stufe
knurrtet	knurrtet
vertrieb	vertrieb
unterforderten	unterforderten
gute	gute
bromiert	bromiert
gedachtest	gedachtest
zweifeln	zweifeln
anhangt	anhangt
Nahrungsbestandteil	Nahrungsbestandteil
verlaßt	verlaßt
Beryll	Beryll
inszenierst	inszenierst
ziehst	ziehst
lodert	lodert
Cyclodextrinen	Cyclodextrinen
schöben	schöben
Däumlings	Däumlings
mögt	mögt
Flöße	Flöße
massierst	massierst
Rechenbrettern	Rechenbrettern
Rückumlaute	Rückumlaute
Schwänze	Schwänze
baute	baute
war	war
regeln	regeln
Lazarett	Lazarett
stärkte	stärkte
Oberlippe	Oberlippe
Sehnen	Sehnen
unterwerfe	unterwerfe
Europameisters	Europameisters
Knabe	Knabe
blasen	blasen
entwischtet	entwischtet
Öfchens	Öfchens
Brechnuss	Brechnuss
hattet	hattet
Atemluft	Atemluft
deute	deute
zirpen	zirpen
überqueren	überqueren
Peptid	Peptid
betrüge	betrüge
füsilierten	füsilierten
schließt	schließt
Pianos	Pianos
Welteninsel	Welteninsel
unterschieden	unterschieden
gönnest	gönnest
Reichweite	Reichweite
umkäme	umkäme
beauftragt	beauftragt
Vollkornbrot	Vollkornbrot
steigest	steigest
zerbrichst	zerbrichst
speist	speist
Blaumeise	Blaumeise
haust	haust
neigte	neigte
rebelliere	rebelliere
Jungfernflüge	Jungfernflüge
ballaste	ballaste
Berufen	Berufen
Türkin	Türkin
maximiere	maximiere
denaturieret	denaturieret
Willen	Willen
verstand	verstand
Rehen	Rehen
Wiedergutmachung	Wiedergutmachung
Kommoden	Kommoden
Kerl	Kerl
heiligt	heiligt
kehret	kehret
verzögerten	verzögerten
graben	graben
Hochzeitstorten	Hochzeitstorten
konnten	konnten
Helme	Helme
backen	backen
beäugst	beäugst
Reiseleitern	Reiseleitern
verzeichne	verzeichne
Nervenzellen	Nervenzellen
ladest	ladest
älteste	älteste
Ästen	Ästen
Fingerhüten	Fingerhüten
kauerten	kauerten
Plumpsen	Plumpsen
bekehrst	bekehrst
Einen	Einen
taufen	taufen
raffinier	raffinier
Anführer	Anführer
wehe	wehe
vertraute	vertraute
verbrauchten	verbrauchten
Treppe	Treppe
durchzuck	durchzuck
sabbelten	sabbelten
aufhobt	aufhobt
sabbelt	sabbelt
brauchte	brauchte
Polarisation	Polarisation
Abbindebeschleunigern	Abbindebeschleunigern
türmt	türmt
Saiblingen	Saiblingen
ansehen	ansehen
wichsten	wichsten
lögest	lögest
Scherzen	Scherzen
parfümierst	parfümierst
Fällt	Fällt
ungehorsame	ungehorsame
vermischten	vermischten
Blütenachse	Blütenachse
linke	linke
Chlorwasserstoffmoleküls	Chlorwasserstoffmoleküls
belauerten	belauerten
Seelöwe	Seelöwe
Saiblinge	Saiblinge
Randbemerkung	Randbemerkung
Radfahrer	Radfahrer
Kronsbeere	Kronsbeere
Funktionalität	Funktionalität
analysiere	analysiere
Aprikose	Aprikose
spaltest	spaltest
Kernspaltungen	Kernspaltungen
Wehklagen	Wehklagen
wallfahrten	wallfahrten
erwärmet	erwärmet
Weinbergen	Weinbergen
bemerket	bemerket
Gesetzen	Gesetzen
Schnittlauch	Schnittlauch
wohnet	wohnet
Meines	Meines
verwahrst	verwahrst
Notärztinnen	Notärztinnen
nähet	nähet
Tumult	Tumult
erwache	erwache
antworte	antworte
dresche	dresche
kritzeln	kritzeln
Eins	Eins
lautete	lautete
Aas	Aas
schlabberte	schlabberte
Kunstgeschichte	Kunstgeschichte
reim	reim
Markise	Markise
erdacht	erdacht
umhüllend	umhüllend
Schaffe	Schaffe
entwaffnest	entwaffnest
wäre	wäre
rauschte	rauschte
Jochen	Jochen
erstarrten	erstarrten
brillieret	brillieret
eher	eher
verpuffe	verpuffe
maximierten	maximierten
transportierst	transportierst
erinnerest	erinnerest
obfuskierten	obfuskierten
hieltet	hieltet
Seetaucher	Seetaucher
zweite	zweite
optimiert	optimiert
Dans	Dans
fragest	fragest
Ringe	Ringe
designierst	designierst
Subspezies	Subspezies
freiwilligen	freiwilligen
Pis	Pis
Futtermitteln	Futtermitteln
Drachen	Drachen
hüpfen	hüpfen
kürzten	kürzten
hebräische	hebräische
Deinem	Deinem
Lötzinn	Lötzinn
verkündiget	verkündiget
putzt	putzt
Gespenst	Gespenst
Braunralle	Braunralle
blamierest	blamierest
Feiertagen	Feiertagen
berücksichtiget	berücksichtiget
falteten	falteten
orgelt	orgelt
Rubine	Rubine
amenagieren	amenagieren
verzweifelt	verzweifelt
schauen	schauen
Haben	Haben
filzten	filzten
teilen	teilen
verzierten	verzierten
tat	tat
Senkung	Senkung
Tore	Tore
generiert	generiert
folgen	folgen
Lobe	Lobe
gestikulierst	gestikulierst
Brechnüssen	Brechnüssen
Otavit	Otavit
zeugt	zeugt
Vordenker	Vordenker
Zähnen	Zähnen
Laie	Laie
Hin	Hin
grüßest	grüßest
frevle	frevle
verfehlten	verfehlten
Programmiererinnen	Programmiererinnen
Abfertigungsgebäude	Abfertigungsgebäude
verseucht	verseucht
verfliegest	verfliegest
funktionalisierte	funktionalisierte
Kindergeld	Kindergeld
Füllfederhalters	Füllfederhalters
Sprüchen	Sprüchen
trotzest	trotzest
Anhang	Anhang
Aggressoren	Aggressoren
kautest	kautest
ramme	ramme
grüßte	grüßte
Gleitzeiten	Gleitzeiten
Lehnen	Lehnen
Metallothionein	Metallothionein
Röcke	Röcke
Gässchen	Gässchen
eurem	eurem
zürnte	zürnte
Schuldner	Schuldner
Früchten	Früchten
verselbständigt	verselbständigt
Weißflügelpinguin	Weißflügelpinguin
schwirrt	schwirrt
dressieret	dressieret
geboten	geboten
wechselte	wechselte
bekehrte	bekehrte
kühl	kühl
stützen	stützen
Leitungsweg	Leitungsweg
knackt	knackt
bündelest	bündelest
ansehet	ansehet
Anker	Anker
Frettchen	Frettchen
plissierten	plissierten
Hirsche	Hirsche
Böse	Böse
Gebeten	Gebeten
Beiblättern	Beiblättern
Reflexionen	Reflexionen
Sanatoriums	Sanatoriums
Gaschromatographien	Gaschromatographien
Assimilationen	Assimilationen
bewässertet	bewässertet
Kindergeldern	Kindergeldern
addierest	addierest
stehest	stehest
entsündigten	entsündigten
anzeigt	anzeigt
begehrtest	begehrtest
armen	armen
Friedensforscherinnen	Friedensforscherinnen
versüße	versüße
Autonomie	Autonomie
kriegte	kriegte
bestimmt	bestimmt
Säue	Säue
frottierten	frottierten
Eingeweiden	Eingeweiden
pressiere	pressiere
Blitzableiter	Blitzableiter
beläufst	beläufst
Taufen	Taufen
selbst	selbst
Schamentzündungen	Schamentzündungen
filzen	filzen
berücksichtigt	berücksichtigt
könnest	könnest
weichen	weichen
grünst	grünst
planschest	planschest
annektierten	annektierten
Sekretärinnen	Sekretärinnen
Dünungen	Dünungen
ihren	ihren
beschwindele	beschwindele
verwirfst	verwirfst
verstrahlet	verstrahlet
laute	laute
gähnten	gähnten
Substanz	Substanz
besehet	besehet
defragmentierest	defragmentierest
Herr	Herr
siegen	siegen
verbasele	verbasele
reglementierte	reglementierte
interagierte	interagierte
setztet	setztet
vermöget	vermöget
lochtest	lochtest
Mops	Mops
gelobst	gelobst
verirrt	verirrt
Lammfellhandschuhen	Lammfellhandschuhen
nütze	nütze
holst	holst
lauft	lauft
herrschet	herrschet
markiere	markiere
Rehe	Rehe
sorget	sorget
All	All
fotzt	fotzt
Kurkuma	Kurkuma
meinst	meinst
verbitterest	verbitterest
Bette	Bette
leistete	leistete
quatschest	quatschest
betrübt	betrübt
verbitterten	verbitterten
hievten	hievten
gehörst	gehörst
duckmäusere	duckmäusere
würde	würde
beeindrucket	beeindrucket
schäumt	schäumt
harrten	harrten
kehre	kehre
evakuieret	evakuieret
Haltepunkt	Haltepunkt
sitzt	sitzt
hinterzöge	hinterzöge
beschlug	beschlug
Kontaktierungen	Kontaktierungen
erbaust	erbaust
schwelle	schwelle
bespracht	bespracht
spähet	spähet
Wiederbelebung	Wiederbelebung
hicksest	hicksest
ringet	ringet
vergibst	vergibst
narren	narren
fallen	fallen
solchem	solchem
austilgen	austilgen
Treppen	Treppen
Genkinits	Genkinits
solchen	solchen
verwirklicht	verwirklicht
zerstreuest	zerstreuest
strafe	strafe
harmonierest	harmonierest
föhnten	föhnten
brausen	brausen
Grabe	Grabe
vermag	vermag
präsentiere	präsentiere
gern	gern
verludet	verludet
Lazarette	Lazarette
Bürzel	Bürzel
halt	halt
werdest	werdest
wachte	wachte
wolle	wolle
grünt	grünt
Rutheniumisotopen	Rutheniumisotopen
verdammen	verdammen
labert	labert
Flamingo	Flamingo
addieret	addieret
schwirret	schwirret
sagst	sagst
verladet	verladet
entwaffneten	entwaffneten
Geschäften	Geschäften
beleuchteten	beleuchteten
Futur	Futur
Normdatum	Normdatum
wurde	wurde
Schläfchens	Schläfchens
vermischen	vermischen
erwähnten	erwähnten
Blumenstrauß	Blumenstrauß
Fluorgehalte	Fluorgehalte
Ochs	Ochs
Haltepunkten	Haltepunkten
halbe	halbe
Rücktrittbremsen	Rücktrittbremsen
Atemgas	Atemgas
verdamme	verdamme
befürchtet	befürchtet
entwickele	entwickele
Primärenergie	Primärenergie
schmiert	schmiert
schlagest	schlagest
kehrte	kehrte
Greyerzern	Greyerzern
wog	wog
Büchereien	Büchereien
Klotzes	Klotzes
Enthärtungen	Enthärtungen
Briefwechsel	Briefwechsel
Laufring	Laufring
schämten	schämten
Maultiere	Maultiere
hantiert	hantiert
haarte	haarte
Verehrer	Verehrer
ermächtigest	ermächtigest
Ölspuren	Ölspuren
beweise	beweise
Radiergummis	Radiergummis
implodiere	implodiere
Feiertage	Feiertage
Abfahrtsliste	Abfahrtsliste
Laib	Laib
zersetzte	zersetzte
Unterseiten	Unterseiten
Schrei	Schrei
Oxalate	Oxalate
vereinigte	vereinigte
warne	warne
Apfelbäume	Apfelbäume
bedeckt	bedeckt
Elfen	Elfen
machst	machst
Dienstgrade	Dienstgrade
speise	speise
schläfst	schläfst
UND-Gatter	UND-Gatter
koexistierten	koexistierten
meldeten	meldeten
gafften	gafften
Würfelspiel	Würfelspiel
Kerzenlichter	Kerzenlichter
erstaunst	erstaunst
Moren	Moren
kristallisierest	kristallisierest
Denkmünze	Denkmünze
Essigsäurechlorid	Essigsäurechlorid
Schwan	Schwan
verzieret	verzieret
tanzen	tanzen
Wehklage	Wehklage
überweist	überweist
rodet	rodet
zerrütteten	zerrütteten
Ablösung	Ablösung
Finanzministerium	Finanzministerium
Kornnattern	Kornnattern
Schafen	Schafen
Diagnostik	Diagnostik
jammerte	jammerte
Briefe	Briefe
blockierten	blockierten
Fluorgehalt	Fluorgehalt
Wiederauferstehung	Wiederauferstehung
bekehret	bekehret
weg	weg
Benzol	Benzol
Augur	Augur
Trinkgefäßen	Trinkgefäßen
Zwergschwan	Zwergschwan
Altäre	Altäre
versuche	versuche
Deinen	Deinen
niemanden	niemanden
Schreibtischtäter	Schreibtischtäter
beten	beten
Äquatoren	Äquatoren
Zäunen	Zäunen
Shortcut	Shortcut
Kanzleien	Kanzleien
assimilierten	assimilierten
Ärzte	Ärzte
Melanteriten	Melanteriten
Götzen	Götzen
Gar	Gar
Strontiumamalgamen	Strontiumamalgamen
Theologie	Theologie
empört	empört
Begrenzung	Begrenzung
Jungen	Jungen
frikassiert	frikassiert
Atomphysiker	Atomphysiker
hegst	hegst
imprägniere	imprägniere
betrübtest	betrübtest
verhören	verhören
aßest	aßest
schwellen	schwellen
faule	faule
pressiert	pressiert
Rücktrittbremse	Rücktrittbremse
klemmen	klemmen
führst	führst
Kirgisinnen	Kirgisinnen
malen	malen
ruckeln	ruckeln
kommet	kommet
füsilierte	füsilierte
umhüllt	umhüllt
inhalier	inhalier
Zeugen	Zeugen
zeuget	zeuget
Löwe	Löwe
Bajonette	Bajonette
übte	übte
wünschet	wünschet
umarmen	umarmen
verallgemeinerest	verallgemeinerest
Tritt	Tritt
Löwen	Löwen
Buntspechten	Buntspechten
tobet	tobet
Monde	Monde
dritten	dritten
überlebest	überlebest
Ärschen	Ärschen
Tritte	Tritte
Elf	Elf
sollst	sollst
Schenken	Schenken
deines	deines
vernehmen	vernehmen
Ärztinnen	Ärztinnen
Gebeinen	Gebeinen
verderbest	verderbest
entmineralisierten	entmineralisierten
Kaufhäusern	Kaufhäusern
Pflanzungen	Pflanzungen
Graben	Graben
Speere	Speere
behalte	behalte
einernten	einernten
Luftschiff	Luftschiff
den	den
Technetiumatom	Technetiumatom
beleuchte	beleuchte
verletzte	verletzte
überreichst	überreichst
deaktiviere	deaktiviere
frohlockest	frohlockest
Bedeutung	Bedeutung
Minischweine	Minischweine
verspäte	verspäte
pendele	pendele
betrübe	betrübe
Fluorkohlenwasserstoff	Fluorkohlenwasserstoff
Rechte	Rechte
decken	decken
einführte	einführte
Emmer	Emmer
schnürest	schnürest
Ektoplasmen	Ektoplasmen
dramatisiert	dramatisiert
reicht	reicht
verzweifelten	verzweifelten
tattre	tattre
nähre	nähre
beschwöre	beschwöre
Fiebermittel	Fiebermittel
Bienenstock	Bienenstock
peilst	peilst
gehorchest	gehorchest
verbraucht	verbraucht
Gehorchet	Gehorchet
segmentiere	segmentiere
Mäusen	Mäusen
trieb	trieb
verwirren	verwirren
Kernladungszahl	Kernladungszahl
Piratensender	Piratensender
Leitungswegs	Leitungswegs
winkt	winkt
Cola	Cola
erst	erst
merke	merke
Zipfelmütze	Zipfelmütze
Leiden	Leiden
Pfeilen	Pfeilen
folg	folg
Basilikum	Basilikum
verblute	verblute
knüpfte	knüpfte
Gegenleistung	Gegenleistung
changieren	changieren
jauchzte	jauchzte
Grenzwert	Grenzwert
Schwärmereien	Schwärmereien
benachrichtiget	benachrichtiget
erinnre	erinnre
verstörte	verstörte
befehlt	befehlt
hättest	hättest
gewitterte	gewitterte
Kannst	Kannst
zürne	zürne
Fermium	Fermium
Ackerschachtelhalme	Ackerschachtelhalme
hineinbrächte	hineinbrächte
scheinest	scheinest
winke	winke
stäupt	stäupt
zierte	zierte
jene	jene
Kissenschlacht	Kissenschlacht
Feierabend	Feierabend
Gäste	Gäste
beherrscht	beherrscht
sündigt	sündigt
beschuldiget	beschuldiget
verzögerte	verzögerte
Feind	Feind
demütig	demütig
Gemurmel	Gemurmel
wahre	wahre
beschotterten	beschotterten
geselle	geselle
Greyerzer	Greyerzer
Verwundete	Verwundete
nehmest	nehmest
leerst	leerst
zagt	zagt
Lüste	Lüste
Lotterien	Lotterien
Operationssälen	Operationssälen
zwölften	zwölften
schlabberten	schlabberten
Abschußring	Abschußring
listeten	listeten
nötige	nötige
mehret	mehret
schwängen	schwängen
Chlorats	Chlorats
Pailletten	Pailletten
Steige	Steige
predigtest	predigtest
Ringeltaube	Ringeltaube
baggerst	baggerst
Schaffnerin	Schaffnerin
Wert	Wert
Einöde	Einöde
schaffe	schaffe
Frage	Frage
trödeltest	trödeltest
grabbelten	grabbelten
oben	oben
Brüdern	Brüdern
verbündeten	verbündeten
Lusitaners	Lusitaners
Wasserquelle	Wasserquelle
weine	weine
beben	beben
fokussieret	fokussieret
Lenkstange	Lenkstange
bist	bist
platzt	platzt
Dominicanerinnen	Dominicanerinnen
bombardiertet	bombardiertet
bleiben	bleiben
Spanne	Spanne
Excimerlasern	Excimerlasern
hinterfragten	hinterfragten
betreibet	betreibet
Fahrzeugkatalysatoren	Fahrzeugkatalysatoren
überschattet	überschattet
hintertreiben	hintertreiben
verscheißerte	verscheißerte
trödele	trödele
klappest	klappest
glaubst	glaubst
erhebst	erhebst
Donoren	Donoren
Pläsieren	Pläsieren
höben	höben
strullerte	strullerte
erratet	erratet
vollendest	vollendest
beiden	beiden
Oberlandesgericht	Oberlandesgericht
bekotete	bekotete
imprägnieret	imprägnieret
Hirt	Hirt
Höschens	Höschens
ratschlagen	ratschlagen
Zöpfen	Zöpfen
Krusten	Krusten
sterilisiert	sterilisiert
Leuchtkäfer	Leuchtkäfer
sehest	sehest
bereitend	bereitend
beteuerest	beteuerest
lüftetet	lüftetet
Steinen	Steinen
umhüllst	umhüllst
Tatsachenbeschönigern	Tatsachenbeschönigern
Zubrötchen	Zubrötchen
Argentit	Argentit
strafte	strafte
wegführen	wegführen
alarmiere	alarmiere
kaufe	kaufe
gelegt	gelegt
Prügelstrafen	Prügelstrafen
standet	standet
tränkten	tränkten
Jungfernflug	Jungfernflug
Nährmediums	Nährmediums
erwärmten	erwärmten
hupen	hupen
erforschest	erforschest
setze	setze
sprichst	sprichst
nähernd	nähernd
Fanatiker	Fanatiker
Antitranspiranten	Antitranspiranten
kooperierst	kooperierst
rufet	rufet
entkörperlichten	entkörperlichten
spritzt	spritzt
Einzelgänger	Einzelgänger
Gitarrenspieler	Gitarrenspieler
verdränge	verdränge
Friesen	Friesen
aufnahmen	aufnahmen
Schreien	Schreien
Aufsätzen	Aufsätzen
Riesen	Riesen
mein	mein
verbaselt	verbaselt
Monaten	Monaten
Mikrowellenfilter	Mikrowellenfilter
prangte	prangte
Regierung	Regierung
plärrt	plärrt
bang	bang
linsten	linsten
Vorhäuten	Vorhäuten
Buch	Buch
Wüste	Wüste
lanciertet	lanciertet
Ärzteblatt	Ärzteblatt
Spektralbereichen	Spektralbereichen
am	am
Sinne	Sinne
Steigen	Steigen
Nussknackern	Nussknackern
Mageninhalten	Mageninhalten
lösend	lösend
baue	baue
blondieren	blondieren
gleitest	gleitest
schätzen	schätzen
heparinisiere	heparinisiere
Untiefe	Untiefe
Hertz	Hertz
unschuldigen	unschuldigen
vorn	vorn
rollten	rollten
Dein	Dein
häuftet	häuftet
ernten	ernten
folge	folge
betonierte	betonierte
grüßt	grüßt
observiertest	observiertest
Zeile	Zeile
Abtrünnigen	Abtrünnigen
benachrichtige	benachrichtige
übet	übet
verunglimpfest	verunglimpfest
duckmäuseret	duckmäuseret
Deck	Deck
gequasselt	gequasselt
formulierst	formulierst
verdrängt	verdrängt
bewerbet	bewerbet
blaset	blaset
erkältete	erkältete
Pfunden	Pfunden
Industrienation	Industrienation
Büstenhaltern	Büstenhaltern
verjährest	verjährest
widerriefe	widerriefe
Schlagern	Schlagern
Sabbatjahr	Sabbatjahr
Tollkirsche	Tollkirsche
Buchstaben	Buchstaben
bebet	bebet
Aufprall	Aufprall
fluktuiert	fluktuiert
erlagst	erlagst
dunkelten	dunkelten
ungeistlichen	ungeistlichen
funkeln	funkeln
begrabet	begrabet
Angabe	Angabe
Essigsäurechloriden	Essigsäurechloriden
Radiergummi	Radiergummi
touchiere	touchiere
Kreisen	Kreisen
frommen	frommen
Herde	Herde
Feierabende	Feierabende
Innenschau	Innenschau
Organistin	Organistin
der	der
fragmentiert	fragmentiert
Pumpellyiten	Pumpellyiten
sterbest	sterbest
kremieren	kremieren
begnügt	begnügt
Charakteristikan	Charakteristikan
Ausstiegstüren	Ausstiegstüren
unehrt	unehrt
schlaf	schlaf
hauest	hauest
trügen	trügen
regen	regen
nimmt	nimmt
wallet	wallet
Iberer	Iberer
Bildschirmfoto	Bildschirmfoto
helft	helft
versuchtet	versuchtet
verstörten	verstörten
observierst	observierst
Teilnehmerin	Teilnehmerin
Hektaren	Hektaren
Hobbys	Hobbys
Tust	Tust
bekennst	bekennst
folgtet	folgtet
Testamenten	Testamenten
Danket	Danket
seinen	seinen
Seile	Seile
beansprucht	beansprucht
zappen	zappen
Steine	Steine
verseifet	verseifet
attestierten	attestierten
Hunde	Hunde
Gymnasien	Gymnasien
Päckchen	Päckchen
Mäuse	Mäuse
Schilden	Schilden
Molybdit	Molybdit
käbbelte	käbbelte
Fotosynthese	Fotosynthese
Brieftaubenzüchters	Brieftaubenzüchters
sponseret	sponseret
weichest	weichest
Nanosatelliten	Nanosatelliten
jemand	jemand
Milz	Milz
Adler	Adler
stellet	stellet
geleitet	geleitet
vertilgt	vertilgt
stimme	stimme
dampfte	dampfte
Trübsalen	Trübsalen
ehrest	ehrest
Dithiolane	Dithiolane
Bienenstöcke	Bienenstöcke
kurz	kurz
sortierte	sortierte
Reisebüros	Reisebüros
Fußbodens	Fußbodens
Flöten	Flöten
Aprikosen	Aprikosen
sagtet	sagtet
Gasen	Gasen
moppte	moppte
Steuerberater	Steuerberater
Willst	Willst
Käsereiben	Käsereiben
hilfst	hilfst
bereite	bereite
Europium	Europium
ertragen	ertragen
begräbt	begräbt
Golfplatz	Golfplatz
klagen	klagen
abtrünnige	abtrünnige
kennst	kennst
verkleide	verkleide
drückte	drückte
flieh	flieh
Butzemann	Butzemann
einigst	einigst
Weichlote	Weichlote
binden	binden
Pforte	Pforte
Komplexionen	Komplexionen
treffen	treffen
bündelten	bündelten
Anschläge	Anschläge
gare	gare
erste	erste
glühten	glühten
Rauten	Rauten
sortiert	sortiert
Sprichwort	Sprichwort
Geflecktheit	Geflecktheit
vor	vor
mangelte	mangelte
Brieföffner	Brieföffner
vergaste	vergaste
Herbstwinden	Herbstwinden
Pläsier	Pläsier
erbte	erbte
erbringen	erbringen
kapiert	kapiert
kramten	kramten
Theistinnen	Theistinnen
Schnallen	Schnallen
zürnet	zürnet
versuchen	versuchen
geräuchert	geräuchert
frisch	frisch
Alte	Alte
betrübet	betrübet
Begrenzungen	Begrenzungen
hetzte	hetzte
torpedieret	torpedieret
widerrufe	widerrufe
lohnt	lohnt
amenagiere	amenagiere
Fallturm	Fallturm
Riese	Riese
sehnst	sehnst
privatisiert	privatisiert
vertilgten	vertilgten
parametrisierte	parametrisierte
ab	ab
fressen	fressen
Fluoratomen	Fluoratomen
Autokraten	Autokraten
sinterte	sinterte
Fußboden	Fußboden
entert	entert
dingte	dingte
schwöllen	schwöllen
Tyrannen	Tyrannen
raubte	raubte
Diebe	Diebe
Bromidquellen	Bromidquellen
Mönche	Mönche
Bürzeln	Bürzeln
sponsert	sponsert
verkriechst	verkriechst
Zähne	Zähne
Alibis	Alibis
hydrogentartrate	hydrogentartrate
Nachteile	Nachteile
Wollte	Wollte
erwürgten	erwürgten
stigmatisierst	stigmatisierst
Zeitungsente	Zeitungsente
gräbst	gräbst
ausgehst	ausgehst
Zeitüberschreitung	Zeitüberschreitung
sprecht	sprecht
Aktivisten	Aktivisten
verglichest	verglichest
Raten	Raten
Reliquiar	Reliquiar
zeiget	zeiget
speichertest	speichertest
Premierministerinnen	Premierministerinnen
harmonierte	harmonierte
formirte	formirte
pflücke	pflücke
sollt	sollt
Vetter	Vetter
explodierst	explodierst
Entmachtungen	Entmachtungen
Mobilfunknetzen	Mobilfunknetzen
härten	härten
ernte	ernte
reizet	reizet
fette	fette
Münzsammlung	Münzsammlung
bedrücktest	bedrücktest
erzwinget	erzwinget
Zeilen	Zeilen
Äthern	Äthern
Fittichen	Fittichen
Geschrei	Geschrei
begrubt	begrubt
posierten	posierten
kabeln	kabeln
suchet	suchet
produziert	produziert
ermutigt	ermutigt
Trockendock	Trockendock
Gebäck	Gebäck
beschlügen	beschlügen
Schlangen	Schlangen
Chelatkomplex	Chelatkomplex
scheue	scheue
fehlet	fehlet
Deine	Deine
plaziert	plaziert
Gebot	Gebot
zerfielest	zerfielest
Braunrallen	Braunrallen
flupptest	flupptest
Unterschlagung	Unterschlagung
Sitzfleisch	Sitzfleisch
Nullpunkt	Nullpunkt
sterilisierten	sterilisierten
Freunden	Freunden
Schotten	Schotten
Männlein	Männlein
Ängste	Ängste
concessioniert	concessioniert
Gefilden	Gefilden
Lehne	Lehne
solches	solches
wünschest	wünschest
bereuest	bereuest
erkundigte	erkundigte
misstrauest	misstrauest
enträtselst	enträtselst
Videoaufzeichnungen	Videoaufzeichnungen
Bilderstürmereien	Bilderstürmereien
Schnute	Schnute
Welche	Welche
jappten	jappten
Polizeisprechern	Polizeisprechern
verboten	verboten
Uteri	Uteri
verdeckst	verdeckst
Meter	Meter
Gefäßen	Gefäßen
Reinigungsschrittes	Reinigungsschrittes
Falzen	Falzen
Abschreckung	Abschreckung
Früchtchen	Früchtchen
Eingabe	Eingabe
Alterität	Alterität
haltest	haltest
Taschenwörterbuch	Taschenwörterbuch
Maximierung	Maximierung
brennen	brennen
zuhört	zuhört
bedeckest	bedeckest
Gedächtnissen	Gedächtnissen
Grab	Grab
stärken	stärken
verlähmte	verlähmte
Atommassen	Atommassen
Stolz	Stolz
Suche	Suche
initiierten	initiierten
mästet	mästet
unterscheide	unterscheide
gelobe	gelobe
ringelten	ringelten
krähte	krähte
Bleiglanz	Bleiglanz
jappte	jappte
Unwahrheit	Unwahrheit
Ein	Ein
Laubbaum	Laubbaum
Pfeile	Pfeile
gehörte	gehörte
Wissen	Wissen
Gicht	Gicht
Binden	Binden
krähen	krähen
Türkinnen	Türkinnen
infiziertet	infiziertet
greife	greife
redetet	redetet
Wüsten	Wüsten
Ringen	Ringen
Gasgemischen	Gasgemischen
kappet	kappet
Kakao	Kakao
watete	watete
Anfängern	Anfängern
Weichseln	Weichseln
Anschlägen	Anschlägen
Reizen	Reizen
schwimmst	schwimmst
Wache	Wache
grünend	grünend
Bushaltestelle	Bushaltestelle
rekonstruieren	rekonstruieren
bedenken	bedenken
Märtyrer	Märtyrer
Heiden	Heiden
blitze	blitze
Exilanten	Exilanten
Katamaranen	Katamaranen
Briefköpfen	Briefköpfen
Wunden	Wunden
gewärtigten	gewärtigten
Brüder	Brüder
denn	denn
Welteninseln	Welteninseln
lehnen	lehnen
ersparen	ersparen
klappten	klappten
knutschst	knutschst
Gefilde	Gefilde
fällen	fällen
Forschung	Forschung
Apostels	Apostels
Malen	Malen
säuselest	säuselest
steckst	steckst
Außenministerien	Außenministerien
Hälse	Hälse
Gerichten	Gerichten
Rabe	Rabe
traueret	traueret
schießt	schießt
spalten	spalten
gedenkt	gedenkt
pflegte	pflegte
halben	halben
Diesen	Diesen
dingten	dingten
schubse	schubse
bestellten	bestellten
Quatsch	Quatsch
Grönländer	Grönländer
erfahret	erfahret
negierest	negierest
Basiliken	Basiliken
Safran	Safran
verreisest	verreisest
maß	maß
Füllfedern	Füllfedern
beleidige	beleidige
erschrickst	erschrickst
Recitativen	Recitativen
keinem	keinem
forschet	forschet
Kernladungszahlen	Kernladungszahlen
Messiassen	Messiassen
faschieret	faschieret
Technikerinnen	Technikerinnen
Dessous	Dessous
Massenarbeitslosigkeit	Massenarbeitslosigkeit
Herd	Herd
Hinkelsteine	Hinkelsteine
Anhänge	Anhänge
Sitz	Sitz
Trägergas	Trägergas
verunreinigst	verunreinigst
Tübinger	Tübinger
stoße	stoße
Flossen	Flossen
kappten	kappten
speiest	speiest
reifen	reifen
Prostyloi	Prostyloi
Kautschuke	Kautschuke
trägst	trägst
Sagte	Sagte
porträtiert	porträtiert
analysiert	analysiert
anderen	anderen
Gleitzeit	Gleitzeit
Diäresen	Diäresen
Firnis	Firnis
Omnibus	Omnibus
Jünger	Jünger
Plumpse	Plumpse
Banknoten	Banknoten
Geheimdienst	Geheimdienst
wichste	wichste
verflog	verflog
Besprechung	Besprechung
bejubelte	bejubelte
weinst	weinst
Fürst	Fürst
halle	halle
verführest	verführest
bewahrst	bewahrst
speiste	speiste
eigene	eigene
legen	legen
sedimentiere	sedimentiere
Händen	Händen
verlobt	verlobt
Dorsch	Dorsch
Panzerschreck	Panzerschreck
Habe	Habe
Ende	Ende
Paradiesapfel	Paradiesapfel
hingeht	hingeht
aufkäme	aufkäme
vermögen	vermögen
sonderte	sonderte
besprächen	besprächen
sündigten	sündigten
Druckfehler	Druckfehler
pipettierten	pipettierten
liebe	liebe
hätten	hätten
kräuselten	kräuselten
moppst	moppst
Gedanken	Gedanken
Mönchen	Mönchen
verwechseltet	verwechseltet
leite	leite
Linguistinnen	Linguistinnen
Höhen	Höhen
Einrad	Einrad
Zeitbombe	Zeitbombe
Gedränge	Gedränge
reichet	reichet
sitzest	sitzest
stäupen	stäupen
jaulst	jaulst
finanziere	finanziere
konstatiere	konstatiere
Klappertöpfen	Klappertöpfen
Wachteln	Wachteln
Rückwege	Rückwege
übrigbleibet	übrigbleibet
genieret	genieret
rotten	rotten
Kuckucken	Kuckucken
entschleieret	entschleieret
Fingerspitze	Fingerspitze
Zeitbomben	Zeitbomben
steuerte	steuerte
verzehre	verzehre
Hallelujas	Hallelujas
ärgerst	ärgerst
verewiget	verewiget
Mikrometern	Mikrometern
frevles	frevles
sehnet	sehnet
Präservativs	Präservativs
begehrend	begehrend
spukte	spukte
aktualisiere	aktualisiere
versuchet	versuchet
begründest	begründest
schimmerst	schimmerst
knitterte	knitterte
unterbewertete	unterbewertete
Quelle	Quelle
beschlaget	beschlaget
kletteret	kletteret
wehen	wehen
Ausgangssperren	Ausgangssperren
Grabbeltischen	Grabbeltischen
Hörst	Hörst
mobilisieret	mobilisieret
Tübingern	Tübingern
zerfetzt	zerfetzt
fremde	fremde
Elektrophil	Elektrophil
welchen	welchen
Radsatzes	Radsatzes
wirft	wirft
Arsenit	Arsenit
Hochhäusern	Hochhäusern
entzogen	entzogen
gedenken	gedenken
benehme	benehme
regte	regte
gedenk	gedenk
Loben	Loben
Staatsführungen	Staatsführungen
verständig	verständig
häufen	häufen
Setzt	Setzt
Hörspiel	Hörspiel
kooperierte	kooperierte
flirre	flirre
erschütterte	erschütterte
beschotteret	beschotteret
Asthenosphäre	Asthenosphäre
eins	eins
glawbten	glawbten
aufkämen	aufkämen
beeinflusste	beeinflusste
Tausche	Tausche
Linie	Linie
klingest	klingest
Wirtschaftswissenschaft	Wirtschaftswissenschaft
stiege	stiege
Nadelbäumen	Nadelbäumen
steuerst	steuerst
lieget	lieget
Massage	Massage
befehlen	befehlen
Taschendieb	Taschendieb
Käsereibe	Käsereibe
Spurensicherung	Spurensicherung
Landstreicher	Landstreicher
Markisen	Markisen
erfahrest	erfahrest
sticke	sticke
Polyphosphat	Polyphosphat
offenbarest	offenbarest
Schlepper	Schlepper
Lebenskraft	Lebenskraft
unseren	unseren
vergast	vergast
Laubbläser	Laubbläser
nötig	nötig
laufe	laufe
misstrauen	misstrauen
Autonomien	Autonomien
Schwänzchen	Schwänzchen
jeder	jeder
setzen	setzen
erhöhest	erhöhest
sezierte	sezierte
schwimmen	schwimmen
tasteten	tasteten
warntet	warntet
Beinen	Beinen
Carbids	Carbids
Generatoren	Generatoren
Montagmittagen	Montagmittagen
koche	koche
Omnibusse	Omnibusse
entzweit	entzweit
hineinbrächten	hineinbrächten
heulte	heulte
prosteten	prosteten
Heiratsgütern	Heiratsgütern
schwächst	schwächst
blitzte	blitzte
vertilgest	vertilgest
globalisieret	globalisieret
Kernspaltung	Kernspaltung
Zuschauer	Zuschauer
verkürzest	verkürzest
dirigieren	dirigieren
ahnten	ahnten
blast	blast
untertretet	untertretet
begebe	begebe
injizierest	injizierest
haare	haare
esset	esset
Gammastrahlen	Gammastrahlen
dürfe	dürfe
Bestecken	Bestecken
Sünders	Sünders
greifen	greifen
erpress	erpress
Buchhalterin	Buchhalterin
Recht	Recht
instanziier	instanziier
pilgert	pilgert
Zankapfel	Zankapfel
Chlorwasserstoffmolekül	Chlorwasserstoffmolekül
Aggressor	Aggressor
Meeren	Meeren
Tiegel	Tiegel
Adelung	Adelung
irrte	irrte
Mop	Mop
UND-Gattern	UND-Gattern
Wanderfalken	Wanderfalken
moppen	moppen
Scheck	Scheck
erlaubest	erlaubest
Wahn	Wahn
Schade	Schade
Coventrisierungen	Coventrisierungen
versteigernd	versteigernd
auszieht	auszieht
Teile	Teile
Volltreffer	Volltreffer
hure	hure
Theologien	Theologien
holet	holet
repräsentierten	repräsentierten
ummantle	ummantle
impfst	impfst
stigmatisierest	stigmatisierest
greinet	greinet
Leugnung	Leugnung
Atommodelle	Atommodelle
habest	habest
Großstädtern	Großstädtern
Händedrücken	Händedrücken
schätzt	schätzt
fälle	fälle
gedächtet	gedächtet
Hahnenkämmen	Hahnenkämmen
Schläfchen	Schläfchen
Renegaten	Renegaten
Bande	Bande
streute	streute
bedingst	bedingst
Hinkelstein	Hinkelstein
Agoraphobie	Agoraphobie
Enden	Enden
Aufsätze	Aufsätze
Rosinenkuchenmodell	Rosinenkuchenmodell
erschüttere	erschüttere
Sabbatjahre	Sabbatjahre
schreie	schreie
föhnest	föhnest
Wiedergutmachungen	Wiedergutmachungen
Fellachinnen	Fellachinnen
Bällchen	Bällchen
Trinken	Trinken
negierte	negierte
Entree	Entree
Keiner	Keiner
sorge	sorge
Gefängnissen	Gefängnissen
danket	danket
fern	fern
Marokkanern	Marokkanern
Brikette	Brikette
Elastomer	Elastomer
streue	streue
langte	langte
verdunstet	verdunstet
plazierest	plazierest
unser	unser
Brote	Brote
Aderhaut	Aderhaut
schummelten	schummelten
urteilte	urteilte
bilden	bilden
Werdet	Werdet
Physikerin	Physikerin
Inauguration	Inauguration
Gut	Gut
eurer	eurer
klöne	klöne
Antimustern	Antimustern
überfischt	überfischt
Negermusik	Negermusik
Rundbriefe	Rundbriefe
Haue	Haue
formiret	formiret
Abhänge	Abhänge
Mitschuld	Mitschuld
pflanzen	pflanzen
mikrominiaturisiere	mikrominiaturisiere
Alteritäten	Alteritäten
sedimentiertet	sedimentiertet
trotzt	trotzt
brach	brach
Puffersystemen	Puffersystemen
Samen	Samen
Rotgüssen	Rotgüssen
Lehrbücher	Lehrbücher
initiierst	initiierst
Automatikgetriebe	Automatikgetriebe
Lehrbüchern	Lehrbüchern
verfängt	verfängt
Notärztin	Notärztin
vertiefe	vertiefe
Protonen	Protonen
Konfitüre	Konfitüre
seht	seht
Kanzlerinnen	Kanzlerinnen
Kohle	Kohle
deckst	deckst
transportierten	transportierten
unterbewerte	unterbewerte
regieret	regieret
Gibst	Gibst
Westen	Westen
Chasar	Chasar
globalisier	globalisier
Soll	Soll
Erbse	Erbse
Laien	Laien
verhalten	verhalten
gewurstelt	gewurstelt
heftetest	heftetest
Ecke	Ecke
erbauet	erbauet
Hansen	Hansen
Brandbeschleuniger	Brandbeschleuniger
generiertet	generiertet
wilden	wilden
strecke	strecke
denaturierte	denaturierte
prediget	prediget
Adlerbussarden	Adlerbussarden
Elstern	Elstern
Briefen	Briefen
gestattest	gestattest
Unsere	Unsere
stirbst	stirbst
absolviertet	absolviertet
wallfahrest	wallfahrest
Erstarren	Erstarren
Krumen	Krumen
feierte	feierte
platz	platz
regierest	regierest
zerreißt	zerreißt
Altbau	Altbau
ritten	ritten
erstürmet	erstürmet
durchwachen	durchwachen
verwirrest	verwirrest
linken	linken
Wembley-Tore	Wembley-Tore
kitzele	kitzele
Herabsetzungen	Herabsetzungen
verfolgt	verfolgt
ausrufest	ausrufest
befestigte	befestigte
Stimmen	Stimmen
verzehrst	verzehrst
Strafraum	Strafraum
Banden	Banden
verliert	verliert
verletzt	verletzt
messet	messet
bereits	bereits
Füllen	Füllen
Rehböcken	Rehböcken
ehren	ehren
Acht	Acht
bewahret	bewahret
erzürnst	erzürnst
wehre	wehre
umarbeiten	umarbeiten
funzen	funzen
Äxte	Äxte
Dachdeckerinnen	Dachdeckerinnen
seinem	seinem
reife	reife
griffe	griffe
meines	meines
babbelten	babbelten
ärger	ärger
abweichest	abweichest
kämmtet	kämmtet
regelten	regelten
verwahret	verwahret
Falz	Falz
Altären	Altären
installiert	installiert
Früchte	Früchte
Waren	Waren
fluppe	fluppe
Kryostat	Kryostat
fluppst	fluppst
reichte	reichte
feiern	feiern
lauf	lauf
Seil	Seil
Wühltische	Wühltische
klaget	klaget
Ärgernisse	Ärgernisse
Kontrollkästchen	Kontrollkästchen
neigest	neigest
Regenten	Regenten
eingehst	eingehst
Herbstwinde	Herbstwinde
Weh	Weh
Sprechers	Sprechers
Weil	Weil
Untern	Untern
verjährte	verjährte
Pausbacke	Pausbacke
rittest	rittest
verziehst	verziehst
Arme	Arme
strandend	strandend
entwendet	entwendet
mehrte	mehrte
Organisationen	Organisationen
Perle	Perle
schöpfe	schöpfe
absagt	absagt
finanzierest	finanzierest
Wände	Wände
Rinde	Rinde
Honigbär	Honigbär
besinnen	besinnen
versteckend	versteckend
Gläubigen	Gläubigen
Kohlen	Kohlen
fragmentierst	fragmentierst
Stellen	Stellen
besicheret	besicheret
Leitkegel	Leitkegel
teile	teile
flambierest	flambierest
Adventskalender	Adventskalender
bölket	bölket
freute	freute
fastetest	fastetest
Sportlerinnen	Sportlerinnen
Märchenbuches	Märchenbuches
lausche	lausche
Adlerbussard	Adlerbussard
gespeist	gespeist
Besprechungen	Besprechungen
Gemeinden	Gemeinden
Fehlen	Fehlen
kämmt	kämmt
Fallt	Fallt
entsetzet	entsetzet
räucheret	räucheret
besitze	besitze
Chasaren	Chasaren
wende	wende
Vaginen	Vaginen
überweisend	überweisend
verzehrt	verzehrt
fragte	fragte
keinen	keinen
argumentierten	argumentierten
Bruchstriches	Bruchstriches
bequemen	bequemen
Ehren	Ehren
preisen	preisen
kennet	kennet
Erzeugungen	Erzeugungen
herrschte	herrschte
piesacken	piesacken
destabilisierte	destabilisierte
Flosse	Flosse
Sei	Sei
haschieret	haschieret
Paradiesäpfeln	Paradiesäpfeln
Silbererze	Silbererze
versteckst	versteckst
Gehör	Gehör
Preisanstieg	Preisanstieg
leistest	leistest
Minimierungen	Minimierungen
Gläubigern	Gläubigern
überwachest	überwachest
Unrechten	Unrechten
Weiß	Weiß
Ionen	Ionen
verstanden	verstanden
vibriere	vibriere
Malaysierinnen	Malaysierinnen
Fülle	Fülle
predigen	predigen
bebten	bebten
könnten	könnten
Kleinod	Kleinod
Briten	Briten
Teufeln	Teufeln
Forschungen	Forschungen
Zunge	Zunge
verschlingt	verschlingt
Macht	Macht
hydrolysierest	hydrolysierest
Ställe	Ställe
hängen	hängen
ob	ob
stehet	stehet
gestaltest	gestaltest
schreckt	schreckt
messen	messen
Schamentzündung	Schamentzündung
grün	grün
Höschen	Höschen
nachwandelt	nachwandelt
Leiste	Leiste
Rufet	Rufet
Zirkelbeweis	Zirkelbeweis
alles	alles
Leide	Leide
kreieren	kreieren
regierten	regierten
verabschiedeten	verabschiedeten
Ichs	Ichs
austilge	austilge
begliche	begliche
Flussbetten	Flussbetten
Same	Same
Bundesgebieten	Bundesgebieten
Laufringen	Laufringen
klumpe	klumpe
kaufst	kaufst
führte	führte
Bote	Bote
geratest	geratest
laufet	laufet
missverstände	missverstände
säst	säst
laben	laben
Preisen	Preisen
Paralipse	Paralipse
Linke	Linke
stürzte	stürzte
Stärkungsmittel	Stärkungsmittel
chloroformieret	chloroformieret
Ochse	Ochse
Monarchien	Monarchien
bürsteten	bürsteten
steige	steige
grüntet	grüntet
Rutheniumisotop	Rutheniumisotop
blamierte	blamierte
Android	Android
Warten	Warten
Meerschweinchen	Meerschweinchen
gelobt	gelobt
Tiefen	Tiefen
schämst	schämst
Auguren	Auguren
beschuldigt	beschuldigt
Bleche	Bleche
Regieren	Regieren
besuche	besuche
Schauen	Schauen
Gichten	Gichten
Wühltischen	Wühltischen
Tische	Tische
grüßten	grüßten
bekehrt	bekehrt
wollten	wollten
Samstagnachmittag	Samstagnachmittag
Heuschrecken	Heuschrecken
Cyanat	Cyanat
irre	irre
Nullpunktes	Nullpunktes
Unternehmensanwendungsintegrationen	Unternehmensanwendungsintegrationen
Fahlflanken-Ameisenwürger	Fahlflanken-Ameisenwürger
Übelkeit	Übelkeit
Abbildern	Abbildern
Bluffs	Bluffs
Nachweisreagenzien	Nachweisreagenzien
ratschlagte	ratschlagte
stickten	stickten
Schale	Schale
suchten	suchten
Reinigungsschritten	Reinigungsschritten
demütigst	demütigst
Muhme	Muhme
schöpfen	schöpfen
quatschen	quatschen
log	log
mogelten	mogelten
mampfen	mampfen
Andrologie	Andrologie
Urbare	Urbare
Adeliepinguin	Adeliepinguin
Reinstoff	Reinstoff
Beten	Beten
werde	werde
Jagdhunden	Jagdhunden
klappst	klappst
Leuchtstoff	Leuchtstoff
Ränke	Ränke
Freibrief	Freibrief
Lehrkörpers	Lehrkörpers
Blattgeweben	Blattgeweben
foppten	foppten
verständige	verständige
eroberte	eroberte
hebe	hebe
verklärt	verklärt
scheute	scheute
Tintenfische	Tintenfische
andere	andere
polymerisierte	polymerisierte
parlieren	parlieren
Erdbirnen	Erdbirnen
Brettspiele	Brettspiele
Pfleglingen	Pfleglingen
Klüften	Klüften
Verbindungsdraht	Verbindungsdraht
Sprödmetall	Sprödmetall
ermahnt	ermahnt
Theistin	Theistin
machest	machest
ausführen	ausführen
schwöre	schwöre
nächste	nächste
Versorgungen	Versorgungen
wiederholte	wiederholte
zürn	zürn
streckte	streckte
rodete	rodete
bestanden	bestanden
setztest	setztest
sehnte	sehnte
begrabt	begrabt
Zebrahaies	Zebrahaies
Drohkulissen	Drohkulissen
kaufet	kaufet
Möbelstoff	Möbelstoff
deinem	deinem
Angaben	Angaben
Schuhe	Schuhe
freuet	freuet
Floß	Floß
suchest	suchest
ausführe	ausführe
drängst	drängst
schluchze	schluchze
verlassen	verlassen
Sabbaten	Sabbaten
verdränget	verdränget
predigten	predigten
erscheinest	erscheinest
verzweigt	verzweigt
Halbzeiten	Halbzeiten
legest	legest
Amt	Amt
vertrieben	vertrieben
emittiert	emittiert
Tieren	Tieren
Bestechungsgelder	Bestechungsgelder
Abflug	Abflug
Ring	Ring
Freizeitzentren	Freizeitzentren
missversteht	missversteht
demütigte	demütigte
immunisiere	immunisiere
erzeigest	erzeigest
schlummerte	schlummerte
Trümmersprache	Trümmersprache
grüne	grüne
Schatten	Schatten
frohlockte	frohlockte
Minischwein	Minischwein
instanziiere	instanziiere
Tollkirschen	Tollkirschen
tun	tun
Ypecaharalle	Ypecaharalle
stolze	stolze
überbewerte	überbewerte
plumpsten	plumpsten
Buntspechte	Buntspechte
verkaufst	verkaufst
schnappt	schnappt
wetzte	wetzte
rühmst	rühmst
bandagiert	bandagiert
Alkin	Alkin
wachet	wachet
Ausnahmen	Ausnahmen
Recitativ	Recitativ
Tretlager	Tretlager
kennest	kennest
Polizeisprecher	Polizeisprecher
fistet	fistet
Feuerteufel	Feuerteufel
vermutest	vermutest
Dachdeckerin	Dachdeckerin
Wärt	Wärt
filzte	filzte
Zeugnisse	Zeugnisse
Sorgen	Sorgen
Ambiguitäten	Ambiguitäten
schleimte	schleimte
beides	beides
Elle	Elle
rangieret	rangieret
Berichterstattungen	Berichterstattungen
drosselten	drosselten
Almanachen	Almanachen
Rechnungen	Rechnungen
Taschendiebe	Taschendiebe
Knöllchens	Knöllchens
Meinst	Meinst
reinstitutionalisiert	reinstitutionalisiert
schauet	schauet
ringen	ringen
verunreinigt	verunreinigt
analysierest	analysierest
streckst	streckst
Fromme	Fromme
leer	leer
Verkehrsflugzeuge	Verkehrsflugzeuge
Kavalier	Kavalier
Bund	Bund
bedeckst	bedeckst
Durchbruches	Durchbruches
Schote	Schote
tyrannisiertest	tyrannisiertest
zweifel	zweifel
befehle	befehle
Weinstöcke	Weinstöcke
filzst	filzst
stillest	stillest
Teppichen	Teppichen
schubset	schubset
loste	loste
besorgten	besorgten
durften	durften
schabst	schabst
schlafet	schlafet
ehrte	ehrte
Ausbeuterei	Ausbeuterei
zähltet	zähltet
beide	beide
verkauften	verkauften
Meere	Meere
hüten	hüten
Dank	Dank
deponierte	deponierte
fassest	fassest
stoßet	stoßet
betrübst	betrübst
filteret	filteret
beichten	beichten
Attentäter	Attentäter
rüstetet	rüstetet
flucht	flucht
sagest	sagest
Jüngern	Jüngern
meuterest	meuterest
Rumänin	Rumänin
Pferde	Pferde
Eistaucher	Eistaucher
karikieret	karikieret
Elementen	Elementen
käbbelnd	käbbelnd
sieht	sieht
schließen	schließen
Teekessel	Teekessel
Äste	Äste
knuffend	knuffend
strafest	strafest
Epoxiden	Epoxiden
Schwermetallionen	Schwermetallionen
überdächte	überdächte
scheitertet	scheitertet
fließen	fließen
egalisiertet	egalisiertet
verbündet	verbündet
Schlöte	Schlöte
Werk	Werk
Euphemismen	Euphemismen
hintertrieben	hintertrieben
schlafest	schlafest
Elektronenschale	Elektronenschale
Verdacht	Verdacht
Rhodochrositen	Rhodochrositen
gründe	gründe
sortierest	sortierest
Ratsherren	Ratsherren
Gute	Gute
konntest	konntest
Sorget	Sorget
diese	diese
eine	eine
Epoxide	Epoxide
respektiert	respektiert
verurteilen	verurteilen
Merkel-Rauten	Merkel-Rauten
kriegen	kriegen
hintertriebe	hintertriebe
erobern	erobern
Gewürzen	Gewürzen
unterdrückte	unterdrückte
lieb	lieb
auszögen	auszögen
begehrtet	begehrtet
demoralisiere	demoralisiere
bete	bete
Dewargefäße	Dewargefäße
Suffixen	Suffixen
spurtest	spurtest
Freitagnachmittage	Freitagnachmittage
bescherten	bescherten
Strafräume	Strafräume
Mäppchen	Mäppchen
Feuerteufels	Feuerteufels
strafen	strafen
Gerät	Gerät
fresset	fresset
Welchen	Welchen
Asteroid	Asteroid
gelangen	gelangen
Höret	Höret
sinnst	sinnst
verbarg	verbarg
transportierte	transportierte
Regent	Regent
Dorngesträuch	Dorngesträuch
leuchten	leuchten
Raben	Raben
verseuchen	verseuchen
verstehst	verstehst
Hinterwäldler	Hinterwäldler
Basilisk	Basilisk
schickte	schickte
fabuliert	fabuliert
läute	läute
beanspruchte	beanspruchte
wisperest	wisperest
krank	krank
attestiertet	attestiertet
könnte	könnte
