sov	sov
vridas	vridas
vässer	vässer
försvunna	försvunna
intaga	intaga
hitlistas	hitlistas
antända	antända
trycka	trycka
kålroten	kålroten
talades	talades
verkligheten	verkligheten
förlett	förlett
borrade	borrade
Berias	Berias
kolvätets	kolvätets
Sköt	Sköt
sin	sin
trycker	trycker
handlägga	handlägga
styrkt	styrkt
kokosnötters	kokosnötters
eolsharpors	eolsharpors
upphäva	upphäva
blattarna	blattarna
anfangers	anfangers
minikjolars	minikjolars
asbest	asbest
surdegen	surdegen
regenter	regenter
tysthetens	tysthetens
fördärvet	fördärvet
torkare	torkare
basketbollar	basketbollar
fullborde	fullborde
hållplatsers	hållplatsers
förste	förste
Jakob	Jakob
anpassningars	anpassningars
altruisters	altruisters
blåses	blåses
drage	drage
lama	lama
böjd	böjd
Sadoks	Sadoks
exponerade	exponerade
åten	åten
Ussias	Ussias
sångerna	sångerna
Sara	Sara
konvojens	konvojens
yngstes	yngstes
höjd	höjd
baltiskt	baltiskt
annandagens	annandagens
tränges	tränges
bokmärkes	bokmärkes
Det	Det
Joab	Joab
50-öringarna	50-öringarna
docerande	docerande
rodna	rodna
preciserade	preciserade
Allt	Allt
räknade	räknade
består	består
elektronhjärnorna	elektronhjärnorna
tyristorerna	tyristorerna
förtäljes	förtäljes
Isak	Isak
dubbelmackorna	dubbelmackorna
bildrullars	bildrullars
dröja	dröja
Orion	Orion
pråmar	pråmar
förgörs	förgörs
munskänkar	munskänkar
spott	spott
viktiga	viktiga
twittrande	twittrande
Abrahams	Abrahams
beställda	beställda
HERREN	HERREN
resecheckars	resecheckars
Hesron	Hesron
smaragden	smaragden
sådan	sådan
synderna	synderna
hemsökt	hemsökt
tröstar	tröstar
polygonen	polygonen
stor	stor
kulsprutas	kulsprutas
Het	Het
jodens	jodens
insamlande	insamlande
begrundas	begrundas
gömde	gömde
besöka	besöka
ledas	ledas
intagen	intagen
Gats	Gats
busschaufförs	busschaufförs
styckade	styckade
sista	sista
undersökande	undersökande
bromspedal	bromspedal
förlite	förlite
rov	rov
rikt	rikt
piercings	piercings
föräldralösa	föräldralösa
möjliggörande	möjliggörande
undermeny	undermeny
förlåtna	förlåtna
uträckt	uträckt
duetts	duetts
faste	faste
känd	känd
bryggkaffets	bryggkaffets
Babels	Babels
bokriser	bokriser
make	make
funnes	funnes
statsrådsberedningars	statsrådsberedningars
Tre	Tre
modet	modet
förleda	förleda
Heber	Heber
fängelsehålorna	fängelsehålorna
omvända	omvända
kronologiske	kronologiske
bredd	bredd
essenserna	essenserna
vilt	vilt
Antikrists	Antikrists
sexpacket	sexpacket
fungerar	fungerar
åttondedelars	åttondedelars
handlade	handlade
plågade	plågade
Tres	Tres
spanjors	spanjors
spritt	spritt
barrträdets	barrträdets
rannsakade	rannsakade
varierades	varierades
jämte	jämte
skuldoffersväduren	skuldoffersväduren
vilade	vilade
omkomma	omkomma
Nebos	Nebos
cykelhandlares	cykelhandlares
stänger	stänger
bajskorven	bajskorven
övergiva	övergiva
utföra	utföra
Amons	Amons
kokt	kokt
ursprungskällas	ursprungskällas
Ismael	Ismael
rasmassa	rasmassa
handlar	handlar
händelsehorisonter	händelsehorisonter
Egyptens	Egyptens
laktosintolerant	laktosintolerant
Barak	Barak
specialtecken	specialtecken
a-kassornas	a-kassornas
kloriderna	kloriderna
mödar	mödar
infogade	infogade
fegisars	fegisars
tungt	tungt
skrapade	skrapade
slipat	slipat
nämnda	nämnda
löpen	löpen
ledda	ledda
sträcka	sträcka
fortfare	fortfare
bevaren	bevaren
erinrade	erinrade
varulvarna	varulvarna
raggmunkarna	raggmunkarna
notställens	notställens
fördolde	fördolde
arrendena	arrendena
dubbelklickets	dubbelklickets
presenningen	presenningen
Alexanders	Alexanders
döva	döva
befordran	befordran
släta	släta
fiskmatens	fiskmatens
skärvors	skärvors
anlöpas	anlöpas
bevekt	bevekt
garantifond	garantifond
pilar	pilar
inrikesministerium	inrikesministerium
förres	förres
zappa	zappa
oss	oss
släktets	släktets
initiativtagares	initiativtagares
institutionella	institutionella
memen	memen
åskådade	åskådade
jublen	jublen
retade	retade
stod	stod
Vilket	Vilket
chipspåsars	chipspåsars
Saul	Saul
närande	närande
bordläggande	bordläggande
vidhäftande	vidhäftande
sexpacken	sexpacken
Hela	Hela
givandet	givandet
smädade	smädade
kanslisekreterare	kanslisekreterare
utrikespolitiken	utrikespolitiken
ballonger	ballonger
vare	vare
bevare	bevare
rövande	rövande
avhärvlade	avhärvlade
Loven	Loven
täckta	täckta
mötts	mötts
bevekande	bevekande
förbehålla	förbehålla
rådde	rådde
libyer	libyer
fräta	fräta
sändas	sändas
Joabs	Joabs
vädurarna	vädurarna
Gilead	Gilead
libyerna	libyerna
vittnesbörden	vittnesbörden
indikera	indikera
upptagnare	upptagnare
täck	täck
ögat	ögat
radavståndets	radavståndets
simbassängernas	simbassängernas
tala	tala
sänts	sänts
Berit	Berit
fyllen	fyllen
korset	korset
blinde	blinde
tiga	tiga
vinterdäck	vinterdäck
rättfärdiga	rättfärdiga
säge	säge
bliva	bliva
blygs	blygs
bestämda	bestämda
fördraga	fördraga
gorillas	gorillas
avmätt	avmätt
krondikena	krondikena
ratas	ratas
Nebo	Nebo
döve	döve
essensers	essensers
brassas	brassas
ambassadsekreteraren	ambassadsekreteraren
automatiskt	automatiskt
fjäderbrickorna	fjäderbrickorna
småvilts	småvilts
lämpas	lämpas
ovanor	ovanor
möers	möers
blödd	blödd
homofoners	homofoners
vilket	vilket
beskyddarens	beskyddarens
grymme	grymme
dubbelklicket	dubbelklicket
altruisternas	altruisternas
flatas	flatas
fästa	fästa
begås	begås
utvaldas	utvaldas
Uria	Uria
oscillations	oscillations
bokrisen	bokrisen
skyhöge	skyhöge
åklagande	åklagande
ovanorna	ovanorna
värmebehandlat	värmebehandlat
ugglas	ugglas
föröda	föröda
fruktade	fruktade
kombinerande	kombinerande
springande	springande
offrade	offrade
påvars	påvars
kolgruvors	kolgruvors
anställa	anställa
indoktrineras	indoktrineras
någon	någon
simbassängens	simbassängens
kirrade	kirrade
minimumet	minimumet
vattenkannans	vattenkannans
Hanok	Hanok
tryckt	tryckt
skörtet	skörtet
kullarna	kullarna
ryggsäcken	ryggsäcken
koncentrera	koncentrera
limpan	limpan
inträffades	inträffades
bosätten	bosätten
örtagård	örtagård
förmörkades	förmörkades
blottar	blottar
barberad	barberad
kommuterar	kommuterar
konsekventa	konsekventa
koordinatsystem	koordinatsystem
Ahab	Ahab
varandras	varandras
ryggsimmet	ryggsimmet
diarieför	diarieför
Dina	Dina
omsnärjt	omsnärjt
talade	talade
arbete	arbete
brännes	brännes
stenhuggarna	stenhuggarna
maakatéerna	maakatéerna
antände	antände
anställs	anställs
klipper	klipper
befästas	befästas
smältes	smältes
anklagas	anklagas
resurskrävande	resurskrävande
Abram	Abram
bärande	bärande
sova	sova
gläds	gläds
Naftalis	Naftalis
arkeologens	arkeologens
bordat	bordat
fegis	fegis
kläckt	kläckt
Arba	Arba
predikat	predikat
vredes	vredes
beredde	beredde
besveks	besveks
fonons	fonons
syrgasen	syrgasen
binda	binda
arresterar	arresterar
magsmärtan	magsmärtan
landstingsdirektörens	landstingsdirektörens
jaga	jaga
säljs	säljs
behöva	behöva
visheten	visheten
brodern	brodern
kommandoknapps	kommandoknapps
invigda	invigda
tryckas	tryckas
tryckande	tryckande
förenade	förenade
överfallen	överfallen
Samarias	Samarias
daggkåpan	daggkåpan
retades	retades
öknamnens	öknamnens
förkunnade	förkunnade
förra	förra
Persiens	Persiens
säljes	säljes
utsträck	utsträck
utfärdat	utfärdat
bytte	bytte
avlat	avlat
upptagne	upptagne
utesluts	utesluts
förtryckts	förtryckts
arme	arme
snödroppens	snödroppens
sänkas	sänkas
försynens	försynens
halsbanden	halsbanden
utbudet	utbudet
påbudens	påbudens
avhålla	avhålla
naturvårds	naturvårds
ratificera	ratificera
dia	dia
slitna	slitna
strålblomma	strålblomma
fällas	fällas
ställa	ställa
utträdesarbete	utträdesarbete
cellulosanitrat	cellulosanitrat
Sur	Sur
vette	vette
flunsors	flunsors
fatten	fatten
chilenares	chilenares
marker	marker
förstör	förstör
svepande	svepande
naturvården	naturvården
bortryckta	bortryckta
inägas	inägas
förgätas	förgätas
tänken	tänken
förtrycker	förtrycker
lydelses	lydelses
äppelträds	äppelträds
förnimmande	förnimmande
kemikaliens	kemikaliens
svavelstickors	svavelstickors
tyglades	tyglades
kaos	kaos
svensexorna	svensexorna
fylla	fylla
jobbs	jobbs
bestämde	bestämde
snärja	snärja
släkt	släkt
egyptier	egyptier
altruistiskt	altruistiskt
tremänningen	tremänningen
förlita	förlita
juices	juices
lända	lända
particips	particips
Talen	Talen
pärmars	pärmars
byrådirektörer	byrådirektörer
kakkalas	kakkalas
brunnens	brunnens
öppna	öppna
Melkisedeks	Melkisedeks
frossare	frossare
formande	formande
åts	åts
drogerna	drogerna
vrede	vrede
fångenskapens	fångenskapens
örfilarna	örfilarna
förgöres	förgöres
etiketten	etiketten
attackeras	attackeras
translationer	translationer
oboerna	oboerna
Absalom	Absalom
kvacksalvares	kvacksalvares
stjärntydare	stjärntydare
ponerar	ponerar
antikvarier	antikvarier
vedergälle	vedergälle
Rehabeams	Rehabeams
ändligdimensionelle	ändligdimensionelle
inspekterades	inspekterades
slagen	slagen
lönnmördats	lönnmördats
härdsmältors	härdsmältors
beröven	beröven
kramade	kramade
lägge	lägge
sådda	sådda
polerar	polerar
musikinstruments	musikinstruments
kexet	kexet
Joa	Joa
skurna	skurna
välj	välj
döme	döme
sitt	sitt
ansträng	ansträng
vana	vana
dunstar	dunstar
bromsade	bromsade
mäta	mäta
Maas	Maas
Beker	Beker
följe	följe
upptäckte	upptäckte
utvalde	utvalde
sedeslöshet	sedeslöshet
Båda	Båda
dissekera	dissekera
dominikans	dominikans
bedrivet	bedrivet
avstånds	avstånds
lövträdets	lövträdets
butikskedjor	butikskedjor
racingbanan	racingbanan
föres	föres
fyllde	fyllde
upphäven	upphäven
överlevnaden	överlevnaden
bridge	bridge
borsten	borsten
flata	flata
fyllas	fyllas
axet	axet
vridande	vridande
slickepinnens	slickepinnens
förtryckt	förtryckt
åtalas	åtalas
Kabuls	Kabuls
morfismerna	morfismerna
Salman	Salman
inbärgade	inbärgade
Akajas	Akajas
mången	mången
funna	funna
justitieministrars	justitieministrars
hemsökes	hemsökes
gemak	gemak
fyllda	fyllda
förfares	förfares
homofons	homofons
sena	sena
högskolestyrelsernas	högskolestyrelsernas
åttiondelarna	åttiondelarna
fria	fria
bronsmedalj	bronsmedalj
gripes	gripes
bästa	bästa
gives	gives
kompilerar	kompilerar
slunga	slunga
kyssa	kyssa
värmen	värmen
nattklubb	nattklubb
tennislag	tennislag
Farao	Farao
sporde	sporde
arkivråden	arkivråden
rot	rot
sedeslöshetens	sedeslöshetens
snart	snart
köksön	köksön
bespejen	bespejen
vrida	vrida
vektorfälts	vektorfälts
resande	resande
oändligaste	oändligaste
binde	binde
sträckt	sträckt
stötande	stötande
barrskogar	barrskogar
krullparentesers	krullparentesers
förströdda	förströdda
firas	firas
stige	stige
avlagde	avlagde
bok	bok
alkoholism	alkoholism
förlikt	förlikt
Jerusalems	Jerusalems
brandväggarnas	brandväggarnas
samfund	samfund
fjättrade	fjättrade
sy	sy
miste	miste
förbehåller	förbehåller
såpbubblors	såpbubblors
nigande	nigande
väduren	väduren
öppnas	öppnas
störstes	störstes
anlöpta	anlöpta
förfors	förfors
sköta	sköta
bönerna	bönerna
hon	hon
flunsornas	flunsornas
kontrabas	kontrabas
debattörer	debattörer
vilddjurs	vilddjurs
luggs	luggs
uppenbarad	uppenbarad
Sisaks	Sisaks
översikt	översikt
beskära	beskära
bildrullens	bildrullens
klaffels	klaffels
kombinerar	kombinerar
förlåte	förlåte
badvädret	badvädret
axens	axens
brassat	brassat
utkommen	utkommen
lagstiftningen	lagstiftningen
synas	synas
intrångs	intrångs
nyårsaftons	nyårsaftons
betänkt	betänkt
rykande	rykande
bortföra	bortföra
råd	råd
vattenkonster	vattenkonster
roten	roten
avmäta	avmäta
peruans	peruans
porträtterade	porträtterade
tensorer	tensorer
meddelats	meddelats
spejare	spejare
slagna	slagna
sålde	sålde
Sådant	Sådant
snar	snar
förgiftad	förgiftad
travare	travare
matchs	matchs
pudel	pudel
halt	halt
markens	markens
Abimelek	Abimelek
upphävdes	upphävdes
upptänden	upptänden
dryckerna	dryckerna
5-öringens	5-öringens
uträckas	uträckas
ambassadsekreterarnas	ambassadsekreterarnas
bagatells	bagatells
fogad	fogad
skånks	skånks
följd	följd
äldste	äldste
försona	försona
tromb	tromb
begått	begått
upplåtna	upplåtna
ändligdimensionellt	ändligdimensionellt
De	De
tänka	tänka
Melek	Melek
interagerade	interagerade
bränna	bränna
städerna	städerna
epiteten	epiteten
kläda	kläda
uppföra	uppföra
karoliners	karoliners
tillkommelsen	tillkommelsen
procentenheten	procentenheten
fiskade	fiskade
skotsk	skotsk
läs	läs
bildordboken	bildordboken
lyckas	lyckas
Anas	Anas
upplagda	upplagda
skjuta	skjuta
polisbyråerna	polisbyråerna
Serubbabels	Serubbabels
pappersknivar	pappersknivar
ringar	ringar
springa	springa
Elis	Elis
Uris	Uris
ventilens	ventilens
gileaditerna	gileaditerna
maskuliner	maskuliner
knäveck	knäveck
trängt	trängt
brända	brända
urladdningen	urladdningen
eftersträvar	eftersträvar
klappa	klappa
handläggares	handläggares
värma	värma
gäckade	gäckade
blidka	blidka
systematiserad	systematiserad
invigen	invigen
dolde	dolde
jeeparna	jeeparna
blixtnedslaget	blixtnedslaget
förstörda	förstörda
halvimperials	halvimperials
hjortar	hjortar
överdragna	överdragna
fårs	fårs
Faraos	Faraos
sköte	sköte
fattas	fattas
barberar	barberar
betäckt	betäckt
skörten	skörten
tillspillogivna	tillspillogivna
säg	säg
halvimperialen	halvimperialen
utvalda	utvalda
dirigistiskt	dirigistiskt
joden	joden
bilagornas	bilagornas
ägare	ägare
senare	senare
korsfästa	korsfästa
betänken	betänken
bortkastade	bortkastade
förblivande	förblivande
rört	rört
befäst	befäst
koncentrationer	koncentrationer
synd	synd
aktivismen	aktivismen
mustens	mustens
ansträngd	ansträngd
kursfordran	kursfordran
Jairs	Jairs
år	år
Brödet	Brödet
livslängden	livslängden
förgörare	förgörare
jordbävningen	jordbävningen
förbyta	förbyta
Aras	Aras
framsteg	framsteg
bon	bon
Ain	Ain
omsnärjer	omsnärjer
syddes	syddes
tvilling	tvilling
förunnade	förunnade
kufarna	kufarna
rädd	rädd
inägorna	inägorna
säkrande	säkrande
arbetssätts	arbetssätts
arvedelar	arvedelar
Judeens	Judeens
dörjande	dörjande
predikare	predikare
participet	participet
vilken	vilken
Surs	Surs
Sutelas	Sutelas
sväljt	sväljt
hajande	hajande
Guds	Guds
Moabs	Moabs
väckes	väckes
byten	byten
logarna	logarna
altarets	altarets
fisket	fisket
beskrivit	beskrivit
undermenyernas	undermenyernas
kläder	kläder
vingarna	vingarna
förvånande	förvånande
falls	falls
cykelpump	cykelpump
Elias	Elias
mördare	mördare
anarkister	anarkister
blive	blive
uppfyller	uppfyller
Ais	Ais
avfallna	avfallna
annan	annan
äggulor	äggulor
dröj	dröj
självt	självt
Att	Att
arkivskåp	arkivskåp
homografens	homografens
ponerad	ponerad
brinnande	brinnande
uddens	uddens
uppfört	uppfört
koken	koken
besegra	besegra
hurudant	hurudant
fortfarande	fortfarande
betydande	betydande
överblickas	överblickas
övergiven	övergiven
vishets	vishets
försynen	försynen
oxarna	oxarna
skriftligt	skriftligt
Syriens	Syriens
barn	barn
embarkeringskortets	embarkeringskortets
fälla	fälla
obetalbara	obetalbara
kruciverbists	kruciverbists
ratificerades	ratificerades
betrycktas	betrycktas
retstickor	retstickor
5-öring	5-öring
gileadit	gileadit
krattorna	krattorna
aga	aga
Meleks	Meleks
mikroelektronikens	mikroelektronikens
väljares	väljares
pub	pub
krattors	krattors
upptändas	upptändas
uppställde	uppställde
arkiverats	arkiverats
utsatta	utsatta
domar	domar
färgad	färgad
betänk	betänk
gode	gode
renas	renas
omnämnandenas	omnämnandenas
uppställa	uppställa
hölje	hölje
graverar	graverar
arglistigt	arglistigt
västlig	västlig
förvaltade	förvaltade
inspekterat	inspekterat
hövdingdömen	hövdingdömen
tillgodogöra	tillgodogöra
backar	backar
altaret	altaret
fiskare	fiskare
vandren	vandren
Marias	Marias
församlas	församlas
lärkas	lärkas
etiketterna	etiketterna
rättfärdigas	rättfärdigas
Belas	Belas
svalka	svalka
vedergälla	vedergälla
förbytt	förbytt
henne	henne
snutits	snutits
dröjen	dröjen
prutten	prutten
satt	satt
tågstationerna	tågstationerna
piruetters	piruetters
pelare	pelare
dryck	dryck
åtgärdsbedömning	åtgärdsbedömning
tanzanierna	tanzanierna
utkom	utkom
fingeravtryckets	fingeravtryckets
förundran	förundran
näpet	näpet
villig	villig
bombarderats	bombarderats
bäres	bäres
pressar	pressar
anlöpte	anlöpte
stigen	stigen
lösdriverska	lösdriverska
Balak	Balak
potentiellt	potentiellt
modedockorna	modedockorna
sjunge	sjunge
svindeln	svindeln
varen	varen
lovar	lovar
förvånad	förvånad
Abias	Abias
visen	visen
filatelisterna	filatelisterna
fågelskådares	fågelskådares
rädda	rädda
beskärt	beskärt
forskningsbibliotek	forskningsbibliotek
arkivarierna	arkivarierna
vårdare	vårdare
inhägnad	inhägnad
utrikespolitiks	utrikespolitiks
upptänd	upptänd
kvantiteter	kvantiteter
Simmas	Simmas
Hans	Hans
busschaufförerna	busschaufförerna
väcka	väcka
mångfacetterade	mångfacetterade
sidensvans	sidensvans
uppförde	uppförde
syrgas	syrgas
derivatas	derivatas
arbetskamraterna	arbetskamraterna
dropp	dropp
murar	murar
fruktan	fruktan
låta	låta
julaftonens	julaftonens
nattduksbordet	nattduksbordet
landstingsrådens	landstingsrådens
anletes	anletes
ässets	ässets
narra	narra
avfallen	avfallen
Tabors	Tabors
tranbärs	tranbärs
svalt	svalt
linslusens	linslusens
vinn	vinn
rätt	rätt
radiostationens	radiostationens
förökades	förökades
glåpords	glåpords
känden	känden
redigeringskrigs	redigeringskrigs
nejlikornas	nejlikornas
byar	byar
blattes	blattes
trampas	trampas
slaktade	slaktade
vishet	vishet
upplöst	upplöst
protesterad	protesterad
halshugga	halshugga
agat	agat
arrestera	arrestera
styrkes	styrkes
Judeen	Judeen
beskäres	beskäres
dyrkande	dyrkande
landstingsdirektören	landstingsdirektören
Asafs	Asafs
någons	någons
avbärgad	avbärgad
andas	andas
stöttes	stöttes
Sanna	Sanna
pilspetsen	pilspetsen
kläde	kläde
frälse	frälse
skrymtan	skrymtan
Hets	Hets
omgivna	omgivna
nyponen	nyponen
tillgodogör	tillgodogör
tjänare	tjänare
mötande	mötande
handläggare	handläggare
embarkeringskort	embarkeringskort
intellektuellt	intellektuellt
överlevnad	överlevnad
gastade	gastade
Hagar	Hagar
cykelpumparna	cykelpumparna
allas	allas
begynt	begynt
stoderna	stoderna
genomsökt	genomsökt
träta	träta
gräslökens	gräslökens
fattade	fattade
brändes	brändes
trädstammen	trädstammen
badvädrets	badvädrets
Soan	Soan
lodjurens	lodjurens
Anaks	Anaks
väckas	väckas
faktisk	faktisk
mjölksyran	mjölksyran
upprest	upprest
smittskyddet	smittskyddet
mördade	mördade
singla	singla
flygas	flygas
nyårsaftonen	nyårsaftonen
blåmesarnas	blåmesarnas
bespejade	bespejade
dina	dina
denne	denne
överleva	överleva
åra	åra
ytterst	ytterst
Bosra	Bosra
utbytes	utbytes
jordskreds	jordskreds
komikers	komikers
slangordet	slangordet
åtnjutas	åtnjutas
frambära	frambära
korsordet	korsordet
mikrofonerna	mikrofonerna
friat	friat
trugad	trugad
kommutatorns	kommutatorns
sprängmedlen	sprängmedlen
upptänt	upptänt
transporterade	transporterade
plommon	plommon
palindroms	palindroms
vårdkasarna	vårdkasarna
dyrkades	dyrkades
bifloder	bifloder
vindhålets	vindhålets
50-öring	50-öring
linjekartor	linjekartor
utsträcker	utsträcker
bespejare	bespejare
förflyttningar	förflyttningar
sjuke	sjuke
Resa	Resa
felfortplantningarna	felfortplantningarna
Ehud	Ehud
luta	luta
korsord	korsord
Taga	Taga
sås	sås
fatta	fatta
löjtnantens	löjtnantens
lästes	lästes
fångenskaps	fångenskaps
särk	särk
gladd	gladd
egyptierna	egyptierna
betecknad	betecknad
tillspillogiven	tillspillogiven
saknas	saknas
bekräftade	bekräftade
atommassornas	atommassornas
Lovat	Lovat
Joktans	Joktans
resa	resa
rulltårtan	rulltårtan
Sauls	Sauls
uppmanande	uppmanande
oskadliggör	oskadliggör
könsnorm	könsnorm
tigs	tigs
avhållen	avhållen
flydda	flydda
värka	värka
Joas	Joas
Dennes	Dennes
störste	störste
sjunga	sjunga
snökedja	snökedja
buks	buks
provocerade	provocerade
fatet	fatet
gravitationens	gravitationens
fjortondel	fjortondel
gods	gods
indiskans	indiskans
bronsmedaljen	bronsmedaljen
ymnighets	ymnighets
bevisade	bevisade
Edoms	Edoms
kantrar	kantrar
Abrams	Abrams
raggare	raggare
Dess	Dess
döma	döma
besiktigades	besiktigades
fotgängarna	fotgängarna
batteriholken	batteriholken
ringmuskelns	ringmuskelns
stänkt	stänkt
enslinjes	enslinjes
skuggade	skuggade
fullbordades	fullbordades
dubbelklickar	dubbelklickar
varandra	varandra
huggna	huggna
glidytas	glidytas
såga	såga
undersöka	undersöka
blåhakarna	blåhakarna
föröke	föröke
censors	censors
förtälj	förtälj
kort	kort
blottat	blottat
funderades	funderades
snökedjorna	snökedjorna
vilkas	vilkas
fajtens	fajtens
flunsorna	flunsorna
Högstes	Högstes
årors	årors
Kemuels	Kemuels
byarna	byarna
förkortningens	förkortningens
göra	göra
manchesters	manchesters
oxens	oxens
städ	städ
ripjakts	ripjakts
förgör	förgör
stridsmedel	stridsmedel
räckas	räckas
förtryckes	förtryckes
ballongpelare	ballongpelare
skånken	skånken
flyga	flyga
Hebrons	Hebrons
beskrivningsspråk	beskrivningsspråk
duetterna	duetterna
tvaget	tvaget
hackade	hackade
Gode	Gode
blankstegs	blankstegs
landstingsråds	landstingsråds
glädjas	glädjas
gorillor	gorillor
hala	hala
kartografiska	kartografiska
surjektionens	surjektionens
upphöjd	upphöjd
längs	längs
utföres	utföres
utgjorde	utgjorde
byttor	byttor
avbärga	avbärga
fängelsehålans	fängelsehålans
vållen	vållen
antytt	antytt
stöts	stöts
fördömen	fördömen
brinna	brinna
hållen	hållen
återbesöket	återbesöket
porträtterad	porträtterad
dödas	dödas
flickvänner	flickvänner
kosta	kosta
påvisat	påvisat
drives	drives
Elia	Elia
Jedutun	Jedutun
långtradaren	långtradaren
lodjuret	lodjuret
trofasthet	trofasthet
utdelade	utdelade
elddop	elddop
åttondedelar	åttondedelar
hälsade	hälsade
träda	träda
palindromers	palindromers
knarkats	knarkats
Evad	Evad
vilddjur	vilddjur
visar	visar
konservburkars	konservburkars
ylande	ylande
bedraga	bedraga
anklagar	anklagar
Helt	Helt
svågrars	svågrars
dräpt	dräpt
odjuret	odjuret
konverterad	konverterad
gömmas	gömmas
Noas	Noas
komme	komme
förstes	förstes
ringa	ringa
minskade	minskade
Arabiens	Arabiens
smälta	smälta
Abia	Abia
Lots	Lots
hedersbetygelsen	hedersbetygelsen
Johannes	Johannes
vårt	vårt
markörers	markörers
defenestrerad	defenestrerad
havererade	havererade
flyge	flyge
upprört	upprört
släkterna	släkterna
pärlugglor	pärlugglor
annandagars	annandagars
beskyddare	beskyddare
Hebers	Hebers
Sikems	Sikems
nymånadsdagar	nymånadsdagar
gaffeln	gaffeln
bortrycktes	bortrycktes
Amon	Amon
bergochdalbanorna	bergochdalbanorna
behövande	behövande
betrodda	betrodda
epitet	epitet
röras	röras
nattduksbord	nattduksbord
räddare	räddare
Vilka	Vilka
anfangen	anfangen
förgätit	förgätit
restaurerar	restaurerar
trugat	trugat
störtkrukors	störtkrukors
Isebels	Isebels
frossa	frossa
nyktre	nyktre
skrämmes	skrämmes
högskolelagarna	högskolelagarna
blåhaken	blåhaken
Moses	Moses
avhärvlat	avhärvlat
koffert	koffert
dåd	dåd
förledets	förledets
homograferna	homograferna
Gamaliels	Gamaliels
sitter	sitter
tumnagelns	tumnagelns
boks	boks
bebodde	bebodde
överseende	överseende
flädermärgskulornas	flädermärgskulornas
Lea	Lea
eforn	eforn
bränns	bränns
absiderna	absiderna
refererande	refererande
flugits	flugits
visa	visa
dess	dess
hyst	hyst
anfallen	anfallen
patenterade	patenterade
gendriver	gendriver
fiskas	fiskas
bjödo	bjödo
tremänningarna	tremänningarna
kläcka	kläcka
Sebaots	Sebaots
omdefinierar	omdefinierar
länderna	länderna
Elieser	Elieser
upptagna	upptagna
brunbjörnar	brunbjörnar
nymånadsdagen	nymånadsdagen
dödsdagarna	dödsdagarna
kabinettssekreterare	kabinettssekreterare
örfilarnas	örfilarnas
bastet	bastet
död	död
mentor	mentor
besatta	besatta
barntås	barntås
vederkvicka	vederkvicka
monsunernas	monsunernas
kristadelfianernas	kristadelfianernas
malen	malen
närståendes	närståendes
Jafets	Jafets
hölja	hölja
mista	mista
både	både
slicke	slicke
byttornas	byttornas
Ai	Ai
blottades	blottades
föden	föden
fördärv	fördärv
lida	lida
tages	tages
skattmästare	skattmästare
omvände	omvände
bjudes	bjudes
lösa	lösa
möts	möts
vårdkasens	vårdkasens
ringas	ringas
agade	agade
fördelaktiga	fördelaktiga
kroppsvätskans	kroppsvätskans
tjeckiskans	tjeckiskans
penningkistor	penningkistor
vålds	vålds
Jabin	Jabin
dissekerat	dissekerat
dräp	dräp
bevaras	bevaras
låte	låte
utplånades	utplånades
möjliggör	möjliggör
veta	veta
hyresnämnden	hyresnämnden
spelpjäsen	spelpjäsen
röra	röra
lagats	lagats
webbplats	webbplats
undantagna	undantagna
julaftnarnas	julaftnarnas
Gud	Gud
kokade	kokade
Diana	Diana
berylls	berylls
bruset	bruset
bestämmande	bestämmande
vreden	vreden
dissars	dissars
Abimeleks	Abimeleks
modernt	modernt
Man	Man
Bileam	Bileam
svalkas	svalkas
betyda	betyda
utvandrande	utvandrande
energifrågor	energifrågor
meddelade	meddelade
moppar	moppar
svepts	svepts
Asiens	Asiens
bergochdalbanors	bergochdalbanors
stores	stores
ordningens	ordningens
kvällstidningarnas	kvällstidningarnas
stycke	stycke
haverera	haverera
traditionella	traditionella
modernast	modernast
visst	visst
knacka	knacka
Sutela	Sutela
talas	talas
släkten	släkten
genade	genade
flyttats	flyttats
Adas	Adas
Lus	Lus
genomsöka	genomsöka
korskrank	korskrank
killingarnas	killingarnas
juicen	juicen
förstören	förstören
ut	ut
snigelns	snigelns
skötet	skötet
zappade	zappade
Ono	Ono
mittpunkts	mittpunkts
tyristorer	tyristorer
årtusendes	årtusendes
lavs	lavs
välva	välva
terapeuts	terapeuts
uträcker	uträcker
glåporden	glåporden
droppade	droppade
vett	vett
sådanas	sådanas
småländskas	småländskas
kränka	kränka
bordlägga	bordlägga
ackuschören	ackuschören
abonnemangsavgiften	abonnemangsavgiften
akvarellmålare	akvarellmålare
cabbars	cabbars
Lot	Lot
lågt	lågt
rörde	rörde
ollades	ollades
möjliggjord	möjliggjord
hylla	hylla
nymånadsdag	nymånadsdag
kufen	kufen
tordes	tordes
Natan	Natan
uddar	uddar
vika	vika
Isebel	Isebel
sko	sko
hycklare	hycklare
förflyttningarnas	förflyttningarnas
ihågkommen	ihågkommen
översta	översta
rädes	rädes
blottande	blottande
förmörka	förmörka
Esaus	Esaus
stadsstadgornas	stadsstadgornas
albanskas	albanskas
sådant	sådant
åttondelars	åttondelars
slites	slites
stadier	stadier
tillhöra	tillhöra
frukte	frukte
dömen	dömen
tycke	tycke
årsfest	årsfest
hotfulle	hotfulle
genomslagets	genomslagets
stridsmedlen	stridsmedlen
fästena	fästena
sköts	sköts
älgar	älgar
Kain	Kain
nagellackets	nagellackets
svavelstickan	svavelstickan
ockupationers	ockupationers
önskans	önskans
Nebajot	Nebajot
dråparna	dråparna
vässt	vässt
finsko	finsko
olivträd	olivträd
retirera	retirera
siares	siares
plats	plats
Haso	Haso
gömmes	gömmes
redaktionssekreterarnas	redaktionssekreterarnas
förläts	förläts
arbetssättet	arbetssättet
marks	marks
örtagårdars	örtagårdars
Assyrien	Assyrien
blöt	blöt
länge	länge
ståndens	ståndens
homogene	homogene
drive	drive
läras	läras
borttaga	borttaga
försvunno	försvunno
stjärten	stjärten
uppgiven	uppgiven
drages	drages
konsekvente	konsekvente
etiopierna	etiopierna
bigamis	bigamis
jordskredet	jordskredet
slags	slags
livstiders	livstiders
masochists	masochists
hyllade	hyllade
förgjort	förgjort
förtärda	förtärda
anrättningar	anrättningar
vände	vände
nämnde	nämnde
anställde	anställde
köpingen	köpingen
Hanes	Hanes
terrorists	terrorists
uzbeks	uzbeks
upphöjda	upphöjda
möte	möte
hajade	hajade
anklagats	anklagats
jeepars	jeepars
vanna	vanna
Persien	Persien
qväljes	qväljes
Mas	Mas
bäre	bäre
svavelväte	svavelväte
Aven	Aven
näpst	näpst
Israels	Israels
uttalad	uttalad
klädda	klädda
före	före
retsticka	retsticka
Ögat	Ögat
papperskniv	papperskniv
sudda	sudda
ringare	ringare
drivna	drivna
förtära	förtära
valrossar	valrossar
Ussia	Ussia
Jered	Jered
dragare	dragare
verkade	verkade
kontrasterades	kontrasterades
gödda	gödda
upphöjde	upphöjde
korsfäst	korsfäst
kontextuelle	kontextuelle
förstörs	förstörs
äldstes	äldstes
svindel	svindel
Ismaels	Ismaels
sålden	sålden
fostrare	fostrare
departementsråds	departementsråds
chilenarens	chilenarens
klöv	klöv
fast	fast
Sådan	Sådan
argentinskorna	argentinskorna
kokar	kokar
Elisa	Elisa
give	give
bortfört	bortfört
jordbävnings	jordbävnings
ministeriers	ministeriers
förståndet	förståndet
låge	låge
anlöpt	anlöpt
blygas	blygas
skapare	skapare
ettstrukna	ettstrukna
kroppsvätskors	kroppsvätskors
Fourierseriens	Fourierseriens
drypa	drypa
huvens	huvens
drog	drog
verket	verket
borgen	borgen
förblive	förblive
marinbiologis	marinbiologis
besökt	besökt
uppenbarat	uppenbarat
efterföljd	efterföljd
diesel	diesel
arglistige	arglistige
skifte	skifte
pingis	pingis
vingar	vingar
filter	filter
fagottisten	fagottisten
homogena	homogena
talar	talar
kryptan	kryptan
flunsa	flunsa
galningars	galningars
förfars	förfars
täckas	täckas
stickmygga	stickmygga
Datan	Datan
inrop	inrop
ungkarl	ungkarl
beställa	beställa
barrskog	barrskog
ätes	ätes
svågrarnas	svågrarnas
beredd	beredd
dragne	dragne
sjöboden	sjöboden
Babel	Babel
dennes	dennes
Orions	Orions
påbudet	påbudet
statschefer	statschefer
translationen	translationen
Din	Din
förhandlad	förhandlad
killingars	killingars
packets	packets
sina	sina
bedrövande	bedrövande
egyptologins	egyptologins
bjuda	bjuda
används	används
korer	korer
visars	visars
maakatéernas	maakatéernas
överdomstols	överdomstols
hysa	hysa
preliminärskattens	preliminärskattens
befästa	befästa
Onan	Onan
resas	resas
härdsmältans	härdsmältans
filialens	filialens
sjungs	sjungs
slipas	slipas
öppnats	öppnats
segrare	segrare
grumlade	grumlade
olivträdets	olivträdets
ellipsen	ellipsen
viska	viska
predikade	predikade
kvantifiera	kvantifiera
betänka	betänka
upplösa	upplösa
slösade	slösade
dyrkade	dyrkade
uppläst	uppläst
anrättningars	anrättningars
fästas	fästas
bedrage	bedrage
påves	påves
nertiders	nertiders
Salomo	Salomo
strålen	strålen
kriteriet	kriteriet
Merari	Merari
monsuners	monsuners
tv:n	tv:n
Ett	Ett
bytt	bytt
vinrankors	vinrankors
efterföljare	efterföljare
skiften	skiften
regleringsbrev	regleringsbrev
raggarna	raggarna
kelar	kelar
breda	breda
fattat	fattat
noggrant	noggrant
slagverkaren	slagverkaren
skickade	skickade
ryckes	ryckes
såpbubblorna	såpbubblorna
kompletterade	kompletterade
porren	porren
stärkt	stärkt
arvedelen	arvedelen
försonas	försonas
minimum	minimum
nominera	nominera
viskade	viskade
räcka	räcka
var	var
anställd	anställd
Lud	Lud
gräns	gräns
styrkas	styrkas
beröms	beröms
Nilen	Nilen
blödas	blödas
skulptörs	skulptörs
Alexander	Alexander
Vårt	Vårt
påvisar	påvisar
anrättade	anrättade
sen	sen
rev	rev
liden	liden
skapades	skapades
befästes	befästes
vattenkannas	vattenkannas
upphöjt	upphöjt
Maria	Maria
kattdjur	kattdjur
moppars	moppars
dunstats	dunstats
nämna	nämna
Vilken	Vilken
graverad	graverad
förtryck	förtryck
räckt	räckt
vikt	vikt
upplagens	upplagens
katalanske	katalanske
tjänarna	tjänarna
fallna	fallna
upptäcktsresas	upptäcktsresas
mög	mög
graverades	graverades
bast	bast
kostande	kostande
modedockan	modedockan
expanderas	expanderas
murarens	murarens
förlåten	förlåten
förenklar	förenklar
skatbons	skatbons
dödsfalls	dödsfalls
kvitterande	kvitterande
uttalas	uttalas
vita	vita
garantifonden	garantifonden
födes	födes
växe	växe
kulminera	kulminera
kröna	kröna
utökas	utökas
släppa	släppa
Ana	Ana
besegrades	besegrades
lösande	lösande
kors	kors
omsnärjde	omsnärjde
nypon	nypon
göda	göda
förtrycktas	förtrycktas
budens	budens
stödstrumpans	stödstrumpans
fången	fången
karoliner	karoliner
täcke	täcke
sliten	sliten
förenklats	förenklats
Beta	Beta
uppväcka	uppväcka
oxes	oxes
förtvivlat	förtvivlat
lexikografisk	lexikografisk
glädes	glädes
grandets	grandets
vädur	vädur
undervattensbåts	undervattensbåts
besviken	besviken
förökade	förökade
bundna	bundna
tanzanier	tanzanier
allt	allt
bronsmedaljs	bronsmedaljs
bete	bete
öst	öst
minikjols	minikjols
Kains	Kains
klädde	klädde
Allas	Allas
fetma	fetma
sovo	sovo
rökrutor	rökrutor
brukade	brukade
bilagorna	bilagorna
antimaterian	antimaterian
omnämnandes	omnämnandes
doktorsavhandling	doktorsavhandling
panteistens	panteistens
svensexors	svensexors
oboens	oboens
rycka	rycka
vädurs	vädurs
viljes	viljes
hörare	hörare
följda	följda
polarforsknings	polarforsknings
enda	enda
absids	absids
kor	kor
Falla	Falla
judoutövares	judoutövares
klaffelen	klaffelen
debattörerna	debattörerna
varieras	varieras
skarpa	skarpa
lös	lös
övertäckt	övertäckt
kombinerad	kombinerad
log	log
manas	manas
hållare	hållare
lames	lames
lösare	lösare
skrämma	skrämma
repmånaden	repmånaden
benämnande	benämnande
plåga	plåga
skuldoffersvädur	skuldoffersvädur
abonnemangsavgifts	abonnemangsavgifts
linslusar	linslusar
Asien	Asien
nästes	nästes
accelerationen	accelerationen
stativens	stativens
krockarnas	krockarnas
gäsparna	gäsparna
Aner	Aner
legitimiteten	legitimiteten
killingarna	killingarna
allegorin	allegorin
kabinettssekreteraren	kabinettssekreteraren
täckte	täckte
åttondels	åttondels
Syrien	Syrien
stimulerat	stimulerat
översedd	översedd
nästen	nästen
versioner	versioner
förkastas	förkastas
murares	murares
steka	steka
gileaditen	gileaditen
räknen	räknen
fononernas	fononernas
potentielle	potentielle
föräldralöst	föräldralöst
gravvårdar	gravvårdar
Jereds	Jereds
kids	kids
nagellacker	nagellacker
deklarera	deklarera
släktet	släktet
ordnings	ordnings
transaktioner	transaktioner
son	son
tvillings	tvillings
Gudarna	Gudarna
sexhörningarnas	sexhörningarnas
skottdags	skottdags
vittnesbörd	vittnesbörd
kräftans	kräftans
hållplats	hållplats
sjuka	sjuka
fontäners	fontäners
Resen	Resen
avla	avla
kokas	kokas
preciseras	preciseras
befälhavare	befälhavare
hycklarnas	hycklarnas
mentorer	mentorer
utfärdar	utfärdar
tågats	tågats
tryckarna	tryckarna
substraten	substraten
svängande	svängande
tålmodigt	tålmodigt
Sems	Sems
fornengelskan	fornengelskan
gripa	gripa
talats	talats
bältes	bältes
gripna	gripna
trakassera	trakassera
huvars	huvars
mätten	mätten
lindade	lindade
sjungits	sjungits
hållna	hållna
flyta	flyta
medelhavs	medelhavs
konvojers	konvojers
förutsatt	förutsatt
begrundades	begrundades
komma	komma
sken	sken
draget	draget
frambären	frambären
rustningarnas	rustningarnas
dricka	dricka
odjur	odjur
applicera	applicera
förehaven	förehaven
tjänade	tjänade
mångas	mångas
kolumnbredder	kolumnbredder
ekobrottets	ekobrottets
anden	anden
masochisten	masochisten
twittras	twittras
våra	våra
nejlikan	nejlikan
överdragen	överdragen
tjugofemöringens	tjugofemöringens
extentor	extentor
önska	önska
skänk	skänk
rots	rots
Rabba	Rabba
födda	födda
hämta	hämta
förvarande	förvarande
söka	söka
görare	görare
planteren	planteren
mös	mös
förtäljen	förtäljen
uppståndna	uppståndna
gärningsmannen	gärningsmannen
ha	ha
tvillingar	tvillingar
bruse	bruse
Husen	Husen
oxidationstal	oxidationstal
davnad	davnad
kloridernas	kloridernas
provocerats	provocerats
cypriotiskas	cypriotiskas
genomslaget	genomslaget
basketbollarnas	basketbollarnas
tänkare	tänkare
sans	sans
avbildande	avbildande
vinklades	vinklades
Öga	Öga
kära	kära
chipspåsarnas	chipspåsarnas
fogas	fogas
utröna	utröna
kuddarnas	kuddarnas
verke	verke
smältas	smältas
meterna	meterna
värnpliktskongress	värnpliktskongress
bunden	bunden
Hasor	Hasor
stött	stött
sökt	sökt
avgudens	avgudens
deisters	deisters
Susa	Susa
anlete	anlete
kombineras	kombineras
vete	vete
gjordes	gjordes
ögonhålas	ögonhålas
preciserat	preciserat
medelhavet	medelhavet
diarieförande	diarieförande
drogs	drogs
svavelstickas	svavelstickas
svastikans	svastikans
gripen	gripen
uträcka	uträcka
inmatningsfältets	inmatningsfältets
gören	gören
snörena	snörena
rörande	rörande
arkeologen	arkeologen
givet	givet
fordren	fordren
plommons	plommons
näste	näste
punktlistan	punktlistan
ordlistor	ordlistor
oscillation	oscillation
årens	årens
ammade	ammade
pennvässare	pennvässare
övergåve	övergåve
omgives	omgives
kronologiska	kronologiska
båda	båda
bokmärken	bokmärken
droppen	droppen
minne	minne
sann	sann
fagott	fagott
bromsat	bromsat
cichlids	cichlids
sava	sava
torts	torts
rulltårta	rulltårta
Antikrist	Antikrist
draga	draga
gena	gena
snöre	snöre
kolonistens	kolonistens
börja	börja
afrikanskorna	afrikanskorna
beställningsarbete	beställningsarbete
bit	bit
Abels	Abels
gelé	gelé
guldfiskarna	guldfiskarna
cykelhandlaren	cykelhandlaren
påbud	påbud
läses	läses
överstes	överstes
kriget	kriget
hugges	hugges
hörn	hörn
förgöras	förgöras
pennalens	pennalens
sjöslagen	sjöslagen
lärkorna	lärkorna
fajternas	fajternas
utbredda	utbredda
säljen	säljen
korniskan	korniskan
fjättrar	fjättrar
slån	slån
hjälpsam	hjälpsam
ungdomsförbundet	ungdomsförbundet
koffertarnas	koffertarnas
rövare	rövare
tegs	tegs
sandas	sandas
Gat	Gat
hyresvärden	hyresvärden
Ruben	Ruben
fälles	fälles
doktorsgraderna	doktorsgraderna
niga	niga
omkommo	omkommo
Bered	Bered
utsändas	utsändas
uppväckt	uppväckt
epitetet	epitetet
historisk	historisk
fåtöljen	fåtöljen
datavetenskap	datavetenskap
modets	modets
slösare	slösare
propan	propan
samlades	samlades
förre	förre
rappande	rappande
stadga	stadga
underavdelningars	underavdelningars
kofferts	kofferts
agitatorer	agitatorer
voltens	voltens
sutenörens	sutenörens
förändrat	förändrat
täckts	täckts
döpt	döpt
bilfärjornas	bilfärjornas
Jobs	Jobs
jagat	jagat
lärt	lärt
upphandlingars	upphandlingars
golfklubbens	golfklubbens
intressera	intressera
togs	togs
agitatorns	agitatorns
Obeds	Obeds
slickade	slickade
förhindrats	förhindrats
vätas	vätas
styrka	styrka
Hanna	Hanna
förtär	förtär
bevarad	bevarad
krullparentesens	krullparentesens
provisoriets	provisoriets
markerna	markerna
siare	siare
använt	använt
psykologers	psykologers
systematiseras	systematiseras
oftare	oftare
stärken	stärken
tillgängligheten	tillgängligheten
fagottisterna	fagottisterna
dominerade	dominerade
leva	leva
dal	dal
existentielle	existentielle
köpingens	köpingens
fingeravtrycks	fingeravtrycks
Bosras	Bosras
indikerad	indikerad
trollade	trollade
fåren	fåren
åka	åka
tåga	tåga
stupade	stupade
utgiftstakets	utgiftstakets
loven	loven
stadsbibliotek	stadsbibliotek
upptages	upptages
namne	namne
Job	Job
juble	juble
indoktrinerings	indoktrinerings
ambassadsekreterares	ambassadsekreterares
galningen	galningen
tretalets	tretalets
krig	krig
utdelat	utdelat
förkunnades	förkunnades
Jona	Jona
massförstörelsevapens	massförstörelsevapens
lamans	lamans
tatuerarnas	tatuerarnas
korsar	korsar
blott	blott
ruinera	ruinera
slita	slita
trycks	trycks
Et	Et
tatuerares	tatuerares
fanfaronaders	fanfaronaders
twittrats	twittrats
givna	givna
mödat	mödat
enar	enar
Leviatan	Leviatan
signerade	signerade
böjen	böjen
renar	renar
läkare	läkare
sanna	sanna
epitets	epitets
förskräcka	förskräcka
blottats	blottats
linda	linda
stenas	stenas
kuddarna	kuddarna
disponeras	disponeras
tävlingsbana	tävlingsbana
studiet	studiet
kulturlivs	kulturlivs
skåden	skåden
tennislaget	tennislaget
Ard	Ard
sök	sök
kvällstidnings	kvällstidnings
vinylskiva	vinylskiva
judoutövaren	judoutövaren
konungadömes	konungadömes
handlägg	handlägg
finna	finna
dom	dom
slickepinnen	slickepinnen
lidandet	lidandet
tillgiva	tillgiva
lokaliserande	lokaliserande
Benjamin	Benjamin
bokriserna	bokriserna
sökte	sökte
Jeriko	Jeriko
besiktigas	besiktigas
avtaget	avtaget
avlägsnas	avlägsnas
enes	enes
syns	syns
sons	sons
Efrons	Efrons
ospontant	ospontant
slangordets	slangordets
sångarna	sångarna
kände	kände
dräpas	dräpas
borgare	borgare
kommutatorn	kommutatorn
krypta	krypta
berömt	berömt
Gehenna	Gehenna
extentans	extentans
sports	sports
tänke	tänke
enas	enas
omdefinierande	omdefinierande
förstöres	förstöres
moppen	moppen
beskärd	beskärd
bundne	bundne
beaktandeledens	beaktandeledens
Jonatans	Jonatans
åkerstycket	åkerstycket
utsatte	utsatte
rovs	rovs
förkunnat	förkunnat
bosätta	bosätta
borttagen	borttagen
doktorsexamen	doktorsexamen
medfödde	medfödde
justeras	justeras
betade	betade
respekterad	respekterad
förändrade	förändrade
brännande	brännande
misshandlade	misshandlade
åtalar	åtalar
dörjade	dörjade
deklarerar	deklarerar
förgöra	förgöra
långstrumpas	långstrumpas
stjäle	stjäle
revo	revo
åsens	åsens
rastade	rastade
gravitation	gravitation
särkarnas	särkarnas
Omar	Omar
uppväcken	uppväcken
ellipser	ellipser
utlysa	utlysa
varulvs	varulvs
yttersta	yttersta
paketerar	paketerar
vilen	vilen
anställas	anställas
alls	alls
upplagt	upplagt
levererade	levererade
Hanoks	Hanoks
märka	märka
gross	gross
datavetenskapens	datavetenskapens
hindarna	hindarna
snarast	snarast
Sered	Sered
läroverk	läroverk
sydnäktergalarnas	sydnäktergalarnas
Jabins	Jabins
relaterar	relaterar
vid	vid
undkom	undkom
qvadrater	qvadrater
annexet	annexet
räknades	räknades
konsortiets	konsortiets
överdraga	överdraga
ledarsidor	ledarsidor
konfigurera	konfigurera
Efraims	Efraims
utföre	utföre
säkrades	säkrades
hembäre	hembäre
kramades	kramades
upphäver	upphäver
kämpade	kämpade
afrikanskors	afrikanskors
dominikaners	dominikaners
Manasses	Manasses
antropologin	antropologin
påvar	påvar
kejsares	kejsares
Beria	Beria
skatbo	skatbo
överfalla	överfalla
Amalek	Amalek
cerebrospinalvätskans	cerebrospinalvätskans
determinant	determinant
välvt	välvt
dubbelmacka	dubbelmacka
kvantifierar	kvantifierar
Hanan	Hanan
läser	läser
färgat	färgat
sänt	sänt
nejets	nejets
roa	roa
giva	giva
fare	fare
betäck	betäck
Nilens	Nilens
barka	barka
pilsnerns	pilsnerns
förkortningarna	förkortningarna
rökrutas	rökrutas
segrar	segrar
förleder	förleder
dån	dån
ända	ända
utträdesarbetet	utträdesarbetet
spridda	spridda
talande	talande
bade	bade
snödroppe	snödroppe
undervattensbåtars	undervattensbåtars
Seir	Seir
kvantifierade	kvantifierade
hakar	hakar
rumänen	rumänen
förlik	förlik
tvagen	tvagen
omstrukturerades	omstrukturerades
svordom	svordom
flydde	flydde
maka	maka
översikts	översikts
klippa	klippa
åte	åte
förgjorde	förgjorde
kokat	kokat
ens	ens
använd	använd
bovarna	bovarna
interagerande	interagerande
stridsmedlet	stridsmedlet
förundrade	förundrade
Bileams	Bileams
vinna	vinna
agas	agas
blyges	blyges
uppfyll	uppfyll
knäveckets	knäveckets
rätas	rätas
tröstas	tröstas
droge	droge
Rabbas	Rabbas
arms	arms
butikskedja	butikskedja
kexets	kexets
korsförhörens	korsförhörens
Melkisedek	Melkisedek
inviga	inviga
drivas	drivas
oxideras	oxideras
dominerad	dominerad
klädd	klädd
allmänspråklige	allmänspråklige
fördolda	fördolda
tvagna	tvagna
byråkratiske	byråkratiske
sidensvansar	sidensvansar
upprörd	upprörd
gestaltningars	gestaltningars
trampa	trampa
falsifierad	falsifierad
Bröder	Bröder
orena	orena
förlåta	förlåta
täckes	täckes
ugglors	ugglors
rymdfysikens	rymdfysikens
odjurs	odjurs
främmande	främmande
döpa	döpa
anställda	anställda
föda	föda
trigonometri	trigonometri
nickas	nickas
tryckarens	tryckarens
mustasch	mustasch
Våra	Våra
fläka	fläka
skjuten	skjuten
sakerna	sakerna
undan	undan
älg	älg
Samaria	Samaria
bältena	bältena
uppfylls	uppfylls
avfalla	avfalla
näst	näst
vises	vises
Bela	Bela
åt	åt
atommassor	atommassor
tandvårdens	tandvårdens
reduktioners	reduktioners
ek	ek
hennes	hennes
öppnat	öppnat
bytande	bytande
polygonernas	polygonernas
torkade	torkade
Gads	Gads
formas	formas
årornas	årornas
lösaste	lösaste
förlösa	förlösa
förutsätts	förutsätts
kulsprutorna	kulsprutorna
prissumman	prissumman
knyte	knyte
sakens	sakens
upplyses	upplyses
uppresa	uppresa
stiftas	stiftas
Baal	Baal
funno	funno
sköt	sköt
metern	metern
antänd	antänd
konverteras	konverteras
förlitade	förlitade
kommunicerat	kommunicerat
dessa	dessa
fakultetsnämnden	fakultetsnämnden
fara	fara
koffertarna	koffertarna
anglicismen	anglicismen
Heles	Heles
Baraks	Baraks
citrusfrukten	citrusfrukten
trofastheten	trofastheten
församla	församla
ytteröra	ytteröra
tagen	tagen
Den	Den
initiativtagarna	initiativtagarna
Iskariot	Iskariot
mät	mät
inhägnade	inhägnade
förtäres	förtäres
Rehabeam	Rehabeam
äte	äte
emigrerade	emigrerade
skymd	skymd
Varde	Varde
längten	längten
Simma	Simma
trollas	trollas
torka	torka
Tro	Tro
bältens	bältens
sydnäktergalarna	sydnäktergalarna
minska	minska
blixtnedslagen	blixtnedslagen
Ned	Ned
referera	referera
ende	ende
då	då
holonymens	holonymens
slickepinnes	slickepinnes
förhärligen	förhärligen
grindarnas	grindarnas
vidhäftade	vidhäftade
förtäre	förtäre
fråga	fråga
arrendes	arrendes
ymnighetens	ymnighetens
beaktandeleds	beaktandeleds
bebott	bebott
spisoffret	spisoffret
förenar	förenar
Kemuel	Kemuel
fäst	fäst
ansedda	ansedda
förhindra	förhindra
möta	möta
luffarens	luffarens
kedjehus	kedjehus
rykte	rykte
omsluten	omsluten
uttagning	uttagning
Samuels	Samuels
Ehuds	Ehuds
släktes	släktes
Hiskia	Hiskia
vållade	vållade
din	din
anticyklonens	anticyklonens
fästande	fästande
Baals	Baals
nödgade	nödgade
nallarnas	nallarnas
kulturliv	kulturliv
komiker	komiker
rövar	rövar
pärms	pärms
bombarderades	bombarderades
beställt	beställt
Hagars	Hagars
anpassningar	anpassningar
Jafet	Jafet
bestänka	bestänka
koncentrerande	koncentrerande
mikrofonens	mikrofonens
Ande	Ande
uppenbaras	uppenbaras
fallerar	fallerar
snörens	snörens
musikallåtar	musikallåtar
stjäl	stjäl
sjöbods	sjöbods
pulver	pulver
löste	löste
Under	Under
säkrast	säkrast
mopps	mopps
uppenbara	uppenbara
Sina	Sina
psykologs	psykologs
Obed	Obed
blottas	blottas
sändande	sändande
skulptör	skulptör
kända	kända
använde	använde
avskilde	avskilde
Sjustjärnornas	Sjustjärnornas
skuren	skuren
borgar	borgar
lika	lika
underskriften	underskriften
homeopati	homeopati
ackuschör	ackuschör
förordnandet	förordnandet
finnes	finnes
försvarade	försvarade
ed	ed
underskrifts	underskrifts
anglicism	anglicism
löse	löse
rörmokares	rörmokares
energikälla	energikälla
äppelmos	äppelmos
tillfrisknade	tillfrisknade
Israel	Israel
saker	saker
bagerier	bagerier
Om	Om
vilde	vilde
lavarnas	lavarnas
främmandes	främmandes
protestera	protestera
efterfrågans	efterfrågans
viljen	viljen
upplys	upplys
predikades	predikades
bortkastat	bortkastat
förehava	förehava
öre	öre
Son	Son
utsläckes	utsläckes
våte	våte
singlas	singlas
stöta	stöta
kinesens	kinesens
ackumuleras	ackumuleras
affint	affint
sabbat	sabbat
massakern	massakern
leverera	leverera
förbytes	förbytes
gjorda	gjorda
vifta	vifta
uppmana	uppmana
ketonerna	ketonerna
räknestickors	räknestickors
nonanet	nonanet
fören	fören
vattna	vattna
lagade	lagade
ringmuskels	ringmuskels
musikinstrument	musikinstrument
stötte	stötte
debattören	debattören
bortkastad	bortkastad
kattdjuret	kattdjuret
Både	Både
skattmästarna	skattmästarna
konstartens	konstartens
buren	buren
duad	duad
rycke	rycke
handläggs	handläggs
Jotam	Jotam
prokrastinera	prokrastinera
marinbiologers	marinbiologers
fortfara	fortfara
justitiekanslerns	justitiekanslerns
mitokondriers	mitokondriers
depå	depå
ringfingret	ringfingret
fritös	fritös
vävstol	vävstol
ospontane	ospontane
förfärade	förfärade
fungerade	fungerade
slakt	slakt
fästes	fästes
doktorsexamens	doktorsexamens
utforsken	utforsken
indiskorna	indiskorna
bältets	bältets
kilarna	kilarna
förkunnen	förkunnen
Kabul	Kabul
ställda	ställda
årsfester	årsfester
upptäcktsresa	upptäcktsresa
väns	väns
tage	tage
transaktionerna	transaktionerna
renade	renade
ene	ene
spåra	spåra
avsats	avsats
jeeparnas	jeeparnas
ursprungskällans	ursprungskällans
ryggsäckens	ryggsäckens
kirrande	kirrande
klövens	klövens
förödes	förödes
frälsare	frälsare
hembära	hembära
ordlistors	ordlistors
bakgrundsstrålnings	bakgrundsstrålnings
flögo	flögo
förtrycken	förtrycken
racingbanors	racingbanors
dämpare	dämpare
släckt	släckt
krigarna	krigarna
matlagning	matlagning
spotten	spotten
Nea	Nea
Betuel	Betuel
vattnades	vattnades
ax	ax
förströdde	förströdde
ute	ute
efor	efor
utföras	utföras
asbestens	asbestens
Sereds	Sereds
derivatorna	derivatorna
kaoset	kaoset
godtyckliga	godtyckliga
hämnas	hämnas
dricke	dricke
Josef	Josef
ekar	ekar
betrodde	betrodde
förtvivla	förtvivla
bergfinkars	bergfinkars
bilagt	bilagt
bedrivne	bedrivne
åkerstycken	åkerstycken
gasta	gasta
Massas	Massas
utökades	utökades
dräps	dräps
beställs	beställs
hotfull	hotfull
förspel	förspel
öppnades	öppnades
underskattad	underskattad
förlike	förlike
satsa	satsa
Jerusalem	Jerusalem
spanjorers	spanjorers
radianer	radianer
våldsverkares	våldsverkares
sjudande	sjudande
stjälen	stjälen
tänker	tänker
gifte	gifte
föröken	föröken
sedvänjor	sedvänjor
bud	bud
drängen	drängen
klätt	klätt
ställt	ställt
utlyst	utlyst
förda	förda
sörgårdsidyllen	sörgårdsidyllen
släkte	släkte
morgonsoffas	morgonsoffas
spridd	spridd
Meribas	Meribas
trängde	trängde
rövas	rövas
fylld	fylld
Abiram	Abiram
bortförde	bortförde
upphäves	upphäves
Hebron	Hebron
fläkt	fläkt
redaktionssekreteraren	redaktionssekreteraren
qvadrats	qvadrats
galleriorna	galleriorna
svavelvätes	svavelvätes
smides	smides
dödsfallet	dödsfallet
minskar	minskar
läkt	läkt
utgöra	utgöra
grumlen	grumlen
moder	moder
jagas	jagas
bifloderna	bifloderna
byttan	byttan
fostrade	fostrade
åran	åran
rötter	rötter
knarka	knarka
sälja	sälja
tänkt	tänkt
förvånade	förvånade
justerande	justerande
kos	kos
maakatéer	maakatéer
departementssekreterare	departementssekreterare
förgiftade	förgiftade
kolumnbredd	kolumnbredd
trakasserat	trakasserat
Vars	Vars
löst	löst
trampade	trampade
Abirams	Abirams
anställdes	anställdes
lovade	lovade
bordas	bordas
seende	seende
plågas	plågas
pluskvamperfekten	pluskvamperfekten
stödstrumpors	stödstrumpors
berömde	berömde
deister	deister
årorna	årorna
gileaditernas	gileaditernas
meter	meter
departementsråd	departementsråd
renades	renades
Hul	Hul
höre	höre
lidandes	lidandes
drucken	drucken
som	som
domänerna	domänerna
spenderas	spenderas
vinterdäckets	vinterdäckets
tillredes	tillredes
dödande	dödande
vattnade	vattnade
utsträcks	utsträcks
vinklande	vinklande
första	första
skänke	skänke
yrkesutövningen	yrkesutövningen
sornas	sornas
undantaget	undantaget
sexpacks	sexpacks
ögonglobers	ögonglobers
könskromosomernas	könskromosomernas
återbesökets	återbesökets
sändes	sändes
trängd	trängd
alkoholismens	alkoholismens
håla	håla
manlige	manlige
store	store
gräto	gräto
Jeremia	Jeremia
lokaliserades	lokaliserades
snärjas	snärjas
tiger	tiger
länder	länder
ejder	ejder
sambands	sambands
förras	förras
vänd	vänd
vet	vet
ässen	ässen
bot	bot
tunga	tunga
hör	hör
ledarsidorna	ledarsidorna
sänds	sänds
förhandlar	förhandlar
godtycklige	godtycklige
slickepinnar	slickepinnar
slås	slås
stötas	stötas
bagateller	bagateller
radavståndet	radavståndet
Eliesers	Eliesers
Tala	Tala
beröm	beröm
borstars	borstars
determinanter	determinanter
Iskariots	Iskariots
inbärgat	inbärgat
signalement	signalement
klistrande	klistrande
tryckte	tryckte
kålrots	kålrots
tillfrisknat	tillfrisknat
framsäte	framsäte
bröade	bröade
äta	äta
filatelister	filatelister
spenderar	spenderar
affin	affin
hjorts	hjorts
adelssläkt	adelssläkt
brödet	brödet
beträden	beträden
utspelad	utspelad
steningar	steningar
dräpes	dräpes
livstids	livstids
bröder	bröder
vin	vin
svängts	svängts
doktriners	doktriners
ystades	ystades
förvarar	förvarar
utpantat	utpantat
malströmmarna	malströmmarna
vaken	vaken
Kedars	Kedars
födas	födas
deltaga	deltaga
egyptologis	egyptologis
friköpt	friköpt
hyresvärd	hyresvärd
frisörens	frisörens
dirigistiske	dirigistiske
läka	läka
uppfyllda	uppfyllda
ås	ås
framsäten	framsäten
delat	delat
barnbördshuset	barnbördshuset
övrigt	övrigt
lämpande	lämpande
riksantikvarien	riksantikvarien
höghjulingarna	höghjulingarna
hjälpsamma	hjälpsamma
fackverk	fackverk
hacka	hacka
öppnade	öppnade
värden	värden
dragna	dragna
färgbild	färgbild
distributive	distributive
betecknat	betecknat
stänga	stänga
uppgives	uppgives
påbuden	påbuden
Judas	Judas
atomfysik	atomfysik
dragen	dragen
bereda	bereda
Salem	Salem
hoppas	hoppas
Amminadabs	Amminadabs
Lotan	Lotan
Gamaliel	Gamaliel
Akan	Akan
bildsidor	bildsidor
viskas	viskas
ansade	ansade
oxiderande	oxiderande
rodnat	rodnat
höghjuling	höghjuling
eskimåer	eskimåer
Ava	Ava
blottade	blottade
cyklotroners	cyklotroners
metansyra	metansyra
blinda	blinda
underskattat	underskattat
druckna	druckna
Nod	Nod
brus	brus
sabbaterna	sabbaterna
örlogsskolor	örlogsskolor
Satan	Satan
departementssekreterarens	departementssekreterarens
skilda	skilda
utplånande	utplånande
skjuls	skjuls
källingars	källingars
täcken	täcken
sandades	sandades
klon	klon
städer	städer
sköten	sköten
silverbägarna	silverbägarna
uppstånden	uppstånden
hövdingdömet	hövdingdömet
maskulinet	maskulinet
invig	invig
Sem	Sem
utsläckt	utsläckt
nedgjorda	nedgjorda
skrymtade	skrymtade
lysa	lysa
mötes	mötes
sjöslag	sjöslag
köksöars	köksöars
signalementet	signalementet
getingars	getingars
vetet	vetet
sticka	sticka
drogens	drogens
uppgiva	uppgiva
bräde	bräde
partistyrelserna	partistyrelserna
marinbiologs	marinbiologs
sågade	sågade
Noa	Noa
borrats	borrats
klöven	klöven
råds	råds
Laban	Laban
samfunds	samfunds
epistel	epistel
Dans	Dans
gräslöken	gräslöken
ondast	ondast
beteckna	beteckna
diss	diss
utstött	utstött
återstod	återstod
förenas	förenas
Leviatans	Leviatans
året	året
dateras	dateras
förehaves	förehaves
Undan	Undan
bars	bars
grindarna	grindarna
platås	platås
bevisande	bevisande
höj	höj
steningen	steningen
värde	värde
funne	funne
räcken	räcken
låga	låga
förmörkas	förmörkas
rödhaken	rödhaken
åkerstycke	åkerstycke
sädesledaren	sädesledaren
synds	synds
trumpetare	trumpetare
Talar	Talar
vis	vis
veten	veten
sexpackets	sexpackets
duande	duande
täcka	täcka
akvarellmålares	akvarellmålares
terroriserande	terroriserande
terosens	terosens
utsträckt	utsträckt
hitlistornas	hitlistornas
aqvedukt	aqvedukt
Johanna	Johanna
bjöden	bjöden
utfördes	utfördes
departementschefers	departementschefers
vattenplanings	vattenplanings
traditionelle	traditionelle
förfrågans	förfrågans
indoktrinera	indoktrinera
upplag	upplag
ösregnens	ösregnens
utrotades	utrotades
pila	pila
gör	gör
rike	rike
störes	störes
höljas	höljas
talat	talat
frambäres	frambäres
kullar	kullar
förtryckare	förtryckare
misshandlar	misshandlar
dieseln	dieseln
Benjamins	Benjamins
avlagda	avlagda
skötte	skötte
tröghet	tröghet
vida	vida
hålen	hålen
sutenören	sutenören
Jerikos	Jerikos
hämmas	hämmas
tig	tig
Satans	Satans
lyste	lyste
föra	föra
gestaltning	gestaltning
omgiven	omgiven
röva	röva
bedrövas	bedrövas
bäste	bäste
hyresnämnderna	hyresnämnderna
rödingars	rödingars
sköter	sköter
blotten	blotten
inne	inne
tröstare	tröstare
väljen	väljen
joniske	joniske
kommunikations	kommunikations
rövade	rövade
bakhålls	bakhålls
förhärligade	förhärligade
återlämnande	återlämnande
förnimma	förnimma
lärda	lärda
myste	myste
arkivrådens	arkivrådens
punktlista	punktlista
stånd	stånd
Asas	Asas
samma	samma
fästenas	fästenas
hören	hören
Balaks	Balaks
kokosnöts	kokosnöts
dövt	dövt
rumäner	rumäner
leksak	leksak
holländsk	holländsk
ettstrukne	ettstrukne
cerebrospinalvätska	cerebrospinalvätska
orenen	orenen
ministerium	ministerium
tjäne	tjäne
råda	råda
raggmunk	raggmunk
visas	visas
åklagar	åklagar
panteisters	panteisters
Mana	Mana
sänka	sänka
återbesöken	återbesöken
ringe	ringe
rättfärdigade	rättfärdigade
värme	värme
höljes	höljes
hakens	hakens
jagad	jagad
uppfyllen	uppfyllen
dukat	dukat
infiltreras	infiltreras
krokodilen	krokodilen
förgjordes	förgjordes
gravvårdarnas	gravvårdarnas
rötternas	rötternas
fallen	fallen
plommonen	plommonen
vittnesbördets	vittnesbördets
egyptiers	egyptiers
höje	höje
sprängmedel	sprängmedel
urladdningars	urladdningars
tänkares	tänkares
jordreforms	jordreforms
källingen	källingen
inrätta	inrätta
backarna	backarna
svängdes	svängdes
buds	buds
passusens	passusens
förstörare	förstörare
Natans	Natans
ringfinger	ringfinger
berömda	berömda
Urias	Urias
anklagades	anklagades
licentiats	licentiats
konstarter	konstarter
borrar	borrar
skrapa	skrapa
avhålle	avhålle
kolonisters	kolonisters
lagades	lagades
berömmande	berömmande
Juda	Juda
skilt	skilt
vandrade	vandrade
delgrupperna	delgrupperna
tunnbrödsrullen	tunnbrödsrullen
anklagade	anklagade
klappade	klappade
uppsatta	uppsatta
vittna	vittna
törsta	törsta
centralafrikan	centralafrikan
utrote	utrote
begravde	begravde
betryckta	betryckta
fjättras	fjättras
fadern	fadern
påve	påve
notställ	notställ
beredda	beredda
mjölksyras	mjölksyras
Simons	Simons
vätt	vätt
slaktet	slaktet
stickas	stickas
Asaf	Asaf
företaga	företaga
tackade	tackade
dubbelklicka	dubbelklicka
tillgänglighet	tillgänglighet
siste	siste
kines	kines
äppelträden	äppelträden
bajskorvarna	bajskorvarna
Jason	Jason
tvivlande	tvivlande
förgjorda	förgjorda
getingarna	getingarna
gångjärn	gångjärn
spelpjäserna	spelpjäserna
dessas	dessas
eds	eds
paketera	paketera
tacka	tacka
örlogsskolas	örlogsskolas
överser	överser
marinbiologin	marinbiologin
strida	strida
övriga	övriga
Bera	Bera
soven	soven
fogat	fogat
domän	domän
amma	amma
kaktus	kaktus
räkor	räkor
Efron	Efron
kontrasterar	kontrasterar
skämtsamt	skämtsamt
altruistisk	altruistisk
Joktan	Joktan
grossen	grossen
fördöma	fördöma
hurudana	hurudana
lider	lider
ambassadsekreterare	ambassadsekreterare
möttes	möttes
stjärntydarna	stjärntydarna
föreställas	föreställas
massakerns	massakerns
talen	talen
rättvisan	rättvisan
afrikanskan	afrikanskan
femöring	femöring
lärare	lärare
hämnare	hämnare
dugande	dugande
borgarens	borgarens
orterna	orterna
bröas	bröas
fatte	fatte
sänkt	sänkt
utstöta	utstöta
murare	murare
vitt	vitt
verklighets	verklighets
till	till
pluskvamperfekt	pluskvamperfekt
böjt	böjt
Milkas	Milkas
slaktades	slaktades
tågade	tågade
församlade	församlade
villkoren	villkoren
bjude	bjude
eldgaffel	eldgaffel
vant	vant
Abel	Abel
göras	göras
tyglas	tyglas
kommandoknappar	kommandoknappar
manade	manade
inbärgning	inbärgning
pack	pack
bereder	bereder
antikvarien	antikvarien
nynorskans	nynorskans
sökts	sökts
tränga	tränga
oren	oren
San	San
gäspar	gäspar
förtryckta	förtryckta
hjälpt	hjälpt
väckt	väckt
socialförsäkringsministrar	socialförsäkringsministrar
droppat	droppat
förnimmen	förnimmen
renat	renat
firad	firad
budbärarna	budbärarna
råka	råka
gudsfruktans	gudsfruktans
vingarnas	vingarnas
stadiers	stadiers
förgäte	förgäte
löpare	löpare
röding	röding
skapade	skapade
upptändes	upptändes
utgjordes	utgjordes
fostrades	fostrades
amperena	amperena
Egypten	Egypten
slidans	slidans
byrådirektören	byrådirektören
Amaleks	Amaleks
dukades	dukades
skrymtarna	skrymtarna
lexikografiska	lexikografiska
samme	samme
redigeringskrig	redigeringskrig
frisörers	frisörers
defenestrerat	defenestrerat
betrycktes	betrycktes
stupa	stupa
kapitalisternas	kapitalisternas
oxidationstalet	oxidationstalet
arglistighet	arglistighet
dråp	dråp
uppförd	uppförd
arglistig	arglistig
förödda	förödda
antänder	antänder
twittra	twittra
Ada	Ada
utsändande	utsändande
värdemängds	värdemängds
armen	armen
fat	fat
förena	förena
mods	mods
upptaga	upptaga
X-kromosom	X-kromosom
broders	broders
stadsstadgan	stadsstadgan
sväljen	sväljen
Datans	Datans
episteln	episteln
Amminadab	Amminadab
grymmare	grymmare
bryggkaffet	bryggkaffet
våldsverkare	våldsverkare
skilde	skilde
upptänts	upptänts
levande	levande
kokande	kokande
mittpunkten	mittpunkten
Eder	Eder
inrättat	inrättat
retronym	retronym
censor	censor
upphävande	upphävande
terrorismens	terrorismens
platåerna	platåerna
böjs	böjs
uppfödd	uppfödd
offras	offras
förtövades	förtövades
utbuden	utbuden
Arbas	Arbas
draksegel	draksegel
Susan	Susan
Moab	Moab
släckes	släckes
inramningen	inramningen
jugoslaviskorna	jugoslaviskorna
överraskas	överraskas
respekterades	respekterades
nejs	nejs
lydelse	lydelse
domänens	domänens
signera	signera
diskuterats	diskuterats
namnars	namnars
Sisak	Sisak
drype	drype
rustningars	rustningars
ihågkomma	ihågkomma
lägg	lägg
golfklubbs	golfklubbs
Jair	Jair
beskärda	beskärda
tensorns	tensorns
utroten	utroten
ödmjuke	ödmjuke
övrigas	övrigas
förlitat	förlitat
kombinerade	kombinerade
lönnmördas	lönnmördas
Dianas	Dianas
Gera	Gera
krondiken	krondiken
pilsners	pilsners
Isaks	Isaks
fördragen	fördragen
flickväns	flickväns
påbuds	påbuds
atomfysikens	atomfysikens
mitokondries	mitokondries
berömts	berömts
Rebecka	Rebecka
väges	väges
begravt	begravt
peruanen	peruanen
högskolelags	högskolelags
givare	givare
Kanaans	Kanaans
gräte	gräte
grundämnet	grundämnet
socialförsäkringsministers	socialförsäkringsministers
resecheckens	resecheckens
uppfylle	uppfylle
hemsöka	hemsöka
murarnas	murarnas
dräptes	dräptes
Ut	Ut
cypriotiska	cypriotiska
Rahabs	Rahabs
spenderande	spenderande
beryll	beryll
trätt	trätt
bestänkt	bestänkt
halshuggande	halshuggande
kommunicera	kommunicera
förskräckes	förskräckes
kuf	kuf
handla	handla
rymdfysiks	rymdfysiks
stjäla	stjäla
noggranne	noggranne
rörmokaren	rörmokaren
tillhörande	tillhörande
vila	vila
röres	röres
oxe	oxe
assisterade	assisterade
polera	polera
säga	säga
frågen	frågen
döpes	döpes
fordran	fordran
övergive	övergive
snuten	snuten
Gehennas	Gehennas
sport	sport
förliten	förliten
kontrabasens	kontrabasens
ösregns	ösregns
sitta	sitta
vända	vända
ystats	ystats
förstår	förstår
anfalla	anfalla
dementeras	dementeras
magsmärta	magsmärta
behöves	behöves
frambär	frambär
hos	hos
dräpa	dräpa
fordras	fordras
saltstången	saltstången
fjäderbrickans	fjäderbrickans
länders	länders
blankstegen	blankstegen
assisterad	assisterad
mala	mala
nittondels	nittondels
satte	satte
ond	ond
Tamars	Tamars
åtnjuta	åtnjuta
vitsars	vitsars
Högste	Högste
kedjehusets	kedjehusets
kartografisk	kartografisk
ekobrott	ekobrott
ungkarlens	ungkarlens
elektriciteten	elektriciteten
betar	betar
skådade	skådade
finne	finne
koordinatsystemets	koordinatsystemets
nobelpristagares	nobelpristagares
brunne	brunne
radiostationen	radiostationen
bestå	bestå
patentera	patentera
döm	döm
granden	granden
Manasse	Manasse
könskromosom	könskromosom
Rebeckas	Rebeckas
qvald	qvald
nämner	nämner
infiltrerades	infiltrerades
sökas	sökas
flyttas	flyttas
sanerade	sanerade
svala	svala
specialtecknets	specialtecknets
kolgruvan	kolgruvan
jämt	jämt
burna	burna
arkivariens	arkivariens
Lemek	Lemek
lägga	lägga
växt	växt
snören	snören
det	det
stativ	stativ
tyngste	tyngste
klövs	klövs
förtryckas	förtryckas
längtan	längtan
olla	olla
Akbor	Akbor
intellektuella	intellektuella
vårdar	vårdar
förmörkat	förmörkat
utfärdas	utfärdas
penningkistorna	penningkistorna
bollklubb	bollklubb
elverken	elverken
utfärdad	utfärdad
rättshaverist	rättshaverist
nyanseras	nyanseras
bestämmer	bestämmer
ställde	ställde
Tamar	Tamar
seds	seds
chiffers	chiffers
bosatte	bosatte
utpantning	utpantning
diskuteras	diskuteras
klämdagar	klämdagar
skalärprodukter	skalärprodukter
slagares	slagares
pennalen	pennalen
Sans	Sans
ödmjuk	ödmjuk
överblickat	överblickat
tjäna	tjäna
välkomnad	välkomnad
avståndet	avståndet
inrättande	inrättande
släppe	släppe
Nebajots	Nebajots
förvarade	förvarade
långtradares	långtradares
uddarna	uddarna
höra	höra
förfäras	förfäras
vägs	vägs
barnbördshus	barnbördshus
förkunnats	förkunnats
överlever	överlever
nödgas	nödgas
tagna	tagna
vanärade	vanärade
finländaren	finländaren
embarkeringskortens	embarkeringskortens
Jorams	Jorams
Ahabs	Ahabs
satta	satta
upplöses	upplöses
patrullerar	patrullerar
bered	bered
barrträd	barrträd
Efraim	Efraim
sådana	sådana
a-kassa	a-kassa
suspensoarens	suspensoarens
lycka	lycka
förkunnare	förkunnare
täcktes	täcktes
övergivna	övergivna
kvaddas	kvaddas
konvoluts	konvoluts
bränn	bränn
gömma	gömma
ansiktes	ansiktes
mögs	mögs
attackerar	attackerar
vissna	vissna
fördömda	fördömda
sälje	sälje
borgaren	borgaren
bevisad	bevisad
Denne	Denne
förmörkade	förmörkade
kommuteras	kommuteras
ring	ring
bön	bön
Berea	Berea
nynorskan	nynorskan
Ners	Ners
fordrades	fordrades
man	man
David	David
Jasons	Jasons
deltagande	deltagande
Hulda	Hulda
berömma	berömma
ripjaktens	ripjaktens
Jonatan	Jonatan
departementschefens	departementschefens
domarna	domarna
märkt	märkt
förskräckt	förskräckt
släppt	släppt
taga	taga
pråmars	pråmars
bevise	bevise
stänka	stänka
narkomanens	narkomanens
ort	ort
göden	göden
Akas	Akas
bortförda	bortförda
upphöja	upphöja
Ute	Ute
Kedar	Kedar
hons	hons
konungadömens	konungadömens
avgasrörets	avgasrörets
Ren	Ren
halsband	halsband
under	under
accenterna	accenterna
Sadok	Sadok
såddes	såddes
utplåna	utplåna
citronsyran	citronsyran
insamlade	insamlade
tyckes	tyckes
uppgivna	uppgivna
falla	falla
kläckts	kläckts
underavdelningarnas	underavdelningarnas
lära	lära
finskors	finskors
rappad	rappad
Jedutuns	Jedutuns
kommunikationers	kommunikationers
sänd	sänd
format	format
bilfärja	bilfärja
laman	laman
gäckas	gäckas
fagotts	fagotts
upplåten	upplåten
slakta	slakta
anticyklons	anticyklons
gruvstolparnas	gruvstolparnas
comebackerna	comebackerna
ringaren	ringaren
världsmästaren	världsmästaren
återbesök	återbesök
skärva	skärva
drängs	drängs
tillgiven	tillgiven
cabbarna	cabbarna
ringarna	ringarna
förstods	förstods
vars	vars
tankar	tankar
läroverket	läroverket
övertäcka	övertäcka
Abraham	Abraham
förunne	förunne
regentens	regentens
klistra	klistra
partistyrelses	partistyrelses
oxen	oxen
vattnar	vattnar
ödmjuka	ödmjuka
Hiskias	Hiskias
brandväggar	brandväggar
läsen	läsen
än	än
tävlingsbanors	tävlingsbanors
dyrkad	dyrkad
händelsehorisonten	händelsehorisonten
Tagen	Tagen
snöret	snöret
uppsatte	uppsatte
forskningsbiblioteks	forskningsbiblioteks
blöte	blöte
utbjudande	utbjudande
holländska	holländska
snedstrecks	snedstrecks
vinylskivornas	vinylskivornas
affine	affine
smälte	smälte
korsfästs	korsfästs
skänka	skänka
frätas	frätas
konservburks	konservburks
fästens	fästens
markörerna	markörerna
ingen	ingen
uträckte	uträckte
skymmas	skymmas
Abida	Abida
koret	koret
arbetskamrat	arbetskamrat
byrådirektörernas	byrådirektörernas
bära	bära
fanfaronads	fanfaronads
yngste	yngste
utforskade	utforskade
beskärde	beskärde
Naftali	Naftali
mödade	mödade
isotonens	isotonens
krokodilers	krokodilers
höres	höres
rekommenderade	rekommenderade
befordrans	befordrans
Anatot	Anatot
beten	beten
oxars	oxars
accent	accent
killingar	killingar
bilägger	bilägger
lurarnas	lurarnas
skjul	skjul
budbärare	budbärare
etiopier	etiopier
prokrastinerande	prokrastinerande
Sikem	Sikem
omdefinierades	omdefinierades
lur	lur
tillreds	tillreds
upplöser	upplöser
Gad	Gad
utbjuda	utbjuda
pubarna	pubarna
fångade	fångade
kolväten	kolväten
eldgaffelns	eldgaffelns
repmånader	repmånader
lame	lame
Joram	Joram
kortslutande	kortslutande
Aten	Aten
renad	renad
Meraris	Meraris
fiskar	fiskar
Sköna	Sköna
preliminärskatt	preliminärskatt
preliminäre	preliminäre
innan	innan
homeopatis	homeopatis
Akaja	Akaja
begynde	begynde
cellulosanitrats	cellulosanitrats
argentinskans	argentinskans
Aran	Aran
klämdag	klämdag
vits	vits
inbärgen	inbärgen
substansens	substansens
uppfylles	uppfylles
byråkratiskt	byråkratiskt
provisoriers	provisoriers
uttagningars	uttagningars
centralafrikaners	centralafrikaners
konsortier	konsortier
morgonsofforna	morgonsofforna
klämdagarna	klämdagarna
inbärgar	inbärgar
förtälja	förtälja
förståndets	förståndets
doktrins	doktrins
flöge	flöge
benämns	benämns
snara	snara
tungas	tungas
äggulans	äggulans
uppfödde	uppfödde
budet	budet
byråassistenterna	byråassistenterna
plusteckens	plusteckens
kraftkabels	kraftkabels
näpna	näpna
ljudlös	ljudlös
eftersträvas	eftersträvas
Absaloms	Absaloms
Libanon	Libanon
kompilerats	kompilerats
spårade	spårade
Meriba	Meriba
beviset	beviset
ruinerande	ruinerande
rikes	rikes
korn	korn
lägsta	lägsta
slutlige	slutlige
skildes	skildes
glänsa	glänsa
tillgängliggörs	tillgängliggörs
formeln	formeln
citrusfrukters	citrusfrukters
utvandrade	utvandrade
länsledningens	länsledningens
handläggas	handläggas
smide	smide
asgarvande	asgarvande
förbliva	förbliva
visade	visade
ventilers	ventilers
tillgängliggjord	tillgängliggjord
skrymtare	skrymtare
vaka	vaka
korna	korna
Kanaan	Kanaan
kloner	kloner
ungdomsförbund	ungdomsförbund
kapitalisterna	kapitalisterna
spisoffrets	spisoffrets
skrinlägger	skrinlägger
jublande	jublande
utrotade	utrotade
bevarade	bevarade
kulminerar	kulminerar
sädesledarens	sädesledarens
stekt	stekt
Milka	Milka
könsnormer	könsnormer
adelssläktens	adelssläktens
hälsa	hälsa
saknade	saknade
förödande	förödande
väljarnas	väljarnas
åskvädrens	åskvädrens
Fadern	Fadern
Elisas	Elisas
uträcken	uträcken
munskänken	munskänken
lugg	lugg
Jesajas	Jesajas
indoktrineringen	indoktrineringen
fogar	fogar
viktige	viktige
utför	utför
beträda	beträda
sörgårdsidyllers	sörgårdsidyllers
fyllt	fyllt
glänsande	glänsande
höjes	höjes
reklamationen	reklamationen
avtagne	avtagne
bildordbokens	bildordbokens
gårdsplanens	gårdsplanens
lögnprofeternas	lögnprofeternas
åker	åker
udd	udd
vinge	vinge
nitälsken	nitälsken
glada	glada
Saras	Saras
åttondelar	åttondelar
spridde	spridde
äppelträdet	äppelträdet
citronsyrans	citronsyrans
villkor	villkor
tvivla	tvivla
väta	väta
hålles	hålles
våld	våld
dömda	dömda
önskningarna	önskningarna
västliga	västliga
förfara	förfara
skarpt	skarpt
överdomstolen	överdomstolen
tystades	tystades
färgbildernas	färgbildernas
bereds	bereds
savat	savat
mons	mons
felfortplantningen	felfortplantningen
pärlugglorna	pärlugglorna
skugga	skugga
stickmyggor	stickmyggor
reduktions	reduktions
doktorsgraders	doktorsgraders
stadgar	stadgar
prissummas	prissummas
äga	äga
travarna	travarna
avskilda	avskilda
hålla	hålla
rovets	rovets
clowneri	clowneri
versionerna	versionerna
basta	basta
återlämnats	återlämnats
eolsharpor	eolsharpor
bildsidan	bildsidan
kursfordrans	kursfordrans
nitälskan	nitälskan
gruvstolpar	gruvstolpar
fallera	fallera
Beten	Beten
förkunnar	förkunnar
bageriers	bageriers
födde	födde
luftmassan	luftmassan
tålmodiga	tålmodiga
given	given
kläck	kläck
mätta	mätta
tjugofemöringarna	tjugofemöringarna
skilts	skilts
isotoner	isotoner
eder	eder
Hesrons	Hesrons
fördelaktig	fördelaktig
utgjord	utgjord
mäter	mäter
beskrivningsspråken	beskrivningsspråken
gömda	gömda
hurudan	hurudan
smädare	smädare
Esau	Esau
gräten	gräten
automatiska	automatiska
Jesaja	Jesaja
mårkorna	mårkorna
dalarna	dalarna
institutionelle	institutionelle
segra	segra
nattduksbordets	nattduksbordets
kraftkabeln	kraftkabeln
mysterier	mysterier
förvaltare	förvaltare
fotgängaren	fotgängaren
vindhåls	vindhåls
lutade	lutade
upphöjen	upphöjen
försvarare	försvarare
vakar	vakar
stiftades	stiftades
snöres	snöres
mysande	mysande
många	många
saltstångs	saltstångs
försonats	försonats
öppnen	öppnen
höljets	höljets
spände	spände
provisorierna	provisorierna
hot	hot
löpa	löpa
vinrankans	vinrankans
tills	tills
platserna	platserna
täckt	täckt
hjälpa	hjälpa
somt	somt
utfärdades	utfärdades
leksakerna	leksakerna
böjes	böjes
additionerna	additionerna
fordrande	fordrande
davnas	davnas
bara	bara
selleri	selleri
spända	spända
filial	filial
fritösers	fritösers
syndarna	syndarna
sto	sto
lösdriverskas	lösdriverskas
roande	roande
såren	såren
musikallåt	musikallåt
nittondelar	nittondelar
linets	linets
kutad	kutad
faders	faders
hat	hat
cichliders	cichliders
ockupationen	ockupationen
nonan	nonan
blåmes	blåmes
dolda	dolda
betänkte	betänkte
korsförhöret	korsförhöret
isters	isters
Seras	Seras
höjen	höjen
intrången	intrången
minimera	minimera
delade	delade
svordomars	svordomars
stärkas	stärkas
åter	åter
de	de
blindas	blindas
förkunnas	förkunnas
duka	duka
samvetena	samvetena
samlen	samlen
avlägsna	avlägsna
mätt	mätt
stjärtars	stjärtars
rastades	rastades
Gileads	Gileads
trigonometrin	trigonometrin
konfiskerad	konfiskerad
Geras	Geras
öra	öra
betäcka	betäcka
vakade	vakade
Labans	Labans
kokades	kokades
läger	läger
lever	lever
pudels	pudels
doktorands	doktorands
skämtsamme	skämtsamme
kämpad	kämpad
ena	ena
världsmästarna	världsmästarna
fiskmaten	fiskmaten
svälja	svälja
beta	beta
annat	annat
ryggsims	ryggsims
arbetade	arbetade
vilddjuret	vilddjuret
mister	mister
förlöst	förlöst
mustascherna	mustascherna
tankarna	tankarna
säljare	säljare
passusar	passusar
mötas	mötas
Denna	Denna
ytterörats	ytterörats
muskedundren	muskedundren
fakulteternas	fakulteternas
bortförd	bortförd
springare	springare
utarmande	utarmande
tog	tog
vederkvickt	vederkvickt
Sebaot	Sebaot
Jo	Jo
tystande	tystande
lägges	lägges
utbytena	utbytena
stänkes	stänkes
gendrivande	gendrivande
bröar	bröar
morfism	morfism
ösa	ösa
Johanans	Johanans
uppföda	uppföda
armes	armes
återstodo	återstodo
rötmånadernas	rötmånadernas
accelerationens	accelerationens
glidyta	glidyta
behövs	behövs
rannsaken	rannsaken
tjeckiskorna	tjeckiskorna
allegorier	allegorier
Ner	Ner
råder	råder
kvitteras	kvitteras
upptagen	upptagen
Jakobs	Jakobs
fyll	fyll
torkarnas	torkarnas
slungade	slungade
flädermärgskulors	flädermärgskulors
bräderna	bräderna
Faders	Faders
slaktas	slaktas
gränserna	gränserna
förtövande	förtövande
Alls	Alls
värmebehandlar	värmebehandlar
sjöds	sjöds
framstegen	framstegen
avbärgat	avbärgat
piercingars	piercingars
borra	borra
falle	falle
pagens	pagens
vattnas	vattnas
finansmarknadens	finansmarknadens
like	like
betalen	betalen
telegrafis	telegrafis
namnens	namnens
sälj	sälj
vann	vann
transporterande	transporterande
surdegarna	surdegarna
utsträcka	utsträcka
kronprins	kronprins
kröner	kröner
viken	viken
anrättas	anrättas
reta	reta
Lemeks	Lemeks
bin	bin
tillkommelsens	tillkommelsens
dräpe	dräpe
korsfästande	korsfästande
fåtölj	fåtölj
tänk	tänk
svågern	svågern
byrådirektör	byrådirektör
misshandlas	misshandlas
borras	borras
våldsverkarna	våldsverkarna
planeras	planeras
kulsprutor	kulsprutor
existentiellt	existentiellt
Sjustjärnorna	Sjustjärnorna
galningarna	galningarna
höjningars	höjningars
annex	annex
sväng	sväng
gånge	gånge
satsar	satsar
Sin	Sin
släcka	släcka
stadgas	stadgas
utgiftstaken	utgiftstaken
vägrade	vägrade
arbetare	arbetare
stört	stört
beställningsarbetes	beställningsarbetes
avsatserna	avsatserna
dementerad	dementerad
Fallen	Fallen
kränkt	kränkt
nallens	nallens
stenat	stenat
småländska	småländska
rena	rena
tvillingars	tvillingars
Salome	Salome
disponerad	disponerad
inga	inga
länsledningar	länsledningar
antänt	antänt
förstörd	förstörd
blidkad	blidkad
fordra	fordra
undersökt	undersökt
göre	göre
korskrankens	korskrankens
vidlyftig	vidlyftig
ispravniken	ispravniken
antimaterias	antimaterias
småländskan	småländskan
bridges	bridges
stötes	stötes
Assurs	Assurs
sanera	sanera
Davids	Davids
fira	fira
kortslutas	kortslutas
muggen	muggen
lärd	lärd
upptage	upptage
upptända	upptända
säges	säges
Husas	Husas
bronsmedaljer	bronsmedaljer
omgiva	omgiva
antydde	antydde
dennas	dennas
barntårs	barntårs
sålda	sålda
öppnande	öppnande
driva	driva
fullbordade	fullbordade
skotskt	skotskt
Eva	Eva
gileaditer	gileaditer
Rubens	Rubens
spejade	spejade
lövträdet	lövträdet
avbärgade	avbärgade
linjekartans	linjekartans
elektricitet	elektricitet
förlitar	förlitar
bastat	bastat
mon	mon
vänt	vänt
barkas	barkas
utbredde	utbredde
omsluta	omsluta
sedvänja	sedvänja
webbplatser	webbplatser
blidkas	blidkas
assisterar	assisterar
Dan	Dan
vattenplaningen	vattenplaningen
musikliv	musikliv
undkomma	undkomma
upplösande	upplösande
hjärta	hjärta
förvånas	förvånas
utgörande	utgörande
limpans	limpans
Anak	Anak
Inga	Inga
gångerna	gångerna
slätt	slätt
höjningar	höjningar
tillreda	tillreda
duga	duga
hals	hals
leven	leven
hämtats	hämtats
löses	löses
rättvisans	rättvisans
borrmaskinens	borrmaskinens
småviltet	småviltet
kommande	kommande
dödades	dödades
råkade	råkade
Ingen	Ingen
ansad	ansad
emigreras	emigreras
huggen	huggen
årtusendena	årtusendena
fäste	fäste
tröstade	tröstade
läggen	läggen
betäckas	betäckas
anklagare	anklagare
gudsfruktan	gudsfruktan
oskadliggjorde	oskadliggjorde
lärde	lärde
gallerior	gallerior
kysst	kysst
brassades	brassades
bergfinken	bergfinken
stärka	stärka
studium	studium
gemaket	gemaket
antändande	antändande
filtren	filtren
statsbudgetar	statsbudgetar
anklagen	anklagen
tågades	tågades
lidande	lidande
retas	retas
retronymens	retronymens
tågas	tågas
närstående	närstående
stenhuggare	stenhuggare
Salems	Salems
vandrarna	vandrarna
Mose	Mose
odjurets	odjurets
bröderna	bröderna
uppfylla	uppfylla
ställd	ställd
krockars	krockars
åtgärdsbedömningar	åtgärdsbedömningar
laotiskans	laotiskans
presenning	presenning
blotta	blotta
index	index
hämtar	hämtar
nöjt	nöjt
fiskades	fiskades
bevarades	bevarades
eskimåernas	eskimåernas
driven	driven
hoppade	hoppade
ockrare	ockrare
tänkte	tänkte
pennvässares	pennvässares
anklaga	anklaga
edens	edens
använda	använda
bovs	bovs
teros	teros
ordstävets	ordstävets
näpsa	näpsa
Betuels	Betuels
Simon	Simon
Vakna	Vakna
Edom	Edom
svänger	svänger
falsifierade	falsifierade
förgäta	förgäta
docerade	docerade
fördömd	fördömd
rest	rest
Anatots	Anatots
Assur	Assur
blåst	blåst
sexhörningars	sexhörningars
terapeuter	terapeuter
restaurerades	restaurerades
terroristen	terroristen
bytas	bytas
knyta	knyta
mångfacetterat	mångfacetterat
kombinerat	kombinerat
bindes	bindes
rådande	rådande
infogad	infogad
dömes	dömes
flyttar	flyttar
bromspedalen	bromspedalen
finansmarknaderna	finansmarknaderna
köpa	köpa
fattades	fattades
daterat	daterat
fontänerna	fontänerna
Lod	Lod
stadgen	stadgen
inrikesministeriums	inrikesministeriums
följande	följande
släktena	släktena
åttiondelars	åttiondelars
böja	böja
nära	nära
holonym	holonym
substrat	substrat
Vare	Vare
Sådana	Sådana
skött	skött
snigel	snigel
femörings	femörings
kuddars	kuddars
efterfrågan	efterfrågan
konfigurerande	konfigurerande
konverterades	konverterades
kommutativ	kommutativ
brunbjörnarna	brunbjörnarna
mat	mat
regleringsbrevets	regleringsbrevets
döda	döda
mandatet	mandatet
badade	badade
rödhakars	rödhakars
sedens	sedens
läge	läge
baltisk	baltisk
skänkt	skänkt
systerson	systerson
uppröres	uppröres
inramningars	inramningars
räkornas	räkornas
jonisk	jonisk
Assyriens	Assyriens
vakansers	vakansers
retirerat	retirerat
Mahalalel	Mahalalel
öga	öga
minnes	minnes
den	den
suddar	suddar
justitieministrar	justitieministrar
ofta	ofta
bakhåll	bakhåll
fullbordan	fullbordan
vanära	vanära
asgarvar	asgarvar
givandets	givandets
vittnande	vittnande
denna	denna
kon	kon
varde	varde
mårkor	mårkor
svastikornas	svastikornas
söks	söks
pelarna	pelarna
leden	leden
bådas	bådas
uzbekerna	uzbekerna
åskvädren	åskvädren
föreställ	föreställ
besatte	besatte
volten	volten
fotoners	fotoners
tystad	tystad
gravvårdars	gravvårdars
inropen	inropen
radian	radian
fattar	fattar
historiska	historiska
läst	läst
trädstammens	trädstammens
hinder	hinder
uppläsa	uppläsa
Edens	Edens
mana	mana
gifta	gifta
rannsakas	rannsakas
rötterna	rötterna
Sera	Sera
altares	altares
äggulors	äggulors
Josefs	Josefs
gladas	gladas
låter	låter
mött	mött
smaragders	smaragders
slagverkares	slagverkares
inträffa	inträffa
fördärvare	fördärvare
domäns	domäns
kräftor	kräftor
dukade	dukade
fördärvades	fördärvades
släktens	släktens
bägarna	bägarna
vara	vara
stärk	stärk
ockra	ockra
ispravniks	ispravniks
skottdagen	skottdagen
betale	betale
fetmas	fetmas
federationer	federationer
matlagningen	matlagningen
kruciverbisten	kruciverbisten
No	No
hugga	hugga
yla	yla
fördärvade	fördärvade
såge	såge
vilka	vilka
uppvärmning	uppvärmning
Tabor	Tabor
tjänen	tjänen
ost	ost
erövrade	erövrade
klövarna	klövarna
arbetsveckorna	arbetsveckorna
massförstörelsevapen	massförstörelsevapen
sjukt	sjukt
inbärga	inbärga
ekobrottet	ekobrottet
befälhavarna	befälhavarna
ljudlöse	ljudlöse
sån	sån
avbildades	avbildades
gelés	gelés
född	född
oändlig	oändlig
elektronhjärnas	elektronhjärnas
ögonglobs	ögonglobs
smyckena	smyckena
upptagnast	upptagnast
jugoslaviskor	jugoslaviskor
författningen	författningen
systersonen	systersonen
surjektionen	surjektionen
mysteriums	mysteriums
obegränsae	obegränsae
äggula	äggula
HERRENs	HERRENs
fras	fras
gångar	gångar
köpt	köpt
rekommenderat	rekommenderat
samlas	samlas
Serubbabel	Serubbabel
nominerat	nominerat
luffarnas	luffarnas
ryka	ryka
stadsbiblioteks	stadsbiblioteks
hövdingdöme	hövdingdöme
hämma	hämma
obetalbar	obetalbar
åskådar	åskådar
förordnandenas	förordnandenas
fakultet	fakultet
grundämne	grundämne
vise	vise
lagstiftningens	lagstiftningens
valrossars	valrossars
ordstäv	ordstäv
förundren	förundren
ansikte	ansikte
planterade	planterade
ansedde	ansedde
gifts	gifts
kvaddar	kvaddar
upplåta	upplåta
statschefers	statschefers
polisbyrås	polisbyrås
seendes	seendes
antropologins	antropologins
förstöra	förstöra
bollklubbens	bollklubbens
trombs	trombs
lin	lin
gårdsplaner	gårdsplaner
käre	käre
stycken	stycken
Fourierserier	Fourierserier
vedergäll	vedergäll
blidkats	blidkats
maskrosen	maskrosen
efterfölja	efterfölja
krönt	krönt
uppenbarades	uppenbarades
clowneriet	clowneriet
vattenkonsts	vattenkonsts
licentiaten	licentiaten
såld	såld
fört	fört
företagen	företagen
lögnprofeterna	lögnprofeterna
bevis	bevis
sårande	sårande
arkiverad	arkiverad
förlät	förlät
örtagårdar	örtagårdar
stiga	stiga
byta	byta
dyrkar	dyrkar
högskolestyrelses	högskolestyrelses
Res	Res
uppenbarande	uppenbarande
övergåvo	övergåvo
erövrare	erövrare
X-kromosomens	X-kromosomens
oxarnas	oxarnas
justitiekanslerer	justitiekanslerer
friköpa	friköpa
Samuel	Samuel
Jotams	Jotams
tumnagel	tumnagel
kejsarens	kejsarens
gångjärnens	gångjärnens
bärare	bärare
Seirs	Seirs
vit	vit
Bekers	Bekers
själva	själva
förlika	förlika
löjtnanten	löjtnanten
öknamn	öknamn
exponerad	exponerad
utfören	utfören
fördömde	fördömde
dräpen	dräpen
böjde	böjde
smittskydd	smittskydd
stickade	stickade
korsfästes	korsfästes
lagstiftningar	lagstiftningar
malströmmar	malströmmar
cykloheptanets	cykloheptanets
strids	strids
rötmånaders	rötmånaders
hjärtas	hjärtas
oxar	oxar
lokaliserad	lokaliserad
upplösas	upplösas
Ars	Ars
tigits	tigits
patrullerats	patrullerats
mättas	mättas
bukar	bukar
förtrycka	förtrycka
bröades	bröades
mördande	mördande
Rahab	Rahab
fackverket	fackverket
kuddes	kuddes
sida	sida
byråassistents	byråassistents
muggar	muggar
Dessa	Dessa
Asa	Asa
upptäcks	upptäcks
beskriver	beskriver
förenklad	förenklad
matchen	matchen
Arabien	Arabien
blåsa	blåsa
additionens	additionens
räta	räta
läsa	läsa
Salma	Salma
dyrkas	dyrkas
formade	formade
mark	mark
delgrupp	delgrupp
försonade	försonade
Jeremias	Jeremias
spanjorens	spanjorens
svågers	svågers
besök	besök
göres	göres
expanderade	expanderade
beställde	beställde
spottade	spottade
fågelskådarnas	fågelskådarnas
skriftlig	skriftlig
berövade	berövade
interagera	interagera
kutar	kutar
hjärtat	hjärtat
flytt	flytt
legitimitetens	legitimitetens
lysande	lysande
fegisens	fegisens
uteslöts	uteslöts
undantagen	undantagen
snedstreck	snedstreck
säker	säker
vävstolens	vävstolens
möjliggjordes	möjliggjordes
hörda	hörda
pressade	pressade
räknestickans	räknestickans
skickad	skickad
åskväder	åskväder
användande	användande
hedersbetygelsens	hedersbetygelsens
pages	pages
Mahalalels	Mahalalels
katalansk	katalansk
Goa	Goa
kristadelfians	kristadelfians
inmatningsfältet	inmatningsfältet
ögonhålornas	ögonhålornas
kela	kela
lösts	lösts
fraser	fraser
nöjer	nöjer
maskros	maskros
omstruktureras	omstruktureras
knackas	knackas
bindas	bindas
kompletteras	kompletteras
Massa	Massa
koka	koka
utrönt	utrönt
års	års
bägare	bägare
spanjorerna	spanjorerna
koncentrationerna	koncentrationerna
silverbägare	silverbägare
fint	fint
nedgjorde	nedgjorde
enslinjerna	enslinjerna
Libanons	Libanons
fördärven	fördärven
träd	träd
manliga	manliga
Vaken	Vaken
säkrar	säkrar
förstörde	förstörde
frågade	frågade
kantrad	kantrad
bruke	bruke
stridsmedels	stridsmedels
stimuleras	stimuleras
preliminär	preliminär
utsläcka	utsläcka
Akbors	Akbors
Leas	Leas
Johanan	Johanan
