lüftet	lüftet
posierst	posierst
Atemgas	Atemgas
Bunde	Bunde
Monarchie	Monarchie
annektierst	annektierst
Wirtschaftswissenschaft	Wirtschaftswissenschaft
begehrst	begehrst
querest	querest
beschrifte	beschrifte
billigte	billigte
Esset	Esset
Adamsapfel	Adamsapfel
Prostylos	Prostylos
Möbelstoffen	Möbelstoffen
Reinelemente	Reinelemente
Sitzfleisch	Sitzfleisch
seien	seien
Gebeinen	Gebeinen
einigst	einigst
Äxten	Äxten
baggerst	baggerst
verdunstet	verdunstet
durchwacht	durchwacht
flöteten	flöteten
Maxima	Maxima
anzeige	anzeige
aufwachte	aufwachte
erlauben	erlauben
könnte	könnte
dissentierte	dissentierte
Auguren	Auguren
bewahrheitete	bewahrheitete
zertifiziertest	zertifiziertest
verderben	verderben
transportierten	transportierten
interagierte	interagierte
Rheumatismus	Rheumatismus
schaue	schaue
Apfelbäumen	Apfelbäumen
verwiesen	verwiesen
Kadavergehorsam	Kadavergehorsam
feierten	feierten
replizierten	replizierten
rangierst	rangierst
zittertest	zittertest
amenagierst	amenagierst
Wehklagen	Wehklagen
erkalten	erkalten
rinnt	rinnt
Vergrößerungen	Vergrößerungen
aßest	aßest
Zehe	Zehe
Desserts	Desserts
Hallelujas	Hallelujas
besehet	besehet
Seehechten	Seehechten
Meinst	Meinst
Huflattich	Huflattich
Denn	Denn
seht	seht
Zwangsarbeiterin	Zwangsarbeiterin
Prozeduren	Prozeduren
Safrane	Safrane
Farbstoffe	Farbstoffe
Epoxiden	Epoxiden
Deck	Deck
missversteht	missversteht
sintertest	sintertest
kaufte	kaufte
heiße	heiße
finanzieret	finanzieret
verdrehet	verdrehet
verstrahlet	verstrahlet
übet	übet
blondieren	blondieren
schwächst	schwächst
gähnten	gähnten
Kardinäle	Kardinäle
Schau	Schau
rundet	rundet
Teekesseln	Teekesseln
öle	öle
Haarshampoos	Haarshampoos
schöpfte	schöpfte
Marokkaners	Marokkaners
Alkali	Alkali
Laufringen	Laufringen
säet	säet
verleumdetest	verleumdetest
zeichnest	zeichnest
verbasele	verbasele
revoltieren	revoltieren
schmettern	schmettern
Rutheniumkomplex	Rutheniumkomplex
Beine	Beine
duckmäusere	duckmäusere
watete	watete
Zeugnissen	Zeugnissen
imkernd	imkernd
ungehorsame	ungehorsame
verschlingt	verschlingt
Gipfeltreffen	Gipfeltreffen
Maut	Maut
besprichst	besprichst
verselbständigst	verselbständigst
Zur-Schau-Stellen	Zur-Schau-Stellen
straften	straften
stürzen	stürzen
versteckten	versteckten
grünet	grünet
polymerisierte	polymerisierte
berücksichtiget	berücksichtiget
kühl	kühl
Kleinoden	Kleinoden
Kriegsenden	Kriegsenden
speiest	speiest
kitzeln	kitzeln
Früchten	Früchten
erniedrigt	erniedrigt
Fellachinnen	Fellachinnen
kasernierte	kasernierte
imprägnieret	imprägnieret
Mischelementen	Mischelementen
strafend	strafend
wähnt	wähnt
filzst	filzst
Alkine	Alkine
verschlungen	verschlungen
Werkzeuge	Werkzeuge
blondierten	blondierten
anfingst	anfingst
sorge	sorge
Oberlippe	Oberlippe
Gigapascaln	Gigapascaln
gehorchst	gehorchst
optimierte	optimierte
verführtest	verführtest
Eisstein	Eisstein
wollten	wollten
austilge	austilge
verwirft	verwirft
knackt	knackt
flambiert	flambiert
pflegte	pflegte
tote	tote
Höschen	Höschen
Brieföffner	Brieföffner
sondern	sondern
Haltepunkt	Haltepunkt
Grenze	Grenze
Flöße	Flöße
Gerät	Gerät
ziehet	ziehet
wirfst	wirfst
zerbrichst	zerbrichst
Krume	Krume
trauerten	trauerten
evakuierte	evakuierte
Füchsen	Füchsen
Türkis	Türkis
schlafest	schlafest
Ausstiegstüren	Ausstiegstüren
beschert	beschert
Zipfelmütze	Zipfelmütze
Drohkulissen	Drohkulissen
Wiederauferstehung	Wiederauferstehung
schiebest	schiebest
gefügt	gefügt
Meter	Meter
Recitativ	Recitativ
zwänget	zwänget
behalte	behalte
Mops	Mops
glänzen	glänzen
Chinakohl	Chinakohl
führet	führet
Abschreckung	Abschreckung
Acetaten	Acetaten
Bettlers	Bettlers
überführen	überführen
Barschaften	Barschaften
Füllfederhalter	Füllfederhalter
Abfertigungsschalters	Abfertigungsschalters
inhalierest	inhalierest
verkündigest	verkündigest
angehöre	angehöre
fern	fern
Spitze	Spitze
Entrées	Entrées
bewieset	bewieset
kapiert	kapiert
Thioacetal	Thioacetal
tanzen	tanzen
Kompromissen	Kompromissen
Zähnen	Zähnen
dingt	dingt
Effekt	Effekt
frappierte	frappierte
Homodimere	Homodimere
Schlöte	Schlöte
gezählt	gezählt
streiften	streiften
suchst	suchst
Zöpfen	Zöpfen
Herabsetzung	Herabsetzung
zählte	zählte
Augengläsern	Augengläsern
glänzt	glänzt
Mensch	Mensch
betätigtet	betätigtet
verbündete	verbündete
Mittelaltermarkt	Mittelaltermarkt
Anfängern	Anfängern
lausche	lausche
schenkte	schenkte
Habe	Habe
Präservativen	Präservativen
Weihen	Weihen
Indianer	Indianer
schließt	schließt
vierten	vierten
Schläge	Schläge
Pferden	Pferden
innere	innere
stelle	stelle
Zirkelschlüssen	Zirkelschlüssen
Pflaume	Pflaume
ausgerecktem	ausgerecktem
Sabbate	Sabbate
Schaffnerinnen	Schaffnerinnen
verprügelet	verprügelet
Cyclodextrinen	Cyclodextrinen
Zitronensäften	Zitronensäften
lancierst	lancierst
aufkommen	aufkommen
amen	amen
Held	Held
Gefängnisse	Gefängnisse
Haltepunkten	Haltepunkten
Strohhälmchen	Strohhälmchen
kürzt	kürzt
Vorstädte	Vorstädte
seufzest	seufzest
grabe	grabe
Sphäre	Sphäre
Gedränge	Gedränge
Palme	Palme
dressierten	dressierten
errötest	errötest
verwechsele	verwechsele
Wurzelwachstum	Wurzelwachstum
substituierest	substituierest
Weile	Weile
Steiget	Steiget
Knechte	Knechte
gerne	gerne
bringst	bringst
strafen	strafen
attestiertet	attestiertet
Geliebten	Geliebten
Rhabarber	Rhabarber
Zehnt	Zehnt
Lautwandeln	Lautwandeln
weise	weise
Agoraphobien	Agoraphobien
Wehe	Wehe
Adeliepinguin	Adeliepinguin
bedingst	bedingst
verringeret	verringeret
vertreibt	vertreibt
Atommasse	Atommasse
verkapselten	verkapselten
trinkest	trinkest
Solch	Solch
Einöde	Einöde
folgend	folgend
kremieren	kremieren
Schiffe	Schiffe
Epiker	Epiker
Päderast	Päderast
schichteten	schichteten
ziehest	ziehest
verkapselt	verkapselt
Schulleiterin	Schulleiterin
Schal	Schal
Lötzinn	Lötzinn
kommst	kommst
Hadithe	Hadithe
Pfählen	Pfählen
beneidete	beneidete
hinterfragst	hinterfragst
Ringen	Ringen
funktionierte	funktionierte
wehte	wehte
wohnst	wohnst
mein	mein
Milchflasche	Milchflasche
beäugen	beäugen
schälte	schälte
eskaliert	eskaliert
berufen	berufen
zürnet	zürnet
verladet	verladet
grabbelten	grabbelten
Anhängsel	Anhängsel
Riesen	Riesen
steigerten	steigerten
Essigsäurechloriden	Essigsäurechloriden
wirst	wirst
notlandet	notlandet
Sexten	Sexten
klickte	klickte
brauste	brauste
Wegen	Wegen
Zement	Zement
gestalten	gestalten
Wiedergutmachung	Wiedergutmachung
überstehst	überstehst
schnelle	schnelle
wilden	wilden
Mönchen	Mönchen
Ein	Ein
Leset	Leset
Hörst	Hörst
wachen	wachen
transportierte	transportierte
Gallan	Gallan
deaktiviere	deaktiviere
schnell	schnell
kategorisierst	kategorisierst
ringelten	ringelten
plissiere	plissiere
gelangen	gelangen
schau	schau
Kontaktierungen	Kontaktierungen
eher	eher
zerschlagt	zerschlagt
halbierte	halbierte
überreichend	überreichend
schweigst	schweigst
bewürben	bewürben
leuchten	leuchten
kommest	kommest
gestikulierst	gestikulierst
entsetzten	entsetzten
bekennt	bekennt
fasset	fasset
blondiert	blondiert
Stämme	Stämme
produzierte	produzierte
deckte	deckte
brillierest	brillierest
Bildpunkt	Bildpunkt
betrübe	betrübe
installierten	installierten
Aufsätzen	Aufsätzen
überdenkest	überdenkest
belüftete	belüftete
Sitzfleisches	Sitzfleisches
widerlegte	widerlegte
pilgerte	pilgerte
hupet	hupet
entsündigten	entsündigten
blast	blast
dotierst	dotierst
binden	binden
Helden	Helden
Abfertigungsgebäude	Abfertigungsgebäude
Unwahrheiten	Unwahrheiten
Piratensendern	Piratensendern
beschottre	beschottre
Märchenbüchern	Märchenbüchern
schenkst	schenkst
beschottert	beschottert
Steige	Steige
Fadenlauf	Fadenlauf
liege	liege
markiere	markiere
Klotz	Klotz
verrostet	verrostet
Weiblein	Weiblein
bewährt	bewährt
Muster	Muster
opfern	opfern
Briketten	Briketten
aufheben	aufheben
Teppichen	Teppichen
Ochse	Ochse
Bleche	Bleche
Junge	Junge
rüstetet	rüstetet
säuselest	säuselest
Hadith	Hadith
sahet	sahet
Carbids	Carbids
Selbstversuche	Selbstversuche
quietschest	quietschest
Gase	Gase
liebst	liebst
ernte	ernte
beantrage	beantrage
zuhört	zuhört
Indianern	Indianern
stellen	stellen
zwang	zwang
Sabbatjahr	Sabbatjahr
tragen	tragen
löse	löse
unehrt	unehrt
rüstete	rüstete
geraten	geraten
motivieren	motivieren
linken	linken
thematisierten	thematisierten
motivierte	motivierte
Futtermittel	Futtermittel
Besprechungen	Besprechungen
verblute	verblute
danket	danket
Ingredienzen	Ingredienzen
überschattete	überschattete
Gemüt	Gemüt
Pflanzenwachstum	Pflanzenwachstum
Kautschuken	Kautschuken
hebräische	hebräische
trinkst	trinkst
erwürgest	erwürgest
Tyrann	Tyrann
Streichen	Streichen
gewinnet	gewinnet
lehrst	lehrst
Gesamtmengen	Gesamtmengen
zweite	zweite
appellierte	appellierte
Ausnahme	Ausnahme
Retter	Retter
Dominicanerinnen	Dominicanerinnen
sprühend	sprühend
konvertiere	konvertiere
sündigt	sündigt
streite	streite
oxidierst	oxidierst
Eutern	Eutern
eggt	eggt
glauben	glauben
habet	habet
Vordenker	Vordenker
eines	eines
Stadtbezirken	Stadtbezirken
Reiseleitern	Reiseleitern
Kommet	Kommet
prophezeie	prophezeie
Halleluja	Halleluja
assimilierte	assimilierte
Verwundeten	Verwundeten
klagen	klagen
Ärgernisse	Ärgernisse
ertraget	ertraget
Mitwisserschaft	Mitwisserschaft
Gammastrahlen	Gammastrahlen
herrschst	herrschst
Haben	Haben
schlabberten	schlabberten
Überweisung	Überweisung
entflieht	entflieht
verdeckt	verdeckt
mehret	mehret
gründe	gründe
gebäre	gebäre
Puffersystemen	Puffersystemen
unterstützten	unterstützten
Hälmchen	Hälmchen
Anwendungsgebiet	Anwendungsgebiet
Technikerinnen	Technikerinnen
Schauen	Schauen
Stätten	Stätten
zählend	zählend
Märkten	Märkten
erzwangt	erzwangt
Gegenleistung	Gegenleistung
zierte	zierte
reimte	reimte
loben	loben
Kürass	Kürass
Aerosolen	Aerosolen
fremde	fremde
Gebeine	Gebeine
Sternen	Sternen
Geflecktheiten	Geflecktheiten
Anachronismen	Anachronismen
Werte	Werte
trüb	trüb
konsolidierest	konsolidierest
respektierten	respektierten
bewahret	bewahret
folterst	folterst
verständige	verständige
elfte	elfte
Plumpse	Plumpse
raffinier	raffinier
interpretierten	interpretierten
transportiere	transportiere
Verwaltungsakten	Verwaltungsakten
überlebest	überlebest
erst	erst
Gefängnissen	Gefängnissen
Abflug	Abflug
Membran	Membran
verdammst	verdammst
Libellen	Libellen
Wiederbelebung	Wiederbelebung
strömte	strömte
überdächte	überdächte
Platte	Platte
verderbest	verderbest
besicheret	besicheret
Rutheniumkomplexen	Rutheniumkomplexen
Korrosionsschutzen	Korrosionsschutzen
Anfechtungen	Anfechtungen
Reiseleiter	Reiseleiter
spielte	spielte
griechisch	griechisch
vertilge	vertilge
verführe	verführe
gratuliere	gratuliere
Fetten	Fetten
Keile	Keile
kupiert	kupiert
Ställen	Ställen
brauchte	brauchte
Geschreis	Geschreis
Bärenfelle	Bärenfelle
gebäret	gebäret
Nährmediums	Nährmediums
wässerten	wässerten
Crescendo	Crescendo
ehren	ehren
Efeu	Efeu
Langzeichen	Langzeichen
ermächtige	ermächtige
Herrn	Herrn
dringt	dringt
Campingplatzes	Campingplatzes
Adlerbussard	Adlerbussard
Beschleuniger	Beschleuniger
stille	stille
erfahrest	erfahrest
überschatteten	überschatteten
haderte	haderte
steckst	steckst
kauerten	kauerten
löste	löste
Seetaucher	Seetaucher
Quellen	Quellen
fluche	fluche
Amen	Amen
referenzierte	referenzierte
kontaktiere	kontaktiere
durchwachen	durchwachen
kühlen	kühlen
speise	speise
stäupte	stäupte
schmuggelte	schmuggelte
Herkunft	Herkunft
verklagst	verklagst
Zeitungsente	Zeitungsente
beantragt	beantragt
lehrte	lehrte
nagelest	nagelest
lögen	lögen
jappen	jappen
Baisers	Baisers
überdenkst	überdenkst
verlaß	verlaß
halltet	halltet
vergrabest	vergrabest
liehe	liehe
ersparten	ersparten
Gebete	Gebete
addierest	addierest
Paradiesäpfeln	Paradiesäpfeln
Backenbärten	Backenbärten
Wiedergutmachungen	Wiedergutmachungen
umarbeitest	umarbeitest
besichtiget	besichtiget
grünte	grünte
Fluorkohlenwasserstoffe	Fluorkohlenwasserstoffe
Kindergeldern	Kindergeldern
Genie	Genie
bereuest	bereuest
Laubbaum	Laubbaum
Türkenbünden	Türkenbünden
Alltag	Alltag
drücke	drücke
verfängt	verfängt
dampfte	dampfte
ertönst	ertönst
suche	suche
nachwandelt	nachwandelt
Pfleglinge	Pfleglinge
lügst	lügst
Astat	Astat
Herzchen	Herzchen
Strontiumamalgams	Strontiumamalgams
konvertieren	konvertieren
gedachtest	gedachtest
webet	webet
Schanktisch	Schanktisch
malen	malen
stiftete	stiftete
porträtiert	porträtiert
grauten	grauten
extemporiere	extemporiere
Entsetzen	Entsetzen
Fremdwörter	Fremdwörter
Mäuse	Mäuse
Flenser	Flenser
misstrauen	misstrauen
Feste	Feste
blättertet	blättertet
mogelest	mogelest
teile	teile
ansehen	ansehen
Geräte	Geräte
knautsche	knautsche
Kryostat	Kryostat
freiwillige	freiwillige
Haue	Haue
links	links
Gebot	Gebot
Linguisten	Linguisten
traueret	traueret
Organisationen	Organisationen
Fingerspitze	Fingerspitze
zürnten	zürnten
kramst	kramst
ausgehst	ausgehst
Basiliken	Basiliken
schiesst	schiesst
beziehen	beziehen
entsetzte	entsetzte
zerrütteten	zerrütteten
Vipernatter	Vipernatter
Oberbegriff	Oberbegriff
leere	leere
versagt	versagt
leiten	leiten
Ionenaustauscher	Ionenaustauscher
wirft	wirft
betrübt	betrübt
wollest	wollest
Californium	Californium
pflanzt	pflanzt
zürn	zürn
tabuisiert	tabuisiert
steige	steige
Fellhandschuh	Fellhandschuh
protestierest	protestierest
log	log
puddelst	puddelst
Hektare	Hektare
besorg	besorg
gelobst	gelobst
kehre	kehre
mache	mache
vermutest	vermutest
trage	trage
verkürzten	verkürzten
Organisation	Organisation
Stühle	Stühle
Schnarchralle	Schnarchralle
Festen	Festen
Gegebenheiten	Gegebenheiten
Begünstigungen	Begünstigungen
zürne	zürne
trefft	trefft
peilst	peilst
verjährte	verjährte
tragest	tragest
grüßen	grüßen
ermächtigest	ermächtigest
ermutigte	ermutigte
Weinbergen	Weinbergen
vermahnet	vermahnet
konntest	konntest
hängte	hängte
Piratensender	Piratensender
gedächtet	gedächtet
tendiertet	tendiertet
fritieret	fritieret
Funkfeuern	Funkfeuern
hievten	hievten
bemühet	bemühet
verspätest	verspätest
scheuchtest	scheuchtest
sucht	sucht
Abschußringe	Abschußringe
Fallturm	Fallturm
vermutet	vermutet
Adeliepinguins	Adeliepinguins
demütiget	demütiget
Schneider	Schneider
wahre	wahre
planschest	planschest
gelobtet	gelobtet
ausgeht	ausgeht
Kräften	Kräften
dekoriere	dekoriere
Sündern	Sündern
Serverzugriffen	Serverzugriffen
Apfelbäume	Apfelbäume
greife	greife
Keilen	Keilen
Älteste	Älteste
Fällt	Fällt
Kernladungszahl	Kernladungszahl
gelangt	gelangt
erkältete	erkältete
Kupferkiese	Kupferkiese
Putschisten	Putschisten
hebräisch	hebräisch
gehören	gehören
bummeltet	bummeltet
Nanosatellit	Nanosatellit
Schnipsel	Schnipsel
Aussätzige	Aussätzige
Ärgernissen	Ärgernissen
Gasgemischen	Gasgemischen
Gebern	Gebern
grüßte	grüßte
Trinker	Trinker
schäumtest	schäumtest
henket	henket
Einheimische	Einheimische
Tatsachenbeschöniger	Tatsachenbeschöniger
außen	außen
gehorchte	gehorchte
scheiterest	scheiterest
widerrufe	widerrufe
trägt	trägt
pflanzet	pflanzet
NAND-Gatter	NAND-Gatter
verdammet	verdammet
Darlegungen	Darlegungen
beschuldiget	beschuldiget
entsündigte	entsündigte
Plüschtiere	Plüschtiere
blitz	blitz
Raute	Raute
Wucher	Wucher
Leid	Leid
schaut	schaut
Türkenbund	Türkenbund
meißelt	meißelt
sortiert	sortiert
Westen	Westen
Crescendos	Crescendos
erwürgtest	erwürgtest
Tasten	Tasten
restaurierten	restaurierten
dürfest	dürfest
fluchten	fluchten
wenden	wenden
glaubest	glaubest
Sekretärinnen	Sekretärinnen
unterscheide	unterscheide
vertraget	vertraget
greifet	greifet
Schlüchte	Schlüchte
wässerst	wässerst
tyrannisierte	tyrannisierte
Freunden	Freunden
loste	loste
Kriege	Kriege
suchest	suchest
Vorhäuten	Vorhäuten
versteckend	versteckend
Gegebenheit	Gegebenheit
Euter	Euter
entsündigt	entsündigt
bemerket	bemerket
Scheck	Scheck
speicherten	speicherten
benützt	benützt
reichen	reichen
flehst	flehst
schweiget	schweiget
lostet	lostet
Extremen	Extremen
baute	baute
berührt	berührt
aufstehet	aufstehet
schabst	schabst
erpresst	erpresst
absagt	absagt
Königreichen	Königreichen
verwerten	verwerten
entsetzet	entsetzet
Dunkelkammern	Dunkelkammern
Stierkämpfe	Stierkämpfe
reden	reden
verwirfst	verwirfst
ungeistlich	ungeistlich
Schenke	Schenke
Suffix	Suffix
Sprödmetallen	Sprödmetallen
protestieret	protestieret
pflügte	pflügte
belüftet	belüftet
weinen	weinen
begrub	begrub
gehörst	gehörst
manche	manche
Füße	Füße
Armband	Armband
sichten	sichten
Bebauungsplänen	Bebauungsplänen
nippst	nippst
Alterität	Alterität
Operationssälen	Operationssälen
Schlüchten	Schlüchten
regierte	regierte
illustriere	illustriere
Stadtbezirke	Stadtbezirke
Buchfinken	Buchfinken
babbelten	babbelten
Außenministerium	Außenministerium
Untern	Untern
zeiget	zeiget
Unwahrheit	Unwahrheit
Freibrief	Freibrief
Augur	Augur
begehrte	begehrte
Schwermetallionen	Schwermetallionen
vier	vier
kennst	kennst
Beiblätter	Beiblätter
wärt	wärt
eins	eins
schlafe	schlafe
fehlte	fehlte
Großstädtern	Großstädtern
stäupen	stäupen
bemühst	bemühst
verkündige	verkündige
Nukleinsäuren	Nukleinsäuren
schlagt	schlagt
neigest	neigest
Buch	Buch
helfet	helfet
predigtest	predigtest
erschrickst	erschrickst
Pflichten	Pflichten
Leichen	Leichen
buddeln	buddeln
Kuckucken	Kuckucken
Fotosynthese	Fotosynthese
Reizen	Reizen
Martyrologien	Martyrologien
solche	solche
Euphemismen	Euphemismen
moppst	moppst
defragmentierten	defragmentierten
könnt	könnt
Golfplätzen	Golfplätzen
hingehet	hingehet
siegen	siegen
gelang	gelang
ruhte	ruhte
Rechnung	Rechnung
wache	wache
gern	gern
panaschieret	panaschieret
Backpflaumen	Backpflaumen
preisen	preisen
Zwetschgen	Zwetschgen
colorierend	colorierend
Spiralen	Spiralen
Koniferen	Koniferen
Perlen	Perlen
verdränget	verdränget
fromme	fromme
heiß	heiß
Händedruck	Händedruck
schätzte	schätzte
Halbmonden	Halbmonden
urbanisiert	urbanisiert
glaubten	glaubten
verbluteten	verbluteten
wachet	wachet
Gänge	Gänge
verurteile	verurteile
Abkürzungsverzeichnisse	Abkürzungsverzeichnisse
scheucht	scheucht
Unterschlagungen	Unterschlagungen
emendierte	emendierte
frohlockest	frohlockest
Pumpellyiten	Pumpellyiten
stand	stand
Leiste	Leiste
Zeithorizonte	Zeithorizonte
manövrieret	manövrieret
borgte	borgte
Kunstgeschichte	Kunstgeschichte
schläft	schläft
machst	machst
massakrierte	massakrierte
überfällst	überfällst
Räte	Räte
Flammen	Flammen
Einheimischen	Einheimischen
umgaben	umgaben
Hüllenelektronen	Hüllenelektronen
Stiefvater	Stiefvater
Höfe	Höfe
Leuchtstoff	Leuchtstoff
Vorstoß	Vorstoß
verschafft	verschafft
bummelet	bummelet
meine	meine
Ellen	Ellen
Irrtümern	Irrtümern
verbitterest	verbitterest
schwöllen	schwöllen
gravierten	gravierten
Gehorsam	Gehorsam
Halbmond	Halbmond
mißversteht	mißversteht
Videoaufzeichnung	Videoaufzeichnung
Spende	Spende
untertretet	untertretet
Ölspuren	Ölspuren
Spirale	Spirale
pflanzte	pflanzte
Katamaranen	Katamaranen
füsilierte	füsilierte
entständen	entständen
Stühlen	Stühlen
Kaufhäusern	Kaufhäusern
hingehst	hingehst
Uranerz	Uranerz
tyrannisiertest	tyrannisiertest
ehre	ehre
Sprödmetall	Sprödmetall
heile	heile
Vollkornbrot	Vollkornbrot
Spektralbereich	Spektralbereich
verkürzt	verkürzt
besänftigtest	besänftigtest
sabbelten	sabbelten
Ärzte	Ärzte
betrete	betrete
zuhörte	zuhörte
Preisen	Preisen
Einen	Einen
schmuggele	schmuggele
traget	traget
Helmen	Helmen
WebHook	WebHook
sündigte	sündigte
Primärenergie	Primärenergie
brach	brach
Sachen	Sachen
bauest	bauest
plumpsten	plumpsten
Wahnen	Wahnen
hicksest	hicksest
versteckst	versteckst
verwirren	verwirren
verkündigte	verkündigte
Tyrannen	Tyrannen
Kontraindikation	Kontraindikation
trotzt	trotzt
Götzen	Götzen
schwöret	schwöret
bereite	bereite
bekehret	bekehret
schnüren	schnüren
einer	einer
trieb	trieb
Rotgüssen	Rotgüssen
Pinguinen	Pinguinen
Abnahmen	Abnahmen
Atombombe	Atombombe
Kandidaturen	Kandidaturen
reizt	reizt
umgäben	umgäben
fallet	fallet
Gehörst	Gehörst
Golfplatz	Golfplatz
Binden	Binden
evakuieret	evakuieret
neigte	neigte
Samen	Samen
Festons	Festons
faule	faule
Erzherzogshüte	Erzherzogshüte
Unter	Unter
reif	reif
Sportlerinnen	Sportlerinnen
heißet	heißet
wallfahrten	wallfahrten
rännen	rännen
habt	habt
bestellte	bestellte
wechselwirkt	wechselwirkt
widmend	widmend
Telefonverkäufer	Telefonverkäufer
Geschwindigkeitsmessern	Geschwindigkeitsmessern
faschieren	faschieren
Pfeilen	Pfeilen
verachtend	verachtend
Glatteis	Glatteis
schaffte	schaffte
Greyerzern	Greyerzern
Grüßet	Grüßet
Dienstgrad	Dienstgrad
ärgertest	ärgertest
Grab	Grab
schlängelest	schlängelest
griffen	griffen
streutet	streutet
siehst	siehst
entfolgte	entfolgte
scherze	scherze
bestanden	bestanden
brachen	brachen
Däumlingen	Däumlingen
Hummer	Hummer
andere	andere
drillest	drillest
geahnt	geahnt
klone	klone
Wehklage	Wehklage
Dudelsäcken	Dudelsäcken
Obszönität	Obszönität
Dödeln	Dödeln
Schwermetallion	Schwermetallion
stapelten	stapelten
chloroformieret	chloroformieret
negierte	negierte
Schlägen	Schlägen
Sinne	Sinne
haltest	haltest
diesen	diesen
Fischotter	Fischotter
schäumt	schäumt
Spießen	Spießen
Mageninhalten	Mageninhalten
gabelt	gabelt
rühmet	rühmet
ehrest	ehrest
Recitativen	Recitativen
Höret	Höret
liegst	liegst
Frommen	Frommen
moppet	moppet
bezichtigten	bezichtigten
Borkenkäfer	Borkenkäfer
verspätete	verspätete
Zitronensaft	Zitronensaft
Eingeweiden	Eingeweiden
Argentits	Argentits
spaltete	spaltete
preist	preist
Jünglinge	Jünglinge
Verkehrsflugzeuge	Verkehrsflugzeuge
Steuerberatern	Steuerberatern
taten	taten
konnte	konnte
benehme	benehme
producieret	producieret
blätteret	blätteret
Bevölkerungsdichte	Bevölkerungsdichte
Leichnamen	Leichnamen
forschen	forschen
Dithiolan	Dithiolan
Paragraphenreiter	Paragraphenreiter
Version	Version
Malaysierin	Malaysierin
Solcher	Solcher
Gehirnwellen	Gehirnwellen
Füllfederhalters	Füllfederhalters
billigen	billigen
Kühen	Kühen
Sprüchen	Sprüchen
blitzt	blitzt
Managementsystem	Managementsystem
Päckchen	Päckchen
griff	griff
bromiertet	bromiertet
wehrt	wehrt
suchen	suchen
Kontrollboxen	Kontrollboxen
Sonnenfinsternissen	Sonnenfinsternissen
gewitterest	gewitterest
Sippe	Sippe
aufkäme	aufkäme
Trübsalen	Trübsalen
springst	springst
ausziehst	ausziehst
lieget	lieget
mästest	mästest
grüble	grüble
sieht	sieht
aufhobt	aufhobt
Neumonden	Neumonden
gibt	gibt
trödeltest	trödeltest
auflegst	auflegst
besäet	besäet
glühenden	glühenden
Kupferkiesen	Kupferkiesen
Fäuste	Fäuste
weissagst	weissagst
lügen	lügen
Selbstversuchen	Selbstversuchen
Genetikerin	Genetikerin
werten	werten
knüpfen	knüpfen
konsolidierend	konsolidierend
beschotteret	beschotteret
Fischen	Fischen
Däumlings	Däumlings
klettert	klettert
schnürest	schnürest
arrivierst	arrivierst
prostituieret	prostituieret
Gehilfe	Gehilfe
fluktuierte	fluktuierte
Eine	Eine
besitzest	besitzest
tobte	tobte
genieret	genieret
föchte	föchte
Fusseln	Fusseln
grau	grau
Waldbränden	Waldbränden
sehn	sehn
gedacht	gedacht
schummelst	schummelst
wurde	wurde
Bluffs	Bluffs
losen	losen
Letzte	Letzte
Bagger	Bagger
Weiß	Weiß
Republikflucht	Republikflucht
stigmatisierest	stigmatisierest
heparinisierten	heparinisierten
fragen	fragen
entzweiest	entzweiest
Stilllegung	Stilllegung
lockerst	lockerst
Brite	Brite
bezahlest	bezahlest
erhörest	erhörest
bedingten	bedingten
substituierend	substituierend
Würfelspiel	Würfelspiel
beweise	beweise
Nervenzellen	Nervenzellen
pharyngalisierten	pharyngalisierten
begrübe	begrübe
Hie	Hie
kranken	kranken
kräuselten	kräuselten
Wembley-Toren	Wembley-Toren
Hornung	Hornung
strandend	strandend
nippend	nippend
erbringst	erbringst
Aufprall	Aufprall
Fremde	Fremde
Butzemänner	Butzemänner
verabschiedetet	verabschiedetet
preiset	preiset
kaufest	kaufest
vergaste	vergaste
impfst	impfst
schluchze	schluchze
Zwetschge	Zwetschge
Charakteristika	Charakteristika
Schild	Schild
schmuggle	schmuggle
Rechenbrettern	Rechenbrettern
schummelten	schummelten
Reißnagel	Reißnagel
erschütterte	erschütterte
Diebe	Diebe
Ektoplasmen	Ektoplasmen
vertrieb	vertrieb
schießen	schießen
verkleinern	verkleinern
Färsen	Färsen
Oheim	Oheim
verdränge	verdränge
hätte	hätte
verkaufte	verkaufte
standet	standet
Mäusen	Mäusen
Andrologie	Andrologie
Geschichtsbüchern	Geschichtsbüchern
Auszüge	Auszüge
verzehrst	verzehrst
bandagierte	bandagierte
Abschirmungen	Abschirmungen
pulsiert	pulsiert
Urheimaten	Urheimaten
auflegt	auflegt
beeindruckt	beeindruckt
initiierst	initiierst
Notärztin	Notärztin
hüte	hüte
enttäusche	enttäusche
Geldautomaten	Geldautomaten
fünfte	fünfte
lösten	lösten
ehe	ehe
steckte	steckte
Schafen	Schafen
tätowierest	tätowierest
betrieben	betrieben
betrüge	betrüge
harmoniere	harmoniere
Taufe	Taufe
applizirte	applizirte
toten	toten
Achatschnecken	Achatschnecken
bröckeln	bröckeln
Nadelbäume	Nadelbäume
kaserniert	kaserniert
dringst	dringst
speiste	speiste
überweisend	überweisend
Basilikum	Basilikum
Komponistinnen	Komponistinnen
müsse	müsse
ausgereckter	ausgereckter
Bittersüß	Bittersüß
lachen	lachen
haare	haare
Schale	Schale
fistet	fistet
solchen	solchen
veranstaltest	veranstaltest
verwahrst	verwahrst
schmusen	schmusen
schreie	schreie
Aspartame	Aspartame
sitzen	sitzen
Fehlen	Fehlen
Menschenhandel	Menschenhandel
schwängen	schwängen
beunruhigte	beunruhigte
Präservativs	Präservativs
spannte	spannte
zerstückt	zerstückt
notlande	notlande
Woge	Woge
Schilden	Schilden
sterbest	sterbest
Abkömmling	Abkömmling
ruckelst	ruckelst
säusele	säusele
Firnis	Firnis
Krustentier	Krustentier
Irrtumes	Irrtumes
Schiffen	Schiffen
befestigten	befestigten
erwähnet	erwähnet
Schlössern	Schlössern
speisend	speisend
thematisierte	thematisierte
kichert	kichert
enterten	enterten
Laufring	Laufring
fresset	fresset
Abszisse	Abszisse
aber	aber
betrügen	betrügen
Zirkelschluss	Zirkelschluss
Schilde	Schilde
legen	legen
Meeren	Meeren
Excimerlaser	Excimerlaser
wohnet	wohnet
Schneepflügen	Schneepflügen
Notständen	Notständen
haschieret	haschieret
Dreieinigkeit	Dreieinigkeit
Metallspiegel	Metallspiegel
Hektaren	Hektaren
Flossen	Flossen
parliere	parliere
Werdet	Werdet
aufnahmt	aufnahmt
föhnten	föhnten
foppte	foppte
Lusitaner	Lusitaner
Polizeisprecher	Polizeisprecher
verschränken	verschränken
Stoffwechselwegen	Stoffwechselwegen
verzehrt	verzehrt
Landstreichereien	Landstreichereien
dümpelt	dümpelt
Meinet	Meinet
radierte	radierte
Gefügen	Gefügen
Apportierhund	Apportierhund
bereue	bereue
Anfechtung	Anfechtung
verkaufst	verkaufst
griechischen	griechischen
dividiere	dividiere
Sexte	Sexte
Schuhen	Schuhen
tatteret	tatteret
Gummibäumen	Gummibäumen
reicht	reicht
Herkünften	Herkünften
nötigte	nötigte
haben	haben
Rückumlaute	Rückumlaute
möge	möge
Essen	Essen
pflüget	pflüget
entwendete	entwendete
tattert	tattert
Traggasen	Traggasen
Arbeitsunfähigkeit	Arbeitsunfähigkeit
Kürasse	Kürasse
Trioxid	Trioxid
aufhebt	aufhebt
kitzele	kitzele
knistert	knistert
quasselten	quasselten
Hirnstämmen	Hirnstämmen
balkanisierte	balkanisierte
ungehorsam	ungehorsam
Ältesten	Ältesten
Rechenbrett	Rechenbrett
vermeße	vermeße
grünten	grünten
Eutektikum	Eutektikum
kristallisiertest	kristallisiertest
kaufe	kaufe
Reflexionen	Reflexionen
beanspruchte	beanspruchte
tragt	tragt
Zeugen	Zeugen
Lebenskraft	Lebenskraft
Sichelzellenanämien	Sichelzellenanämien
bewässertet	bewässertet
Ahnen	Ahnen
Rutheniumisotopen	Rutheniumisotopen
lohnten	lohnten
entsündigen	entsündigen
dekorieren	dekorieren
zerstreuten	zerstreuten
Altären	Altären
quatschen	quatschen
dich	dich
malten	malten
Trockendock	Trockendock
ausgereckten	ausgereckten
bewiesen	bewiesen
Zuschauer	Zuschauer
Anker	Anker
Lehnen	Lehnen
kämpfen	kämpfen
anzeigest	anzeigest
Apotheose	Apotheose
Aprikosen	Aprikosen
Schwänzchen	Schwänzchen
nützt	nützt
Bestecken	Bestecken
Lunisolarkalender	Lunisolarkalender
blitze	blitze
repräsentieret	repräsentieret
Enden	Enden
backen	backen
Kirgisinnen	Kirgisinnen
Leitkegeln	Leitkegeln
beherrschest	beherrschest
Brötchen	Brötchen
Kleinod	Kleinod
zwängtet	zwängtet
ungeistlichen	ungeistlichen
zeugte	zeugte
zupfte	zupfte
abalieniertest	abalieniertest
Steigen	Steigen
erntete	erntete
heilet	heilet
dringest	dringest
rangieret	rangieret
Türkinnen	Türkinnen
Würfen	Würfen
Steuerwagens	Steuerwagens
brauchst	brauchst
begnügte	begnügte
erzürnst	erzürnst
Ackerschachtelhalme	Ackerschachtelhalme
instanziier	instanziier
entrümpelest	entrümpelest
übte	übte
vielen	vielen
schaffen	schaffen
stoppten	stoppten
verletzt	verletzt
gelobend	gelobend
gespeist	gespeist
Literaturen	Literaturen
lüge	lüge
keulte	keulte
Trichtern	Trichtern
hintertrieben	hintertrieben
aufrichte	aufrichte
trotzest	trotzest
aßet	aßet
herrschet	herrschet
Bällchen	Bällchen
neige	neige
führest	führest
verfinstert	verfinstert
wünschest	wünschest
pflanze	pflanze
beleidige	beleidige
bezahlst	bezahlst
verkleide	verkleide
Dezernaten	Dezernaten
surrst	surrst
Reichweite	Reichweite
Stäben	Stäben
schmuste	schmuste
Hälse	Hälse
scheinest	scheinest
Frettchen	Frettchen
Gibt	Gibt
Firnisse	Firnisse
bescheiße	bescheiße
Fäusten	Fäusten
Tut	Tut
haste	haste
einerntest	einerntest
Brieftaubenzüchter	Brieftaubenzüchter
Gemurmel	Gemurmel
Verbrechen	Verbrechen
Juden	Juden
zuppen	zuppen
Krankenschein	Krankenschein
Pudern	Pudern
sticke	sticke
liebten	liebten
Betainen	Betainen
verwahret	verwahret
emigrieret	emigrieret
Wembley-Tore	Wembley-Tore
Flöte	Flöte
ermutigt	ermutigt
schimmerest	schimmerest
Kaufleuten	Kaufleuten
kramen	kramen
Satzungen	Satzungen
Ausbeutern	Ausbeutern
schwimmst	schwimmst
Bazzit	Bazzit
substituierten	substituierten
filteret	filteret
spezialisiere	spezialisiere
Küsserei	Küsserei
Glauben	Glauben
Mobilfunknetze	Mobilfunknetze
Baiser	Baiser
Membranen	Membranen
Krumen	Krumen
stäupten	stäupten
zanket	zanket
gedächte	gedächte
kabbelnd	kabbelnd
kramten	kramten
ladest	ladest
glawbten	glawbten
enträtselten	enträtselten
attackieren	attackieren
Schlaraffenlandes	Schlaraffenlandes
Falltürme	Falltürme
Malaysierinnen	Malaysierinnen
evaluierten	evaluierten
taufet	taufet
gut	gut
verpufftest	verpufftest
entwaffneten	entwaffneten
Polizeisprechern	Polizeisprechern
Bären	Bären
gewärtigt	gewärtigt
Entmachtungen	Entmachtungen
funzen	funzen
wild	wild
Städte	Städte
gelobten	gelobten
Tiefen	Tiefen
schauest	schauest
Arbeitsbereichen	Arbeitsbereichen
Verkehrsflugzeug	Verkehrsflugzeug
Sterne	Sterne
umhüllt	umhüllt
Vesper	Vesper
empört	empört
Äthern	Äthern
Harpune	Harpune
unschuldige	unschuldige
niemand	niemand
schauspielert	schauspielert
pflügten	pflügten
kehren	kehren
kaufst	kaufst
Schwestern	Schwestern
Einöden	Einöden
treibst	treibst
legte	legte
watet	watet
gute	gute
babbeltet	babbeltet
heiligt	heiligt
Türme	Türme
regierten	regierten
erfüllst	erfüllst
krähen	krähen
Talisman	Talisman
Durchbruches	Durchbruches
wollt	wollt
zuppt	zuppt
Sprichwort	Sprichwort
Urbaren	Urbaren
verkleidete	verkleidete
außer	außer
Toypudel	Toypudel
Pentaboraten	Pentaboraten
benachrichtiget	benachrichtiget
überbewertet	überbewertet
Paragraphenreitern	Paragraphenreitern
erkannten	erkannten
lanciertet	lanciertet
versklavte	versklavte
nachwandelst	nachwandelst
Kompassen	Kompassen
Hehler	Hehler
erschüttere	erschüttere
Sportlerin	Sportlerin
Stücke	Stücke
verreisest	verreisest
Schwärmereien	Schwärmereien
älteste	älteste
verlötest	verlötest
lodertet	lodertet
Wasserbades	Wasserbades
fluppten	fluppten
Ölfässern	Ölfässern
zersetzet	zersetzet
gestattest	gestattest
Füllet	Füllet
Nukleinsäure	Nukleinsäure
Deckenfarbe	Deckenfarbe
süsst	süsst
restaurieret	restaurieret
sortierte	sortierte
Amputierte	Amputierte
Feuerteufel	Feuerteufel
blitzte	blitzte
meinet	meinet
klemmen	klemmen
Mischelement	Mischelement
Schneidern	Schneidern
steigest	steigest
fastetet	fastetet
befestigt	befestigt
Stolze	Stolze
changieren	changieren
schmetterst	schmetterst
laut	laut
behauptest	behauptest
erliegst	erliegst
beläufst	beläufst
Türklingeln	Türklingeln
fastetest	fastetest
zeuge	zeuge
entkämen	entkämen
Introjektion	Introjektion
reinstitutionalisiert	reinstitutionalisiert
Tintenklecks	Tintenklecks
wisperten	wisperten
bemächtigte	bemächtigte
blockiert	blockiert
verstört	verstört
Brüdern	Brüdern
Nagellackentferner	Nagellackentferner
verzeichnete	verzeichnete
googelten	googelten
haarten	haarten
leite	leite
klonet	klonet
Name	Name
Schafe	Schafe
Exzentriker	Exzentriker
Schnallen	Schnallen
Wühltische	Wühltische
Antimusters	Antimusters
Automatikgetrieben	Automatikgetrieben
Bundesgebieten	Bundesgebieten
Heptamolybdat	Heptamolybdat
ertragen	ertragen
ermahnt	ermahnt
kabelte	kabelte
Schlägst	Schlägst
Bademäntel	Bademäntel
Laien	Laien
waren	waren
Falz	Falz
tat	tat
einem	einem
zentrifugieren	zentrifugieren
scheitern	scheitern
verbesserten	verbesserten
hinterfragten	hinterfragten
blitztet	blitztet
Monarchien	Monarchien
anderen	anderen
Dorngesträuchen	Dorngesträuchen
erhebet	erhebet
Solche	Solche
bombardiertet	bombardiertet
Aase	Aase
Zwergschwanes	Zwergschwanes
linsten	linsten
kontaktieret	kontaktieret
Füchse	Füchse
Kurkuma	Kurkuma
Lazarette	Lazarette
hure	hure
Aderhäuten	Aderhäuten
spielen	spielen
Steuerborden	Steuerborden
Holzquirl	Holzquirl
Unterwerfungen	Unterwerfungen
Jagdbomber	Jagdbomber
bleibst	bleibst
Lasten	Lasten
Orgeln	Orgeln
Bankettes	Bankettes
beunruhige	beunruhige
Signal	Signal
Fieberanfall	Fieberanfall
ausrufest	ausrufest
verspielte	verspielte
segmentiere	segmentiere
Kirchhof	Kirchhof
trügen	trügen
späht	späht
höret	höret
Öfchen	Öfchen
Ärzten	Ärzten
heulet	heulet
hättet	hättet
Planern	Planern
säumet	säumet
moppte	moppte
Puffersystem	Puffersystem
Berber	Berber
untersagtest	untersagtest
Trinken	Trinken
vernichtest	vernichtest
Grenzen	Grenzen
Aufsätze	Aufsätze
verklärest	verklärest
gedenket	gedenket
Anliegen	Anliegen
Notstand	Notstand
Ösophagospasmus	Ösophagospasmus
Falle	Falle
duckmäuseret	duckmäuseret
Taufen	Taufen
prahlet	prahlet
filzten	filzten
Knaben	Knaben
verkürztet	verkürztet
Fettsack	Fettsack
schaffet	schaffet
Säcken	Säcken
Pimmel	Pimmel
Als	Als
seufzt	seufzt
Orte	Orte
wichste	wichste
Gaschromatographien	Gaschromatographien
Rehbock	Rehbock
Hinkelstein	Hinkelstein
berühret	berühret
kristallisierest	kristallisierest
hintertreibt	hintertreibt
betrüben	betrüben
frappiere	frappiere
Gehirnwelle	Gehirnwelle
Leuchtstoffen	Leuchtstoffen
Städten	Städten
Aachener	Aachener
hebräischen	hebräischen
Anarchisten	Anarchisten
wehrte	wehrte
unterstützet	unterstützet
Taschendiebe	Taschendiebe
Lenkstange	Lenkstange
umarmen	umarmen
verzweigst	verzweigst
Brettspielen	Brettspielen
beäugst	beäugst
Schreien	Schreien
erkälteten	erkälteten
unterwerfe	unterwerfe
konsumiere	konsumiere
Zebrahaies	Zebrahaies
Mop	Mop
sicherst	sicherst
pilgert	pilgert
wehren	wehren
Seehechte	Seehechte
Landesverräterinnen	Landesverräterinnen
Silbererzen	Silbererzen
bewässerest	bewässerest
gleiche	gleiche
Heiratsgut	Heiratsgut
Bajonette	Bajonette
Weißt	Weißt
berücksichtigt	berücksichtigt
Sprachräumen	Sprachräumen
Hacker	Hacker
kriegte	kriegte
Chelatkomplex	Chelatkomplex
überfischt	überfischt
dampfst	dampfst
Liebchen	Liebchen
Strahlentierchens	Strahlentierchens
höbest	höbest
verlasse	verlasse
laufe	laufe
heiligten	heiligten
Nadel	Nadel
Halte	Halte
Argyroditen	Argyroditen
dressieret	dressieret
torpediert	torpediert
wischt	wischt
Kakadu	Kakadu
kehret	kehret
feierte	feierte
Freitagnachmittagen	Freitagnachmittagen
Referenz	Referenz
Sabbaten	Sabbaten
Aufträgen	Aufträgen
prahlte	prahlte
Mikrometer	Mikrometer
trotze	trotze
Langschwanzpinguin	Langschwanzpinguin
erntet	erntet
Werken	Werken
Minimierungen	Minimierungen
lösen	lösen
Drache	Drache
Stimmen	Stimmen
instrumentalisierest	instrumentalisierest
begleicht	begleicht
aufrichtet	aufrichtet
Gewürze	Gewürze
Aas	Aas
Knöllchens	Knöllchens
Kost	Kost
Gebäck	Gebäck
suchte	suchte
Bienenstöcke	Bienenstöcke
jemand	jemand
stimmte	stimmte
Arsenit	Arsenit
verwirrt	verwirrt
Fellachin	Fellachin
Gammastrahl	Gammastrahl
absagen	absagen
lieb	lieb
Wandergesellen	Wandergesellen
Narkotikum	Narkotikum
Stierkämpfen	Stierkämpfen
würden	würden
Ambiguitäten	Ambiguitäten
Artischocken	Artischocken
Eilande	Eilande
wispern	wispern
Pailletten	Pailletten
Rasterkraftmikroskop	Rasterkraftmikroskop
haarte	haarte
klingt	klingt
Hat	Hat
Minimierung	Minimierung
rechte	rechte
kollidierte	kollidierte
Wolfesgrube	Wolfesgrube
Buchhalterinnen	Buchhalterinnen
ihnen	ihnen
Elementarzellen	Elementarzellen
Silbererze	Silbererze
klumpe	klumpe
Einstufung	Einstufung
verboten	verboten
zerstücken	zerstücken
Dithiolane	Dithiolane
verbitterten	verbitterten
Shortcut	Shortcut
Jochen	Jochen
Linken	Linken
vertrieben	vertrieben
ratschlagen	ratschlagen
jauchzte	jauchzte
Pläsier	Pläsier
gelobt	gelobt
erzeigen	erzeigen
attestierten	attestierten
Kakao	Kakao
liebend	liebend
piesackest	piesackest
spannen	spannen
pflücktet	pflücktet
rächest	rächest
Bleiglanz	Bleiglanz
bleiben	bleiben
Bausch	Bausch
Laufringe	Laufringe
imitiertet	imitiertet
erkaltest	erkaltest
Anfänger	Anfänger
Töpfen	Töpfen
Jungfernflüge	Jungfernflüge
Eissteinen	Eissteinen
vertrauten	vertrauten
Orgel	Orgel
tendierst	tendierst
Einfältigkeiten	Einfältigkeiten
täuschet	täuschet
spaltest	spaltest
sannen	sannen
begrabet	begrabet
Abbindebeschleuniger	Abbindebeschleuniger
Wehr	Wehr
haschiert	haschiert
beschlügen	beschlügen
Krusten	Krusten
Kurkumen	Kurkumen
verkündigten	verkündigten
weinet	weinet
fressen	fressen
abtrünnige	abtrünnige
verließet	verließet
schauten	schauten
Sollten	Sollten
entwischten	entwischten
flucht	flucht
ausführen	ausführen
gare	gare
vermöget	vermöget
Werkzeugen	Werkzeugen
Feldzug	Feldzug
widerstanden	widerstanden
nimmt	nimmt
Lautschriften	Lautschriften
Kerfe	Kerfe
verfanget	verfanget
gebieten	gebieten
setzte	setzte
wohnest	wohnest
verirrt	verirrt
Licht	Licht
häufte	häufte
Futur	Futur
Schicksen	Schicksen
bekehrten	bekehrten
Raucherinnen	Raucherinnen
parfümierte	parfümierte
chloroformiere	chloroformiere
ratschlagt	ratschlagt
Ente	Ente
sinnst	sinnst
finanziere	finanziere
schneidet	schneidet
trompete	trompete
Chlorwasserstoffmoleküls	Chlorwasserstoffmoleküls
Freibergits	Freibergits
hetzte	hetzte
erwärmten	erwärmten
ballaste	ballaste
Großfürsten	Großfürsten
Klüfte	Klüfte
reichet	reichet
meinst	meinst
holte	holte
grüßet	grüßet
Beobachtung	Beobachtung
Nullpunktes	Nullpunktes
Spieße	Spieße
Verwaltungsakte	Verwaltungsakte
Büsche	Büsche
Gasen	Gasen
nähre	nähre
gewurstelt	gewurstelt
Nahrungsbestandteil	Nahrungsbestandteil
Pinguin	Pinguin
Radsätzen	Radsätzen
annektierten	annektierten
heilte	heilte
Rehe	Rehe
Bildschirmfoto	Bildschirmfoto
beteuerest	beteuerest
putzte	putzte
konstatiertest	konstatiertest
Busen	Busen
löset	löset
nähernd	nähernd
Einsatz	Einsatz
wäre	wäre
Fiebermitteln	Fiebermitteln
blende	blende
Apostel	Apostel
Messiassen	Messiassen
bestand	bestand
besitze	besitze
prangest	prangest
begliche	begliche
buddelten	buddelten
Kannen	Kannen
malt	malt
Kohlenstoffgehalten	Kohlenstoffgehalten
aufsteht	aufsteht
hantiert	hantiert
hatten	hatten
unterwirft	unterwirft
Pfründe	Pfründe
Füllfedern	Füllfedern
bekehrte	bekehrte
Kriegsschauplätze	Kriegsschauplätze
schleim	schleim
wachset	wachset
gebühren	gebühren
verberge	verberge
sezierte	sezierte
beleuchte	beleuchte
begrübest	begrübest
versuchest	versuchest
Apportierhunde	Apportierhunde
Kriegsknechte	Kriegsknechte
Last	Last
schlaft	schlaft
verklärt	verklärt
läutetet	läutetet
bewahrt	bewahrt
Same	Same
säte	säte
schaffest	schaffest
Leichname	Leichname
Beziehung	Beziehung
Abschußring	Abschußring
Flamme	Flamme
Treppen	Treppen
balkanisierten	balkanisierten
geliebt	geliebt
verdammte	verdammte
Dorsch	Dorsch
geratest	geratest
Butzemann	Butzemann
Leisten	Leisten
bis	bis
Signalen	Signalen
pulsiere	pulsiere
Böreks	Böreks
Halogenatomen	Halogenatomen
Exilanten	Exilanten
Fußboden	Fußboden
emendieret	emendieret
Tiefschutz	Tiefschutz
wachte	wachte
Mopp	Mopp
welche	welche
addierte	addierte
Technetate	Technetate
übersteht	übersteht
instanziiere	instanziiere
Rosinenkuchenmodell	Rosinenkuchenmodell
entmineralisieret	entmineralisieret
viele	viele
hauen	hauen
knurrt	knurrt
Linguist	Linguist
Videoaufzeichnungen	Videoaufzeichnungen
lös	lös
Stellen	Stellen
Begrenzungen	Begrenzungen
Erdbirnen	Erdbirnen
obfuskieren	obfuskieren
Arm	Arm
hinterzöge	hinterzöge
unterforderten	unterforderten
Collagen	Collagen
bestellt	bestellt
Hubschrauber	Hubschrauber
Schreiben	Schreiben
Trägergasen	Trägergasen
Meine	Meine
flehte	flehte
scheute	scheute
schauspieleren	schauspieleren
hattet	hattet
Adlerbussarden	Adlerbussarden
Pater	Pater
idealisierest	idealisierest
Lammfellhandschuhen	Lammfellhandschuhen
Hochsommern	Hochsommern
Nahrungsbestandteilen	Nahrungsbestandteilen
Entree	Entree
Zeug	Zeug
fremden	fremden
Wir	Wir
solle	solle
Erdkruste	Erdkruste
Gasgemisch	Gasgemisch
tobet	tobet
erklingt	erklingt
gefällst	gefällst
posierten	posierten
wehrtest	wehrtest
Kakaos	Kakaos
forschet	forschet
ummantelten	ummantelten
vernehmen	vernehmen
bölkte	bölkte
dehydrierte	dehydrierte
War	War
Elementen	Elementen
begraben	begraben
Garten	Garten
Mauten	Mauten
grause	grause
zirpen	zirpen
Katz-und-Maus-Spielen	Katz-und-Maus-Spielen
schichtet	schichtet
Fittiche	Fittiche
Berichterstattungen	Berichterstattungen
hupen	hupen
Weichloten	Weichloten
quantisiere	quantisiere
Trotzkisten	Trotzkisten
egalisierten	egalisierten
analysieret	analysieret
Milzen	Milzen
Normdatum	Normdatum
vergliche	vergliche
nähet	nähet
gehöre	gehöre
griffe	griffe
Toren	Toren
Deuteriums	Deuteriums
Basilisken	Basilisken
plazierest	plazierest
offenbartest	offenbartest
faschieret	faschieret
hätten	hätten
schlag	schlag
Hörspiel	Hörspiel
Großstädter	Großstädter
schlagest	schlagest
Abschreckungen	Abschreckungen
pressiere	pressiere
hebet	hebet
Langschwanzpinguinen	Langschwanzpinguinen
Türkise	Türkise
rebellieren	rebellieren
neiden	neiden
Fluoratomen	Fluoratomen
Zeitschlitze	Zeitschlitze
produziert	produziert
formulieren	formulieren
Gurten	Gurten
unterbewerte	unterbewerte
Grabbeltisch	Grabbeltisch
rodet	rodet
heißest	heißest
wünschte	wünschte
Schlot	Schlot
verzeichne	verzeichne
Heiden	Heiden
Werden	Werden
legt	legt
zeugt	zeugt
injizierest	injizierest
gedolmetscht	gedolmetscht
googelest	googelest
entmineralisieren	entmineralisieren
wer	wer
arbeiten	arbeiten
Klauen	Klauen
Langeweile	Langeweile
beweiset	beweiset
konjugiere	konjugiere
bewässerst	bewässerst
entkörperlichten	entkörperlichten
wart	wart
generalisiert	generalisiert
erbrüte	erbrüte
Klaue	Klaue
lege	lege
Schalen	Schalen
aktualisiere	aktualisiere
denn	denn
besinnen	besinnen
erwache	erwache
Finanzministerium	Finanzministerium
Märkte	Märkte
tunet	tunet
Feierabend	Feierabend
häufen	häufen
übrigbleibt	übrigbleibt
hadertet	hadertet
Wechselstube	Wechselstube
Teekessel	Teekessel
grün	grün
maximiere	maximiere
verkauften	verkauften
ach	ach
Drachenblut	Drachenblut
prophezeiet	prophezeiet
privilegierst	privilegierst
Erste	Erste
Hanse	Hanse
erliegest	erliegest
mögest	mögest
teilte	teilte
schnattert	schnattert
beweist	beweist
Speere	Speere
hattest	hattest
ratschlagten	ratschlagten
warnt	warnt
Arsenbergwerk	Arsenbergwerk
fritierten	fritierten
Bauwerken	Bauwerken
verziehe	verziehe
bildest	bildest
weist	weist
Blaumeise	Blaumeise
lose	lose
Nadelbäumen	Nadelbäumen
meinen	meinen
idealisierten	idealisierten
faschierst	faschierst
Heide	Heide
Augenglases	Augenglases
Diethylether	Diethylether
Farbstoffen	Farbstoffen
heben	heben
massierend	massierend
streckte	streckte
bracht	bracht
schaffst	schaffst
Marjellchen	Marjellchen
Kommoden	Kommoden
generiertet	generiertet
lauten	lauten
verzweigt	verzweigt
Hüfte	Hüfte
sitzest	sitzest
Männlein	Männlein
Konzentrat	Konzentrat
stärkte	stärkte
Totenglocke	Totenglocke
Fahrzeugkatalysator	Fahrzeugkatalysator
erinnerest	erinnerest
Tieren	Tieren
entdecket	entdecket
stürzt	stürzt
Maultier	Maultier
Hochsommer	Hochsommer
Schreiet	Schreiet
näht	näht
Nussknacker	Nussknacker
reichst	reichst
Aphasie	Aphasie
Angaben	Angaben
Drillinge	Drillinge
Willen	Willen
Bestechungsgelder	Bestechungsgelder
bilden	bilden
Suchet	Suchet
Flamingo	Flamingo
Übertretung	Übertretung
Wer	Wer
Thioacetalen	Thioacetalen
verkündet	verkündet
zankte	zankte
hastete	hastete
sehnst	sehnst
stützen	stützen
herrschten	herrschten
kletteret	kletteret
Taube	Taube
erinnre	erinnre
hurst	hurst
verkleinerest	verkleinerest
häuftet	häuftet
erfahrt	erfahrt
gibst	gibst
sponseret	sponseret
leerst	leerst
feiertest	feiertest
Kannst	Kannst
Primärenergien	Primärenergien
Rubinen	Rubinen
Lümmeltüten	Lümmeltüten
gebt	gebt
Möbiusbänder	Möbiusbänder
Nehmet	Nehmet
Eisenkräutern	Eisenkräutern
Wahn	Wahn
Maße	Maße
schlängelt	schlängelt
Senkungen	Senkungen
kritzelet	kritzelet
Pi	Pi
Metaphern	Metaphern
jauchzt	jauchzt
umhüll	umhüll
Strafraum	Strafraum
sitzet	sitzet
decke	decke
verselbständigt	verselbständigt
dringen	dringen
stickten	stickten
reizen	reizen
Hinterwäldler	Hinterwäldler
Friedensforscherinnen	Friedensforscherinnen
Untiefe	Untiefe
Fokusse	Fokusse
bekannten	bekannten
schließen	schließen
zerrisset	zerrisset
erhebest	erhebest
äussern	äussern
Heeren	Heeren
offenbarest	offenbarest
plagest	plagest
versüße	versüße
Peptid	Peptid
halben	halben
dividiert	dividiert
dürft	dürft
weichet	weichet
bräunst	bräunst
vermahnten	vermahnten
Konfitüre	Konfitüre
rufet	rufet
stürzte	stürzte
motivierten	motivierten
wünschet	wünschet
verkriechst	verkriechst
verzieh	verzieh
Anhängseln	Anhängseln
Abschiedsbriefe	Abschiedsbriefe
Scherzes	Scherzes
nachwandelte	nachwandelte
sündigst	sündigst
gewähret	gewähret
verhungert	verhungert
schneide	schneide
Flame	Flame
zeltest	zeltest
begehren	begehren
fällte	fällte
leiste	leiste
Empörungen	Empörungen
verformen	verformen
stammeln	stammeln
Samarskit	Samarskit
Funkfeuer	Funkfeuer
reichte	reichte
driftete	driftete
Zwingburg	Zwingburg
besprengen	besprengen
Schober	Schober
jungen	jungen
lösest	lösest
Auge	Auge
Donoren	Donoren
teilen	teilen
kautest	kautest
verforme	verforme
Bromidquelle	Bromidquelle
trägst	trägst
Kronsbeeren	Kronsbeeren
Leichtmetallen	Leichtmetallen
Büstenhalters	Büstenhalters
Plumpsen	Plumpsen
wälzet	wälzet
Meldezettel	Meldezettel
Teilnehmerin	Teilnehmerin
Psi	Psi
babbelst	babbelst
Fremden	Fremden
sprachen	sprachen
Kardinal	Kardinal
bereiteten	bereiteten
lobet	lobet
fluppt	fluppt
erbest	erbest
föhnest	föhnest
Wunde	Wunde
liebest	liebest
Wachen	Wachen
verlautete	verlautete
Wache	Wache
Fusselbärten	Fusselbärten
Maß	Maß
knitterte	knitterte
beschwören	beschwören
Futtermitteln	Futtermitteln
anders	anders
Zeithorizonten	Zeithorizonten
wiederkamen	wiederkamen
nehmet	nehmet
tut	tut
Halt	Halt
schnorrest	schnorrest
pflanzen	pflanzen
möchtest	möchtest
Einfältigkeit	Einfältigkeit
Hebet	Hebet
bündelet	bündelet
fertigte	fertigte
formirend	formirend
weinest	weinest
Uteri	Uteri
plärrtest	plärrtest
beteuerten	beteuerten
bimmelten	bimmelten
Sprechers	Sprechers
foppten	foppten
Gitarrenspieler	Gitarrenspieler
punktest	punktest
Schaden	Schaden
Gelobt	Gelobt
erstaunte	erstaunte
Quellfluss	Quellfluss
Blitzableiter	Blitzableiter
tattre	tattre
Abbild	Abbild
beleuchteten	beleuchteten
entheilige	entheilige
Pfunden	Pfunden
decket	decket
Schobern	Schobern
letzten	letzten
verbündend	verbündend
Landstreicher	Landstreicher
Dewargefäße	Dewargefäße
moppen	moppen
leide	leide
Freunde	Freunde
Laiben	Laiben
verlobte	verlobte
Frieden	Frieden
werft	werft
hängen	hängen
verließen	verließen
Kanzleien	Kanzleien
Ha	Ha
dümpelte	dümpelte
kram	kram
setzet	setzet
verwaiset	verwaiset
Inkarnationen	Inkarnationen
Berufen	Berufen
stimmen	stimmen
nahte	nahte
Radsatzes	Radsatzes
essen	essen
deaktivierst	deaktivierst
verschmelzen	verschmelzen
Alkin	Alkin
erhörst	erhörst
Tintenfische	Tintenfische
gestatteten	gestatteten
Kraftfahrzeugen	Kraftfahrzeugen
nehmest	nehmest
sagtet	sagtet
Griechen	Griechen
besser	besser
Streich	Streich
entwaffnest	entwaffnest
Laib	Laib
Riese	Riese
schöpfest	schöpfest
harmoniert	harmoniert
schlachten	schlachten
Aha-Erlebnisse	Aha-Erlebnisse
fluktuiert	fluktuiert
Gruftis	Gruftis
Stiefvätern	Stiefvätern
Hummel	Hummel
verallgemeinerst	verallgemeinerst
folgt	folgt
demütigte	demütigte
schautest	schautest
eiterte	eiterte
Solches	Solches
bebet	bebet
umkämen	umkämen
erstehst	erstehst
Shortcuts	Shortcuts
protestiere	protestiere
Knabe	Knabe
wechselwirkte	wechselwirkte
Ruße	Ruße
Proton	Proton
Frösche	Frösche
Generation	Generation
zeugten	zeugten
vereinigt	vereinigt
Ruß	Ruß
essest	essest
salzen	salzen
schlaget	schlaget
versuchen	versuchen
simulierst	simulierst
nagelte	nagelte
vergiften	vergiften
Ausgangssperren	Ausgangssperren
zügelten	zügelten
Schwester	Schwester
Druckfehler	Druckfehler
sagte	sagte
Halsabschneidern	Halsabschneidern
predig	predig
Schlepper	Schlepper
Höhe	Höhe
beherrscht	beherrscht
weine	weine
jenen	jenen
zerrissen	zerrissen
emittierte	emittierte
reagierte	reagierte
kurze	kurze
dissentierten	dissentierten
verwirrte	verwirrte
verschont	verschont
reiche	reiche
hintertreiben	hintertreiben
Dichten	Dichten
überschattet	überschattet
Entsetzet	Entsetzet
baggerte	baggerte
nächste	nächste
gravierst	gravierst
Braunralle	Braunralle
fraget	fraget
bekennst	bekennst
geselle	geselle
Drillingen	Drillingen
amputiere	amputiere
vertonten	vertonten
umhüllst	umhüllst
Leugnungen	Leugnungen
Stall	Stall
pressierten	pressierten
Gebote	Gebote
Mähnenwolfes	Mähnenwolfes
wiederholte	wiederholte
babbelt	babbelt
Fische	Fische
verzögerten	verzögerten
bromiert	bromiert
Welchen	Welchen
Abarten	Abarten
Tausch	Tausch
treffen	treffen
bricht	bricht
letzte	letzte
Spektralbereichen	Spektralbereichen
graben	graben
Braunrallen	Braunrallen
Vorstädten	Vorstädten
Magiern	Magiern
Tollkirsche	Tollkirsche
rufst	rufst
Würze	Würze
argumentierest	argumentierest
zelte	zelte
hatte	hatte
ermordet	ermordet
Prügelstrafen	Prügelstrafen
ersten	ersten
Martyrologium	Martyrologium
Träumers	Träumers
schöben	schöben
Ambiguität	Ambiguität
Sünders	Sünders
rühmst	rühmst
Nachruf	Nachruf
leben	leben
Chlorwasserstoffmolekül	Chlorwasserstoffmolekül
frottier	frottier
fette	fette
imkeret	imkeret
schämte	schämte
füllen	füllen
steinigst	steinigst
kabbelet	kabbelet
Asylrechte	Asylrechte
Hummern	Hummern
Löwen	Löwen
brillieren	brillieren
Herr	Herr
ausführt	ausführt
hörest	hörest
verstörten	verstörten
drängest	drängest
häufe	häufe
Uranerzen	Uranerzen
halbierest	halbierest
Erlösungen	Erlösungen
lavierte	lavierte
Zain	Zain
Dobermännern	Dobermännern
Serverzugriffe	Serverzugriffe
bringet	bringet
vibriere	vibriere
Bande	Bande
wollte	wollte
anhangt	anhangt
Lehrkörpers	Lehrkörpers
schenke	schenke
ärgerst	ärgerst
stoßet	stoßet
hydrogentartrate	hydrogentartrate
Märtyrern	Märtyrern
Sollst	Sollst
verwechselet	verwechselet
begrabt	begrabt
leistest	leistest
Wege	Wege
stärken	stärken
reizte	reizte
Jungen	Jungen
Antimustern	Antimustern
untertreten	untertreten
regierest	regierest
angehört	angehört
Fetzen	Fetzen
fingiere	fingiere
Aphasien	Aphasien
pustet	pustet
Gedächtnisse	Gedächtnisse
halte	halte
Kerf	Kerf
Fittichen	Fittichen
übrigbleibet	übrigbleibet
sprechet	sprechet
hinterzögen	hinterzögen
knistern	knistern
sterilisierten	sterilisierten
fladerest	fladerest
Primatologen	Primatologen
Tauben	Tauben
kauten	kauten
scheu	scheu
Remis	Remis
handhaben	handhaben
Europameistern	Europameistern
fertig	fertig
verewigt	verewigt
Leuchtkäfern	Leuchtkäfern
fokussieret	fokussieret
türmen	türmen
macht	macht
verifizierten	verifizierten
Male	Male
stoßt	stoßt
Gesetze	Gesetze
raffiniere	raffiniere
taufe	taufe
Rücktrittbremse	Rücktrittbremse
würdet	würdet
neidest	neidest
duckt	duckt
Carbiden	Carbiden
Scheißkerl	Scheißkerl
süsse	süsse
jene	jene
stellet	stellet
Roben	Roben
lobte	lobte
Saiblingen	Saiblingen
Fiasko	Fiasko
Könige	Könige
wegführen	wegführen
setze	setze
glänzte	glänzte
rittest	rittest
Welche	Welche
Danket	Danket
ratschlaget	ratschlaget
versuchet	versuchet
kugele	kugele
Zankapfel	Zankapfel
ermordetet	ermordetet
beneidest	beneidest
Suchanfrage	Suchanfrage
Wimpertierchen	Wimpertierchen
feiern	feiern
verewiget	verewiget
Temperaturanstiege	Temperaturanstiege
Welpen	Welpen
schlachtet	schlachtet
brandet	brandet
Blaumeisen	Blaumeisen
beschotterten	beschotterten
übrigbleiben	übrigbleiben
Katz-und-Maus-Spiele	Katz-und-Maus-Spiele
Leiden	Leiden
liehen	liehen
Referenzen	Referenzen
verschmelze	verschmelze
nähret	nähret
gräbst	gräbst
Fingerhüten	Fingerhüten
schmelzen	schmelzen
Hin	Hin
verbirgst	verbirgst
überreichen	überreichen
sagen	sagen
Diesen	Diesen
Ängsten	Ängsten
Kassettenrekorder	Kassettenrekorder
dingten	dingten
Komponistin	Komponistin
Programmiererinnen	Programmiererinnen
spukte	spukte
Zainen	Zainen
gedachte	gedachte
Weinstöcken	Weinstöcken
ärgere	ärgere
Zehnten	Zehnten
bollerest	bollerest
Kleinode	Kleinode
gelangte	gelangte
mangeln	mangeln
Decket	Decket
jagst	jagst
raubest	raubest
Wolle	Wolle
bröckelten	bröckelten
langweiltest	langweiltest
leihe	leihe
erhört	erhört
Elf	Elf
auszögen	auszögen
handhabest	handhabest
Iberers	Iberers
kürzest	kürzest
könne	könne
Monde	Monde
verunreinigt	verunreinigt
feire	feire
Pardelkatze	Pardelkatze
Berylle	Berylle
äusserst	äusserst
Feiertage	Feiertage
Handbüchern	Handbüchern
tasteten	tasteten
warten	warten
Gar	Gar
zuppe	zuppe
verdamm	verdamm
Katalanen	Katalanen
Leichenschauhäusern	Leichenschauhäusern
tagen	tagen
steigen	steigen
Gebirgen	Gebirgen
ausfuhren	ausfuhren
Badezimmer	Badezimmer
Grufti	Grufti
erhöhest	erhöhest
protokollieren	protokollieren
zweifeln	zweifeln
Staatsanleihe	Staatsanleihe
kugelten	kugelten
knutschst	knutschst
Schotten	Schotten
benachrichtige	benachrichtige
Kriegsknechten	Kriegsknechten
Leitungsweg	Leitungsweg
Oxalate	Oxalate
Ei	Ei
Tische	Tische
zentrifugierst	zentrifugierst
Kraftfahrzeuges	Kraftfahrzeuges
erbet	erbet
verstörte	verstörte
sich	sich
filzen	filzen
zerschlaget	zerschlaget
Samstagnachmittagen	Samstagnachmittagen
bedeckst	bedeckst
Benzol	Benzol
erwärmst	erwärmst
Samarskite	Samarskite
gedurft	gedurft
offenbare	offenbare
stärket	stärket
hievst	hievst
Diagnostik	Diagnostik
inhalier	inhalier
kürzten	kürzten
Höfen	Höfen
verantwortetest	verantwortetest
knuffend	knuffend
Früchtchen	Früchtchen
separieren	separieren
Gefäße	Gefäße
Geschäften	Geschäften
Friesen	Friesen
vernickele	vernickele
Besteck	Besteck
kupieren	kupieren
appellierst	appellierst
Büstenhaltern	Büstenhaltern
eng	eng
Adler	Adler
Herbstwinden	Herbstwinden
Laubholz	Laubholz
Steine	Steine
gekröst	gekröst
Fürst	Fürst
rollten	rollten
referenzierst	referenzierst
bejubelte	bejubelte
Lärchen	Lärchen
zensierten	zensierten
Heuhaufen	Heuhaufen
drängte	drängte
Bildschirmfotos	Bildschirmfotos
finanzierest	finanzierest
Begünstigung	Begünstigung
Aktenkoffer	Aktenkoffer
streckst	streckst
Technetiumatom	Technetiumatom
verführten	verführten
flitzen	flitzen
Warte	Warte
Normdaten	Normdaten
hättest	hättest
geherrscht	geherrscht
köderte	köderte
erfüllet	erfüllet
Ölspur	Ölspur
denaturierten	denaturierten
speisen	speisen
ansehet	ansehet
verallgemeinerest	verallgemeinerest
flitzte	flitzte
Puder	Puder
verdunsten	verdunsten
beklagte	beklagte
rekonstruieret	rekonstruieret
löge	löge
ärgernd	ärgernd
verkürzest	verkürzest
grünst	grünst
weinst	weinst
Tetraiodide	Tetraiodide
Trichter	Trichter
Wirst	Wirst
Hochhäusern	Hochhäusern
Münzsammlung	Münzsammlung
lüg	lüg
verlobt	verlobt
Polierstahl	Polierstahl
verachte	verachte
Affenbrotbaum	Affenbrotbaum
sedimentiertet	sedimentiertet
Subspezies	Subspezies
rufe	rufe
Palästen	Palästen
schnitt	schnitt
wolle	wolle
führe	führe
besucht	besucht
misstrauest	misstrauest
redete	redete
Alten	Alten
trüge	trüge
Tiere	Tiere
Wüsten	Wüsten
Stufen	Stufen
Aussätzigen	Aussätzigen
verbarg	verbarg
Anhang	Anhang
Kalb	Kalb
Gauner	Gauner
exmatrikulierte	exmatrikulierte
habe	habe
übersiehst	übersiehst
Milchflaschen	Milchflaschen
Einrädern	Einrädern
austilgest	austilgest
Wühltischen	Wühltischen
Macht	Macht
Randbemerkung	Randbemerkung
Anachronismus	Anachronismus
vertreiben	vertreiben
Anschlägen	Anschlägen
Fromme	Fromme
blitzet	blitzet
setzt	setzt
losten	losten
Metallquirlen	Metallquirlen
schöpfen	schöpfen
verdrängen	verdrängen
werden	werden
bescherten	bescherten
Zähne	Zähne
predigten	predigten
ehrte	ehrte
Portal	Portal
kurbelte	kurbelte
bequemest	bequemest
behaltest	behaltest
Buntspechten	Buntspechten
Unglaube	Unglaube
strömt	strömt
Küchenmaschinen	Küchenmaschinen
zürntet	zürntet
malträtiere	malträtiere
verglühte	verglühte
entgegenkamst	entgegenkamst
bestrafe	bestrafe
zeug	zeug
bemühten	bemühten
Fiebermittel	Fiebermittel
Theistin	Theistin
Sagte	Sagte
Elstern	Elstern
leertet	leertet
eine	eine
Chronisten	Chronisten
bessere	bessere
verstrahlten	verstrahlten
fragest	fragest
blenden	blenden
Spurensicherung	Spurensicherung
spritzt	spritzt
Zahnfleischentzündungen	Zahnfleischentzündungen
vergibst	vergibst
Ausnahmen	Ausnahmen
stickt	stickt
entrümpelst	entrümpelst
Hochzeitstorten	Hochzeitstorten
lieben	lieben
dotiere	dotiere
Omnibus	Omnibus
begrubt	begrubt
knüpfte	knüpfte
reparieret	reparieret
quatschest	quatschest
Fussel	Fussel
Heringen	Heringen
Kernladungszahlen	Kernladungszahlen
Königen	Königen
egalisiertet	egalisiertet
Bromidquellen	Bromidquellen
belauere	belauere
Zipfelmützen	Zipfelmützen
Schätzen	Schätzen
verhalte	verhalte
Drachen	Drachen
Reststoffen	Reststoffen
referenziere	referenziere
Überschüsse	Überschüsse
pensionierten	pensionierten
Ehren	Ehren
meuternd	meuternd
glaube	glaube
entkäme	entkäme
schütze	schütze
Ställe	Ställe
Rücktrittes	Rücktrittes
Otavit	Otavit
begäben	begäben
privatisiert	privatisiert
Töpfe	Töpfe
erscheinest	erscheinest
aufstanden	aufstanden
Reinelementen	Reinelementen
Weichseln	Weichseln
Oxalaten	Oxalaten
Linguistinnen	Linguistinnen
bölket	bölket
am	am
gewährtest	gewährtest
gelobest	gelobest
lobe	lobe
erste	erste
Entsetzt	Entsetzt
Gläubigern	Gläubigern
unterdrückte	unterdrückte
Flitzer	Flitzer
Fluorkohlenwasserstoff	Fluorkohlenwasserstoff
Dank	Dank
Heere	Heere
arrivieren	arrivieren
Komplexionen	Komplexionen
bitten	bitten
bücktest	bücktest
würdest	würdest
rolltet	rolltet
Kreise	Kreise
installiert	installiert
Erfahrungen	Erfahrungen
erdachten	erdachten
Gelobet	Gelobet
urbanisier	urbanisier
Biokraftstoff	Biokraftstoff
hinterlegt	hinterlegt
brausen	brausen
initiierten	initiierten
Totgeburten	Totgeburten
heulte	heulte
surre	surre
Anschläge	Anschläge
scheuchten	scheuchten
hilfst	hilfst
begehr	begehr
Gerücht	Gerücht
Arsenbergwerken	Arsenbergwerken
scheltet	scheltet
verseucht	verseucht
Lüste	Lüste
planschtest	planschtest
schenket	schenket
dolmetschst	dolmetschst
murmeln	murmeln
amenagier	amenagier
reiftet	reiftet
verscheißerte	verscheißerte
gedenken	gedenken
möpperst	möpperst
höhnte	höhnte
hintertriebe	hintertriebe
messet	messet
Taschendieb	Taschendieb
weissagten	weissagten
Kreisen	Kreisen
mangelte	mangelte
fragmentierst	fragmentierst
bemächtigest	bemächtigest
grübelte	grübelte
fünften	fünften
Alibis	Alibis
taufte	taufte
schauet	schauet
Fröschen	Fröschen
Rauten	Rauten
säst	säst
punktetest	punktetest
Lobe	Lobe
verzehre	verzehre
tun	tun
Ränke	Ränke
Gemeinden	Gemeinden
reife	reife
ruhest	ruhest
Pedant	Pedant
erkennet	erkennet
Sage	Sage
vergleichet	vergleichet
fabulierte	fabulierte
trübe	trübe
heftetest	heftetest
sagt	sagt
kickst	kickst
bete	bete
begräbt	begräbt
Abfahrtslisten	Abfahrtslisten
ziere	ziere
Alkalien	Alkalien
Mache	Mache
Adamsäpfeln	Adamsäpfeln
egge	egge
klappest	klappest
Anhänge	Anhänge
dritten	dritten
prostete	prostete
grien	grien
wärmet	wärmet
verarbeite	verarbeite
Ecken	Ecken
Anwendungsgebiete	Anwendungsgebiete
mikrominiaturisiere	mikrominiaturisiere
Arsch	Arsch
wurden	wurden
regte	regte
globalisier	globalisier
harrten	harrten
ratschlagte	ratschlagte
besät	besät
liebtest	liebtest
lade	lade
Geber	Geber
Brikette	Brikette
bewies	bewies
deckst	deckst
gefällt	gefällt
Pis	Pis
punkten	punkten
Rehen	Rehen
mobilisieret	mobilisieret
Adhäsionen	Adhäsionen
Stätte	Stätte
Wasserquelle	Wasserquelle
stiege	stiege
er	er
Flensern	Flensern
punkteten	punkteten
Banknoten	Banknoten
initiieret	initiieret
besorgest	besorgest
Gedächtnissen	Gedächtnissen
erwischten	erwischten
Unrecht	Unrecht
arbeit	arbeit
vermeßest	vermeßest
klage	klage
inszenierst	inszenierst
lackiere	lackiere
machte	machte
bang	bang
ringele	ringele
Kohle	Kohle
Wehret	Wehret
verkröchet	verkröchet
straftet	straftet
Zankapfels	Zankapfels
Weißflügelpinguin	Weißflügelpinguin
Gallanen	Gallanen
Mitschuld	Mitschuld
radiertest	radiertest
ausfuhr	ausfuhr
zerfetzte	zerfetzte
kehrst	kehrst
hydrogentartrat	hydrogentartrat
Zäunen	Zäunen
Scherzen	Scherzen
mehrte	mehrte
Lebenskräften	Lebenskräften
parlieren	parlieren
Kriegen	Kriegen
gelobtest	gelobtest
schubse	schubse
Blechen	Blechen
betrübten	betrübten
schlage	schlage
Sei	Sei
gezügelt	gezügelt
grünest	grünest
formiret	formiret
Loben	Loben
Libelle	Libelle
Suchanfragen	Suchanfragen
fegst	fegst
Reliquiare	Reliquiare
Gefangenen	Gefangenen
möget	möget
unterfordern	unterfordern
reim	reim
tränkten	tränkten
untersagest	untersagest
extemporieret	extemporieret
gewähr	gewähr
Metallothionein	Metallothionein
entschleiert	entschleiert
Energiespeicher	Energiespeicher
grüßend	grüßend
Dieben	Dieben
tobend	tobend
charakterisierend	charakterisierend
Nachweisreagenzien	Nachweisreagenzien
hänget	hänget
Weg	Weg
besäest	besäest
Leugnung	Leugnung
Wespen	Wespen
Durchbruch	Durchbruch
rechten	rechten
knüpfet	knüpfet
Amokläuferinnen	Amokläuferinnen
boß	boß
Speeren	Speeren
Pferde	Pferde
begehre	begehre
Asteroide	Asteroide
Rinde	Rinde
Ausbeuter	Ausbeuter
Forschung	Forschung
schicke	schicke
blase	blase
folg	folg
Halle	Halle
ausgereckt	ausgereckt
stürzest	stürzest
Seile	Seile
Ypecaharalle	Ypecaharalle
sollte	sollte
vollendete	vollendete
bebten	bebten
hantierte	hantierte
ehrst	ehrst
Thioestere	Thioestere
Verbindungsdraht	Verbindungsdraht
Myriade	Myriade
blaset	blaset
Joche	Joche
Satzung	Satzung
Götze	Götze
sündigten	sündigten
reifst	reifst
wiederkamt	wiederkamt
Schnipseln	Schnipseln
Lümmeltüte	Lümmeltüte
möchte	möchte
ferne	ferne
Arbeitskreis	Arbeitskreis
concessioniert	concessioniert
Laufen	Laufen
Rechte	Rechte
Zäume	Zäume
urteilen	urteilen
werdest	werdest
Fanmeilen	Fanmeilen
kategorisierte	kategorisierte
gewinnen	gewinnen
bezieht	bezieht
grüne	grüne
gähne	gähne
rühmte	rühmte
zeigst	zeigst
dienest	dienest
Impedanz	Impedanz
irre	irre
Carbid	Carbid
destabilisierst	destabilisierst
Kompass	Kompass
taufen	taufen
Fettes	Fettes
verwechselst	verwechselst
gequasselt	gequasselt
entwischtet	entwischtet
heparinisiere	heparinisiere
speisest	speisest
Brettspiele	Brettspiele
malochte	malochte
teilet	teilet
warst	warst
zürnst	zürnst
Herden	Herden
aasend	aasend
lauschte	lauschte
fragst	fragst
Tausche	Tausche
Abkömmlingen	Abkömmlingen
stellst	stellst
Isobars	Isobars
Kehre	Kehre
folgtet	folgtet
Amnestie	Amnestie
Ochsen	Ochsen
verziehen	verziehen
Apostels	Apostels
Geschwindigkeitsmesser	Geschwindigkeitsmesser
reinigst	reinigst
Garben	Garben
Atommodellen	Atommodellen
Führet	Führet
Flaschenhälsen	Flaschenhälsen
ritt	ritt
säumen	säumen
Gichten	Gichten
beten	beten
inszeniere	inszeniere
Dilettanten	Dilettanten
Tun	Tun
erliegen	erliegen
möchten	möchten
Campingplätzen	Campingplätzen
Bademantel	Bademantel
Wände	Wände
pipettierten	pipettierten
parkierst	parkierst
geboten	geboten
raten	raten
erstürmet	erstürmet
Pflanzung	Pflanzung
verabschiedeten	verabschiedeten
fällt	fällt
kennet	kennet
zerrüttet	zerrüttet
Grizzlybären	Grizzlybären
ander	ander
Streiten	Streiten
Chasar	Chasar
Autokraten	Autokraten
verbündeten	verbündeten
Kaufleute	Kaufleute
gleitest	gleitest
erfreu	erfreu
Karer	Karer
Wäre	Wäre
Vogelscheuche	Vogelscheuche
Geflecktheit	Geflecktheit
Heringe	Heringe
kritzelst	kritzelst
Briefe	Briefe
erkannte	erkannte
Ebene	Ebene
rebelliertet	rebelliertet
schnorrtet	schnorrtet
hüpfen	hüpfen
gestatte	gestatte
stapften	stapften
lebest	lebest
ermordetest	ermordetest
billige	billige
Bürzel	Bürzel
verbaselt	verbaselt
Seelöwe	Seelöwe
mehr	mehr
Decks	Decks
vergiftet	vergiftet
Sorge	Sorge
Basilisk	Basilisk
ersparet	ersparet
seit	seit
Hunden	Hunden
reanimiere	reanimiere
Höhen	Höhen
Indern	Indern
holet	holet
plumpse	plumpse
Kaufkraft	Kaufkraft
begnadigst	begnadigst
verknüpfet	verknüpfet
Aktienkursen	Aktienkursen
Chlorat	Chlorat
Gehorsams	Gehorsams
lauf	lauf
dürftet	dürftet
knacktest	knacktest
könnten	könnten
Vorhäute	Vorhäute
verunglimpftet	verunglimpftet
Elfen	Elfen
Äxte	Äxte
Händedrücken	Händedrücken
Krankenscheinen	Krankenscheinen
Bäusche	Bäusche
Begrenzung	Begrenzung
Seetauchers	Seetauchers
quantisierte	quantisierte
Außenministerien	Außenministerien
Eingeweide	Eingeweide
entgegenkamen	entgegenkamen
Falzen	Falzen
Somite	Somite
plagen	plagen
tief	tief
bemerken	bemerken
krieget	krieget
geschlummert	geschlummert
Rekursion	Rekursion
folterte	folterte
torpedieret	torpedieret
diskutiere	diskutiere
Kettenraucher	Kettenraucher
der	der
Hypochlorite	Hypochlorite
unschuldigen	unschuldigen
parametrisierten	parametrisierten
siegte	siegte
Anmeldern	Anmeldern
Molybdite	Molybdite
flambierest	flambierest
heftete	heftete
verlöteten	verlöteten
dirigieret	dirigieret
Monaten	Monaten
Bundesgebiet	Bundesgebiet
Verselbstständigung	Verselbstständigung
Sagen	Sagen
solch	solch
Gefilde	Gefilde
Hirten	Hirten
anzeigt	anzeigt
war	war
Renegaten	Renegaten
kappet	kappet
einst	einst
verunglimpfte	verunglimpfte
betrübest	betrübest
infiziertet	infiziertet
sehest	sehest
kickend	kickend
Safran	Safran
Kohlenstoffgehalt	Kohlenstoffgehalt
Feldbett	Feldbett
deklarierte	deklarierte
verstecktet	verstecktet
Nussknackern	Nussknackern
filzte	filzte
Klassenzimmer	Klassenzimmer
tabuisierten	tabuisierten
versagen	versagen
Möbelstoff	Möbelstoff
Gewichten	Gewichten
funktionalisierte	funktionalisierte
Deckenzapfen	Deckenzapfen
verführen	verführen
besuche	besuche
diversifiziere	diversifiziere
Ansichtskarte	Ansichtskarte
klappen	klappen
Homodimeren	Homodimeren
grabble	grabble
posiert	posiert
fritierst	fritierst
diese	diese
tatet	tatet
schlaf	schlaf
Reinigungsschritten	Reinigungsschritten
wehen	wehen
protestierst	protestierst
Hobby	Hobby
schleiß	schleiß
hieltet	hieltet
Gnaden	Gnaden
Gedrängen	Gedrängen
Transportweg	Transportweg
Vordenkern	Vordenkern
verfolgt	verfolgt
manchen	manchen
Lautwandel	Lautwandel
fegte	fegte
zürntest	zürntest
knufften	knufften
Genies	Genies
Rhodochrosite	Rhodochrosite
Glaubst	Glaubst
plagte	plagte
entfachten	entfachten
willen	willen
trinken	trinken
verstehst	verstehst
Toypudeln	Toypudeln
Böse	Böse
Dürren	Dürren
Playlists	Playlists
anruft	anruft
unterschiede	unterschiede
hineinbrächten	hineinbrächten
bückest	bückest
falteten	falteten
zagest	zagest
Zeile	Zeile
Stücken	Stücken
bescheißt	bescheißt
schmeichelest	schmeichelest
ahnten	ahnten
verbraucht	verbraucht
Füllen	Füllen
heilige	heilige
verschränkest	verschränkest
Worte	Worte
verdammend	verdammend
Linie	Linie
wehrend	wehrend
beschuldigt	beschuldigt
stiften	stiften
flenstet	flenstet
durchzuckest	durchzuckest
bleibest	bleibest
gestikuliere	gestikuliere
gebet	gebet
bollerte	bollerte
Möbiusbändern	Möbiusbändern
vertiefet	vertiefet
baten	baten
Gefangene	Gefangene
rotten	rotten
winke	winke
vertuest	vertuest
plissierten	plissierten
widmest	widmest
weich	weich
Unternehmung	Unternehmung
erbringen	erbringen
Uterus	Uterus
seist	seist
verfolgst	verfolgst
hickste	hickste
Metallothioneinen	Metallothioneinen
Dingen	Dingen
begehrend	begehrend
Halter	Halter
Unterseiten	Unterseiten
rekrutiere	rekrutiere
fragte	fragte
Rechten	Rechten
rauben	rauben
verwahrt	verwahrt
Dann	Dann
Neuigkeit	Neuigkeit
kritzele	kritzele
einführen	einführen
lostest	lostest
gewarnt	gewarnt
vertäte	vertäte
ernteten	ernteten
Vanadaten	Vanadaten
Epidemie	Epidemie
Fußmatte	Fußmatte
klicket	klicket
ritten	ritten
Blässe	Blässe
bestimmst	bestimmst
Kühe	Kühe
erfreuen	erfreuen
Fellhandschuhen	Fellhandschuhen
Kehret	Kehret
dramatisieren	dramatisieren
Reichweiten	Reichweiten
Geboten	Geboten
kämmtet	kämmtet
trinket	trinket
Mutagenen	Mutagenen
foppst	foppst
Schlaraffenländern	Schlaraffenländern
spukest	spukest
besänftiget	besänftiget
dramatisiert	dramatisiert
Berufe	Berufe
scheuchen	scheuchen
Kerzenlichtern	Kerzenlichtern
Fußmatten	Fußmatten
erdacht	erdacht
koche	koche
Grenzwert	Grenzwert
Hochhäuser	Hochhäuser
knutschest	knutschest
stehet	stehet
vertilgt	vertilgt
streue	streue
Gerichten	Gerichten
malträtierte	malträtierte
Buchfink	Buchfink
Quellflüssen	Quellflüssen
hebe	hebe
wach	wach
welchen	welchen
lösend	lösend
Dezernat	Dezernat
colorierten	colorierten
Pforte	Pforte
dunkelt	dunkelt
stillte	stillte
spritzet	spritzet
tiefe	tiefe
ritze	ritze
Borhydrid	Borhydrid
Bärte	Bärte
Cyanat	Cyanat
Hubschraubern	Hubschraubern
Wasserquellen	Wasserquellen
schautet	schautet
Edelsteinen	Edelsteinen
Ratsherr	Ratsherr
Lopariten	Lopariten
unterrichten	unterrichten
unterbewertete	unterbewertete
kauern	kauern
Meere	Meere
entflöhen	entflöhen
mischst	mischst
meuterest	meuterest
skypet	skypet
mikrominiaturisierten	mikrominiaturisierten
ortete	ortete
Rückweg	Rückweg
Mönche	Mönche
Bleigehalten	Bleigehalten
wogen	wogen
verbitterte	verbitterte
Erzherzogshüten	Erzherzogshüten
löstest	löstest
verdeckten	verdeckten
Brandbeschleuniger	Brandbeschleuniger
Ärztin	Ärztin
Wachtel	Wachtel
aufrichtest	aufrichtest
Erdboden	Erdboden
angehören	angehören
Gedanken	Gedanken
bombardiert	bombardiert
versteigerest	versteigerest
lügt	lügt
funktionalisiertest	funktionalisiertest
Türkin	Türkin
bedrücktest	bedrücktest
breche	breche
Besprechung	Besprechung
Vaginen	Vaginen
vermahnen	vermahnen
verurteilen	verurteilen
krank	krank
amputierten	amputierten
schämst	schämst
vermahne	vermahne
Raten	Raten
schnatternd	schnatternd
spanne	spanne
rundest	rundest
Musters	Musters
bedeckest	bedeckest
Riegel	Riegel
Briefen	Briefen
Nanotesla	Nanotesla
verstand	verstand
erbrütet	erbrütet
Kernspaltung	Kernspaltung
Kuttern	Kuttern
Wandergewerbe	Wandergewerbe
Playlist	Playlist
wog	wog
Germanisten	Germanisten
Sprüche	Sprüche
verwirkliche	verwirkliche
sagest	sagest
Urologe	Urologe
lehnte	lehnte
weichest	weichest
meldet	meldet
Tritte	Tritte
grübelten	grübelten
Pflaumen	Pflaumen
bündelten	bündelten
ausführe	ausführe
frohlockte	frohlockte
zerstreuet	zerstreuet
umarmet	umarmet
gafften	gafften
Elektronenschale	Elektronenschale
absolviertet	absolviertet
rammte	rammte
offenbar	offenbar
brechet	brechet
Ratet	Ratet
liebe	liebe
verdreht	verdreht
kappten	kappten
erwachte	erwachte
Filzläusen	Filzläusen
Unrechten	Unrechten
erhöht	erhöht
verliere	verliere
verringertet	verringertet
Galeere	Galeere
boykottierst	boykottierst
Gibst	Gibst
zweifel	zweifel
Bedeutung	Bedeutung
Somiten	Somiten
ausgereckte	ausgereckte
Akkadierinnen	Akkadierinnen
gewährte	gewährte
grübelt	grübelt
glaubtet	glaubtet
Kontraindikationen	Kontraindikationen
lockerte	lockerte
sündiget	sündiget
Ring	Ring
schöpfe	schöpfe
speiset	speiset
Wissen	Wissen
Heiratsgütern	Heiratsgütern
erweckest	erweckest
Bruchstriches	Bruchstriches
Bilderstürmer	Bilderstürmer
setzest	setzest
dichten	dichten
weisest	weisest
Zapfhähnen	Zapfhähnen
Lobgesängen	Lobgesängen
armen	armen
Beiblättern	Beiblättern
Geckos	Geckos
reinige	reinige
Leuchtkäfer	Leuchtkäfer
besorgten	besorgten
Gewürzen	Gewürzen
Ärzteblättern	Ärzteblättern
Eins	Eins
reanimierten	reanimierten
Hirschen	Hirschen
Berge	Berge
Tore	Tore
Felsboden	Felsboden
Polierstählen	Polierstählen
gehst	gehst
dümpelest	dümpelest
fingieret	fingieret
Massenarbeitslosigkeit	Massenarbeitslosigkeit
Saget	Saget
Asiatin	Asiatin
verlautet	verlautet
stoßest	stoßest
Arreste	Arreste
schluchzte	schluchzte
verweise	verweise
inspirierest	inspirierest
unehret	unehret
fistete	fistete
changiere	changiere
Rotzinkerzen	Rotzinkerzen
Karikaturistinnen	Karikaturistinnen
Waren	Waren
Hobbys	Hobbys
Tetraiodiden	Tetraiodiden
Anzeichen	Anzeichen
Moren	Moren
murmelten	murmelten
sedimentieret	sedimentieret
Kaktusfeige	Kaktusfeige
beschrifteten	beschrifteten
negierest	negierest
tagest	tagest
piesacken	piesacken
freiwilligen	freiwilligen
Massenanteilen	Massenanteilen
hänge	hänge
erlaubest	erlaubest
glawbte	glawbte
Prostyloi	Prostyloi
mopst	mopst
Tritt	Tritt
Höhle	Höhle
zerfielest	zerfielest
Kacke	Kacke
versteckt	versteckt
enttäuschet	enttäuschet
verzeigt	verzeigt
mästet	mästet
Rufet	Rufet
Abfahrtsliste	Abfahrtsliste
zweiten	zweiten
karikieret	karikieret
Substanz	Substanz
eskalieret	eskalieret
kabeln	kabeln
Milz	Milz
verkehrten	verkehrten
Flussbetten	Flussbetten
Pausbacke	Pausbacke
analysierest	analysierest
flötete	flötete
habest	habest
Spanne	Spanne
blockierten	blockierten
Argyrodite	Argyrodite
Mutagen	Mutagen
Ringeltauben	Ringeltauben
Fischotters	Fischotters
befehlt	befehlt
Überfamilie	Überfamilie
Ärztinnen	Ärztinnen
Perle	Perle
Zöpfe	Zöpfe
brenne	brenne
frisch	frisch
Stoffwechselweg	Stoffwechselweg
Dachdecker	Dachdecker
abweichest	abweichest
Fahrt	Fahrt
strafest	strafest
reifen	reifen
arme	arme
Charakteristikan	Charakteristikan
drücken	drücken
Leichenschauhäuser	Leichenschauhäuser
umhüllend	umhüllend
fahrest	fahrest
Anlässe	Anlässe
Flosse	Flosse
verschaffte	verschaffte
tagten	tagten
sitzt	sitzt
Sabotagen	Sabotagen
forschte	forschte
Ärschen	Ärschen
Sphären	Sphären
Remisen	Remisen
regelet	regelet
stapele	stapele
Schamentzündungen	Schamentzündungen
Preisanstiegen	Preisanstiegen
Fußballweltmeisterschaftsqualifikationsspielen	Fußballweltmeisterschaftsqualifikationsspielen
erbaust	erbaust
zittere	zittere
erstehen	erstehen
Ångström	Ångström
Rundbriefe	Rundbriefe
Weinen	Weinen
erstarre	erstarre
Aromastoffen	Aromastoffen
Sauberfrauen	Sauberfrauen
steuerst	steuerst
Mobilfunknetzen	Mobilfunknetzen
Fremdwort	Fremdwort
Fetzens	Fetzens
erziehen	erziehen
verlieren	verlieren
sagtest	sagtest
Blütenachse	Blütenachse
zertifizierst	zertifizierst
fertige	fertige
führen	führen
Neuigkeiten	Neuigkeiten
lest	lest
Gepäckträger	Gepäckträger
Strafräume	Strafräume
Minischweine	Minischweine
Penis	Penis
Affenbrotbäumen	Affenbrotbäumen
Türklingel	Türklingel
Cola	Cola
erweckt	erweckt
lebte	lebte
Rast	Rast
Gläubigen	Gläubigen
brandeten	brandeten
Silberdrähten	Silberdrähten
weinte	weinte
Freizeitzentrum	Freizeitzentrum
Menschen	Menschen
Fingerhüte	Fingerhüte
Reliquiar	Reliquiar
schwöre	schwöre
konvergiere	konvergiere
reformierten	reformierten
zappten	zappten
aufkämen	aufkämen
plärrt	plärrt
Schuhe	Schuhe
Freeganer	Freeganer
Pflanzungen	Pflanzungen
täuschte	täuschte
bekannt	bekannt
verschickte	verschickte
puste	puste
vertilgten	vertilgten
steig	steig
Petersfisch	Petersfisch
bezahlt	bezahlt
generalisiere	generalisiere
explodierst	explodierst
darfst	darfst
pressiert	pressiert
Pianos	Pianos
prostet	prostet
Hälsen	Hälsen
offenbart	offenbart
dümpelst	dümpelst
zupftet	zupftet
Schnute	Schnute
naschten	naschten
beseht	beseht
frevle	frevle
Melanteriten	Melanteriten
Heteroatom	Heteroatom
Sekte	Sekte
Huren	Huren
verklagt	verklagt
Pest	Pest
träumte	träumte
Fettsäcken	Fettsäcken
Isolatoren	Isolatoren
Brieföffners	Brieföffners
Grönländer	Grönländer
wurdest	wurdest
freuet	freuet
Atomphysikern	Atomphysikern
Fluorgehalt	Fluorgehalt
labert	labert
attackieret	attackieret
duschten	duschten
soll	soll
Kavalier	Kavalier
Meerschweinchen	Meerschweinchen
Karern	Karern
Ecke	Ecke
Hode	Hode
verdammt	verdammt
überquerst	überquerst
schätzen	schätzen
zeuget	zeuget
Beteiligte	Beteiligte
schwadroniert	schwadroniert
vergaset	vergaset
reizest	reizest
Hardwareentwicklerin	Hardwareentwicklerin
bekannte	bekannte
Halbzeit	Halbzeit
Zerfällen	Zerfällen
heil	heil
fällst	fällst
Streite	Streite
sonderte	sonderte
liegen	liegen
Buntwaschmittel	Buntwaschmittel
Säuen	Säuen
verlasset	verlasset
Anlass	Anlass
frommen	frommen
diente	diente
Fokus	Fokus
Schwebfliegen	Schwebfliegen
lispelten	lispelten
Kanzlei	Kanzlei
Europium	Europium
Käsereibe	Käsereibe
Strontiumamalgamen	Strontiumamalgamen
Sigle	Sigle
Loparite	Loparite
respektieren	respektieren
Skorpionen	Skorpionen
wehrten	wehrten
Amtsträger	Amtsträger
filtern	filtern
Hinterwäldlern	Hinterwäldlern
erbte	erbte
bedenket	bedenket
mampfte	mampfte
huren	huren
scheue	scheue
Ringeltaube	Ringeltaube
Telefonnummern	Telefonnummern
Fischzucht	Fischzucht
Überschüssen	Überschüssen
Arbeitsgruppen	Arbeitsgruppen
flupptest	flupptest
vertagest	vertagest
Wachet	Wachet
Eselsohren	Eselsohren
bequemte	bequemte
türmt	türmt
Rufen	Rufen
erzeigte	erzeigte
drückte	drückte
beleidigst	beleidigst
Höschens	Höschens
endlagern	endlagern
heißt	heißt
merket	merket
gelegt	gelegt
wünschen	wünschen
wachsen	wachsen
Denen	Denen
Zementen	Zementen
Unglauben	Unglauben
Tollkirschen	Tollkirschen
Hirte	Hirte
verunziere	verunziere
Quatsch	Quatsch
Schanktischen	Schanktischen
schenkest	schenkest
Zäune	Zäune
entschleieret	entschleieret
Stolz	Stolz
aufstand	aufstand
Entmachtung	Entmachtung
erkennest	erkennest
trieben	trieben
mögt	mögt
hineinbrächte	hineinbrächte
einen	einen
Für	Für
ankern	ankern
Messies	Messies
Einsätzen	Einsätzen
Kaffeelöffel	Kaffeelöffel
Rücktrittbremsen	Rücktrittbremsen
gebot	gebot
Schuldner	Schuldner
Domänen	Domänen
schwebte	schwebte
Siglen	Siglen
Kohlrübe	Kohlrübe
Abfertigungsgebäuden	Abfertigungsgebäuden
hämmerte	hämmerte
erlösest	erlösest
reparierten	reparierten
verpuffe	verpuffe
Pflanzenstoff	Pflanzenstoff
Knöllchen	Knöllchen
drescht	drescht
Prüfbericht	Prüfbericht
bedient	bedient
Trockendocks	Trockendocks
folgte	folgte
schwenkt	schwenkt
Einem	Einem
stoppte	stoppte
Stearat	Stearat
Generationen	Generationen
Protonen	Protonen
erlabet	erlabet
wetzte	wetzte
anfinge	anfinge
abalienierest	abalienierest
Hahnenkämme	Hahnenkämme
befehlen	befehlen
Wären	Wären
scheinet	scheinet
Bedenken	Bedenken
reifte	reifte
Warten	Warten
zählten	zählten
Dochten	Dochten
regiertest	regiertest
reich	reich
überweis	überweis
Erzeugung	Erzeugung
flense	flense
erzürnet	erzürnet
dunkelten	dunkelten
Mein	Mein
Tiefe	Tiefe
Katamaran	Katamaran
schreiet	schreiet
Bettler	Bettler
verspielest	verspielest
Seil	Seil
fallest	fallest
gebietet	gebietet
Flussbett	Flussbett
analysiert	analysiert
verschreibt	verschreibt
tappten	tappten
wechseln	wechseln
simuliertet	simuliertet
Erstlinge	Erstlinge
dürften	dürften
beanspruchet	beanspruchet
Reisebüros	Reisebüros
Aggressor	Aggressor
Sitz	Sitz
Meinem	Meinem
Erbsen	Erbsen
Tumulten	Tumulten
Hure	Hure
bezichtigt	bezichtigt
erwachend	erwachend
Mischung	Mischung
Anführern	Anführern
Renegat	Renegat
batest	batest
Versorgungen	Versorgungen
Antitranspiranten	Antitranspiranten
spurtest	spurtest
Strahlentierchen	Strahlentierchen
Sinnen	Sinnen
Alibi	Alibi
schmelzt	schmelzt
Massage	Massage
urteilte	urteilte
zählet	zählet
Philerast	Philerast
verdammen	verdammen
entsetzt	entsetzt
warne	warne
skypst	skypst
verlähmte	verlähmte
Lazarett	Lazarett
Klärungen	Klärungen
Germanist	Germanist
versuchten	versuchten
Innenministerien	Innenministerien
haust	haust
christianisiere	christianisiere
Gehör	Gehör
wacht	wacht
fälle	fälle
Säue	Säue
Nachteilen	Nachteilen
gedenke	gedenke
Schatten	Schatten
Weinberge	Weinberge
stimmet	stimmet
vermöge	vermöge
überwachest	überwachest
Gängen	Gängen
Ausländer	Ausländer
nütze	nütze
strullerst	strullerst
putzt	putzt
überführt	überführt
verseifet	verseifet
Weh	Weh
messen	messen
Nullpunkt	Nullpunkt
gereicht	gereicht
schämet	schämet
begruben	begruben
fabuliere	fabuliere
Kompromiss	Kompromiss
Trägergas	Trägergas
Fusselbart	Fusselbart
zentrierest	zentrierest
panaschieren	panaschieren
beschwindele	beschwindele
leuchtete	leuchtete
Abbindebeschleunigern	Abbindebeschleunigern
erlöst	erlöst
formulierst	formulierst
dirigiert	dirigiert
recycelten	recycelten
Blumenstrauß	Blumenstrauß
anzögen	anzögen
musizierte	musizierte
sterilisierte	sterilisierte
Schwächung	Schwächung
Schlange	Schlange
Preis	Preis
Substanzen	Substanzen
Genkinit	Genkinit
erntest	erntest
sabbelt	sabbelt
Heuschrecke	Heuschrecke
halbe	halbe
Zahnfleischentzündung	Zahnfleischentzündung
Sprichwörtern	Sprichwörtern
Galoppen	Galoppen
Maultiere	Maultiere
warntest	warntest
Oberlandesgericht	Oberlandesgericht
kollidierten	kollidierten
harren	harren
behütetest	behütetest
vandaliere	vandaliere
lohnt	lohnt
UND-Gattern	UND-Gattern
malträtiert	malträtiert
Tübinger	Tübinger
vertilgest	vertilgest
Händen	Händen
Linke	Linke
zerstückte	zerstückte
konnotierst	konnotierst
blamierte	blamierte
beförderet	beförderet
gehetzt	gehetzt
Agoraphobie	Agoraphobie
begeben	begeben
repräsentierten	repräsentierten
Blättchen	Blättchen
Rückumschlägen	Rückumschlägen
geleite	geleite
grüßten	grüßten
Jungfernflug	Jungfernflug
Zeitbomben	Zeitbomben
Gläubiger	Gläubiger
stäupt	stäupt
schrecken	schrecken
Fußballweltmeisterschaftsqualifikationsspiel	Fußballweltmeisterschaftsqualifikationsspiel
Empörung	Empörung
ankerst	ankerst
feierst	feierst
Metonymie	Metonymie
dürfen	dürfen
obfuskierten	obfuskierten
schneidend	schneidend
Judenrat	Judenrat
Wänden	Wänden
Halbzeiten	Halbzeiten
begehrt	begehrt
wehre	wehre
koordinierte	koordinierte
Wechselstuben	Wechselstuben
Atombomben	Atombomben
beschwöre	beschwöre
Am	Am
Kapitalverkehr	Kapitalverkehr
Graben	Graben
Dachdeckerinnen	Dachdeckerinnen
Steuerbord	Steuerbord
Diamantringen	Diamantringen
lehren	lehren
willst	willst
duzen	duzen
predigt	predigt
steuerte	steuerte
fehle	fehle
Judenräte	Judenräte
Banketten	Banketten
suchet	suchet
Ach	Ach
funktioniertest	funktioniertest
begehrtest	begehrtest
Trickbetrügern	Trickbetrügern
Trümmersprache	Trümmersprache
Schwänzen	Schwänzen
wir	wir
lehret	lehret
Assistentinnen	Assistentinnen
Polyphosphat	Polyphosphat
Überziehen	Überziehen
Gepäckträgern	Gepäckträgern
Bushaltestellen	Bushaltestellen
Zerfall	Zerfall
Anmelder	Anmelder
Wachteln	Wachteln
herrschte	herrschte
verkehrte	verkehrte
überwiese	überwiese
glaubte	glaubte
addieret	addieret
begnügt	begnügt
absolviere	absolviere
Minischwein	Minischwein
ducktest	ducktest
wallfahrest	wallfahrest
sezierst	sezierst
Laie	Laie
Leide	Leide
plissieren	plissieren
Orten	Orten
Blockflöten	Blockflöten
Bächen	Bächen
fotzte	fotzte
bewässern	bewässern
Denunziationen	Denunziationen
benähmen	benähmen
Halsabschneider	Halsabschneider
merkte	merkte
bereitet	bereitet
Dinge	Dinge
Füchsinnen	Füchsinnen
Druckfehlern	Druckfehlern
Diäresen	Diäresen
Theologie	Theologie
Haarverlust	Haarverlust
Untier	Untier
streiten	streiten
besprächen	besprächen
reglementierte	reglementierte
Tust	Tust
Leiche	Leiche
spiele	spiele
fladerst	fladerst
Rooibos	Rooibos
Bildpunkten	Bildpunkten
Teppiche	Teppiche
wären	wären
steinigte	steinigte
denen	denen
Bevölkerungsdichten	Bevölkerungsdichten
Sogen	Sogen
weg	weg
verblutete	verblutete
konsumieren	konsumieren
erkundigte	erkundigte
Steuerberater	Steuerberater
Gehorcht	Gehorcht
verzieht	verzieht
verseuchen	verseuchen
Fischer	Fischer
gehorchest	gehorchest
rufen	rufen
knusperst	knusperst
baue	baue
Alteritäten	Alteritäten
kreieren	kreieren
erlagst	erlagst
beißt	beißt
gehet	gehet
Körpergeruches	Körpergeruches
Machet	Machet
verführt	verführt
schäme	schäme
befestigte	befestigte
Massagen	Massagen
helle	helle
Münzsammlungen	Münzsammlungen
träumen	träumen
überfischte	überfischte
veranstalten	veranstalten
verkündiget	verkündiget
Marjellchens	Marjellchens
Europameisters	Europameisters
endlagerten	endlagerten
Suche	Suche
Buche	Buche
Zäumen	Zäumen
ziehst	ziehst
Abhängen	Abhängen
frohlocke	frohlocke
Weichlote	Weichlote
erwärmte	erwärmte
Äste	Äste
wegführe	wegführe
Rückumschlages	Rückumschlages
emigriert	emigriert
lang	lang
rächte	rächte
anrührte	anrührte
Kommst	Kommst
zerrüttete	zerrüttete
Chasaren	Chasaren
Rotzinkerz	Rotzinkerz
zersetzte	zersetzte
zagt	zagt
belohnte	belohnte
verdammten	verdammten
Bluff	Bluff
Asthenosphäre	Asthenosphäre
niemanden	niemanden
Äquatoren	Äquatoren
schwellen	schwellen
Kornnattern	Kornnattern
vibrierend	vibrierend
Feuerteufels	Feuerteufels
erfreute	erfreute
verschlimmerte	verschlimmerte
assimiliertest	assimiliertest
Rotscheitelreiher	Rotscheitelreiher
verblieben	verblieben
verschärftet	verschärftet
Lautschrift	Lautschrift
blondieret	blondieret
frohlockten	frohlockten
fresse	fresse
nötige	nötige
Silbersulfidbelag	Silbersulfidbelag
setztet	setztet
vermögen	vermögen
Zapfhahn	Zapfhahn
plaziert	plaziert
gedenkest	gedenkest
verletzte	verletzte
geknautscht	geknautscht
bereitend	bereitend
Weihe	Weihe
Beobachtungen	Beobachtungen
überliefere	überliefere
Mähnenwölfen	Mähnenwölfen
kostet	kostet
fasse	fasse
ratet	ratet
Reisebüro	Reisebüro
Gehilfen	Gehilfen
Kortholt	Kortholt
boßte	boßte
Weinet	Weinet
verlassen	verlassen
Stiefmütterchen	Stiefmütterchen
hydrolysierest	hydrolysierest
regeln	regeln
Schwarzseherin	Schwarzseherin
Reststoff	Reststoff
Regenten	Regenten
Operationssaal	Operationssaal
Unterschlagung	Unterschlagung
Laubbläser	Laubbläser
austilgen	austilgen
Buntspechte	Buntspechte
diversifiziert	diversifiziert
Aluminaten	Aluminaten
Gebirge	Gebirge
malet	malet
Fluoratome	Fluoratome
karikierten	karikierten
ramme	ramme
betätigest	betätigest
fluppen	fluppen
amenagiere	amenagiere
Fanatiker	Fanatiker
Harpunen	Harpunen
Tanne	Tanne
Gummibaumes	Gummibaumes
Zubrötchen	Zubrötchen
Gemütes	Gemütes
anzeigen	anzeigen
Insulaner	Insulaner
Noseanen	Noseanen
Seilen	Seilen
Malaysier	Malaysier
helfest	helfest
Regenwald	Regenwald
eroberte	eroberte
Gedicht	Gedicht
Imperialismen	Imperialismen
stigmatisierst	stigmatisierst
entschädiget	entschädiget
Grieße	Grieße
touchierte	touchierte
Leichtmetalle	Leichtmetalle
herrschest	herrschest
Finanzminister	Finanzminister
missverstände	missverstände
abziehen	abziehen
schaben	schaben
prosteten	prosteten
Hurriter	Hurriter
Briten	Briten
besitzet	besitzet
herrschen	herrschen
Organistin	Organistin
fehlen	fehlen
privatisierest	privatisierest
überdenkend	überdenkend
Weste	Weste
Heben	Heben
Stör	Stör
grienest	grienest
Schreiber	Schreiber
Reinstoff	Reinstoff
Gästen	Gästen
redetest	redetest
Namen	Namen
hoben	hoben
sollt	sollt
Trübsale	Trübsale
sorget	sorget
Propheten	Propheten
Toten	Toten
bündelest	bündelest
Rotgusses	Rotgusses
höbe	höbe
Küstenwachen	Küstenwachen
verbündest	verbündest
dingte	dingte
holst	holst
Atemlüfte	Atemlüfte
zürnte	zürnte
Kuckucke	Kuckucke
erhöhet	erhöhet
dechiffriere	dechiffriere
zähltet	zähltet
zerbrechen	zerbrechen
Ringe	Ringe
Ionen	Ionen
verdamme	verdamme
Vogelscheuchen	Vogelscheuchen
wechselte	wechselte
Dessous	Dessous
Verbindungsdrähten	Verbindungsdrähten
Gram	Gram
Rückumlauten	Rückumlauten
Brüder	Brüder
Öfchens	Öfchens
dienet	dienet
ritzten	ritzten
Fallt	Fallt
Grießen	Grießen
Röcke	Röcke
Polarisation	Polarisation
verführest	verführest
Ärzteblatt	Ärzteblatt
Jüngern	Jüngern
zeugen	zeugen
Kindergeld	Kindergeld
Sabbatjahre	Sabbatjahre
respektiert	respektiert
sagten	sagten
Kruste	Kruste
höben	höben
koexistierten	koexistierten
gehorchten	gehorchten
Wadenbein	Wadenbein
käbbelte	käbbelte
Gut	Gut
Verdacht	Verdacht
setzen	setzen
durften	durften
Stempeluhren	Stempeluhren
verfehle	verfehle
Brotkästen	Brotkästen
Weinstöcke	Weinstöcke
Landwirte	Landwirte
ruckeln	ruckeln
implodier	implodier
musizieret	musizieret
explodierten	explodierten
gönnst	gönnst
verhörest	verhörest
Broten	Broten
downloadet	downloadet
hebst	hebst
versklavt	versklavt
Aacheners	Aacheners
designierst	designierst
schämest	schämest
ackerest	ackerest
verfliegest	verfliegest
konntet	konntet
Neumonde	Neumonde
tage	tage
Zunge	Zunge
Schneepflüge	Schneepflüge
Großfürst	Großfürst
Unternehmensanwendungsintegrationen	Unternehmensanwendungsintegrationen
gehörten	gehörten
Wunden	Wunden
Eistaucher	Eistaucher
kreierten	kreierten
krähte	krähte
verziehst	verziehst
verkürzte	verkürzte
entgehst	entgehst
Gläubige	Gläubige
meines	meines
Saiblinge	Saiblinge
Extrems	Extrems
Borhydride	Borhydride
geleitet	geleitet
Atemgasen	Atemgasen
Wadenbeines	Wadenbeines
Felle	Felle
mogelten	mogelten
verscheißert	verscheißert
Talismanen	Talismanen
begrabest	begrabest
Feiertagen	Feiertagen
Schleppern	Schleppern
solchem	solchem
schleißt	schleißt
erweckst	erweckst
nächsten	nächsten
rekrutierest	rekrutierest
begebe	begebe
harmonierte	harmonierte
Eingaben	Eingaben
Bube	Bube
emaillieret	emaillieret
Krieg	Krieg
mobilisierten	mobilisierten
prediget	prediget
vertraute	vertraute
Gäste	Gäste
drifte	drifte
schreibst	schreibst
brechen	brechen
Stäbe	Stäbe
stammelest	stammelest
Korrosionsschutz	Korrosionsschutz
sabbere	sabbere
Gebäcken	Gebäcken
Beschuldigungen	Beschuldigungen
Pfahl	Pfahl
frottierten	frottierten
Isobar	Isobar
regiert	regiert
addieren	addieren
Geigerzähler	Geigerzähler
stolze	stolze
bemüht	bemüht
Sanatoriums	Sanatoriums
Soge	Soge
Coventrisierung	Coventrisierung
fokussierten	fokussierten
verprügelte	verprügelte
beißet	beißet
sollst	sollst
Hackern	Hackern
Dattel	Dattel
Tintenfisch	Tintenfisch
generiert	generiert
blasen	blasen
Herde	Herde
Bär	Bär
Recht	Recht
Rubine	Rubine
Denkmünze	Denkmünze
bekennet	bekennet
Emmer	Emmer
begründetest	begründetest
gesagt	gesagt
Ehre	Ehre
Eisenkraut	Eisenkraut
strafte	strafte
Erstlingen	Erstlingen
zerstreute	zerstreute
zuteil	zuteil
Trübsal	Trübsal
sehet	sehet
stoße	stoße
narren	narren
Zeitplanes	Zeitplanes
deponiere	deponiere
Schwirrvogel	Schwirrvogel
Kronsbeere	Kronsbeere
kennest	kennest
wärme	wärme
assimilieret	assimilieret
meinem	meinem
nähe	nähe
schnappet	schnappet
Sauberfrau	Sauberfrau
Konifere	Konifere
streuen	streuen
sorgte	sorgte
Seiten	Seiten
erniedrigst	erniedrigst
wiederholten	wiederholten
harrtest	harrtest
erzwinget	erzwinget
laufet	laufet
reichtest	reichtest
entwendet	entwendet
Ding	Ding
verselbstständige	verselbstständige
imitiert	imitiert
Sekten	Sekten
Dorngesträuch	Dorngesträuch
Zinkat	Zinkat
Höhlen	Höhlen
linstest	linstest
labe	labe
sinke	sinke
Zensus	Zensus
Soll	Soll
Anspielungen	Anspielungen
Schlagzeugern	Schlagzeugern
baust	baust
Bienenzüchter	Bienenzüchter
Grüße	Grüße
stationierten	stationierten
Paillette	Paillette
Technetaten	Technetaten
weiche	weiche
Kohlen	Kohlen
Rechnungen	Rechnungen
sichere	sichere
Rücktritt	Rücktritt
Bajonetten	Bajonetten
Petersfischen	Petersfischen
dritte	dritte
kräusle	kräusle
wurstelten	wurstelten
mühte	mühte
widerstand	widerstand
vermahnte	vermahnte
pfänden	pfänden
Urbare	Urbare
beichten	beichten
redetet	redetet
binde	binde
Kopfsalaten	Kopfsalaten
Spektroskopie	Spektroskopie
Epidemien	Epidemien
besäen	besäen
läute	läute
parfümierst	parfümierst
eingeht	eingeht
Pläsieren	Pläsieren
müssest	müssest
Schaffnerin	Schaffnerin
durfte	durfte
Katamarane	Katamarane
übersehest	übersehest
bewähret	bewähret
Managementsystemen	Managementsystemen
Datentypen	Datentypen
Rhabarbern	Rhabarbern
Einrad	Einrad
Stimme	Stimme
verantwortet	verantwortet
besetzest	besetzest
gehorchet	gehorchet
Astats	Astats
Gespenstern	Gespenstern
merke	merke
schreiben	schreiben
pflügest	pflügest
umarbeiten	umarbeiten
erzeigt	erzeigt
Unterseite	Unterseite
Sorgen	Sorgen
wichsten	wichsten
bequemen	bequemen
verhungerte	verhungerte
dürfte	dürfte
überschneidet	überschneidet
lärmte	lärmte
betrübet	betrübet
Zwingburgen	Zwingburgen
Hüftgelenken	Hüftgelenken
Epoxide	Epoxide
zerstreut	zerstreut
inspirierten	inspirierten
frevles	frevles
Verdachtes	Verdachtes
Blutgefäß	Blutgefäß
sterbet	sterbet
orgelt	orgelt
Röcken	Röcken
faltest	faltest
erfüllt	erfüllt
stimme	stimme
bleibet	bleibet
Einwirkungen	Einwirkungen
wende	wende
ermordeten	ermordeten
Hallen	Hallen
Rechtsruck	Rechtsruck
dankte	dankte
Klappertöpfen	Klappertöpfen
Angabe	Angabe
faul	faul
Android	Android
überreicht	überreicht
folgst	folgst
kurz	kurz
Edelsteine	Edelsteine
Schreibtischtätern	Schreibtischtätern
zappen	zappen
desertiertet	desertiertet
murmelst	murmelst
Märchenbuches	Märchenbuches
vertagt	vertagt
kichern	kichern
Streife	Streife
Türmen	Türmen
Preisanstieg	Preisanstieg
Notizen	Notizen
Greyerzer	Greyerzer
erstürmt	erstürmt
werde	werde
Krokus	Krokus
Päckchens	Päckchens
manövrierte	manövrierte
könnest	könnest
verstehet	verstehet
duzet	duzet
deponierte	deponierte
Aktivisten	Aktivisten
fragmentiert	fragmentiert
Sanatorien	Sanatorien
beauftragt	beauftragt
Gigapascal	Gigapascal
schlafet	schlafet
Essigsäurechlorid	Essigsäurechlorid
entmineralisierst	entmineralisierst
Blumensträußen	Blumensträußen
Malaysiers	Malaysiers
Pfunde	Pfunde
verseift	verseift
besichtigt	besichtigt
versucht	versucht
schaffe	schaffe
wurdet	wurdet
spekulieren	spekulieren
substituieren	substituieren
klagte	klagte
erscheine	erscheine
Gewinnung	Gewinnung
Suffixen	Suffixen
erlassen	erlassen
Welteninseln	Welteninseln
Finanzministerien	Finanzministerien
Temperaturanstieg	Temperaturanstieg
strullerte	strullerte
Banden	Banden
charakterisiert	charakterisiert
Silbergeschirr	Silbergeschirr
Ich	Ich
eigenen	eigenen
drillte	drillte
betrübend	betrübend
Pfarrerinnen	Pfarrerinnen
Chlorats	Chlorats
Acetat	Acetat
injiziert	injiziert
Bilderstürmereien	Bilderstürmereien
verwechseltet	verwechseltet
grünen	grünen
Bonzen	Bonzen
sprichst	sprichst
ausführte	ausführte
klaget	klaget
imprägniere	imprägniere
liebet	liebet
knusperten	knusperten
illustriertet	illustriertet
fluchet	fluchet
falle	falle
meinte	meinte
Achseln	Achseln
touchiere	touchiere
werdet	werdet
rauschte	rauschte
beben	beben
Sollte	Sollte
verunreinigst	verunreinigst
gaffest	gaffest
Portale	Portale
strafe	strafe
sagst	sagst
replizieret	replizieret
beichteten	beichteten
trompetete	trompetete
rodete	rodete
Spitzen	Spitzen
fluchte	fluchte
geloben	geloben
implodiere	implodiere
segelte	segelte
sprecht	sprecht
Bilderstürmers	Bilderstürmers
Tischen	Tischen
belauerten	belauerten
Hainbuche	Hainbuche
Coventrisierungen	Coventrisierungen
wärst	wärst
Rabe	Rabe
Schickse	Schickse
idealisieret	idealisieret
schnappt	schnappt
rebellieret	rebellieret
gleich	gleich
Asteroid	Asteroid
Fluoratom	Fluoratom
lehre	lehre
ihn	ihn
Geliebte	Geliebte
gehorcht	gehorcht
Vergeltungen	Vergeltungen
koordinieret	koordinieret
verrosteten	verrosteten
Klärung	Klärung
Amt	Amt
Effekten	Effekten
maßen	maßen
bauten	bauten
Deutung	Deutung
verstecken	verstecken
Klappertopf	Klappertopf
ärger	ärger
vertrage	vertrage
emailliert	emailliert
fassest	fassest
Heteroatome	Heteroatome
aufkommt	aufkommt
halt	halt
Fahlflanken-Ameisenwürger	Fahlflanken-Ameisenwürger
überbewerte	überbewerte
grünt	grünt
wahr	wahr
Geburtsnamen	Geburtsnamen
beansprucht	beansprucht
verhören	verhören
wallfahrteten	wallfahrteten
zürnest	zürnest
demoralisiere	demoralisiere
Blitze	Blitze
platzt	platzt
Ächselchen	Ächselchen
antworte	antworte
offenbarten	offenbarten
Elle	Elle
Bist	Bist
streifte	streifte
zerstreust	zerstreust
vergast	vergast
versteigernd	versteigernd
bürsteten	bürsteten
aufhoben	aufhoben
brecht	brecht
Gewinnungen	Gewinnungen
Bifurkationen	Bifurkationen
verbrauchte	verbrauchte
betreibet	betreibet
bürsten	bürsten
verbündet	verbündet
beklage	beklage
Autonomie	Autonomie
Amputierten	Amputierten
glänzten	glänzten
bandagiert	bandagiert
umkäme	umkäme
Teilen	Teilen
funzt	funzt
betonierte	betonierte
haltet	haltet
Sonnenfinsternis	Sonnenfinsternis
fallen	fallen
Kalifeldspate	Kalifeldspate
Gefäßen	Gefäßen
erstarrten	erstarrten
erforscht	erforscht
befördert	befördert
erziehst	erziehst
infizieret	infizieret
liebtet	liebtet
Bushaltestelle	Bushaltestelle
Wüste	Wüste
WebHooks	WebHooks
maß	maß
bewahrest	bewahrest
Lusitaners	Lusitaners
hydrolysierend	hydrolysierend
desertierst	desertierst
Sprecher	Sprecher
handhabt	handhabt
räumen	räumen
teil	teil
Leitkegel	Leitkegel
geniertest	geniertest
Rußen	Rußen
folgen	folgen
Briefköpfen	Briefköpfen
separieret	separieret
Teile	Teile
Pfandgeld	Pfandgeld
Schönredner	Schönredner
Wehre	Wehre
vereinigte	vereinigte
glaubet	glaubet
Hände	Hände
Adelungen	Adelungen
schmuggelest	schmuggelest
Jünger	Jünger
Lärche	Lärche
Stechpalmen	Stechpalmen
nötig	nötig
überstehend	überstehend
gereichte	gereichte
Geschichtsbücher	Geschichtsbücher
Kontrollkästchen	Kontrollkästchen
Ersten	Ersten
fotzt	fotzt
kooperierte	kooperierte
Lehrbücher	Lehrbücher
schämten	schämten
gedenkst	gedenkst
ungefälschtem	ungefälschtem
Hinkelsteine	Hinkelsteine
pharyngalisierst	pharyngalisierst
preise	preise
funkeln	funkeln
überlieferten	überlieferten
Schote	Schote
Panzerschrecke	Panzerschrecke
Rückwege	Rückwege
Zirkelbeweis	Zirkelbeweis
ummantle	ummantle
Seelöwen	Seelöwen
Kassiterits	Kassiterits
Marokkanern	Marokkanern
scheitertet	scheitertet
Noseans	Noseans
bitte	bitte
bestraft	bestraft
Ackerschachtelhalm	Ackerschachtelhalm
Feinde	Feinde
zuppte	zuppte
Handbuch	Handbuch
erriet	erriet
Träumer	Träumer
Muhme	Muhme
Optimisten	Optimisten
verselbstständigest	verselbstständigest
fließen	fließen
Teufeln	Teufeln
beeinflusste	beeinflusste
fahret	fahret
rede	rede
Otaviten	Otaviten
bereits	bereits
verwaisten	verwaisten
hassest	hassest
Tiefschutzen	Tiefschutzen
enttäuschtest	enttäuschtest
sedimentiert	sedimentiert
grüßest	grüßest
Paralipse	Paralipse
alarmieren	alarmieren
Geringschätzung	Geringschätzung
arm	arm
amenagieren	amenagieren
Ankern	Ankern
Setzet	Setzet
Tukanen	Tukanen
Kerls	Kerls
hadere	hadere
Wollte	Wollte
bedenken	bedenken
entwickele	entwickele
verknüpft	verknüpft
hilft	hilft
Animation	Animation
entmineralisierten	entmineralisierten
Smaragdkehlkolibris	Smaragdkehlkolibris
ältesten	ältesten
denaturieret	denaturieret
mopsend	mopsend
setzten	setzten
Knüppels	Knüppels
funkelet	funkelet
bewiese	bewiese
bewerbet	bewerbet
Palisade	Palisade
glaubt	glaubt
Grabe	Grabe
Lobet	Lobet
bauet	bauet
pflücke	pflücke
Mikrowellenfilter	Mikrowellenfilter
ringen	ringen
pendele	pendele
Traubenlese	Traubenlese
prostituierte	prostituierte
kapiertet	kapiertet
Genkinits	Genkinits
verdammtet	verdammtet
kühle	kühle
bewahrst	bewahrst
Abtrünnigen	Abtrünnigen
Führe	Führe
unterwerfest	unterwerfest
versüßtet	versüßtet
behütet	behütet
klemmt	klemmt
Oxonium	Oxonium
abzieht	abzieht
Reiterschwert	Reiterschwert
lackieren	lackieren
erforschet	erforschet
Laubbläsern	Laubbläsern
einigte	einigte
umbrächte	umbrächte
scherzt	scherzt
begehrtet	begehrtet
Funktionalität	Funktionalität
Donnerstagabenden	Donnerstagabenden
gedächten	gedächten
dekompiliertest	dekompiliertest
hegt	hegt
meißeltest	meißeltest
Dans	Dans
auflöste	auflöste
überwachten	überwachten
präsentier	präsentier
revoltierte	revoltierte
Iberer	Iberer
Kriegsschauplatz	Kriegsschauplatz
nahest	nahest
benütztest	benütztest
fluppe	fluppe
geschämt	geschämt
regieret	regieret
gepuddelt	gepuddelt
taufst	taufst
Dich	Dich
entwickelten	entwickelten
Bruchstrich	Bruchstrich
Bäche	Bäche
Abschiedsbrief	Abschiedsbrief
raubte	raubte
härten	härten
erforschest	erforschest
Früchte	Früchte
schwirrt	schwirrt
verkündigst	verkündigst
erwärmet	erwärmet
Verwundete	Verwundete
Dominicanerin	Dominicanerin
überprüftest	überprüftest
Biene	Biene
verzweifelten	verzweifelten
Eiszapfen	Eiszapfen
Patres	Patres
zwölfte	zwölfte
Setzt	Setzt
widmet	widmet
überweiset	überweiset
gründen	gründen
unterwerft	unterwerft
beschlug	beschlug
umbrächten	umbrächten
nahe	nahe
Regiert	Regiert
verspäteten	verspäteten
naschst	naschst
hieltest	hieltest
Gemüseläden	Gemüseläden
Rundbriefen	Rundbriefen
Sucht	Sucht
Atemluft	Atemluft
Freizeitzentren	Freizeitzentren
grabest	grabest
quietsche	quietsche
verbot	verbot
machest	machest
Testamenten	Testamenten
spielet	spielet
überreichst	überreichst
verständig	verständig
Meinen	Meinen
Schauet	Schauet
Autoklaven	Autoklaven
erzeige	erzeige
Drohkulisse	Drohkulisse
esset	esset
Abfertigungsschalter	Abfertigungsschalter
sei	sei
spaltetest	spaltetest
glühende	glühende
Barbareien	Barbareien
raubet	raubet
Ratsherren	Ratsherren
Panamaer	Panamaer
Brieftaubenzüchters	Brieftaubenzüchters
lochtest	lochtest
zieren	zieren
verteidigte	verteidigte
löst	löst
Dewargefäß	Dewargefäß
Reinstoffen	Reinstoffen
Zeugnisse	Zeugnisse
zwingst	zwingst
Konzentrate	Konzentrate
Abartigkeit	Abartigkeit
Aktienkurs	Aktienkurs
Lehne	Lehne
sehnet	sehnet
aufnahmen	aufnahmen
sage	sage
versuchtet	versuchtet
Nehmt	Nehmt
Anführer	Anführer
wilde	wilde
fladerten	fladerten
rebelliere	rebelliere
Friede	Friede
stapfst	stapfst
Zeitbombe	Zeitbombe
vandalieren	vandalieren
vermag	vermag
Teufel	Teufel
Büchereien	Büchereien
glaubst	glaubst
Zehen	Zehen
gewinne	gewinne
Silberdrahts	Silberdrahts
Bis	Bis
schnitten	schnitten
fluppst	fluppst
Stärket	Stärket
stehest	stehest
Fahlflanken-Ameisenwürgern	Fahlflanken-Ameisenwürgern
posiertet	posiertet
bequemtet	bequemtet
brichst	brichst
Linien	Linien
erzürnt	erzürnt
erkanntet	erkanntet
verstehest	verstehest
drosselten	drosselten
backt	backt
geleitest	geleitest
helft	helft
gelobet	gelobet
ab	ab
flirre	flirre
Brechnuss	Brechnuss
Sonderbericht	Sonderbericht
ärgerte	ärgerte
Zapfen	Zapfen
wehr	wehr
Omnibusse	Omnibusse
bekriegt	bekriegt
Raben	Raben
durchläutert	durchläutert
Volltreffer	Volltreffer
vertiefe	vertiefe
jemanden	jemanden
argumentierten	argumentierten
Schwan	Schwan
stirbst	stirbst
Treibhausgase	Treibhausgase
denaturierte	denaturierte
einernten	einernten
entgehe	entgehe
Werk	Werk
begehret	begehret
segmentierten	segmentierten
inneren	inneren
Kaliumdichromat	Kaliumdichromat
legend	legend
schützt	schützt
verbärgen	verbärgen
verführte	verführte
Schaffet	Schaffet
blitzen	blitzen
lavierend	lavierend
laben	laben
versuche	versuche
Markisen	Markisen
Gicht	Gicht
Füchsin	Füchsin
strafet	strafet
Qualifikationen	Qualifikationen
Fiesling	Fiesling
Wille	Wille
zeugtest	zeugtest
ziert	ziert
speist	speist
Einzelgänger	Einzelgänger
Gründungsprivileg	Gründungsprivileg
More	More
Deuterium	Deuterium
grüntet	grüntet
möchtet	möchtet
hüten	hüten
heiligest	heiligest
protokollierst	protokollierst
Lüsten	Lüsten
Brechnüssen	Brechnüssen
warntet	warntet
Erstarren	Erstarren
Trinket	Trinket
Ende	Ende
legest	legest
elften	elften
fabuliert	fabuliert
vertilgst	vertilgst
Bärenfellen	Bärenfellen
feiere	feiere
stützet	stützet
junge	junge
Gewalttäter	Gewalttäter
erstände	erstände
heischten	heischten
Jahre	Jahre
Euphemismus	Euphemismus
Schlager	Schlager
klappst	klappst
Almanache	Almanache
verhalten	verhalten
reichtet	reichtet
Heuschrecken	Heuschrecken
Fallet	Fallet
demütigst	demütigst
befehle	befehle
Volkslehren	Volkslehren
anrichtet	anrichtet
verunzierte	verunzierte
Frage	Frage
erben	erben
zerfetzt	zerfetzt
malochet	malochet
Gebeten	Gebeten
bestimmten	bestimmten
mischt	mischt
verschlimmere	verschlimmere
Elementarzelle	Elementarzelle
Trinkgefäße	Trinkgefäße
Vetter	Vetter
betrübte	betrübte
stiegen	stiegen
Theologien	Theologien
Provinz	Provinz
halle	halle
heiligem	heiligem
Taschenwörterbuch	Taschenwörterbuch
formirte	formirte
pensionierest	pensionierest
verglichest	verglichest
laute	laute
Autonomien	Autonomien
Beile	Beile
zwölften	zwölften
Fanmeile	Fanmeile
Gute	Gute
Schneepflug	Schneepflug
löstet	löstet
verlähmt	verlähmt
verschicket	verschicket
Trickbetrüger	Trickbetrüger
Eiszapfens	Eiszapfens
Konfitüren	Konfitüren
Bleigehalt	Bleigehalt
entzögen	entzögen
massakrierten	massakrierten
Schnittlauch	Schnittlauch
Aha-Erlebnis	Aha-Erlebnis
misstrauet	misstrauet
langweilst	langweilst
polymerisier	polymerisier
Komponisten	Komponisten
hegten	hegten
Dochte	Dochte
deutete	deutete
ein	ein
bombardiere	bombardiere
erstaunst	erstaunst
vertilgen	vertilgen
scheinen	scheinen
Habt	Habt
Ebenen	Ebenen
grausten	grausten
zerstreuest	zerstreuest
bediene	bediene
greinen	greinen
Chlorid	Chlorid
verludet	verludet
bekehrt	bekehrt
weichen	weichen
Beziehungen	Beziehungen
sinkest	sinkest
Gespenst	Gespenst
greifen	greifen
Fledermaus	Fledermaus
Werke	Werke
defragmentierest	defragmentierest
besprachen	besprachen
Nanosatelliten	Nanosatelliten
lochten	lochten
Brote	Brote
rauschen	rauschen
Blattgeweben	Blattgeweben
glühten	glühten
Aktivist	Aktivist
Skorpione	Skorpione
trödele	trödele
Ölfasses	Ölfasses
brause	brause
belohnten	belohnten
Bombardierungen	Bombardierungen
Quelle	Quelle
Prüfberichten	Prüfberichten
Senkung	Senkung
einführte	einführte
Negermusik	Negermusik
Boten	Boten
warnet	warnet
Fluorgehalte	Fluorgehalte
gebären	gebären
Adventskalender	Adventskalender
Massenanteil	Massenanteil
Arsenite	Arsenite
verdrängt	verdrängt
Lotterien	Lotterien
duschte	duschte
kriegen	kriegen
Blicksilber	Blicksilber
verkauft	verkauft
entheiligten	entheiligten
Bürzeln	Bürzeln
schmiert	schmiert
Notärztinnen	Notärztinnen
Gaunern	Gaunern
geleiteten	geleiteten
verkaufe	verkaufe
Honigbären	Honigbären
räumet	räumet
Alte	Alte
erwürgten	erwürgten
Gefilden	Gefilden
dresche	dresche
beschlaget	beschlaget
Pentaborat	Pentaborat
verwertete	verwertete
Fällen	Fällen
nähert	nähert
impfte	impfte
Theistinnen	Theistinnen
unterrichtet	unterrichtet
Besuchen	Besuchen
Aromastoffe	Aromastoffe
besorgend	besorgend
verfange	verfange
entschädigte	entschädigte
fügt	fügt
schauen	schauen
Kairiner	Kairiner
ringe	ringe
vernickelte	vernickelte
besprenget	besprenget
Bleiglanzes	Bleiglanzes
interpretiert	interpretiert
eingehst	eingehst
Küchenmaschine	Küchenmaschine
zentriert	zentriert
Hahnenkämmen	Hahnenkämmen
opferte	opferte
Arme	Arme
revoltiert	revoltiert
Premierministerinnen	Premierministerinnen
querte	querte
Kristallen	Kristallen
klumpt	klumpt
anrufen	anrufen
Gründungsprivilegien	Gründungsprivilegien
Gleitzeiten	Gleitzeiten
Stärkungsmittel	Stärkungsmittel
Beinen	Beinen
zähle	zähle
eiterten	eiterten
Hirt	Hirt
segeln	segeln
erlöset	erlöset
Atmosphäre	Atmosphäre
gedenk	gedenk
hegst	hegst
Politologe	Politologe
verzögerte	verzögerte
finanziert	finanziert
grüßt	grüßt
Würfelspiele	Würfelspiele
Panzerschreck	Panzerschreck
Fallen	Fallen
reizet	reizet
sehnte	sehnte
Reiterschwertern	Reiterschwertern
mühe	mühe
Ästen	Ästen
hämmerst	hämmerst
lebet	lebet
entkörperlichte	entkörperlichte
spähet	spähet
tränke	tränke
Reinigungsschrittes	Reinigungsschrittes
pflügen	pflügen
eingehet	eingehet
bedeckt	bedeckt
bespracht	bespracht
verbüßest	verbüßest
ringst	ringst
Pforten	Pforten
Innenschau	Innenschau
desensibilisierte	desensibilisierte
füsilierten	füsilierten
danke	danke
Regieren	Regieren
begnadigte	begnadigte
Inauguration	Inauguration
Fahrzeugkatalysatoren	Fahrzeugkatalysatoren
Pflicht	Pflicht
überschnitten	überschnitten
Metallquirle	Metallquirle
schmierte	schmierte
predigen	predigen
bedürftet	bedürftet
Mittelaltermarktes	Mittelaltermarktes
Glühwürmchen	Glühwürmchen
Blitzen	Blitzen
suchten	suchten
gestaltest	gestaltest
schenken	schenken
Politologen	Politologen
genehmigt	genehmigt
Büschen	Büschen
befürchtet	befürchtet
sinterte	sinterte
gedachten	gedachten
Planer	Planer
leider	leider
Wollt	Wollt
gewöhnte	gewöhnte
kämmt	kämmt
Wasserbädern	Wasserbädern
höbet	höbet
jammerte	jammerte
Bauwerke	Bauwerke
triebe	triebe
Darlegung	Darlegung
hauest	hauest
wünsche	wünsche
enge	enge
decken	decken
jappte	jappte
Afrikaner	Afrikaner
Geheimdienst	Geheimdienst
kabelst	kabelst
blamierest	blamierest
velarisierend	velarisierend
Monden	Monden
warte	warte
stifte	stifte
massierst	massierst
Prophet	Prophet
Kräfte	Kräfte
behauptete	behauptete
käbbelnd	käbbelnd
heiligte	heiligte
schwadronierten	schwadronierten
aase	aase
lesen	lesen
evaluiert	evaluiert
Mageninhalt	Mageninhalt
Kirgisin	Kirgisin
Schamentzündung	Schamentzündung
Hansen	Hansen
Tintenklecksen	Tintenklecksen
lögest	lögest
Chemikerinnen	Chemikerinnen
erpress	erpress
Beteiligten	Beteiligten
fällen	fällen
schickte	schickte
bestimmt	bestimmt
irrte	irrte
Radiergummi	Radiergummi
vergibt	vergibt
Numerus	Numerus
Augen	Augen
Steuerwagen	Steuerwagen
vierte	vierte
unterdrücke	unterdrücke
Stämmen	Stämmen
liste	liste
Tumult	Tumult
brennen	brennen
überfallen	überfallen
erklinge	erklinge
zensiere	zensiere
Erfahrung	Erfahrung
diskutierst	diskutierst
gewitterte	gewitterte
predigte	predigte
Worten	Worten
Tukans	Tukans
verdinglichest	verdinglichest
bejubelst	bejubelst
Nanoteslan	Nanoteslan
regelten	regelten
verteidigt	verteidigt
Sonderberichte	Sonderberichte
bekriegtet	bekriegtet
aufrichten	aufrichten
verbirgt	verbirgt
schaute	schaute
Düften	Düften
Arbeitsbereich	Arbeitsbereich
säume	säume
Molybdit	Molybdit
Säcke	Säcke
Auszügen	Auszügen
Tretlager	Tretlager
klöne	klöne
verbleibet	verbleibet
Adelung	Adelung
erlabe	erlabe
Blockflöte	Blockflöte
eingehest	eingehest
springen	springen
Asylrechten	Asylrechten
Tier	Tier
applizirst	applizirst
alarmiere	alarmiere
anrichten	anrichten
vertonet	vertonet
schwebe	schwebe
läutet	läutet
Taschenwörterbuches	Taschenwörterbuches
drosselt	drosselt
zerbrechest	zerbrechest
Nachteile	Nachteile
überweise	überweise
wehret	wehret
saht	saht
Rehböcken	Rehböcken
Privatsachen	Privatsachen
Girls	Girls
Leitungswegs	Leitungswegs
Radfahrern	Radfahrern
lautete	lautete
gleite	gleite
fliehe	fliehe
Dödel	Dödel
bräunen	bräunen
Assimilationen	Assimilationen
wegen	wegen
Kopfverletzungen	Kopfverletzungen
wähnet	wähnet
wälzt	wälzt
entfolgst	entfolgst
kehrte	kehrte
läuten	läuten
verwirrest	verwirrest
legten	legten
kämpfte	kämpfte
sabbre	sabbre
Regierung	Regierung
Volkslehre	Volkslehre
ersparte	ersparte
Aufpralle	Aufpralle
verunglimpfest	verunglimpfest
Schlagern	Schlagern
Kerzenfische	Kerzenfische
hinterlege	hinterlege
Kochfeldern	Kochfeldern
entdeckst	entdeckst
wert	wert
zerreißt	zerreißt
verunglimpfen	verunglimpfen
mußte	mußte
jammern	jammern
Betten	Betten
losest	losest
kämpfet	kämpfet
reinstitutionalisierten	reinstitutionalisierten
glaubend	glaubend
hüpfest	hüpfest
Gurt	Gurt
Diese	Diese
Butike	Butike
beweisen	beweisen
tätowiertet	tätowiertet
schätze	schätze
Blattgewebe	Blattgewebe
frevler	frevler
Flöten	Flöten
Bette	Bette
Abhänge	Abhänge
Bazziten	Bazziten
verstecke	verstecke
Gässchen	Gässchen
Sorget	Sorget
rüstetest	rüstetest
halten	halten
solcher	solcher
regiere	regiere
kommet	kommet
möppertet	möppertet
Fellen	Fellen
assimilierten	assimilierten
freute	freute
versteckte	versteckte
gelost	gelost
Kautschuke	Kautschuke
Drang	Drang
Erbse	Erbse
stolz	stolz
Steinen	Steinen
Sehne	Sehne
aufhebest	aufhebest
denaturiert	denaturiert
Assistentin	Assistentin
krösest	krösest
ruhe	ruhe
Zeilen	Zeilen
Wanderfalken	Wanderfalken
bimmelte	bimmelte
Generatoren	Generatoren
kosten	kosten
Merkel-Rauten	Merkel-Rauten
Fülle	Fülle
Klüften	Klüften
erratet	erratet
feiert	feiert
Hast	Hast
Spannt	Spannt
Dachdeckerin	Dachdeckerin
härte	härte
Tiegel	Tiegel
Bund	Bund
Stärke	Stärke
Zeitschlitzen	Zeitschlitzen
Freitagnachmittage	Freitagnachmittage
kritzeln	kritzeln
Dudelsack	Dudelsack
Atomphysiker	Atomphysiker
Treppe	Treppe
betreten	betreten
Gemeinde	Gemeinde
Argentit	Argentit
anhangen	anhangen
abweichet	abweichet
Beten	Beten
föchten	föchten
Ludwigsburger	Ludwigsburger
Kopfsalat	Kopfsalat
sponsertest	sponsertest
verifizieret	verifizieret
Zebrahai	Zebrahai
gehört	gehört
Laken	Laken
ersparen	ersparen
Staatsführungen	Staatsführungen
köderet	köderet
Empfängnisverhütungen	Empfängnisverhütungen
Aerosole	Aerosole
parametrisierst	parametrisierst
anhanget	anhanget
Geschäfte	Geschäfte
hell	hell
beliefen	beliefen
Gesetzen	Gesetzen
lodert	lodert
schmeicheln	schmeicheln
privilegiere	privilegiere
konstatiere	konstatiere
Aderhaut	Aderhaut
Mäusespeck	Mäusespeck
lehnen	lehnen
Grieche	Grieche
koexistierte	koexistierte
Trioxiden	Trioxiden
Pausbacken	Pausbacken
Königreiche	Königreiche
Bertrandite	Bertrandite
bekehrst	bekehrst
dehydrierten	dehydrierten
Schenken	Schenken
Maximierung	Maximierung
bewahrheitetet	bewahrheitetet
Bienen	Bienen
grünend	grünend
Kassettenrekordern	Kassettenrekordern
Besuch	Besuch
vernehmest	vernehmest
koste	koste
Kutter	Kutter
Fette	Fette
Kalifeldspat	Kalifeldspat
Lichte	Lichte
Schnitzeljagd	Schnitzeljagd
anzeigte	anzeigte
treibest	treibest
pflegst	pflegst
führte	führte
auflegte	auflegte
betrübtest	betrübtest
begrabe	begrabe
verliert	verliert
Briefwechsel	Briefwechsel
Haarverlusten	Haarverlusten
Gangster	Gangster
beweisest	beweisest
vollendest	vollendest
verdinglichtest	verdinglichtest
Lob	Lob
Hypochlorit	Hypochlorit
Dorsche	Dorsche
schreien	schreien
Aprikose	Aprikose
Acht	Acht
Rutheniumisotop	Rutheniumisotop
legst	legst
Kosten	Kosten
deute	deute
Denkmünzen	Denkmünzen
schlummerte	schlummerte
Transportwegen	Transportwegen
sorgen	sorgen
ausrufen	ausrufen
Schönrednern	Schönrednern
Lehrkörpern	Lehrkörpern
Excimerlasern	Excimerlasern
verzieret	verzieret
deren	deren
Abbildern	Abbildern
unterschieden	unterschieden
Schwächungen	Schwächungen
Dünungen	Dünungen
tanze	tanze
eggten	eggten
Prozedur	Prozedur
räucheret	räucheret
sollten	sollten
Provinzen	Provinzen
bist	bist
Verehrer	Verehrer
gedenkt	gedenkt
concessionieren	concessionieren
Almanachen	Almanachen
Lobgesänge	Lobgesänge
Übelkeit	Übelkeit
zuteilte	zuteilte
schlabberte	schlabberte
Scheißkerlen	Scheißkerlen
strandeten	strandeten
Pedanten	Pedanten
Pfleglingen	Pfleglingen
saget	saget
Monate	Monate
stutzt	stutzt
Hunde	Hunde
Regent	Regent
Freibergit	Freibergit
bat	bat
verfügten	verfügten
Zinkionen	Zinkionen
beanspruchest	beanspruchest
Feind	Feind
verzweifelt	verzweifelt
verbrauchet	verbrauchet
Wärt	Wärt
Abkürzungsverzeichnis	Abkürzungsverzeichnis
Maßen	Maßen
dechiffrierend	dechiffrierend
Würzen	Würzen
nimmst	nimmst
Decken	Decken
bewiest	bewiest
Letzten	Letzten
reformieren	reformieren
erbauet	erbauet
kaufet	kaufet
selbst	selbst
Darlehen	Darlehen
Honigbär	Honigbär
Schnittlauche	Schnittlauche
Erzeugungen	Erzeugungen
Jünglingen	Jünglingen
widerriefe	widerriefe
liebte	liebte
respektiere	respektiere
lauft	lauft
werte	werte
pflanzest	pflanzest
schreist	schreist
Antitranspirante	Antitranspirante
bereiten	bereiten
flambierten	flambierten
solches	solches
besichert	besichert
bange	bange
globalisieret	globalisieret
leiden	leiden
zerbricht	zerbricht
schießt	schießt
Abtrünnige	Abtrünnige
leget	leget
erhebst	erhebst
fallt	fallt
stellte	stellte
parametrisierte	parametrisierte
verwirklicht	verwirklicht
Beryll	Beryll
Schreibtischtäter	Schreibtischtäter
Fragen	Fragen
Mopps	Mopps
schlabbere	schlabbere
Schläfchen	Schläfchen
Feierabende	Feierabende
dirigieren	dirigieren
produzierest	produzierest
borgst	borgst
Binde	Binde
Radiergummis	Radiergummis
hasse	hasse
Rekursionen	Rekursionen
drängten	drängten
Trägerwellen	Trägerwellen
verringerten	verringerten
recycele	recycele
pfände	pfände
Trümmersprachen	Trümmersprachen
interagiert	interagiert
tappst	tappst
Buchstaben	Buchstaben
lehrest	lehrest
brauche	brauche
liebt	liebt
Bete	Bete
henken	henken
widmeten	widmeten
Schlangen	Schlangen
Ranzigkeit	Ranzigkeit
Montagmittag	Montagmittag
träge	träge
spracht	spracht
fahrt	fahrt
Trinkgefäßen	Trinkgefäßen
Wert	Wert
Hirsche	Hirsche
predigend	predigend
erwähnten	erwähnten
schließe	schließe
Bergsteiger	Bergsteiger
observiertest	observiertest
vermischten	vermischten
gewärtigten	gewärtigten
merken	merken
Fehden	Fehden
keulst	keulst
Atommodelle	Atommodelle
gelobte	gelobte
versuchte	versuchte
entzweit	entzweit
vereinbarten	vereinbarten
präsentiere	präsentiere
erfahret	erfahret
empörte	empörte
Abgaskatalysatoren	Abgaskatalysatoren
regen	regen
lebst	lebst
Wisset	Wisset
nähte	nähte
Samstagnachmittag	Samstagnachmittag
Bombardierung	Bombardierung
wisperest	wisperest
Gerichte	Gerichte
frische	frische
Laufet	Laufet
laden	laden
blamierten	blamierten
produzierten	produzierten
Gewalttätern	Gewalttätern
schweigen	schweigen
verbaseln	verbaseln
meldeten	meldeten
Stufe	Stufe
Ansteckern	Ansteckern
Galopps	Galopps
Arsenolithen	Arsenolithen
berufe	berufe
observierst	observierst
reglementiert	reglementiert
fließt	fließt
Azubi	Azubi
mußten	mußten
gelobe	gelobe
Kassiteriten	Kassiteriten
verderbet	verderbet
begehrest	begehrest
machet	machet
Galeeren	Galeeren
verkürztest	verkürztest
Gedanke	Gedanke
Raucherin	Raucherin
verkündigt	verkündigt
Kerzenlichter	Kerzenlichter
durchzuck	durchzuck
sortierest	sortierest
Schade	Schade
verstanden	verstanden
Autoklav	Autoklav
bedurftest	bedurftest
Schlagzeuger	Schlagzeuger
verglühest	verglühest
schwangt	schwangt
überprüfte	überprüfte
Adenosin	Adenosin
gehörte	gehörte
Geldautomat	Geldautomat
leer	leer
abtrünnigen	abtrünnigen
Armen	Armen
leset	leset
Jude	Jude
unterbrächen	unterbrächen
Käsereiben	Käsereiben
flirtete	flirtete
bekotete	bekotete
Rumänin	Rumänin
zerbräche	zerbräche
Buchstabe	Buchstabe
Donor	Donor
gabelst	gabelst
Mammut	Mammut
verschärfst	verschärfst
spalten	spalten
Cholesterin	Cholesterin
Solchen	Solchen
murmelte	murmelte
fetten	fetten
Kanzlerinnen	Kanzlerinnen
Einer	Einer
speichertest	speichertest
bebte	bebte
verfinstere	verfinstere
listeten	listeten
Schreibern	Schreibern
strecke	strecke
wünschtest	wünschtest
verbrauchten	verbrauchten
Metapher	Metapher
lachet	lachet
greinet	greinet
stürze	stürze
Band	Band
leistete	leistete
Industrienation	Industrienation
Lehrbüchern	Lehrbüchern
verlaßt	verlaßt
Pfeile	Pfeile
Paradiesapfel	Paradiesapfel
Lammfellhandschuhs	Lammfellhandschuhs
steiget	steiget
Jahren	Jahren
Tatsachenbeschönigern	Tatsachenbeschönigern
Anzeichens	Anzeichens
spezialisierst	spezialisierst
Idolatrien	Idolatrien
Füßen	Füßen
entsetzen	entsetzen
spannt	spannt
Räten	Räten
verjährest	verjährest
Tote	Tote
ölt	ölt
dürfe	dürfe
fehlet	fehlet
verbaselte	verbaselte
schon	schon
winkt	winkt
erlösen	erlösen
dekompilierten	dekompilierten
Nährmedien	Nährmedien
Beschuldigung	Beschuldigung
Fußbodens	Fußbodens
Androiden	Androiden
drängst	drängst
wehe	wehe
besuchen	besuchen
klappten	klappten
verringert	verringert
Ochs	Ochs
immunisiere	immunisiere
Biokraftstoffes	Biokraftstoffes
zweifelte	zweifelte
schwirret	schwirret
würde	würde
Stilllegungen	Stilllegungen
UND-Gatter	UND-Gatter
verflog	verflog
rekonstruieren	rekonstruieren
Dürre	Dürre
Domäne	Domäne
Ablösung	Ablösung
Altbau	Altbau
Arbeitsleistung	Arbeitsleistung
Einbrecher	Einbrecher
versuchst	versuchst
begründest	begründest
rüste	rüste
Elektrophil	Elektrophil
ernten	ernten
Nanokondensatoren	Nanokondensatoren
lüftetet	lüftetet
grüße	grüße
boykottierten	boykottierten
zerfielen	zerfielen
Spielen	Spielen
Plüschtier	Plüschtier
Sizilianer	Sizilianer
stirbt	stirbt
sterilisiert	sterilisiert
bedrückest	bedrückest
Märtyrer	Märtyrer
Mäppchen	Mäppchen
widerlegest	widerlegest
lange	lange
strafst	strafst
flieh	flieh
Hertz	Hertz
Kerzenfischen	Kerzenfischen
Zeitplan	Zeitplan
Den	Den
Atommassen	Atommassen
nachwandeln	nachwandeln
Radfahrer	Radfahrer
erwachet	erwachet
verzierten	verzierten
Mähnenwolf	Mähnenwolf
auszogen	auszogen
mampfen	mampfen
wohnte	wohnte
Bezeugungen	Bezeugungen
Ypecaharallen	Ypecaharallen
leid	leid
Schwänze	Schwänze
Landwirt	Landwirt
Abnahme	Abnahme
auflöst	auflöst
werfet	werfet
anrührt	anrührt
frikassiert	frikassiert
Telefonnummer	Telefonnummer
analysiere	analysiere
velarisiert	velarisiert
narret	narret
Automatikgetriebe	Automatikgetriebe
schubset	schubset
ehret	ehret
Wiederauferstehungen	Wiederauferstehungen
Flamen	Flamen
vergrubt	vergrubt
hobt	hobt
jaget	jaget
sterbt	sterbt
verleumdete	verleumdete
Gewicht	Gewicht
wallet	wallet
besänne	besänne
wallte	wallte
platz	platz
Glaubet	Glaubet
Helme	Helme
auszieht	auszieht
demütig	demütig
kabelten	kabelten
erzeigten	erzeigten
fabulierest	fabulierest
Ion	Ion
zeugst	zeugst
prangte	prangte
Schaffe	Schaffe
erobern	erobern
stärke	stärke
desensibilisierten	desensibilisierten
vermahnt	vermahnt
Ausländern	Ausländern
bestellten	bestellten
Paläste	Paläste
setztest	setztest
Altäre	Altäre
mißverstehet	mißverstehet
Willst	Willst
destabilisierte	destabilisierte
schleimte	schleimte
Jagdhunden	Jagdhunden
kremierten	kremierten
Kaufhäuser	Kaufhäuser
Küstenwache	Küstenwache
den	den
gratuliert	gratuliert
steigeret	steigeret
vertilgte	vertilgte
regieren	regieren
Halogenatom	Halogenatom
Kälber	Kälber
Herabsetzungen	Herabsetzungen
kooperierst	kooperierst
zirpe	zirpe
gönnest	gönnest
Gegenleistungen	Gegenleistungen
bereitete	bereitete
Thioester	Thioester
Fett	Fett
Schätze	Schätze
oxidierte	oxidierte
Inder	Inder
ermahnet	ermahnet
ackerst	ackerst
bedürft	bedürft
Luftschiff	Luftschiff
konnotieret	konnotieret
Buchhalterin	Buchhalterin
irren	irren
gewöhnt	gewöhnt
demütige	demütige
führst	führst
Deutungen	Deutungen
tust	tust
fülle	fülle
eigene	eigene
selber	selber
entstände	entstände
Gasflaschen	Gasflaschen
Metallspiegeln	Metallspiegeln
Beilen	Beilen
gebührt	gebührt
enträtselst	enträtselst
Physikerinnen	Physikerinnen
Grabbeltischen	Grabbeltischen
Hehlern	Hehlern
sedimentierte	sedimentierte
Anrufbeantworter	Anrufbeantworter
Sehnen	Sehnen
Traubenlesen	Traubenlesen
vertreibe	vertreibe
Graphem	Graphem
regierst	regierst
Ösophagospasmen	Ösophagospasmen
batet	batet
besorgt	besorgt
strecken	strecken
pendelt	pendelt
auszogst	auszogst
Abartigkeiten	Abartigkeiten
achten	achten
Kristalle	Kristalle
verkriechet	verkriechet
Kleptokratie	Kleptokratie
Peptids	Peptids
vermagst	vermagst
betrübst	betrübst
Lesen	Lesen
Dolde	Dolde
Elastomer	Elastomer
überweist	überweist
Buben	Buben
Körpergeruch	Körpergeruch
jaule	jaule
Testamente	Testamente
Citrat	Citrat
Zeitüberschreitung	Zeitüberschreitung
optimiert	optimiert
Ass	Ass
Gymnasien	Gymnasien
schimmerst	schimmerst
Welteninsel	Welteninsel
emittiert	emittiert
drangen	drangen
Wogen	Wogen
konnten	konnten
exmatrikuliertet	exmatrikuliertet
Düfte	Düfte
Eiland	Eiland
Rhodochrositen	Rhodochrositen
Fahret	Fahret
Schwirrvögel	Schwirrvögel
auszöge	auszöge
frikassierend	frikassierend
harmonierest	harmonierest
schonte	schonte
predige	predige
hasset	hasset
verbluten	verbluten
schreckt	schreckt
lachte	lachte
Dienstgrade	Dienstgrade
Herbstwinde	Herbstwinde
deklarierten	deklarierten
angehöret	angehöret
fastete	fastete
Drehtüren	Drehtüren
Fortsetzungen	Fortsetzungen
Aggressoren	Aggressoren
weisen	weisen
heiliget	heiliget
einführt	einführt
Eingabe	Eingabe
Kerl	Kerl
Ansteckers	Ansteckers
erschrickt	erschrickt
schwächend	schwächend
maximierten	maximierten
entfachet	entfachet
eggte	eggte
Montagmittagen	Montagmittagen
hingeht	hingeht
schaust	schaust
sedimentiere	sedimentiere
jappten	jappten
fritiert	fritiert
stillest	stillest
füllte	füllte
Zwergschwan	Zwergschwan
folge	folge
gebündelt	gebündelt
Schrei	Schrei
begehrten	begehrten
wünschst	wünschst
Selbstversuch	Selbstversuch
Seit	Seit
folget	folget
verschonet	verschonet
stiftest	stiftest
weh	weh
ringet	ringet
entert	entert
Malen	Malen
vereinbaren	vereinbaren
Ängste	Ängste
spekuliere	spekuliere
Kissenschlacht	Kissenschlacht
Aspartamen	Aspartamen
vernichtete	vernichtete
nehmt	nehmt
aufwacht	aufwacht
harrest	harrest
schauend	schauend
Grizzlybär	Grizzlybär
designiertet	designiertet
fladern	fladern
schläfst	schläfst
Bote	Bote
jaulst	jaulst
wachse	wachse
Gleitzeit	Gleitzeit
Finanzministern	Finanzministern
Bergen	Bergen
Robe	Robe
vermischen	vermischen
mineralisierten	mineralisierten
Weil	Weil
Tannen	Tannen
Werde	Werde
ahne	ahne
langte	langte
beeindrucket	beeindrucket
anrichte	anrichte
rufest	rufest
Physikerin	Physikerin
Klassenzimmern	Klassenzimmern
peiltest	peiltest
übrigbleibe	übrigbleibe
rote	rote
Achsel	Achsel
Ichs	Ichs
erlaube	erlaube
betrübtet	betrübtet
begebet	begebet
erlasset	erlasset
reagiert	reagiert
Jagdhund	Jagdhund
schwelle	schwelle
brillieret	brillieret
Locken	Locken
Kleptokratien	Kleptokratien
parkierten	parkierten
überqueren	überqueren
sprüht	sprüht
erstehet	erstehet
entzogen	entzogen
Halbgott	Halbgott
Ausbeuterei	Ausbeuterei
porträtiere	porträtiere
Maultieren	Maultieren
schwimmen	schwimmen
unterbrächest	unterbrächest
besetzen	besetzen
partitionierten	partitionierten
Floß	Floß
Wirte	Wirte
Magier	Magier
Geschrei	Geschrei
tastet	tastet
höhnest	höhnest
Reizt	Reizt
still	still
streute	streute
zuppst	zuppst
verkürze	verkürze
verfehlten	verfehlten
anzöge	anzöge
Knechten	Knechten
Attentäter	Attentäter
Hirnstämme	Hirnstämme
klönen	klönen
Störe	Störe
zeugest	zeugest
Forschungen	Forschungen
weichst	weichst
gesellt	gesellt
schätzt	schätzt
ungefälschter	ungefälschter
geräuchert	geräuchert
Brauhaus	Brauhaus
wünscht	wünscht
verspäte	verspäte
sponsert	sponsert
Dampfschiffen	Dampfschiffen
verdeckte	verdeckte
knurrtet	knurrtet
salz	salz
könnet	könnet
Abschirmung	Abschirmung
Gehorchet	Gehorchet
erlöse	erlöse
downloadete	downloadete
Arresten	Arresten
Überziehens	Überziehens
kürze	kürze
Badezimmers	Badezimmers
braust	braust
Markise	Markise
Botokuden	Botokuden
webte	webte
konvergierest	konvergierest
verachtet	verachtet
härtet	härtet
Zeitungsenten	Zeitungsenten
Selbstsicherheit	Selbstsicherheit
Jahr	Jahr
zeichnet	zeichnet
flirtest	flirtest
Klotzes	Klotzes
Premieren	Premieren
mußt	mußt
lispelt	lispelt
Kleinodien	Kleinodien
Bertrandit	Bertrandit
Knüppeln	Knüppeln
Naturen	Naturen
Füllfeder	Füllfeder
linke	linke
Löwe	Löwe
Meines	Meines
Nigger	Nigger
beeinflusst	beeinflusst
spricht	spricht
achte	achte
Enthärtungen	Enthärtungen
Gesamtmenge	Gesamtmenge
scheiterst	scheiterst
Trotzkist	Trotzkist
Mikrometern	Mikrometern
Herd	Herd
Kernspaltungen	Kernspaltungen
Äther	Äther
durchläuterte	durchläuterte
Gasflasche	Gasflasche
Treibhausgasen	Treibhausgasen
Hornunges	Hornunges
transportierst	transportierst
Breiten	Breiten
Fermium	Fermium
Tübingern	Tübingern
Döner	Döner
Sprachraum	Sprachraum
verdeckst	verdeckst
Eines	Eines
kochte	kochte
füllst	füllst
Ränken	Ränken
erzeigest	erzeigest
klingest	klingest
Schläfchens	Schläfchens
gewünscht	gewünscht
Bienenstock	Bienenstock
Gaschromatographie	Gaschromatographie
