reformieren	reformieren
Sucht	Sucht
besetzest	besetzest
Habe	Habe
wache	wache
fraget	fraget
jaule	jaule
zürntest	zürntest
führet	führet
dotiere	dotiere
Piratensender	Piratensender
beneidete	beneidete
erratet	erratet
Schreibtischtätern	Schreibtischtätern
Spirale	Spirale
Metonymie	Metonymie
erfreute	erfreute
zappen	zappen
Nadel	Nadel
Pläsier	Pläsier
ausführt	ausführt
einigte	einigte
gewähret	gewähret
beliefen	beliefen
Lautschrift	Lautschrift
Drohkulissen	Drohkulissen
fegte	fegte
bräunst	bräunst
erbauet	erbauet
Grieße	Grieße
Sonderberichte	Sonderberichte
lanciertet	lanciertet
Buche	Buche
berühret	berühret
verscheißerte	verscheißerte
Wucher	Wucher
Arsenbergwerk	Arsenbergwerk
gedenket	gedenket
bewiesen	bewiesen
vertuest	vertuest
durchzuckest	durchzuckest
Besuch	Besuch
Schau	Schau
dissentierten	dissentierten
machet	machet
Zehen	Zehen
bediene	bediene
Bundesgebiet	Bundesgebiet
könnest	könnest
Kerf	Kerf
Agoraphobie	Agoraphobie
Abschiedsbriefe	Abschiedsbriefe
bollerest	bollerest
drosselt	drosselt
klickte	klickte
zerbrechen	zerbrechen
koche	koche
betrübten	betrübten
Huren	Huren
Spitze	Spitze
dehydrierten	dehydrierten
verführtest	verführtest
Beziehungen	Beziehungen
sedimentiertet	sedimentiertet
Playlists	Playlists
schöben	schöben
Päckchen	Päckchen
Dithiolan	Dithiolan
preisen	preisen
räucheret	räucheret
Ecken	Ecken
Trümmersprache	Trümmersprache
glaubst	glaubst
höret	höret
Trioxiden	Trioxiden
Haarverlust	Haarverlust
reifen	reifen
hörest	hörest
stärket	stärket
Langzeichen	Langzeichen
anrichten	anrichten
dramatisieren	dramatisieren
verstehet	verstehet
Acetaten	Acetaten
Selbstversuchen	Selbstversuchen
illustriertet	illustriertet
Zeitplan	Zeitplan
Empfängnisverhütungen	Empfängnisverhütungen
Hanse	Hanse
Scheißkerlen	Scheißkerlen
inspirierest	inspirierest
überschnitten	überschnitten
herrschest	herrschest
Leichname	Leichname
unschuldigen	unschuldigen
spracht	spracht
lancierst	lancierst
schmuste	schmuste
Adler	Adler
Bromidquelle	Bromidquelle
Rekursion	Rekursion
Apfelbäumen	Apfelbäumen
pflanzest	pflanzest
Drillingen	Drillingen
gelost	gelost
Rhabarber	Rhabarber
Buntspechte	Buntspechte
kabbelnd	kabbelnd
Organistin	Organistin
Adlerbussard	Adlerbussard
Fingerspitze	Fingerspitze
legte	legte
Ösophagospasmen	Ösophagospasmen
behütet	behütet
kaufte	kaufte
Remis	Remis
säumen	säumen
Steuerwagens	Steuerwagens
Betainen	Betainen
schlabberte	schlabberte
Stadtbezirken	Stadtbezirken
betrübt	betrübt
beschotterten	beschotterten
erlabet	erlabet
streiten	streiten
Atommassen	Atommassen
verkürzte	verkürzte
hüpfest	hüpfest
Futur	Futur
Fremdwörter	Fremdwörter
zerschlaget	zerschlaget
Verwaltungsakten	Verwaltungsakten
Nahrungsbestandteil	Nahrungsbestandteil
Sündern	Sündern
schlafe	schlafe
schaue	schaue
Vordenker	Vordenker
missverstände	missverstände
Zur-Schau-Stellen	Zur-Schau-Stellen
gelobte	gelobte
Kakao	Kakao
tyrannisierte	tyrannisierte
Schlepper	Schlepper
Minischweine	Minischweine
fritierst	fritierst
Feind	Feind
Zainen	Zainen
kabeln	kabeln
Heptamolybdat	Heptamolybdat
Marokkanern	Marokkanern
erforscht	erforscht
besehet	besehet
reich	reich
Blitze	Blitze
grüble	grüble
wohnet	wohnet
Setzt	Setzt
verschont	verschont
kichert	kichert
begrabet	begrabet
stützen	stützen
analysieret	analysieret
fasset	fasset
Euphemismus	Euphemismus
Falltürme	Falltürme
Kissenschlacht	Kissenschlacht
Notärztin	Notärztin
Geschäften	Geschäften
kauten	kauten
klone	klone
schlachtet	schlachtet
christianisiere	christianisiere
Germanisten	Germanisten
auflegst	auflegst
scherzt	scherzt
Golfplätzen	Golfplätzen
überlebest	überlebest
plaziert	plaziert
legen	legen
platzt	platzt
spekuliere	spekuliere
Fiesling	Fiesling
scheitern	scheitern
bündelet	bündelet
Spitzen	Spitzen
untersagest	untersagest
faschieren	faschieren
verdinglichtest	verdinglichtest
dechiffrierend	dechiffrierend
fehlte	fehlte
bringst	bringst
erntete	erntete
Korrosionsschutzen	Korrosionsschutzen
kühl	kühl
kommst	kommst
Empörung	Empörung
bewiese	bewiese
Stätte	Stätte
Selbstversuch	Selbstversuch
pendele	pendele
Mop	Mop
setztet	setztet
ringelten	ringelten
desensibilisierten	desensibilisierten
interagierte	interagierte
mischst	mischst
zentrifugierst	zentrifugierst
billigte	billigte
Fetzen	Fetzen
überfischt	überfischt
Hochzeitstorten	Hochzeitstorten
Paralipse	Paralipse
verlautet	verlautet
grienest	grienest
schlummerte	schlummerte
Anfänger	Anfänger
verbitterest	verbitterest
glänzte	glänzte
Ludwigsburger	Ludwigsburger
anzeigte	anzeigte
verrosteten	verrosteten
verstörte	verstörte
Schlagzeuger	Schlagzeuger
greinet	greinet
Antitranspirante	Antitranspirante
malträtiere	malträtiere
könnt	könnt
Ahnen	Ahnen
grünet	grünet
Zapfhähnen	Zapfhähnen
verformen	verformen
verzieht	verzieht
Mikrowellenfilter	Mikrowellenfilter
ausgehst	ausgehst
Stoffwechselwegen	Stoffwechselwegen
Palisade	Palisade
Adeliepinguins	Adeliepinguins
Überziehens	Überziehens
schnitt	schnitt
Komplexionen	Komplexionen
verführt	verführt
Mammut	Mammut
Hirsche	Hirsche
Gläubigern	Gläubigern
lehrte	lehrte
setzet	setzet
Nigger	Nigger
versüßtet	versüßtet
stapelten	stapelten
regelten	regelten
duschten	duschten
Fusseln	Fusseln
beweise	beweise
Atomphysiker	Atomphysiker
Schote	Schote
besitzet	besitzet
müssest	müssest
prangte	prangte
sticke	sticke
Sehne	Sehne
Gewürze	Gewürze
Bergsteiger	Bergsteiger
kaufe	kaufe
halte	halte
fresse	fresse
entdecket	entdecket
griffen	griffen
Feierabende	Feierabende
Malaysiers	Malaysiers
seufzt	seufzt
Drohkulisse	Drohkulisse
blitzte	blitzte
putzte	putzte
Rücktritt	Rücktritt
puste	puste
Abbindebeschleunigern	Abbindebeschleunigern
Aphasie	Aphasie
mogelest	mogelest
könne	könne
Herabsetzungen	Herabsetzungen
kehre	kehre
Shortcuts	Shortcuts
stigmatisierst	stigmatisierst
dürften	dürften
installierten	installierten
Adeliepinguin	Adeliepinguin
leide	leide
Darlehen	Darlehen
Gitarrenspieler	Gitarrenspieler
fluppten	fluppten
Homodimere	Homodimere
Aggressoren	Aggressoren
Sehnen	Sehnen
besprengen	besprengen
Benzol	Benzol
Würzen	Würzen
Diagnostik	Diagnostik
Sabotagen	Sabotagen
Fahlflanken-Ameisenwürger	Fahlflanken-Ameisenwürger
Gedicht	Gedicht
Buntwaschmittel	Buntwaschmittel
überqueren	überqueren
reinstitutionalisierten	reinstitutionalisierten
Honigbären	Honigbären
mästest	mästest
herrschet	herrschet
Steuerborden	Steuerborden
Blechen	Blechen
Binde	Binde
Meinet	Meinet
annektierten	annektierten
Trinkgefäßen	Trinkgefäßen
markiere	markiere
schicke	schicke
Hadith	Hadith
buddeln	buddeln
exmatrikulierte	exmatrikulierte
Nährmediums	Nährmediums
Pimmel	Pimmel
schlachten	schlachten
planschtest	planschtest
frohlockte	frohlockte
emittiert	emittiert
schätzte	schätzte
dienest	dienest
haschieret	haschieret
motivierte	motivierte
Gammastrahlen	Gammastrahlen
Rotscheitelreiher	Rotscheitelreiher
wiederholte	wiederholte
Märtyrern	Märtyrern
Kerfe	Kerfe
Kleptokratien	Kleptokratien
feierten	feierten
Küchenmaschine	Küchenmaschine
Bajonette	Bajonette
überbewerte	überbewerte
vernehmest	vernehmest
schenke	schenke
WebHooks	WebHooks
Bushaltestelle	Bushaltestelle
entwickelten	entwickelten
Apostel	Apostel
Kirgisinnen	Kirgisinnen
Zeitbomben	Zeitbomben
erstehet	erstehet
Rechenbrettern	Rechenbrettern
Bluff	Bluff
schnürest	schnürest
trompetete	trompetete
Kriegsschauplatz	Kriegsschauplatz
erinnerest	erinnerest
lobte	lobte
Bettler	Bettler
sehest	sehest
Kaufhäusern	Kaufhäusern
Minischwein	Minischwein
Sanatoriums	Sanatoriums
kennst	kennst
mißversteht	mißversteht
Genkinits	Genkinits
Sünders	Sünders
kennet	kennet
nagelest	nagelest
Hallen	Hallen
Rauten	Rauten
gehöre	gehöre
verschärfst	verschärfst
erliegest	erliegest
Dorngesträuchen	Dorngesträuchen
heilige	heilige
besänftigtest	besänftigtest
Schreiben	Schreiben
falteten	falteten
Kernspaltungen	Kernspaltungen
harmonierest	harmonierest
erhöhet	erhöhet
Perlen	Perlen
Badezimmer	Badezimmer
langweilst	langweilst
Politologe	Politologe
Leugnungen	Leugnungen
sabbelt	sabbelt
überweiset	überweiset
Blockflöte	Blockflöte
Aktivisten	Aktivisten
besicheret	besicheret
feiern	feiern
brechet	brechet
Mähnenwölfen	Mähnenwölfen
mobilisierten	mobilisierten
Schal	Schal
verkehrte	verkehrte
salzen	salzen
regiert	regiert
Flammen	Flammen
Barbareien	Barbareien
Werke	Werke
blondieret	blondieret
Chasaren	Chasaren
schwöre	schwöre
vertiefe	vertiefe
tabuisierten	tabuisierten
erhebst	erhebst
belüftete	belüftete
Lautwandeln	Lautwandeln
Äthern	Äthern
liegst	liegst
ärgerst	ärgerst
klingest	klingest
sabbere	sabbere
losen	losen
zanket	zanket
flense	flense
Jünger	Jünger
Funktionalität	Funktionalität
grün	grün
zerstreuet	zerstreuet
knusperst	knusperst
Stiefvätern	Stiefvätern
Playlist	Playlist
begebet	begebet
reiftet	reiftet
Wasserquelle	Wasserquelle
verschlingt	verschlingt
Gemeinde	Gemeinde
erscheine	erscheine
Klärungen	Klärungen
Höschen	Höschen
tätowierest	tätowierest
werdet	werdet
drangen	drangen
schützt	schützt
besinnen	besinnen
Kronsbeeren	Kronsbeeren
Dobermännern	Dobermännern
umarbeitest	umarbeitest
speisend	speisend
ausgeht	ausgeht
überstehend	überstehend
gepuddelt	gepuddelt
installiert	installiert
Hubschraubern	Hubschraubern
Berber	Berber
Literaturen	Literaturen
kreieren	kreieren
schubse	schubse
wirft	wirft
Handbüchern	Handbüchern
brandeten	brandeten
Katamarane	Katamarane
chloroformieret	chloroformieret
liebend	liebend
Emmer	Emmer
steinigst	steinigst
Geldautomaten	Geldautomaten
kappet	kappet
Nährmedien	Nährmedien
Eiland	Eiland
Flosse	Flosse
Gurt	Gurt
schmiert	schmiert
gehorchet	gehorchet
benehme	benehme
parfümierte	parfümierte
speichertest	speichertest
Briefen	Briefen
trage	trage
Gewinnung	Gewinnung
changieren	changieren
stammeln	stammeln
Schaffnerin	Schaffnerin
geräuchert	geräuchert
Brieftaubenzüchter	Brieftaubenzüchter
Beiblätter	Beiblätter
Genkinit	Genkinit
gleite	gleite
Traggasen	Traggasen
bracht	bracht
Fußballweltmeisterschaftsqualifikationsspiel	Fußballweltmeisterschaftsqualifikationsspiel
schmuggele	schmuggele
steige	steige
massierst	massierst
vernehmen	vernehmen
verschafft	verschafft
mobilisieret	mobilisieret
Herd	Herd
führe	führe
Wehklage	Wehklage
sucht	sucht
defragmentierest	defragmentierest
Radsatzes	Radsatzes
Ackerschachtelhalm	Ackerschachtelhalm
Zunge	Zunge
revoltierte	revoltierte
hantiert	hantiert
schreiet	schreiet
ballaste	ballaste
feierte	feierte
parfümierst	parfümierst
Schlagzeugern	Schlagzeugern
werdest	werdest
Platte	Platte
Bombardierungen	Bombardierungen
beweisen	beweisen
Bürzel	Bürzel
protokollierst	protokollierst
begründest	begründest
Zwetschge	Zwetschge
Kernladungszahl	Kernladungszahl
verklagt	verklagt
Lehnen	Lehnen
Tieren	Tieren
seufzest	seufzest
Rehböcken	Rehböcken
zürnest	zürnest
stillte	stillte
Sage	Sage
Haarverlusten	Haarverlusten
Tyrann	Tyrann
amputiere	amputiere
heischten	heischten
Borkenkäfer	Borkenkäfer
Schaden	Schaden
widmest	widmest
Lebenskraft	Lebenskraft
bemerken	bemerken
behütetest	behütetest
Händedrücken	Händedrücken
fällen	fällen
Alkin	Alkin
Augur	Augur
verwechsele	verwechsele
addierest	addierest
Küstenwache	Küstenwache
Libellen	Libellen
Weiblein	Weiblein
beanspruchest	beanspruchest
Tasten	Tasten
flupptest	flupptest
Halbmonden	Halbmonden
Weinberge	Weinberge
weichen	weichen
entwaffnest	entwaffnest
beschotteret	beschotteret
faschierst	faschierst
Milz	Milz
Kandidaturen	Kandidaturen
Anwendungsgebiete	Anwendungsgebiete
Mobilfunknetze	Mobilfunknetze
Artischocken	Artischocken
restaurieret	restaurieret
kriegen	kriegen
Fettes	Fettes
Laufringe	Laufringe
reparierten	reparierten
gewinnen	gewinnen
prophezeie	prophezeie
raubet	raubet
weise	weise
tut	tut
schaute	schaute
Kanzlei	Kanzlei
liebte	liebte
gewöhnte	gewöhnte
Böse	Böse
Ölfasses	Ölfasses
Untier	Untier
halle	halle
verletzt	verletzt
sterilisierten	sterilisierten
pflanzte	pflanzte
Deuteriums	Deuteriums
füsilierte	füsilierte
durchwacht	durchwacht
wolle	wolle
Feldbett	Feldbett
überweis	überweis
jaulst	jaulst
heile	heile
besuche	besuche
hintertrieben	hintertrieben
Montagmittagen	Montagmittagen
Paillette	Paillette
Bäusche	Bäusche
Frettchen	Frettchen
Kälber	Kälber
wach	wach
Schenke	Schenke
Äther	Äther
verarbeite	verarbeite
verleumdetest	verleumdetest
Cyclodextrinen	Cyclodextrinen
ausziehst	ausziehst
gelobtest	gelobtest
verdammt	verdammt
Almanachen	Almanachen
zappten	zappten
Nukleinsäuren	Nukleinsäuren
Autokraten	Autokraten
erwürgest	erwürgest
weinst	weinst
reichet	reichet
bescherten	bescherten
baggerst	baggerst
Kutter	Kutter
träumen	träumen
Raute	Raute
referenzierst	referenzierst
bekehret	bekehret
löste	löste
gleitest	gleitest
meinst	meinst
schnitten	schnitten
reden	reden
Einbrecher	Einbrecher
Neuigkeit	Neuigkeit
Suche	Suche
verzeichne	verzeichne
Agoraphobien	Agoraphobien
Metapher	Metapher
verbarg	verbarg
bürsten	bürsten
Grenzwert	Grenzwert
heißt	heißt
heilte	heilte
demütige	demütige
verkleinerest	verkleinerest
kehret	kehret
spannt	spannt
lüge	lüge
wünschest	wünschest
Soge	Soge
Collagen	Collagen
wachte	wachte
regierten	regierten
Füllfederhalter	Füllfederhalter
Halbzeit	Halbzeit
verjährte	verjährte
Fehlen	Fehlen
pflücke	pflücke
Sonderbericht	Sonderbericht
Acetat	Acetat
nahest	nahest
Kopfsalaten	Kopfsalaten
diskutiere	diskutiere
Weinbergen	Weinbergen
Bagger	Bagger
fallen	fallen
Tübingern	Tübingern
Einöden	Einöden
gewarnt	gewarnt
Kupferkiese	Kupferkiese
Citrat	Citrat
Bleche	Bleche
designiertet	designiertet
betrübtet	betrübtet
Oberbegriff	Oberbegriff
genehmigt	genehmigt
huren	huren
musizieret	musizieret
Geschäfte	Geschäfte
Lusitaner	Lusitaner
flehst	flehst
bekriegt	bekriegt
Grufti	Grufti
beschrifteten	beschrifteten
zerbrechest	zerbrechest
Trotzkist	Trotzkist
scheinet	scheinet
Filzläusen	Filzläusen
gehet	gehet
klönen	klönen
protestiere	protestiere
genieret	genieret
läuten	läuten
preise	preise
sabbelten	sabbelten
lavierte	lavierte
interpretiert	interpretiert
referenzierte	referenzierte
Sonnenfinsternis	Sonnenfinsternis
weinet	weinet
quasselten	quasselten
frohlocke	frohlocke
greife	greife
Fremdwort	Fremdwort
Unwahrheit	Unwahrheit
tyrannisiertest	tyrannisiertest
predigten	predigten
Seile	Seile
klonet	klonet
Besprechung	Besprechung
inhalierest	inhalierest
Ruß	Ruß
Zähne	Zähne
wechselwirkt	wechselwirkt
fingieret	fingieret
Haltepunkten	Haltepunkten
Diethylether	Diethylether
deklarierte	deklarierte
tust	tust
Rast	Rast
Assistentinnen	Assistentinnen
posierst	posierst
filtern	filtern
Katamaranen	Katamaranen
helfet	helfet
Krankenschein	Krankenschein
babbeltet	babbeltet
Irrtumes	Irrtumes
überstehst	überstehst
producieret	producieret
Ehren	Ehren
deutete	deutete
Suchet	Suchet
zerbräche	zerbräche
vergliche	vergliche
stillest	stillest
vergrabest	vergrabest
Schrei	Schrei
Leitkegel	Leitkegel
lögest	lögest
überdenkend	überdenkend
fragte	fragte
bedurftest	bedurftest
ankern	ankern
dringen	dringen
tabuisiert	tabuisiert
Gasgemischen	Gasgemischen
raffinier	raffinier
Indianer	Indianer
Flussbetten	Flussbetten
Pflanzenwachstum	Pflanzenwachstum
verteidigt	verteidigt
Karer	Karer
maximiere	maximiere
Spannt	Spannt
erniedrigt	erniedrigt
stutzt	stutzt
Biokraftstoff	Biokraftstoff
charakterisiert	charakterisiert
Prüfbericht	Prüfbericht
verstehest	verstehest
Bundesgebieten	Bundesgebieten
begrübest	begrübest
Hubschrauber	Hubschrauber
verführest	verführest
erwürgtest	erwürgtest
Eiszapfens	Eiszapfens
plagen	plagen
streue	streue
erhörst	erhörst
verunziere	verunziere
Träumers	Träumers
wehrend	wehrend
Patres	Patres
Treibhausgasen	Treibhausgasen
tobend	tobend
Ärztinnen	Ärztinnen
erinnre	erinnre
versklavte	versklavte
begehrend	begehrend
bringet	bringet
UND-Gattern	UND-Gattern
Epidemie	Epidemie
Hypochlorit	Hypochlorit
Machet	Machet
Schreiber	Schreiber
beschwindele	beschwindele
Beteiligten	Beteiligten
Schlaraffenländern	Schlaraffenländern
Abkürzungsverzeichnisse	Abkürzungsverzeichnisse
oxidierst	oxidierst
ärgernd	ärgernd
Radfahrer	Radfahrer
Aussätzigen	Aussätzigen
Eilande	Eilande
weinen	weinen
Notstand	Notstand
Elektronenschale	Elektronenschale
Huflattich	Huflattich
Stempeluhren	Stempeluhren
sitzest	sitzest
Asiatin	Asiatin
eingehet	eingehet
Male	Male
erfahrest	erfahrest
malträtierte	malträtierte
quantisierte	quantisierte
könnte	könnte
Blumenstrauß	Blumenstrauß
Eselsohren	Eselsohren
verkürzt	verkürzt
Zehe	Zehe
gehören	gehören
Hansen	Hansen
Unternehmung	Unternehmung
Hornung	Hornung
Pfleglingen	Pfleglingen
erbringst	erbringst
Gaunern	Gaunern
bezahlt	bezahlt
meldet	meldet
Urbaren	Urbaren
kritzelet	kritzelet
Pedanten	Pedanten
gratuliert	gratuliert
bleibst	bleibst
verewiget	verewiget
benachrichtiget	benachrichtiget
Gelobt	Gelobt
Elementen	Elementen
verschickte	verschickte
decke	decke
Strahlentierchen	Strahlentierchen
Alkalien	Alkalien
formiret	formiret
lieben	lieben
schöpfest	schöpfest
Schwächungen	Schwächungen
Tretlager	Tretlager
Scherzen	Scherzen
setzest	setzest
Dampfschiffen	Dampfschiffen
Heere	Heere
zähltet	zähltet
pipettierten	pipettierten
Briketten	Briketten
verprügelet	verprügelet
transportiere	transportiere
Inauguration	Inauguration
Druckfehler	Druckfehler
Ärschen	Ärschen
touchierte	touchierte
verunglimpfen	verunglimpfen
beunruhige	beunruhige
frohlockest	frohlockest
dunkelt	dunkelt
löse	löse
spaltetest	spaltetest
Landstreicher	Landstreicher
finanzierest	finanzierest
Messiassen	Messiassen
Brettspiele	Brettspiele
mineralisierten	mineralisierten
zeltest	zeltest
überdenkest	überdenkest
Gegenleistung	Gegenleistung
Nanokondensatoren	Nanokondensatoren
Vorstädte	Vorstädte
plärrtest	plärrtest
verlasset	verlasset
fabuliert	fabuliert
verfehlten	verfehlten
Apportierhund	Apportierhund
glänzen	glänzen
benachrichtige	benachrichtige
Gasflaschen	Gasflaschen
opfern	opfern
wichste	wichste
Sphäre	Sphäre
pulsiere	pulsiere
Prophet	Prophet
fülle	fülle
taufen	taufen
tagest	tagest
dressierten	dressierten
Kanzleien	Kanzleien
Auszüge	Auszüge
keulte	keulte
Introjektion	Introjektion
Klassenzimmern	Klassenzimmern
wacht	wacht
Schotten	Schotten
Tische	Tische
Kernspaltung	Kernspaltung
hängen	hängen
setzte	setzte
Herbstwinde	Herbstwinde
Mutagen	Mutagen
appellierst	appellierst
Aachener	Aachener
duzet	duzet
lohnt	lohnt
Theistin	Theistin
Totenglocke	Totenglocke
Plüschtiere	Plüschtiere
Reinstoff	Reinstoff
Dachdeckerinnen	Dachdeckerinnen
Linguist	Linguist
stimmen	stimmen
Grizzlybären	Grizzlybären
lieget	lieget
segelte	segelte
Überschüsse	Überschüsse
Erdkruste	Erdkruste
Märchenbüchern	Märchenbüchern
Narkotikum	Narkotikum
schöpfe	schöpfe
gestatteten	gestatteten
Normdaten	Normdaten
rännen	rännen
panaschieret	panaschieret
Aderhäuten	Aderhäuten
Herkünften	Herkünften
vereinigt	vereinigt
Iberer	Iberer
Finanzministerium	Finanzministerium
Massagen	Massagen
Amputierten	Amputierten
Milzen	Milzen
malten	malten
Stierkämpfe	Stierkämpfe
fliehe	fliehe
frottier	frottier
Brötchen	Brötchen
mehrte	mehrte
schaffen	schaffen
Rotzinkerz	Rotzinkerz
Sprachraum	Sprachraum
Wehklagen	Wehklagen
grausten	grausten
beeindrucket	beeindrucket
Begünstigungen	Begünstigungen
Lazarett	Lazarett
Konzentrate	Konzentrate
gehorchte	gehorchte
verschlimmere	verschlimmere
läutet	läutet
pflügten	pflügten
Baisers	Baisers
verlöteten	verlöteten
offenbarest	offenbarest
tobet	tobet
Höret	Höret
sezierst	sezierst
verzögerte	verzögerte
naschten	naschten
Bifurkationen	Bifurkationen
enttäusche	enttäusche
treibst	treibst
überschattete	überschattete
tanze	tanze
grünend	grünend
verkauften	verkauften
reglementiert	reglementiert
Futtermittel	Futtermittel
Auszügen	Auszügen
teile	teile
Wasserquellen	Wasserquellen
bestrafe	bestrafe
regierest	regierest
Bromidquellen	Bromidquellen
Hypochlorite	Hypochlorite
nähernd	nähernd
spritzt	spritzt
Steuerwagen	Steuerwagen
Feldzug	Feldzug
fluppt	fluppt
verwirkliche	verwirkliche
Nadelbäume	Nadelbäume
repräsentierten	repräsentierten
Genie	Genie
Radsätzen	Radsätzen
zuppt	zuppt
Trichtern	Trichtern
erstände	erstände
Ding	Ding
bekennst	bekennst
Silberdrahts	Silberdrahts
Gleitzeit	Gleitzeit
Geschrei	Geschrei
Felsboden	Felsboden
Samarskit	Samarskit
glauben	glauben
Teile	Teile
lostest	lostest
werfet	werfet
substituierten	substituierten
reglementierte	reglementierte
Ypecaharalle	Ypecaharalle
liebt	liebt
Blütenachse	Blütenachse
Haue	Haue
überweise	überweise
erpresst	erpresst
drosselten	drosselten
Koniferen	Koniferen
widmend	widmend
überschattet	überschattet
verbündete	verbündete
verselbständigst	verselbständigst
Bildschirmfotos	Bildschirmfotos
knutschest	knutschest
konjugiere	konjugiere
stellte	stellte
Ypecaharallen	Ypecaharallen
grünen	grünen
Krokus	Krokus
Flame	Flame
danke	danke
schenket	schenket
konsolidierend	konsolidierend
betätigest	betätigest
Signal	Signal
erkennet	erkennet
Höschens	Höschens
deponierte	deponierte
Buchfinken	Buchfinken
kämmt	kämmt
fluppst	fluppst
begräbt	begräbt
entkörperlichten	entkörperlichten
wünschtest	wünschtest
gezählt	gezählt
türmen	türmen
Bote	Bote
Teufel	Teufel
verliert	verliert
Stall	Stall
tragest	tragest
Schaffet	Schaffet
stimmet	stimmet
beleidige	beleidige
Technikerinnen	Technikerinnen
Sitzfleisches	Sitzfleisches
finanziere	finanziere
besorgt	besorgt
Isobars	Isobars
blockierten	blockierten
duckmäuseret	duckmäuseret
Freitagnachmittagen	Freitagnachmittagen
verunreinigst	verunreinigst
Normdatum	Normdatum
liebtest	liebtest
bespracht	bespracht
schäme	schäme
verzieh	verzieh
Republikflucht	Republikflucht
Zeitungsente	Zeitungsente
Pflanzungen	Pflanzungen
Kacke	Kacke
Toren	Toren
Amnestie	Amnestie
verlobt	verlobt
erbest	erbest
Elementarzellen	Elementarzellen
auszieht	auszieht
köderet	köderet
erzwangt	erzwangt
massakrierten	massakrierten
Chlorwasserstoffmoleküls	Chlorwasserstoffmoleküls
begrabt	begrabt
Metallquirlen	Metallquirlen
knautsche	knautsche
kramst	kramst
belohnten	belohnten
jappte	jappte
eskalieret	eskalieret
offenbartest	offenbartest
frohlockten	frohlockten
Silbererzen	Silbererzen
klicket	klicket
Fadenlauf	Fadenlauf
still	still
erwischten	erwischten
Hochhäusern	Hochhäusern
Lusitaners	Lusitaners
schau	schau
meinen	meinen
Dezernaten	Dezernaten
Druckfehlern	Druckfehlern
vertiefet	vertiefet
bereuest	bereuest
Haarshampoos	Haarshampoos
Metallquirle	Metallquirle
Tumult	Tumult
Portale	Portale
enträtselst	enträtselst
vernichtest	vernichtest
simulierst	simulierst
Denkmünzen	Denkmünzen
referenziere	referenziere
reim	reim
Volltreffer	Volltreffer
imitiert	imitiert
Retter	Retter
beißet	beißet
gelobt	gelobt
liebet	liebet
Krusten	Krusten
bemächtigte	bemächtigte
Cyanat	Cyanat
neiden	neiden
schlabbere	schlabbere
linstest	linstest
Vogelscheuche	Vogelscheuche
Arbeitsbereichen	Arbeitsbereichen
duzen	duzen
Gemeinden	Gemeinden
Zinkionen	Zinkionen
erziehen	erziehen
dehydrierte	dehydrierte
bedeckst	bedeckst
Dürre	Dürre
berufen	berufen
fällt	fällt
scherze	scherze
Gefängnissen	Gefängnissen
obfuskierten	obfuskierten
verbleibet	verbleibet
verwahret	verwahret
zuhörte	zuhörte
Tiegel	Tiegel
Gasflasche	Gasflasche
schauspielert	schauspielert
Bauwerke	Bauwerke
zerstreuest	zerstreuest
Seehechte	Seehechte
folgte	folgte
bestimmt	bestimmt
Drehtüren	Drehtüren
strandend	strandend
Wiederauferstehung	Wiederauferstehung
malträtiert	malträtiert
Beilen	Beilen
begrabest	begrabest
stickt	stickt
trefft	trefft
Büstenhaltern	Büstenhaltern
hüpfen	hüpfen
produzierten	produzierten
verwechselet	verwechselet
kasernierte	kasernierte
rollten	rollten
Vogelscheuchen	Vogelscheuchen
gestalten	gestalten
produzierest	produzierest
plissieren	plissieren
verkapselten	verkapselten
Technetaten	Technetaten
begehrte	begehrte
Reiterschwert	Reiterschwert
suchen	suchen
Knöllchen	Knöllchen
Schlöte	Schlöte
Vorstoß	Vorstoß
Lüsten	Lüsten
raffiniere	raffiniere
bedürft	bedürft
schichteten	schichteten
Lehrbüchern	Lehrbüchern
befestigten	befestigten
Heringe	Heringe
downloadete	downloadete
verzögerten	verzögerten
Schuldner	Schuldner
ärger	ärger
schauet	schauet
zwang	zwang
gedachtest	gedachtest
Brite	Brite
Nehmet	Nehmet
Untern	Untern
bröckelten	bröckelten
ritze	ritze
knüpfet	knüpfet
Türmen	Türmen
Astats	Astats
Gymnasien	Gymnasien
replizierten	replizierten
Brieftaubenzüchters	Brieftaubenzüchters
Thioester	Thioester
Suffix	Suffix
gelegt	gelegt
fabulierte	fabulierte
verbitterten	verbitterten
stifte	stifte
fluppen	fluppen
Kerl	Kerl
diversifiziert	diversifiziert
steuerst	steuerst
Ölspur	Ölspur
erweckst	erweckst
Uranerz	Uranerz
erhebest	erhebest
Gebeten	Gebeten
Bällchen	Bällchen
Treibhausgase	Treibhausgase
erstaunte	erstaunte
enträtselten	enträtselten
teil	teil
ruckelst	ruckelst
Steuerbord	Steuerbord
strafest	strafest
verfanget	verfanget
Epidemien	Epidemien
ersparten	ersparten
beleuchteten	beleuchteten
lüftetet	lüftetet
wirfst	wirfst
Sogen	Sogen
stille	stille
Nullpunkt	Nullpunkt
betonierte	betonierte
ziehet	ziehet
speise	speise
Kleinod	Kleinod
Trickbetrüger	Trickbetrüger
bewährt	bewährt
reifst	reifst
Enden	Enden
zürnte	zürnte
vermischen	vermischen
baggerte	baggerte
Märtyrer	Märtyrer
Abfertigungsgebäude	Abfertigungsgebäude
amenagieren	amenagieren
prostete	prostete
sollten	sollten
versteckst	versteckst
Dezernat	Dezernat
Tischen	Tischen
schlage	schlage
verdränge	verdränge
wehrtest	wehrtest
verstecktet	verstecktet
Fettsäcken	Fettsäcken
Versorgungen	Versorgungen
zersetzet	zersetzet
Traubenlese	Traubenlese
vertagt	vertagt
Begrenzung	Begrenzung
Gehilfen	Gehilfen
Panzerschrecke	Panzerschrecke
Rechnung	Rechnung
Fallturm	Fallturm
Zeilen	Zeilen
hegst	hegst
Nadelbäumen	Nadelbäumen
Ösophagospasmus	Ösophagospasmus
schichtet	schichtet
verbaselt	verbaselt
Reiseleitern	Reiseleitern
weichest	weichest
verschlungen	verschlungen
schickte	schickte
leite	leite
Aacheners	Aacheners
geleitest	geleitest
verdamm	verdamm
lügen	lügen
Meinst	Meinst
Ausbeuter	Ausbeuter
bewieset	bewieset
verspäteten	verspäteten
Schilden	Schilden
gründe	gründe
ermordetest	ermordetest
vergleichet	vergleichet
überliefere	überliefere
verselbständigt	verselbständigt
empört	empört
Cholesterin	Cholesterin
Unterschlagungen	Unterschlagungen
Leitungswegs	Leitungswegs
meuterest	meuterest
Reisebüros	Reisebüros
Managementsystem	Managementsystem
unterwerft	unterwerft
Halsabschneider	Halsabschneider
versuchten	versuchten
befördert	befördert
boykottierten	boykottierten
Gehilfe	Gehilfe
verludet	verludet
Banknoten	Banknoten
infizieret	infizieret
erschütterte	erschütterte
Floß	Floß
bölket	bölket
sehn	sehn
Träumer	Träumer
Prozeduren	Prozeduren
Gegebenheiten	Gegebenheiten
verglichest	verglichest
offenbar	offenbar
Falz	Falz
vernickele	vernickele
Werkzeugen	Werkzeugen
leerst	leerst
blenden	blenden
kollidierten	kollidierten
kabelten	kabelten
Gigapascal	Gigapascal
Reichweite	Reichweite
höbest	höbest
lehre	lehre
grause	grause
Inder	Inder
übte	übte
Wespen	Wespen
erbet	erbet
liege	liege
gravierten	gravierten
Spiralen	Spiralen
streckst	streckst
Myriade	Myriade
Körpergeruches	Körpergeruches
Überziehen	Überziehen
verfolgt	verfolgt
begleicht	begleicht
Molybdit	Molybdit
Abkömmling	Abkömmling
Ångström	Ångström
kramten	kramten
dressieret	dressieret
moppet	moppet
lebet	lebet
konvertiere	konvertiere
käbbelnd	käbbelnd
webet	webet
näht	näht
reichtest	reichtest
Referenz	Referenz
Trichter	Trichter
reichtet	reichtet
betrübe	betrübe
fragmentiert	fragmentiert
diskutierst	diskutierst
Erstlingen	Erstlingen
Kornnattern	Kornnattern
stapele	stapele
Zement	Zement
moppen	moppen
entkäme	entkäme
nähe	nähe
überweisend	überweisend
Essigsäurechloriden	Essigsäurechloriden
inhalier	inhalier
grünten	grünten
Dunkelkammern	Dunkelkammern
Laufringen	Laufringen
beteuerten	beteuerten
bitten	bitten
Elementarzelle	Elementarzelle
planschest	planschest
dringest	dringest
Oxalate	Oxalate
Verbrechen	Verbrechen
Brikette	Brikette
Hinkelstein	Hinkelstein
schließt	schließt
Schreibern	Schreibern
Hehler	Hehler
Trinker	Trinker
blitzet	blitzet
Schwermetallion	Schwermetallion
schaben	schaben
falle	falle
Hektare	Hektare
bemächtigest	bemächtigest
Eisenkraut	Eisenkraut
unterbewerte	unterbewerte
Bleiglanzes	Bleiglanzes
beschert	beschert
faltest	faltest
pflücktet	pflücktet
betrübet	betrübet
fetten	fetten
Fußballweltmeisterschaftsqualifikationsspielen	Fußballweltmeisterschaftsqualifikationsspielen
grüße	grüße
bereitend	bereitend
merket	merket
Peptid	Peptid
Gewürzen	Gewürzen
kickend	kickend
Münzsammlung	Münzsammlung
stellet	stellet
erstehen	erstehen
Naturen	Naturen
unterwerfe	unterwerfe
Mopp	Mopp
desertiertet	desertiertet
Regenwald	Regenwald
verlautete	verlautete
aufkommt	aufkommt
fluchten	fluchten
schleimte	schleimte
Handbuch	Handbuch
Erlösungen	Erlösungen
Anhängseln	Anhängseln
weissagten	weissagten
schäumtest	schäumtest
bekennt	bekennt
erkundigte	erkundigte
Hahnenkämme	Hahnenkämme
murmelst	murmelst
Zebrahaies	Zebrahaies
kaufest	kaufest
Iberers	Iberers
grübelte	grübelte
respektierten	respektierten
säume	säume
fotzte	fotzte
Wadenbein	Wadenbein
Ambiguität	Ambiguität
Karikaturistinnen	Karikaturistinnen
rufet	rufet
demütigst	demütigst
schenkest	schenkest
darfst	darfst
sage	sage
bereue	bereue
erstürmt	erstürmt
pensionierest	pensionierest
versuchet	versuchet
Kohlrübe	Kohlrübe
verrostet	verrostet
entdeckst	entdeckst
Philerast	Philerast
Krieg	Krieg
Reinigungsschritten	Reinigungsschritten
grüßten	grüßten
laufe	laufe
orgelt	orgelt
Schwänzchen	Schwänzchen
Schnittlauche	Schnittlauche
träumte	träumte
lohnten	lohnten
zirpe	zirpe
sorgen	sorgen
ermächtige	ermächtige
duschte	duschte
versucht	versucht
trübe	trübe
ärgerte	ärgerte
Tiefschutzen	Tiefschutzen
gehetzt	gehetzt
Freeganer	Freeganer
erwachet	erwachet
Komponistinnen	Komponistinnen
holst	holst
Optimisten	Optimisten
missversteht	missversteht
grabbelten	grabbelten
trüb	trüb
Pforten	Pforten
Dachdecker	Dachdecker
Überfamilie	Überfamilie
heiße	heiße
jagst	jagst
Dürren	Dürren
Grüßet	Grüßet
binde	binde
Fische	Fische
dürfen	dürfen
Ringe	Ringe
Heiratsgütern	Heiratsgütern
Schlössern	Schlössern
hebe	hebe
implodier	implodier
grüßt	grüßt
verifizierten	verifizierten
Honigbär	Honigbär
feierst	feierst
nagelte	nagelte
zeugst	zeugst
schnappt	schnappt
hoben	hoben
Stufe	Stufe
Carbids	Carbids
Essigsäurechlorid	Essigsäurechlorid
entheilige	entheilige
Taufen	Taufen
flieh	flieh
gebot	gebot
kichern	kichern
säte	säte
legest	legest
Herzchen	Herzchen
Schanktischen	Schanktischen
enttäuschtest	enttäuschtest
ausführen	ausführen
trödeltest	trödeltest
Gefilde	Gefilde
scheucht	scheucht
Gefilden	Gefilden
Arresten	Arresten
erlaubest	erlaubest
Gnaden	Gnaden
danket	danket
Maultiere	Maultiere
Hirnstämme	Hirnstämme
versuchst	versuchst
stoßt	stoßt
pressiert	pressiert
ehret	ehret
Hacker	Hacker
regierst	regierst
Metallothioneinen	Metallothioneinen
Dudelsäcken	Dudelsäcken
Abszisse	Abszisse
weisest	weisest
umarmet	umarmet
umarbeiten	umarbeiten
lege	lege
Händedruck	Händedruck
Mitschuld	Mitschuld
wässerten	wässerten
hydrolysierest	hydrolysierest
koordinieret	koordinieret
beäugen	beäugen
Trägerwellen	Trägerwellen
Bilderstürmereien	Bilderstürmereien
entfolgst	entfolgst
hegt	hegt
entschleieret	entschleieret
sponsert	sponsert
Elastomer	Elastomer
Laubbläsern	Laubbläsern
verreisest	verreisest
Nanotesla	Nanotesla
Wänden	Wänden
vertonet	vertonet
Hardwareentwicklerin	Hardwareentwicklerin
Liebchen	Liebchen
egalisierten	egalisierten
Domänen	Domänen
Kirchhof	Kirchhof
Serverzugriffe	Serverzugriffe
Gibst	Gibst
borgte	borgte
bitte	bitte
Malaysierin	Malaysierin
bombardiert	bombardiert
Märchenbuches	Märchenbuches
initiierten	initiierten
Treppe	Treppe
Wehret	Wehret
dotierst	dotierst
Rußen	Rußen
schneidend	schneidend
rühmet	rühmet
Gaschromatographien	Gaschromatographien
Gummibäumen	Gummibäumen
boßte	boßte
predig	predig
Hehlern	Hehlern
Nanosatellit	Nanosatellit
punkteten	punkteten
koordinierte	koordinierte
Friedensforscherinnen	Friedensforscherinnen
Decks	Decks
besichert	besichert
tobte	tobte
brandet	brandet
bleibet	bleibet
füsilierten	füsilierten
betrübest	betrübest
Geflecktheiten	Geflecktheiten
hingehst	hingehst
Scherzes	Scherzes
nützt	nützt
beklagte	beklagte
Anmeldern	Anmeldern
Selbstversuche	Selbstversuche
Sachen	Sachen
Aussätzige	Aussätzige
Gründungsprivileg	Gründungsprivileg
Reststoffen	Reststoffen
Tukans	Tukans
gelobtet	gelobtet
reizen	reizen
tun	tun
Aprikosen	Aprikosen
impfst	impfst
anzeigest	anzeigest
zertifizierst	zertifizierst
vereinbarten	vereinbarten
Besuchen	Besuchen
Taschenwörterbuch	Taschenwörterbuch
seht	seht
dringt	dringt
dampfst	dampfst
Telefonnummern	Telefonnummern
pflügest	pflügest
gedächte	gedächte
schenkst	schenkst
fladerest	fladerest
dekoriere	dekoriere
tränke	tränke
werft	werft
Sprichwörtern	Sprichwörtern
Harpunen	Harpunen
sortierest	sortierest
Eingaben	Eingaben
halbierest	halbierest
wollest	wollest
Physikerinnen	Physikerinnen
babbelst	babbelst
verdammet	verdammet
offenbare	offenbare
fragen	fragen
quantisiere	quantisiere
neidest	neidest
argumentierten	argumentierten
erobern	erobern
Zwergschwan	Zwergschwan
Rückumschlägen	Rückumschlägen
Idolatrien	Idolatrien
prangest	prangest
räumen	räumen
instanziier	instanziier
losten	losten
erliegen	erliegen
wallfahrteten	wallfahrteten
führst	führst
vertraute	vertraute
neige	neige
Abfertigungsschalters	Abfertigungsschalters
begehren	begehren
erkalten	erkalten
Lautwandel	Lautwandel
Anker	Anker
Streichen	Streichen
bequemtet	bequemtet
inszeniere	inszeniere
wehrten	wehrten
fluchte	fluchte
funktionalisiertest	funktionalisiertest
Jagdhund	Jagdhund
versuchen	versuchen
Zankapfels	Zankapfels
fahret	fahret
Trinket	Trinket
explodierten	explodierten
Sigle	Sigle
Astat	Astat
Teilnehmerin	Teilnehmerin
Monarchien	Monarchien
Transportweg	Transportweg
bestellten	bestellten
Antimustern	Antimustern
analysierest	analysierest
Zwingburgen	Zwingburgen
Biokraftstoffes	Biokraftstoffes
Abschirmungen	Abschirmungen
Füllfeder	Füllfeder
salz	salz
Würfelspiel	Würfelspiel
schwirrt	schwirrt
durchzuck	durchzuck
motivieren	motivieren
Weg	Weg
Reinelementen	Reinelementen
erbrütet	erbrütet
entwickele	entwickele
fassest	fassest
gewurstelt	gewurstelt
Grenze	Grenze
vibrierend	vibrierend
Sitzfleisch	Sitzfleisch
erstarre	erstarre
Aspartamen	Aspartamen
Ochs	Ochs
möget	möget
Loparite	Loparite
verstrahlet	verstrahlet
Klassenzimmer	Klassenzimmer
regiere	regiere
assimilierten	assimilierten
befürchtet	befürchtet
spezialisierst	spezialisierst
Kriegsschauplätze	Kriegsschauplätze
rekrutierest	rekrutierest
Europameisters	Europameisters
zupftet	zupftet
sagest	sagest
kategorisierte	kategorisierte
impfte	impfte
Oberlandesgericht	Oberlandesgericht
löset	löset
Maut	Maut
Anlässe	Anlässe
Dilettanten	Dilettanten
generalisiert	generalisiert
Halbzeiten	Halbzeiten
steckte	steckte
herrschte	herrschte
ältesten	ältesten
bekehrten	bekehrten
Lotterien	Lotterien
gekröst	gekröst
Freibergits	Freibergits
Lammfellhandschuhen	Lammfellhandschuhen
Einsätzen	Einsätzen
Braunralle	Braunralle
loste	loste
deaktivierst	deaktivierst
Lehrbücher	Lehrbücher
baust	baust
tagen	tagen
ackerest	ackerest
bewahret	bewahret
Konzentrat	Konzentrat
hassest	hassest
Zinkat	Zinkat
Preisanstieg	Preisanstieg
Kassiteriten	Kassiteriten
verlötest	verlötest
fehlen	fehlen
gelobst	gelobst
schnorrest	schnorrest
Schneepflügen	Schneepflügen
sterilisiert	sterilisiert
sehnst	sehnst
vertrieben	vertrieben
beherrschest	beherrschest
funktionalisierte	funktionalisierte
Regierung	Regierung
pflegst	pflegst
scheltet	scheltet
Jungen	Jungen
rekonstruieren	rekonstruieren
addieret	addieret
Denunziationen	Denunziationen
Katamaran	Katamaran
Werken	Werken
schwöllen	schwöllen
Preisen	Preisen
Blattgeweben	Blattgeweben
Mischelement	Mischelement
Wembley-Toren	Wembley-Toren
Peptids	Peptids
Jagdhunden	Jagdhunden
Somite	Somite
Kehre	Kehre
Afrikaner	Afrikaner
Lopariten	Lopariten
verstrahlten	verstrahlten
chloroformiere	chloroformiere
entschädigte	entschädigte
Atemgasen	Atemgasen
Freizeitzentren	Freizeitzentren
flirtete	flirtete
Robe	Robe
rekrutiere	rekrutiere
erfahret	erfahret
gewähr	gewähr
klage	klage
blondiert	blondiert
Rückumlaute	Rückumlaute
erziehst	erziehst
funkeln	funkeln
verklärt	verklärt
Einstufung	Einstufung
eggte	eggte
bewahrest	bewahrest
fallest	fallest
unterwerfest	unterwerfest
bauet	bauet
sagtet	sagtet
Anzeichen	Anzeichen
machst	machst
Besprechungen	Besprechungen
Beten	Beten
bekehrst	bekehrst
denaturiert	denaturiert
ermordet	ermordet
Nussknackern	Nussknackern
langweiltest	langweiltest
Excimerlaser	Excimerlaser
hämmerte	hämmerte
Affenbrotbäumen	Affenbrotbäumen
erstaunst	erstaunst
schnorrtet	schnorrtet
respektiert	respektiert
extemporiere	extemporiere
Trickbetrügern	Trickbetrügern
Membranen	Membranen
posiert	posiert
Wahn	Wahn
Indianern	Indianern
verbärgen	verbärgen
pressierten	pressierten
Atombombe	Atombombe
schreckt	schreckt
stapfst	stapfst
grüßte	grüßte
diente	diente
lobet	lobet
puddelst	puddelst
Quellfluss	Quellfluss
mikrominiaturisiere	mikrominiaturisiere
bezichtigten	bezichtigten
schämten	schämten
grüntet	grüntet
Abfahrtsliste	Abfahrtsliste
Sorge	Sorge
Garben	Garben
Rinde	Rinde
nahe	nahe
Banketten	Banketten
erfreuen	erfreuen
arbeiten	arbeiten
lispelten	lispelten
Stör	Stör
protestierest	protestierest
föhnest	föhnest
Verbindungsdraht	Verbindungsdraht
anrührt	anrührt
Samstagnachmittagen	Samstagnachmittagen
umgaben	umgaben
Amputierte	Amputierte
Däumlings	Däumlings
Heringen	Heringen
drängest	drängest
bilden	bilden
glawbten	glawbten
Fluoratome	Fluoratome
treibest	treibest
emendieret	emendieret
knurrt	knurrt
Zeitungsenten	Zeitungsenten
rauben	rauben
regieren	regieren
Eingabe	Eingabe
bauten	bauten
durften	durften
begeben	begeben
vollendest	vollendest
NAND-Gatter	NAND-Gatter
Nukleinsäure	Nukleinsäure
gabelst	gabelst
bekehrt	bekehrt
Wache	Wache
Stimme	Stimme
Bleigehalt	Bleigehalt
grüßen	grüßen
Sprichwort	Sprichwort
häufen	häufen
begrub	begrub
Safran	Safran
fladerten	fladerten
bücktest	bücktest
lebte	lebte
Trioxid	Trioxid
Hochhäuser	Hochhäuser
Tollkirsche	Tollkirsche
Wegen	Wegen
Temperaturanstieg	Temperaturanstieg
verdinglichest	verdinglichest
radierte	radierte
verschärftet	verschärftet
stimme	stimme
produziert	produziert
More	More
konnotierst	konnotierst
saht	saht
wünscht	wünscht
Mischung	Mischung
hadertet	hadertet
verachte	verachte
transportierten	transportierten
grünte	grünte
Kost	Kost
entfachet	entfachet
recycelten	recycelten
Fotosynthese	Fotosynthese
anrichte	anrichte
konvergiere	konvergiere
gereichte	gereichte
gelobe	gelobe
blase	blase
Kakadu	Kakadu
verkauft	verkauft
Tust	Tust
Zeitschlitze	Zeitschlitze
sedimentierte	sedimentierte
beeinflusste	beeinflusste
Mutagenen	Mutagenen
hicksest	hicksest
Anfängern	Anfängern
zählet	zählet
Hände	Hände
verunglimpftet	verunglimpftet
schauspieleren	schauspieleren
Kommst	Kommst
Eutern	Eutern
verhungerte	verhungerte
warne	warne
habest	habest
Buch	Buch
verblutete	verblutete
Negermusik	Negermusik
verkaufst	verkaufst
Langeweile	Langeweile
Kochfeldern	Kochfeldern
Beziehung	Beziehung
Mittelaltermarkt	Mittelaltermarkt
süsse	süsse
gehorchst	gehorchst
Türkin	Türkin
besitze	besitze
schöpfte	schöpfte
Gebäcken	Gebäcken
Primärenergie	Primärenergie
Crescendos	Crescendos
bombardiertet	bombardiertet
täuschte	täuschte
spannen	spannen
lausche	lausche
Organisation	Organisation
Anzeichens	Anzeichens
Leiste	Leiste
blitz	blitz
bummelet	bummelet
schwächend	schwächend
Zeug	Zeug
verdeckten	verdeckten
greinen	greinen
schnappet	schnappet
lose	lose
schreie	schreie
Sexten	Sexten
Landwirte	Landwirte
behauptete	behauptete
kämpfet	kämpfet
Datentypen	Datentypen
verbrauchte	verbrauchte
lögen	lögen
Ställe	Ställe
ruhest	ruhest
stoßest	stoßest
imprägniere	imprägniere
Keile	Keile
Minimierung	Minimierung
beantrage	beantrage
Organisationen	Organisationen
Abhänge	Abhänge
Erfahrung	Erfahrung
gedächtet	gedächtet
gehorcht	gehorcht
Bademäntel	Bademäntel
Adenosin	Adenosin
wachen	wachen
entwischtet	entwischtet
Panamaer	Panamaer
evaluierten	evaluierten
Monarchie	Monarchie
entsetzet	entsetzet
Zeitüberschreitung	Zeitüberschreitung
glawbte	glawbte
verbesserten	verbesserten
lockerte	lockerte
fokussieret	fokussieret
gedenke	gedenke
mampfte	mampfte
Pinguinen	Pinguinen
Fahlflanken-Ameisenwürgern	Fahlflanken-Ameisenwürgern
Zehnt	Zehnt
Scheck	Scheck
Sinne	Sinne
Satzungen	Satzungen
Gegebenheit	Gegebenheit
scheuchen	scheuchen
verringerten	verringerten
verscheißert	verscheißert
Geldautomat	Geldautomat
müsse	müsse
Unwahrheiten	Unwahrheiten
hievst	hievst
Großfürst	Großfürst
Orgeln	Orgeln
arrivieren	arrivieren
kaserniert	kaserniert
Muster	Muster
kramen	kramen
rundet	rundet
imprägnieret	imprägnieret
karikieret	karikieret
grien	grien
querest	querest
zeigst	zeigst
Gehorcht	Gehorcht
veranstaltest	veranstaltest
unschuldige	unschuldige
bräunen	bräunen
sagst	sagst
verdrehet	verdrehet
Trotzkisten	Trotzkisten
heiß	heiß
schlaft	schlaft
Messies	Messies
entmineralisieren	entmineralisieren
bescheiße	bescheiße
schälte	schälte
Keilen	Keilen
hüten	hüten
Arsenolithen	Arsenolithen
glänzt	glänzt
dampfte	dampfte
Senkungen	Senkungen
Preis	Preis
forschet	forschet
baue	baue
Galoppen	Galoppen
Assistentin	Assistentin
emendierte	emendierte
Marjellchens	Marjellchens
suchst	suchst
Brettspielen	Brettspielen
prediget	prediget
Prüfberichten	Prüfberichten
kontaktieret	kontaktieret
Innenschau	Innenschau
pressiere	pressiere
steigeret	steigeret
Paradiesäpfeln	Paradiesäpfeln
WebHook	WebHook
glaubte	glaubte
optimiert	optimiert
kürzest	kürzest
Buchfink	Buchfink
versüße	versüße
ertragen	ertragen
Tumulten	Tumulten
driftete	driftete
pflanze	pflanze
Zwangsarbeiterin	Zwangsarbeiterin
reinige	reinige
Palme	Palme
Borhydride	Borhydride
fistet	fistet
Linken	Linken
globalisier	globalisier
privilegiere	privilegiere
Basilikum	Basilikum
brauchte	brauchte
betrete	betrete
Grab	Grab
knurrtet	knurrtet
warnt	warnt
reparieret	reparieret
flehte	flehte
erstürmet	erstürmet
Talisman	Talisman
Schamentzündungen	Schamentzündungen
quietschest	quietschest
Rückumlauten	Rückumlauten
schwebe	schwebe
tage	tage
bedingst	bedingst
bestellte	bestellte
Kurkumen	Kurkumen
Ambiguitäten	Ambiguitäten
Rubine	Rubine
Donoren	Donoren
erlöset	erlöset
gehört	gehört
meuternd	meuternd
Teufeln	Teufeln
verdreht	verdreht
gratuliere	gratuliere
rodet	rodet
obfuskieren	obfuskieren
verhören	verhören
besetzen	besetzen
Panzerschreck	Panzerschreck
zürne	zürne
Primatologen	Primatologen
nähret	nähret
Trockendocks	Trockendocks
lavierend	lavierend
Uteri	Uteri
Brotkästen	Brotkästen
Ausgangssperren	Ausgangssperren
Gewichten	Gewichten
erschüttere	erschüttere
dringst	dringst
Großstädtern	Großstädtern
filzst	filzst
Strafraum	Strafraum
Membran	Membran
schaffet	schaffet
Sorgen	Sorgen
Büstenhalters	Büstenhalters
Flamen	Flamen
Weihe	Weihe
beneidest	beneidest
soll	soll
klappen	klappen
beseht	beseht
gelobten	gelobten
zentrifugieren	zentrifugieren
nahte	nahte
Abschreckung	Abschreckung
Vaginen	Vaginen
regelet	regelet
verschonet	verschonet
Fellachin	Fellachin
Alkine	Alkine
Germanist	Germanist
stellen	stellen
Gibt	Gibt
desertierst	desertierst
sollt	sollt
Autoklaven	Autoklaven
übet	übet
verwaisten	verwaisten
hinterzögen	hinterzögen
Grabbeltisch	Grabbeltisch
erscheinest	erscheinest
verbündet	verbündet
gaffest	gaffest
Klotz	Klotz
Junge	Junge
assimiliertest	assimiliertest
reinstitutionalisiert	reinstitutionalisiert
Basilisken	Basilisken
Hörspiel	Hörspiel
Wille	Wille
widerrufe	widerrufe
begebe	begebe
zertifiziertest	zertifiziertest
unterforderten	unterforderten
parametrisierte	parametrisierte
formirend	formirend
hupen	hupen
kickst	kickst
Wechselstube	Wechselstube
verspielte	verspielte
verkleinern	verkleinern
folgt	folgt
tränkten	tränkten
Siglen	Siglen
Kunstgeschichte	Kunstgeschichte
verzehrt	verzehrt
Türkenbund	Türkenbund
strandeten	strandeten
Theologien	Theologien
blamierten	blamierten
ackerst	ackerst
erhöht	erhöht
Rundbriefen	Rundbriefen
verwertete	verwertete
Kerzenlichter	Kerzenlichter
Trockendock	Trockendock
Wehe	Wehe
verweise	verweise
irrte	irrte
Adhäsionen	Adhäsionen
scheiterst	scheiterst
Laubbläser	Laubbläser
flambierten	flambierten
laben	laben
löst	löst
spukte	spukte
schaffest	schaffest
Inkarnationen	Inkarnationen
Wahnen	Wahnen
vermutet	vermutet
entzweiest	entzweiest
Beryll	Beryll
handhabt	handhabt
funktioniertest	funktioniertest
Thioacetal	Thioacetal
kitzele	kitzele
Päckchens	Päckchens
ruhte	ruhte
mache	mache
Rotgüssen	Rotgüssen
sicherst	sicherst
lockerst	lockerst
Entmachtung	Entmachtung
Lebenskräften	Lebenskräften
Ölspuren	Ölspuren
ehrst	ehrst
gestaltest	gestaltest
zentrierest	zentrierest
ermordeten	ermordeten
stoppte	stoppte
billige	billige
möge	möge
borgst	borgst
Bombardierung	Bombardierung
Bildpunkt	Bildpunkt
hüte	hüte
klaget	klaget
besänftiget	besänftiget
Tukanen	Tukanen
parlieren	parlieren
Stärke	Stärke
alarmiere	alarmiere
Schwärmereien	Schwärmereien
kommet	kommet
bürsteten	bürsteten
Rundbriefe	Rundbriefe
stiftest	stiftest
brillierest	brillierest
Ansteckers	Ansteckers
sezierte	sezierte
Safrane	Safrane
Seelöwe	Seelöwe
Knüppels	Knüppels
kritzeln	kritzeln
leiden	leiden
Dominicanerinnen	Dominicanerinnen
Bildschirmfoto	Bildschirmfoto
säst	säst
Portal	Portal
Schlot	Schlot
setzen	setzen
Zitronensäften	Zitronensäften
Rechtsruck	Rechtsruck
webte	webte
Fischer	Fischer
überdächte	überdächte
unterdrücke	unterdrücke
Zeitbombe	Zeitbombe
argumentierest	argumentierest
Kaktusfeige	Kaktusfeige
sedimentiert	sedimentiert
Finanzministern	Finanzministern
Hinterwäldler	Hinterwäldler
Zehnten	Zehnten
Version	Version
Flamme	Flamme
vergaset	vergaset
parametrisierten	parametrisierten
Arme	Arme
formulieren	formulieren
Landesverräterinnen	Landesverräterinnen
bekotete	bekotete
gähnten	gähnten
platz	platz
Mäusespeck	Mäusespeck
Silbererze	Silbererze
Pflaume	Pflaume
hasse	hasse
Ölfässern	Ölfässern
Leuchtkäfer	Leuchtkäfer
Stiefvater	Stiefvater
höhnest	höhnest
hinterlegt	hinterlegt
ermahnet	ermahnet
geselle	geselle
Fettsack	Fettsack
denaturierte	denaturierte
Andrologie	Andrologie
Heeren	Heeren
pflüget	pflüget
lackiere	lackiere
Wühltische	Wühltische
zuhört	zuhört
evakuieret	evakuieret
hinterfragst	hinterfragst
rodete	rodete
ehrest	ehrest
bedürftet	bedürftet
wässerst	wässerst
Malaysier	Malaysier
Schwächung	Schwächung
Entsetzet	Entsetzet
Ring	Ring
Begrenzungen	Begrenzungen
verzeichnete	verzeichnete
greifen	greifen
predigt	predigt
kollidierte	kollidierte
privatisierest	privatisierest
Wüsten	Wüsten
umhüllst	umhüllst
funzt	funzt
Verbindungsdrähten	Verbindungsdrähten
knitterte	knitterte
verpufftest	verpufftest
Grenzen	Grenzen
lügt	lügt
Blitzen	Blitzen
Nachruf	Nachruf
verdeckt	verdeckt
blondierten	blondierten
porträtiere	porträtiere
filzen	filzen
Hahnenkämmen	Hahnenkämmen
vierte	vierte
stimmte	stimmte
flirre	flirre
haltet	haltet
verwaiset	verwaiset
Chelatkomplex	Chelatkomplex
Sagen	Sagen
blitzt	blitzt
Radiergummis	Radiergummis
Qualifikationen	Qualifikationen
Scheißkerl	Scheißkerl
Backenbärten	Backenbärten
verspätete	verspätete
mogelten	mogelten
Achseln	Achseln
Rotgusses	Rotgusses
glaubest	glaubest
zerfielest	zerfielest
Brieföffner	Brieföffner
Arsenit	Arsenit
Akkadierinnen	Akkadierinnen
interagiert	interagiert
posiertet	posiertet
hinterlege	hinterlege
instanziiere	instanziiere
begraben	begraben
designierst	designierst
henket	henket
ladest	ladest
hetzte	hetzte
Flöten	Flöten
bewässertet	bewässertet
kooperierst	kooperierst
dümpelt	dümpelt
verifizieret	verifizieret
braust	braust
Hackern	Hackern
Führet	Führet
Zensus	Zensus
Habt	Habt
Gauner	Gauner
bedrückest	bedrückest
Münzsammlungen	Münzsammlungen
könnten	könnten
verspielest	verspielest
Radfahrern	Radfahrern
protestieret	protestieret
überreichen	überreichen
zerfetzt	zerfetzt
ermächtigest	ermächtigest
taufe	taufe
erhört	erhört
Marokkaners	Marokkaners
Schwebfliegen	Schwebfliegen
Westen	Westen
verdrängen	verdrängen
Wurzelwachstum	Wurzelwachstum
musizierte	musizierte
Genies	Genies
destabilisierte	destabilisierte
Adlerbussarden	Adlerbussarden
Lümmeltüten	Lümmeltüten
diversifiziere	diversifiziere
fluchet	fluchet
Strahlentierchens	Strahlentierchens
Lötzinn	Lötzinn
Nachweisreagenzien	Nachweisreagenzien
bebten	bebten
betrübend	betrübend
Beile	Beile
warst	warst
beklage	beklage
Linguistinnen	Linguistinnen
meißelt	meißelt
haare	haare
verringeret	verringeret
spezialisiere	spezialisiere
erbrüte	erbrüte
knuffend	knuffend
verwerten	verwerten
erwache	erwache
formulierst	formulierst
Puffersystem	Puffersystem
Fanatiker	Fanatiker
wünschst	wünschst
Barschaften	Barschaften
Geber	Geber
gewärtigten	gewärtigten
substituieren	substituieren
Pforte	Pforte
veranstalten	veranstalten
speist	speist
Chemikerinnen	Chemikerinnen
zwängtet	zwängtet
entkämen	entkämen
Schwarzseherin	Schwarzseherin
Aktienkursen	Aktienkursen
ermordetet	ermordetet
bereiten	bereiten
Vetter	Vetter
Gegenleistungen	Gegenleistungen
bereitete	bereitete
schwängen	schwängen
Steuerberater	Steuerberater
zürnten	zürnten
opferte	opferte
vernickelte	vernickelte
erwärmst	erwärmst
analysiert	analysiert
klappst	klappst
knufften	knufften
wälzt	wälzt
auflegte	auflegte
Päderast	Päderast
idealisierten	idealisierten
Jungfernflüge	Jungfernflüge
Donor	Donor
speiste	speiste
Bilderstürmers	Bilderstürmers
heißest	heißest
Sauberfrauen	Sauberfrauen
Kruste	Kruste
alarmieren	alarmieren
frikassiert	frikassiert
Schläfchen	Schläfchen
demütig	demütig
Käsereiben	Käsereiben
Magiern	Magiern
Reflexionen	Reflexionen
Kerzenfische	Kerzenfische
eingehst	eingehst
zeugen	zeugen
tastet	tastet
erwärmte	erwärmte
Graphem	Graphem
Abfahrtslisten	Abfahrtslisten
verkaufe	verkaufe
zügelten	zügelten
grau	grau
Fortsetzungen	Fortsetzungen
Kontaktierungen	Kontaktierungen
begrübe	begrübe
Würfelspiele	Würfelspiele
führen	führen
stirbst	stirbst
Aluminaten	Aluminaten
harren	harren
harmoniere	harmoniere
setze	setze
verschaffte	verschaffte
füllen	füllen
verschmelze	verschmelze
Fußmatten	Fußmatten
generiertet	generiertet
Friesen	Friesen
filzten	filzten
umarmen	umarmen
Gewalttäter	Gewalttäter
Beschuldigung	Beschuldigung
schmuggelest	schmuggelest
entkörperlichte	entkörperlichte
deute	deute
Kortholt	Kortholt
Aromastoffen	Aromastoffen
Hinterwäldlern	Hinterwäldlern
negierest	negierest
Gepäckträgern	Gepäckträgern
segmentiere	segmentiere
ertönst	ertönst
Bärenfellen	Bärenfellen
stoßet	stoßet
Türkinnen	Türkinnen
rebellieret	rebellieret
unterschieden	unterschieden
initiieret	initiieret
Meine	Meine
verdeckst	verdeckst
schauest	schauest
speicherten	speicherten
Preisanstiegen	Preisanstiegen
belauerten	belauerten
Galeeren	Galeeren
Blutgefäß	Blutgefäß
fällte	fällte
rolltet	rolltet
Substanzen	Substanzen
tasteten	tasteten
Ablösung	Ablösung
überfischte	überfischte
gehst	gehst
Zahnfleischentzündung	Zahnfleischentzündung
lochtest	lochtest
Teilen	Teilen
preiset	preiset
durchwachen	durchwachen
säet	säet
Wachtel	Wachtel
aasend	aasend
plissierten	plissierten
Garten	Garten
ziehest	ziehest
schwadroniert	schwadroniert
Kuckucken	Kuckucken
reichen	reichen
Isolatoren	Isolatoren
notlande	notlande
Fanmeilen	Fanmeilen
betrüge	betrüge
äussern	äussern
Bankettes	Bankettes
Maxima	Maxima
Perle	Perle
sagtest	sagtest
drillte	drillte
polymerisierte	polymerisierte
Schauen	Schauen
evaluiert	evaluiert
erwürgten	erwürgten
Apfelbäume	Apfelbäume
Erzeugung	Erzeugung
Pfarrerinnen	Pfarrerinnen
frappierte	frappierte
kletteret	kletteret
Wasserbädern	Wasserbädern
bemüht	bemüht
Drang	Drang
Dienstgrad	Dienstgrad
respektiere	respektiere
Schlüchte	Schlüchte
Vesper	Vesper
Thioacetalen	Thioacetalen
Otaviten	Otaviten
verschicket	verschicket
Präservativs	Präservativs
glaubt	glaubt
Frieden	Frieden
Kindergeldern	Kindergeldern
strullerte	strullerte
Orgel	Orgel
bedeckt	bedeckt
kostet	kostet
Weh	Weh
sehnet	sehnet
Sportlerinnen	Sportlerinnen
partitionierten	partitionierten
Renegat	Renegat
verabschiedeten	verabschiedeten
Gedrängen	Gedrängen
überschneidet	überschneidet
Zapfhahn	Zapfhahn
Fiebermitteln	Fiebermitteln
Türme	Türme
verflog	verflog
Aphasien	Aphasien
Generationen	Generationen
Serverzugriffen	Serverzugriffen
Bausch	Bausch
Spurensicherung	Spurensicherung
schätze	schätze
instrumentalisierest	instrumentalisierest
Heuhaufen	Heuhaufen
schwellen	schwellen
verkröchet	verkröchet
Schlüchten	Schlüchten
gesellt	gesellt
merkte	merkte
Desserts	Desserts
steuerte	steuerte
verführte	verführte
Kosten	Kosten
mischt	mischt
verachtet	verachtet
unterdrückte	unterdrückte
erntet	erntet
Epoxiden	Epoxiden
aufstehet	aufstehet
reformierten	reformierten
umgäben	umgäben
rundest	rundest
Schlaraffenlandes	Schlaraffenlandes
Metallspiegel	Metallspiegel
reanimierten	reanimierten
Ausnahmen	Ausnahmen
widerlegest	widerlegest
Lobe	Lobe
waren	waren
motivierten	motivierten
Welteninsel	Welteninsel
nehmest	nehmest
Wolle	Wolle
Gehorchet	Gehorchet
verbasele	verbasele
ziehst	ziehst
hydrolysierend	hydrolysierend
überfallen	überfallen
verseifet	verseifet
winke	winke
Vordenkern	Vordenkern
binden	binden
hure	hure
haderte	haderte
Meerschweinchen	Meerschweinchen
Subspezies	Subspezies
Schilde	Schilde
Unrechten	Unrechten
entmineralisieret	entmineralisieret
verringert	verringert
Schamentzündung	Schamentzündung
bewässerst	bewässerst
vibriere	vibriere
Blättchen	Blättchen
wischt	wischt
Reichweiten	Reichweiten
jaget	jaget
machte	machte
Programmiererinnen	Programmiererinnen
harmonierte	harmonierte
blondieren	blondieren
Glatteis	Glatteis
zeugten	zeugten
Schlagern	Schlagern
überlieferten	überlieferten
Abbildern	Abbildern
Rutheniumkomplex	Rutheniumkomplex
beweisest	beweisest
Petersfisch	Petersfisch
Gar	Gar
äusserst	äusserst
knüpfen	knüpfen
geleitet	geleitet
besorg	besorg
Dinge	Dinge
Rasterkraftmikroskop	Rasterkraftmikroskop
Drillinge	Drillinge
steigen	steigen
bewies	bewies
Samarskite	Samarskite
verkriechst	verkriechst
Lehne	Lehne
Reisebüro	Reisebüro
auflöst	auflöst
Butike	Butike
Finanzminister	Finanzminister
malt	malt
Telefonnummer	Telefonnummer
pensionierten	pensionierten
ausführte	ausführte
berücksichtigt	berücksichtigt
Lärchen	Lärchen
beförderet	beförderet
Streiten	Streiten
Malen	Malen
Stilllegungen	Stilllegungen
Bademantel	Bademantel
setztest	setztest
geniertest	geniertest
dürfe	dürfe
widmeten	widmeten
Silbergeschirr	Silbergeschirr
meldeten	meldeten
Klauen	Klauen
zupfte	zupfte
zweifel	zweifel
Backpflaumen	Backpflaumen
Stimmen	Stimmen
bandagiert	bandagiert
gebet	gebet
Briten	Briten
Bruchstrich	Bruchstrich
Trübsal	Trübsal
gründen	gründen
Krume	Krume
moppst	moppst
weichst	weichst
Möbiusbändern	Möbiusbändern
Fußmatte	Fußmatte
Asylrechten	Asylrechten
babbelt	babbelt
Gram	Gram
laufet	laufet
erfüllet	erfüllet
haarte	haarte
heparinisiere	heparinisiere
Referenzen	Referenzen
zählte	zählte
Temperaturanstiege	Temperaturanstiege
egalisiertet	egalisiertet
entflöhen	entflöhen
grabe	grabe
Tetraiodide	Tetraiodide
verhalten	verhalten
Sphären	Sphären
Linguisten	Linguisten
feiertest	feiertest
sterbet	sterbet
Anliegen	Anliegen
wärmet	wärmet
Tore	Tore
addieren	addieren
karikierten	karikierten
knacktest	knacktest
Reinstoffen	Reinstoffen
betrübst	betrübst
strafst	strafst
schwebte	schwebte
predigte	predigte
generalisiere	generalisiere
fokussierten	fokussierten
Metaphern	Metaphern
bemühten	bemühten
Flussbett	Flussbett
bezahlst	bezahlst
Proton	Proton
Schaffnerinnen	Schaffnerinnen
weisen	weisen
übersehest	übersehest
Finanzministerien	Finanzministerien
Unrecht	Unrecht
plissiere	plissiere
rebellieren	rebellieren
Zwingburg	Zwingburg
zerstreust	zerstreust
quatschest	quatschest
strafte	strafte
Abfertigungsgebäuden	Abfertigungsgebäuden
Sizilianer	Sizilianer
Domäne	Domäne
erstehst	erstehst
Badezimmers	Badezimmers
begehrt	begehrt
analysiere	analysiere
Eutektikum	Eutektikum
Helden	Helden
verwirrest	verwirrest
Rutheniumkomplexen	Rutheniumkomplexen
verbündeten	verbündeten
gewährte	gewährte
Fusselbart	Fusselbart
Abkürzungsverzeichnis	Abkürzungsverzeichnis
parkierst	parkierst
Kardinal	Kardinal
Anführer	Anführer
Alibis	Alibis
tattert	tattert
sollte	sollte
gönnst	gönnst
schäumt	schäumt
verunreinigt	verunreinigt
attackieret	attackieret
Erzeugungen	Erzeugungen
bimmelte	bimmelte
Knüppeln	Knüppeln
Noseans	Noseans
drücke	drücke
Eissteinen	Eissteinen
demütiget	demütiget
reichte	reichte
zürntet	zürntet
Schneepflüge	Schneepflüge
verspäte	verspäte
Düfte	Düfte
beäugst	beäugst
verdunstet	verdunstet
reimte	reimte
zersetzte	zersetzte
entwendet	entwendet
überschatteten	überschatteten
Konfitüre	Konfitüre
Sinnen	Sinnen
kaufet	kaufet
finanzieret	finanzieret
bezahlest	bezahlest
Maultieren	Maultieren
flötete	flötete
Leugnung	Leugnung
dirigieren	dirigieren
kräuselten	kräuselten
Willen	Willen
grüßend	grüßend
war	war
blast	blast
hastete	hastete
Dorsch	Dorsch
verteidigte	verteidigte
beweist	beweist
jappten	jappten
hingeht	hingeht
Brüdern	Brüdern
feiere	feiere
exmatrikuliertet	exmatrikuliertet
restaurierten	restaurierten
verhörest	verhörest
verzweigst	verzweigst
flenstet	flenstet
Prostyloi	Prostyloi
Bonzen	Bonzen
Einfältigkeiten	Einfältigkeiten
Maßen	Maßen
geloben	geloben
konsumiere	konsumiere
Deckenzapfen	Deckenzapfen
Rhodochrosite	Rhodochrosite
duckt	duckt
sorge	sorge
Plumpse	Plumpse
verringertet	verringertet
posierten	posierten
Anachronismus	Anachronismus
maßen	maßen
zerfielen	zerfielen
versuchtet	versuchtet
schwangt	schwangt
protokollieren	protokollieren
Dödel	Dödel
versteigerest	versteigerest
Frommen	Frommen
Welpen	Welpen
assimilierte	assimilierte
fehlet	fehlet
Ringeltaube	Ringeltaube
habet	habet
grünt	grünt
fritieret	fritieret
blitze	blitze
Hektaren	Hektaren
tanzen	tanzen
Dolde	Dolde
neigest	neigest
drillest	drillest
imitiertet	imitiertet
Buchhalterinnen	Buchhalterinnen
leiten	leiten
Busen	Busen
bewässern	bewässern
anrührte	anrührte
liehe	liehe
Ranzigkeit	Ranzigkeit
erlagst	erlagst
beleidigst	beleidigst
überwachten	überwachten
produzierte	produzierte
Klappertöpfen	Klappertöpfen
schließe	schließe
Californium	Californium
erwärmet	erwärmet
attestiertet	attestiertet
Anfechtung	Anfechtung
Leitkegeln	Leitkegeln
beeinflusst	beeinflusst
Bienenstöcke	Bienenstöcke
Kohlenstoffgehalt	Kohlenstoffgehalt
erweckest	erweckest
ziert	ziert
Azubi	Azubi
stiegen	stiegen
beläufst	beläufst
ringele	ringele
Seil	Seil
kram	kram
Küsserei	Küsserei
Zapfen	Zapfen
kupieren	kupieren
aufrichte	aufrichte
erhebet	erhebet
versklavt	versklavt
verführe	verführe
Jungfernflug	Jungfernflug
beunruhigte	beunruhigte
Schönrednern	Schönrednern
Monden	Monden
Nagellackentferner	Nagellackentferner
Androiden	Androiden
bebet	bebet
Staatsanleihe	Staatsanleihe
prophezeiet	prophezeiet
verblute	verblute
stirbt	stirbt
nehmet	nehmet
Neuigkeiten	Neuigkeiten
Arbeitsunfähigkeit	Arbeitsunfähigkeit
erlöst	erlöst
Hummer	Hummer
Wollte	Wollte
vertraget	vertraget
Piratensendern	Piratensendern
Alterität	Alterität
erbringen	erbringen
läutetet	läutetet
belohnte	belohnte
verwahrt	verwahrt
Gammastrahl	Gammastrahl
schiesst	schiesst
stärkte	stärkte
deaktiviere	deaktiviere
Innenministerien	Innenministerien
Nullpunktes	Nullpunktes
Schulleiterin	Schulleiterin
sterbest	sterbest
googelest	googelest
Schätzen	Schätzen
Rutheniumisotopen	Rutheniumisotopen
unterbewertete	unterbewertete
Mäppchen	Mäppchen
concessioniert	concessioniert
Großstädter	Großstädter
Putschisten	Putschisten
Tausch	Tausch
transportierst	transportierst
sponseret	sponseret
Attentäter	Attentäter
amputierten	amputierten
offenbarten	offenbarten
Steige	Steige
pustet	pustet
Fallet	Fallet
griffe	griffe
Zementen	Zementen
schwelle	schwelle
schwächst	schwächst
käbbelte	käbbelte
surre	surre
bückest	bückest
endlagern	endlagern
Wandergesellen	Wandergesellen
stehet	stehet
Taschendiebe	Taschendiebe
Angaben	Angaben
Deutungen	Deutungen
Massenanteilen	Massenanteilen
Kürass	Kürass
Dachdeckerin	Dachdeckerin
ehren	ehren
weinte	weinte
pulsiert	pulsiert
Urologe	Urologe
deponiere	deponiere
schneide	schneide
Komponisten	Komponisten
drängten	drängten
glaubet	glaubet
gedenkt	gedenkt
Brechnuss	Brechnuss
Würze	Würze
schlaf	schlaf
unterschiede	unterschiede
entfolgte	entfolgte
läute	läute
Apostels	Apostels
gare	gare
endlagerten	endlagerten
Markise	Markise
tappst	tappst
vermutest	vermutest
Euphemismen	Euphemismen
verprügelte	verprügelte
Kairiner	Kairiner
Seelöwen	Seelöwen
deckst	deckst
meinet	meinet
ducktest	ducktest
initiierst	initiierst
Drachenblut	Drachenblut
Aktenkoffer	Aktenkoffer
entsetzte	entsetzte
Ruße	Ruße
streckte	streckte
Toypudeln	Toypudeln
Flamingo	Flamingo
bereiteten	bereiteten
labe	labe
Laib	Laib
Leuchtstoff	Leuchtstoff
spukest	spukest
filteret	filteret
verboten	verboten
verschränkest	verschränkest
unterstützet	unterstützet
erzürnst	erzürnst
Grabbeltischen	Grabbeltischen
brillieret	brillieret
rebelliertet	rebelliertet
Remisen	Remisen
Imperialismen	Imperialismen
plumpsten	plumpsten
wünschte	wünschte
abalienierest	abalienierest
verbot	verbot
heiligest	heiligest
begäben	begäben
Zitronensaft	Zitronensaft
aase	aase
stammelest	stammelest
Crescendo	Crescendo
Fokusse	Fokusse
Dochten	Dochten
kabbelet	kabbelet
Trägergasen	Trägergasen
blaset	blaset
Wollt	Wollt
Butzemann	Butzemann
extemporieret	extemporieret
misstrauest	misstrauest
Argentits	Argentits
watete	watete
Boten	Boten
erbaust	erbaust
Rückumschlages	Rückumschlages
kämmtet	kämmtet
Verdachtes	Verdachtes
grabest	grabest
frottierten	frottierten
vergast	vergast
Ratsherren	Ratsherren
trotzest	trotzest
Unterseite	Unterseite
kremierten	kremierten
Kristallen	Kristallen
begehr	begehr
Mensch	Mensch
kautest	kautest
Flöte	Flöte
Abfertigungsschalter	Abfertigungsschalter
unterbrächen	unterbrächen
Aerosolen	Aerosolen
mästet	mästet
Vollkornbrot	Vollkornbrot
Effekt	Effekt
enterten	enterten
Fluorkohlenwasserstoffe	Fluorkohlenwasserstoffe
negierte	negierte
fragst	fragst
Reiseleiter	Reiseleiter
Treppen	Treppen
Propheten	Propheten
Kautschuken	Kautschuken
downloadet	downloadet
optimierte	optimierte
Abschreckungen	Abschreckungen
Pi	Pi
Rücktrittbremsen	Rücktrittbremsen
Rhabarbern	Rhabarbern
strafen	strafen
Zeile	Zeile
lackieren	lackieren
Schuhe	Schuhe
schämet	schämet
Stechpalmen	Stechpalmen
hintertreibt	hintertreibt
Füllet	Füllet
Höhlen	Höhlen
amenagier	amenagier
prahlet	prahlet
überreichend	überreichend
gereicht	gereicht
Dorngesträuch	Dorngesträuch
Heteroatome	Heteroatome
folterte	folterte
taufet	taufet
Schwester	Schwester
Rooibos	Rooibos
Böreks	Böreks
touchiere	touchiere
Dewargefäße	Dewargefäße
Saiblingen	Saiblingen
Tübinger	Tübinger
Chlorwasserstoffmolekül	Chlorwasserstoffmolekül
verseuchen	verseuchen
verzweigt	verzweigt
begehrtest	begehrtest
verstehst	verstehst
foppte	foppte
Wiederbelebung	Wiederbelebung
Pinguin	Pinguin
knistern	knistern
Impedanz	Impedanz
dekorieren	dekorieren
plazierest	plazierest
Haben	Haben
Führe	Führe
wehre	wehre
Elstern	Elstern
konstatiertest	konstatiertest
Setzet	Setzet
Vergeltungen	Vergeltungen
vernichtete	vernichtete
balkanisierte	balkanisierte
Entrées	Entrées
Stellen	Stellen
Milchflaschen	Milchflaschen
Erzherzogshüten	Erzherzogshüten
wisperten	wisperten
mögest	mögest
liebtet	liebtet
Notärztinnen	Notärztinnen
zwingst	zwingst
Bunde	Bunde
desensibilisierte	desensibilisierte
suchest	suchest
Hirnstämmen	Hirnstämmen
bollerte	bollerte
Katz-und-Maus-Spiele	Katz-und-Maus-Spiele
Kopfsalat	Kopfsalat
Fragen	Fragen
Premierministerinnen	Premierministerinnen
Blockflöten	Blockflöten
entzögen	entzögen
berücksichtiget	berücksichtiget
Premieren	Premieren
Metallothionein	Metallothionein
UND-Gatter	UND-Gatter
leistest	leistest
fälle	fälle
verzeigt	verzeigt
versteigernd	versteigernd
Landwirt	Landwirt
Laubholz	Laubholz
erfüllst	erfüllst
hingehet	hingehet
zirpen	zirpen
Otavit	Otavit
mein	mein
Flaschenhälsen	Flaschenhälsen
Bajonetten	Bajonetten
Ausnahme	Ausnahme
hinterfragten	hinterfragten
sponsertest	sponsertest
blende	blende
bromiert	bromiert
Kleinoden	Kleinoden
Bluffs	Bluffs
Teekessel	Teekessel
bequemen	bequemen
revoltiert	revoltiert
sollst	sollst
kennest	kennest
Asteroide	Asteroide
vertrage	vertrage
Gleitzeiten	Gleitzeiten
Pfandgeld	Pfandgeld
Zain	Zain
begruben	begruben
bauest	bauest
Gehirnwelle	Gehirnwelle
Kaufhäuser	Kaufhäuser
Fiebermittel	Fiebermittel
berufe	berufe
Kakaos	Kakaos
Kettenraucher	Kettenraucher
Chinakohl	Chinakohl
Halleluja	Halleluja
Bürzeln	Bürzeln
Eisenkräutern	Eisenkräutern
Gebäck	Gebäck
Kautschuke	Kautschuke
Industrienation	Industrienation
dresche	dresche
Leichenschauhäusern	Leichenschauhäusern
Kernladungszahlen	Kernladungszahlen
ermutigt	ermutigt
Mopps	Mopps
irre	irre
Numerus	Numerus
amenagiere	amenagiere
Atommodelle	Atommodelle
Begünstigung	Begünstigung
log	log
Gläubige	Gläubige
Sitz	Sitz
bereitet	bereitet
verstecke	verstecke
Deck	Deck
verkürztest	verkürztest
Fallt	Fallt
Freunden	Freunden
Elf	Elf
Buchhalterin	Buchhalterin
Lunisolarkalender	Lunisolarkalender
vergrubt	vergrubt
nütze	nütze
sagt	sagt
schnüren	schnüren
drescht	drescht
Fahrzeugkatalysatoren	Fahrzeugkatalysatoren
Dewargefäß	Dewargefäß
Urheimaten	Urheimaten
beschrifte	beschrifte
Reliquiar	Reliquiar
handhabest	handhabest
hadere	hadere
Adventskalender	Adventskalender
Ionenaustauscher	Ionenaustauscher
fluppe	fluppe
bromiertet	bromiertet
strafe	strafe
Kaliumdichromat	Kaliumdichromat
segeln	segeln
reagierte	reagierte
transportierte	transportierte
erliegst	erliegst
verirrt	verirrt
Hornunges	Hornunges
gesagt	gesagt
buddelten	buddelten
wollten	wollten
Dudelsack	Dudelsack
gebührt	gebührt
entheiligten	entheiligten
Eistaucher	Eistaucher
Fromme	Fromme
verschränken	verschränken
Briefe	Briefe
kürze	kürze
konnotieret	konnotieret
fluktuierte	fluktuierte
holte	holte
benützt	benützt
Dattel	Dattel
gewärtigt	gewärtigt
Fluorgehalte	Fluorgehalte
späht	späht
geahnt	geahnt
bestellt	bestellt
Managementsystemen	Managementsystemen
torpedieret	torpedieret
Kontrollboxen	Kontrollboxen
gewöhnt	gewöhnt
Penis	Penis
funkelet	funkelet
Schwermetallionen	Schwermetallionen
Strafräume	Strafräume
Schnallen	Schnallen
Schreien	Schreien
Tintenklecks	Tintenklecks
glühten	glühten
benütztest	benütztest
predigtest	predigtest
entwaffneten	entwaffneten
tatteret	tatteret
Wandergewerbe	Wandergewerbe
Ionen	Ionen
aufkommen	aufkommen
entschleiert	entschleiert
Kontraindikationen	Kontraindikationen
Nachteilen	Nachteilen
wisperest	wisperest
Taschenwörterbuches	Taschenwörterbuches
entgehst	entgehst
Abnahme	Abnahme
kitzeln	kitzeln
Verwaltungsakte	Verwaltungsakte
begehrest	begehrest
Tiefschutz	Tiefschutz
habt	habt
tagten	tagten
Botokuden	Botokuden
Tut	Tut
dankte	dankte
Deckenfarbe	Deckenfarbe
Musters	Musters
zwänget	zwänget
stationierten	stationierten
legten	legten
weich	weich
beschlug	beschlug
übersteht	übersteht
fotzt	fotzt
föhnten	föhnten
gedächten	gedächten
Stiefmütterchen	Stiefmütterchen
Fingerhüten	Fingerhüten
sagen	sagen
Bienenzüchter	Bienenzüchter
schabst	schabst
polymerisier	polymerisier
Exilanten	Exilanten
Milchflasche	Milchflasche
deckte	deckte
entzogen	entzogen
schauend	schauend
grübelt	grübelt
sprühend	sprühend
bewerbet	bewerbet
verzehre	verzehre
stärke	stärke
Stoffwechselweg	Stoffwechselweg
Abflug	Abflug
klagte	klagte
Held	Held
Tintenfische	Tintenfische
sannen	sannen
Welteninseln	Welteninseln
Tyrannen	Tyrannen
koexistierte	koexistierte
Hure	Hure
funktionierte	funktionierte
verstört	verstört
Lesen	Lesen
unterscheide	unterscheide
verdrängt	verdrängt
Mischelementen	Mischelementen
überwiese	überwiese
feire	feire
Mageninhalt	Mageninhalt
Fallen	Fallen
dolmetschst	dolmetschst
Forschung	Forschung
Bettlers	Bettlers
Flöße	Flöße
Fellhandschuhen	Fellhandschuhen
verglühest	verglühest
zeichnet	zeichnet
blamierest	blamierest
Fokus	Fokus
trödele	trödele
erzürnet	erzürnet
Ausbeuterei	Ausbeuterei
Markisen	Markisen
zeiget	zeiget
fertig	fertig
bündelest	bündelest
Schnarchralle	Schnarchralle
Schaffe	Schaffe
verließet	verließet
besichtigt	besichtigt
verfinstere	verfinstere
verselbstständige	verselbstständige
Monde	Monde
absolviere	absolviere
verdammst	verdammst
Efeu	Efeu
Kontrollkästchen	Kontrollkästchen
nippst	nippst
Android	Android
steiget	steiget
pendelt	pendelt
klöne	klöne
anzeigt	anzeigt
denaturierten	denaturierten
verbluteten	verbluteten
stoße	stoße
Tiere	Tiere
Excimerlasern	Excimerlasern
Darlegung	Darlegung
mögt	mögt
Schleppern	Schleppern
Kassettenrekorder	Kassettenrekorder
Hadithe	Hadithe
Ausländer	Ausländer
Landstreichereien	Landstreichereien
Energiespeicher	Energiespeicher
kaufst	kaufst
Mikrometer	Mikrometer
wiederholten	wiederholten
Abschußringe	Abschußringe
Wehre	Wehre
verkleidete	verkleidete
süsst	süsst
glaubtet	glaubtet
vereinigte	vereinigte
Bienenstock	Bienenstock
verantwortet	verantwortet
Prozedur	Prozedur
Plüschtier	Plüschtier
Sorget	Sorget
Schwan	Schwan
Harpune	Harpune
maß	maß
Videoaufzeichnungen	Videoaufzeichnungen
Mops	Mops
Brechnüssen	Brechnüssen
Fett	Fett
regierte	regierte
dürfest	dürfest
Atomphysikern	Atomphysikern
Bazziten	Bazziten
Nachteile	Nachteile
erkälteten	erkälteten
Pudern	Pudern
Abhängen	Abhängen
eingeht	eingeht
Leichtmetalle	Leichtmetalle
Bezeugungen	Bezeugungen
pharyngalisierst	pharyngalisierst
begnügte	begnügte
handhaben	handhaben
Bestechungsgelder	Bestechungsgelder
Dünungen	Dünungen
Halogenatomen	Halogenatomen
versteckte	versteckte
Operationssaal	Operationssaal
Kaffeelöffel	Kaffeelöffel
bedrücktest	bedrücktest
Gasgemisch	Gasgemisch
Speere	Speere
säusele	säusele
beschottre	beschottre
Beteiligte	Beteiligte
lärmte	lärmte
verglühte	verglühte
Signalen	Signalen
verkürzest	verkürzest
rühmst	rühmst
Färsen	Färsen
formirte	formirte
skypst	skypst
tragt	tragt
repräsentieret	repräsentieret
amenagierst	amenagierst
Suffixen	Suffixen
Diäresen	Diäresen
zeuge	zeuge
Steigen	Steigen
predigend	predigend
erniedrigst	erniedrigst
reiche	reiche
Chronisten	Chronisten
sortierte	sortierte
Feuerteufels	Feuerteufels
Hirschen	Hirschen
Ratsherr	Ratsherr
erlaube	erlaube
verhungert	verhungert
mampfen	mampfen
Gründungsprivilegien	Gründungsprivilegien
Teekesseln	Teekesseln
wehe	wehe
kappten	kappten
Gemurmel	Gemurmel
Hörst	Hörst
lispelt	lispelt
verbündend	verbündend
verunzierte	verunzierte
egge	egge
begnadigst	begnadigst
skypet	skypet
fette	fette
klappten	klappten
fragmentierst	fragmentierst
Bedeutung	Bedeutung
Tatsachenbeschönigern	Tatsachenbeschönigern
stürzest	stürzest
vermischten	vermischten
Lümmeltüte	Lümmeltüte
Anführern	Anführern
Extremen	Extremen
Gangster	Gangster
Zirkelschluss	Zirkelschluss
Anspielungen	Anspielungen
Unterseiten	Unterseiten
Silberdrähten	Silberdrähten
Hummel	Hummel
lösten	lösten
schließen	schließen
heulte	heulte
gedachte	gedachte
Rechnungen	Rechnungen
ziere	ziere
streite	streite
Laufring	Laufring
Basilisk	Basilisk
lüftet	lüftet
schneidet	schneidet
Extrems	Extrems
vergiften	vergiften
traget	traget
Brauhaus	Brauhaus
vertagest	vertagest
Kalifeldspate	Kalifeldspate
simuliertet	simuliertet
zählten	zählten
Bestecken	Bestecken
Übelkeit	Übelkeit
streutet	streutet
gestikulierst	gestikulierst
Gallanen	Gallanen
Wolfesgrube	Wolfesgrube
Pedant	Pedant
bewahrst	bewahrst
emigriert	emigriert
schleißt	schleißt
verseift	verseift
Renegaten	Renegaten
Gummibaumes	Gummibaumes
Sonnenfinsternissen	Sonnenfinsternissen
Abarten	Abarten
maximierten	maximierten
zierte	zierte
arbeit	arbeit
Euter	Euter
stehest	stehest
Halter	Halter
verklärest	verklärest
Baiser	Baiser
Chlorat	Chlorat
fresset	fresset
schauten	schauten
Ich	Ich
Kuckucke	Kuckucke
Wechselstuben	Wechselstuben
frikassierend	frikassierend
Wachen	Wachen
spanne	spanne
wachsen	wachsen
drückte	drückte
strullerst	strullerst
Angabe	Angabe
Automatikgetriebe	Automatikgetriebe
manövrierte	manövrierte
Leitungsweg	Leitungsweg
prostituieret	prostituieret
billigen	billigen
strafend	strafend
Saiblinge	Saiblinge
Meldezettel	Meldezettel
älteste	älteste
Geigerzähler	Geigerzähler
enttäuschet	enttäuschet
porträtiert	porträtiert
sprecht	sprecht
Ente	Ente
vertreibe	vertreibe
pfänden	pfänden
Gemüseläden	Gemüseläden
changiere	changiere
Korrosionsschutz	Korrosionsschutz
addierte	addierte
fritiert	fritiert
Klotzes	Klotzes
Anarchisten	Anarchisten
bekennet	bekennet
Erdbirnen	Erdbirnen
helfest	helfest
manövrieret	manövrieret
Skorpionen	Skorpionen
Sportlerin	Sportlerin
panaschieren	panaschieren
Moren	Moren
haste	haste
verdammtet	verdammtet
wurstelten	wurstelten
Donnerstagabenden	Donnerstagabenden
Feinde	Feinde
wallfahrten	wallfahrten
Rotzinkerzen	Rotzinkerzen
Frage	Frage
thematisierten	thematisierten
Kassettenrekordern	Kassettenrekordern
schämest	schämest
Flossen	Flossen
reicht	reicht
Zirkelbeweis	Zirkelbeweis
ramme	ramme
Abartigkeit	Abartigkeit
Arbeitsleistung	Arbeitsleistung
Schatten	Schatten
blätteret	blätteret
Metallspiegeln	Metallspiegeln
Diamantringen	Diamantringen
Nervenzellen	Nervenzellen
erfüllt	erfüllt
Geckos	Geckos
vermeße	vermeße
klappest	klappest
herrschst	herrschst
zagest	zagest
Gesamtmengen	Gesamtmengen
verschlimmerte	verschlimmerte
bröckeln	bröckeln
Küchenmaschinen	Küchenmaschinen
Ecke	Ecke
Merkel-Rauten	Merkel-Rauten
Kanzlerinnen	Kanzlerinnen
gedolmetscht	gedolmetscht
verbaselte	verbaselte
wetzte	wetzte
Polarisation	Polarisation
verbluten	verbluten
Rücktrittbremse	Rücktrittbremse
zieren	zieren
Verehrer	Verehrer
verdeckte	verdeckte
Klappertopf	Klappertopf
verführten	verführten
behauptest	behauptest
Zerfall	Zerfall
gedenk	gedenk
verkürzten	verkürzten
besprachen	besprachen
Pflanzung	Pflanzung
nehmt	nehmt
Brüder	Brüder
Tollkirschen	Tollkirschen
Borhydrid	Borhydrid
zweifelte	zweifelte
attestierten	attestierten
beantragt	beantragt
Grönländer	Grönländer
betrüben	betrüben
errötest	errötest
Zeugen	Zeugen
malen	malen
Laken	Laken
torpediert	torpediert
heparinisierten	heparinisierten
Spektralbereich	Spektralbereich
Sprödmetallen	Sprödmetallen
Geschwindigkeitsmessern	Geschwindigkeitsmessern
Schuhen	Schuhen
Generation	Generation
begehrten	begehrten
Wembley-Tore	Wembley-Tore
Möbiusbänder	Möbiusbänder
pflanzt	pflanzt
stolze	stolze
attackieren	attackieren
heben	heben
verachtend	verachtend
zerstreut	zerstreut
Ärzteblatt	Ärzteblatt
bessere	bessere
Dochte	Dochte
gewitterest	gewitterest
Trägergas	Trägergas
Tausche	Tausche
Zwergschwanes	Zwergschwanes
Oheim	Oheim
gräbst	gräbst
stickten	stickten
Schanktisch	Schanktisch
folg	folg
langte	langte
Wände	Wände
ummantelten	ummantelten
Gedächtnissen	Gedächtnissen
konsolidierest	konsolidierest
wünschet	wünschet
Adelung	Adelung
Blässe	Blässe
fluktuiert	fluktuiert
immunisiere	immunisiere
rächte	rächte
Pumpellyiten	Pumpellyiten
Fusselbärten	Fusselbärten
Massenarbeitslosigkeit	Massenarbeitslosigkeit
Waldbränden	Waldbränden
ahne	ahne
Uranerzen	Uranerzen
entständen	entständen
zerstreuten	zerstreuten
Ankern	Ankern
schmeichelest	schmeichelest
Mobilfunknetzen	Mobilfunknetzen
gestattest	gestattest
Physikerin	Physikerin
parkierten	parkierten
verlasse	verlasse
beschottert	beschottert
geleite	geleite
auflöste	auflöste
pflanzen	pflanzen
leertet	leertet
Feierabend	Feierabend
Steuerberatern	Steuerberatern
entmineralisierst	entmineralisierst
räumet	räumet
erfahrt	erfahrt
umhüllt	umhüllt
ringet	ringet
kochte	kochte
stelle	stelle
Braunrallen	Braunrallen
zuppen	zuppen
Höhen	Höhen
verbrauchten	verbrauchten
kontaktiere	kontaktiere
lösen	lösen
Pausbacke	Pausbacke
bewahrheitete	bewahrheitete
konvergierest	konvergierest
Wüste	Wüste
zürn	zürn
strömt	strömt
Gipfeltreffen	Gipfeltreffen
Unterwerfungen	Unterwerfungen
zittertest	zittertest
Zwetschgen	Zwetschgen
beißt	beißt
denaturieret	denaturieret
Verselbstständigung	Verselbstständigung
gelobet	gelobet
Zerfällen	Zerfällen
Geschichtsbüchern	Geschichtsbüchern
aufwacht	aufwacht
Wiedergutmachung	Wiedergutmachung
Stilllegung	Stilllegung
colorierten	colorierten
bewahrheitetet	bewahrheitetet
Menschenhandel	Menschenhandel
bimmelten	bimmelten
blockiert	blockiert
Schreibtischtäter	Schreibtischtäter
parliere	parliere
imkernd	imkernd
dekompiliertest	dekompiliertest
Speeren	Speeren
Fieberanfall	Fieberanfall
Halle	Halle
Schönredner	Schönredner
Zeitplanes	Zeitplanes
Bergen	Bergen
lehren	lehren
Fischotters	Fischotters
Verkehrsflugzeug	Verkehrsflugzeug
schnattert	schnattert
sagten	sagten
gestatte	gestatte
nippend	nippend
Binden	Binden
Armband	Armband
verbitterte	verbitterte
Abschiedsbrief	Abschiedsbrief
Kriege	Kriege
Notständen	Notständen
naschst	naschst
speisen	speisen
klumpe	klumpe
legend	legend
Paragraphenreitern	Paragraphenreitern
Achatschnecken	Achatschnecken
Schnute	Schnute
Minimierungen	Minimierungen
inspirierten	inspirierten
Würfen	Würfen
konstatiere	konstatiere
Suchanfragen	Suchanfragen
füllte	füllte
Arbeitsbereich	Arbeitsbereich
Gespenst	Gespenst
Höhe	Höhe
Leuchtkäfern	Leuchtkäfern
sabbre	sabbre
Knöllchens	Knöllchens
Taschendieb	Taschendieb
verselbstständigest	verselbstständigest
Schnittlauch	Schnittlauch
strecke	strecke
infiziertet	infiziertet
fügt	fügt
verdammen	verdammen
Atmosphäre	Atmosphäre
Zubrötchen	Zubrötchen
Alkali	Alkali
stoppten	stoppten
beschuldiget	beschuldiget
Breiten	Breiten
Rheumatismus	Rheumatismus
urbanisiert	urbanisiert
blamierte	blamierte
nähert	nähert
Elfen	Elfen
Werk	Werk
Weihen	Weihen
hydrogentartrate	hydrogentartrate
Rekursionen	Rekursionen
Noseanen	Noseanen
Wiederauferstehungen	Wiederauferstehungen
Türklingeln	Türklingeln
Schnipsel	Schnipsel
gedenken	gedenken
Aerosole	Aerosole
zagt	zagt
Wanderfalken	Wanderfalken
rangierst	rangierst
haben	haben
beherrscht	beherrscht
Gefügen	Gefügen
Oxonium	Oxonium
frappiere	frappiere
Pater	Pater
Hochsommern	Hochsommern
Karern	Karern
antworte	antworte
Geringschätzung	Geringschätzung
Katalanen	Katalanen
weichet	weichet
spiele	spiele
halbierte	halbierte
Entmachtungen	Entmachtungen
Menschen	Menschen
betreibet	betreibet
Trinkgefäße	Trinkgefäße
grauten	grauten
Stätten	Stätten
Aktivist	Aktivist
Füllfederhalters	Füllfederhalters
Erbsen	Erbsen
Traubenlesen	Traubenlesen
Katz-und-Maus-Spielen	Katz-und-Maus-Spielen
vertreibt	vertreibt
Pläsieren	Pläsieren
Kapitalverkehr	Kapitalverkehr
Sauberfrau	Sauberfrau
dümpelst	dümpelst
Auguren	Auguren
Beschuldigungen	Beschuldigungen
wehrt	wehrt
rebelliere	rebelliere
Kronsbeere	Kronsbeere
fluche	fluche
harrten	harrten
erwachend	erwachend
spurtest	spurtest
wehr	wehr
fingiere	fingiere
emaillieret	emaillieret
nähre	nähre
schmetterst	schmetterst
Arm	Arm
Europameistern	Europameistern
Kompass	Kompass
Automatikgetrieben	Automatikgetrieben
Lasten	Lasten
Gurten	Gurten
hydrogentartrat	hydrogentartrat
Fußbodens	Fußbodens
verbündest	verbündest
Kirgisin	Kirgisin
Krankenscheinen	Krankenscheinen
gequasselt	gequasselt
verwirklicht	verwirklicht
schluchze	schluchze
Seetauchers	Seetauchers
Haltepunkt	Haltepunkt
Suchanfrage	Suchanfrage
bequemest	bequemest
gefügt	gefügt
hinterzöge	hinterzöge
radiertest	radiertest
Atommodellen	Atommodellen
punkten	punkten
notlandet	notlandet
flambierest	flambierest
Berge	Berge
Kupferkiesen	Kupferkiesen
Abbild	Abbild
Glühwürmchen	Glühwürmchen
graben	graben
Stufen	Stufen
Amokläuferinnen	Amokläuferinnen
Wimpertierchen	Wimpertierchen
meißeltest	meißeltest
Smaragdkehlkolibris	Smaragdkehlkolibris
bereite	bereite
peilst	peilst
bewähret	bewähret
versteckten	versteckten
verdamme	verdamme
Hobby	Hobby
drifte	drifte
freuet	freuet
Feuerteufel	Feuerteufel
Hochsommer	Hochsommer
vergaste	vergaste
harrtest	harrtest
Zuschauer	Zuschauer
Samstagnachmittag	Samstagnachmittag
kristallisiertest	kristallisiertest
bekriegtet	bekriegtet
hickste	hickste
observiertest	observiertest
Einwirkungen	Einwirkungen
foppten	foppten
höbe	höbe
Nussknacker	Nussknacker
rächest	rächest
loben	loben
zuppte	zuppte
Hummern	Hummern
leihe	leihe
babbelten	babbelten
Gaschromatographie	Gaschromatographie
gedurft	gedurft
folget	folget
Einzelgänger	Einzelgänger
konsumieren	konsumieren
Sichelzellenanämien	Sichelzellenanämien
Buntspechten	Buntspechten
ersparet	ersparet
Wühltischen	Wühltischen
spekulieren	spekulieren
besichtiget	besichtiget
Lehrkörpern	Lehrkörpern
verzehrst	verzehrst
oxidierte	oxidierte
beziehen	beziehen
Volkslehre	Volkslehre
Autonomien	Autonomien
Konfitüren	Konfitüren
Stärkungsmittel	Stärkungsmittel
Falle	Falle
Dienstgrade	Dienstgrade
rüste	rüste
Atombomben	Atombomben
Provinz	Provinz
Plumpsen	Plumpsen
entflieht	entflieht
hänge	hänge
betrübte	betrübte
kristallisierest	kristallisierest
Aha-Erlebnis	Aha-Erlebnis
Schneider	Schneider
moppte	moppte
Gruftis	Gruftis
Zankapfel	Zankapfel
unterstützten	unterstützten
untersagtest	untersagtest
Kleinode	Kleinode
piesacken	piesacken
besorgten	besorgten
pflügen	pflügen
Pflaumen	Pflaumen
umhüll	umhüll
Taufe	Taufe
schummelten	schummelten
Martyrologium	Martyrologium
teilen	teilen
besprichst	besprichst
Zähnen	Zähnen
Zahnfleischentzündungen	Zahnfleischentzündungen
separieren	separieren
Ansteckern	Ansteckern
Rücktrittes	Rücktrittes
Schneepflug	Schneepflug
gespeist	gespeist
betrübtest	betrübtest
befehle	befehle
Butzemänner	Butzemänner
besänne	besänne
Ektoplasmen	Ektoplasmen
pilgerte	pilgerte
Gesetze	Gesetze
vandaliere	vandaliere
Planern	Planern
erstarrten	erstarrten
Aggressor	Aggressor
Ingredienzen	Ingredienzen
überweist	überweist
Freizeitzentrum	Freizeitzentrum
köderte	köderte
wallte	wallte
Dominicanerin	Dominicanerin
aufrichten	aufrichten
verberge	verberge
Augengläsern	Augengläsern
Türklingel	Türklingel
Galeere	Galeere
hurst	hurst
versuchest	versuchest
Abnahmen	Abnahmen
Anlass	Anlass
Lautschriften	Lautschriften
heilet	heilet
balkanisierten	balkanisierten
Funkfeuern	Funkfeuern
kabelst	kabelst
verdammend	verdammend
Pianos	Pianos
mikrominiaturisierten	mikrominiaturisierten
ringe	ringe
zerrisset	zerrisset
Pfahl	Pfahl
inszenierst	inszenierst
gelobend	gelobend
Stierkämpfen	Stierkämpfen
Zeitschlitzen	Zeitschlitzen
zürnet	zürnet
verwechselst	verwechselst
Hertz	Hertz
lauschte	lauschte
hegten	hegten
Ausstiegstüren	Ausstiegstüren
kämpfte	kämpfte
fragest	fragest
schlag	schlag
Fahrt	Fahrt
verurteilen	verurteilen
Entree	Entree
aktualisiere	aktualisiere
verseucht	verseucht
schmettern	schmettern
Hurriter	Hurriter
merke	merke
kategorisierst	kategorisierst
helft	helft
Gemütes	Gemütes
Reinigungsschrittes	Reinigungsschrittes
wehen	wehen
schütze	schütze
beichteten	beichteten
Reliquiare	Reliquiare
werden	werden
verfügten	verfügten
verdunsten	verdunsten
reinigst	reinigst
idealisierest	idealisierest
löge	löge
befehlt	befehlt
gewünscht	gewünscht
Einfältigkeit	Einfältigkeit
erkältete	erkältete
erlabe	erlabe
Gemüt	Gemüt
Zebrahai	Zebrahai
Möbelstoffen	Möbelstoffen
Kommoden	Kommoden
heißet	heißet
entgehe	entgehe
Fehden	Fehden
Pausbacken	Pausbacken
wegen	wegen
Spektralbereichen	Spektralbereichen
Muhme	Muhme
schaffst	schaffst
scheuchten	scheuchten
brauche	brauche
Leuchtstoffen	Leuchtstoffen
Weste	Weste
Fülle	Fülle
narret	narret
wohnst	wohnst
gabelt	gabelt
gebäre	gebäre
häufe	häufe
emailliert	emailliert
Trinken	Trinken
verpuffe	verpuffe
Öfchen	Öfchen
Cola	Cola
häuftet	häuftet
Spektroskopie	Spektroskopie
Europium	Europium
Grüße	Grüße
freute	freute
löstet	löstet
Rubinen	Rubinen
Zipfelmütze	Zipfelmütze
Asylrechte	Asylrechte
rüstetest	rüstetest
Technetate	Technetate
Carbiden	Carbiden
evakuierte	evakuierte
habe	habe
bescheißt	bescheißt
Selbstsicherheit	Selbstsicherheit
sprachen	sprachen
wart	wart
dürfte	dürfte
Silbersulfidbelag	Silbersulfidbelag
velarisierend	velarisierend
Talismanen	Talismanen
Außenministerien	Außenministerien
Theologie	Theologie
lauf	lauf
konvertieren	konvertieren
begründetest	begründetest
Bevölkerungsdichten	Bevölkerungsdichten
Klaue	Klaue
malochet	malochet
Nanosatelliten	Nanosatelliten
besuchen	besuchen
verliere	verliere
beansprucht	beansprucht
surrst	surrst
Ringen	Ringen
prahlte	prahlte
Anachronismen	Anachronismen
dividiere	dividiere
jappen	jappen
wohnest	wohnest
lang	lang
substituierest	substituierest
Trümmersprachen	Trümmersprachen
Kavalier	Kavalier
schrecken	schrecken
zankte	zankte
Kriegen	Kriegen
Entsetzt	Entsetzt
lösend	lösend
schauen	schauen
erwähnten	erwähnten
behalte	behalte
Sprödmetall	Sprödmetall
Operationssälen	Operationssälen
Satzung	Satzung
Erbse	Erbse
Apotheose	Apotheose
Futtermitteln	Futtermitteln
bemühst	bemühst
emittierte	emittierte
Quatsch	Quatsch
Gläubiger	Gläubiger
Quellen	Quellen
flucht	flucht
Durchbruches	Durchbruches
Geschwindigkeitsmesser	Geschwindigkeitsmesser
rede	rede
Blattgewebe	Blattgewebe
Pfründe	Pfründe
Kompromissen	Kompromissen
Hüllenelektronen	Hüllenelektronen
rühmte	rühmte
Ion	Ion
vermeßest	vermeßest
Protonen	Protonen
parametrisierst	parametrisierst
verblieben	verblieben
mißverstehet	mißverstehet
Martyrologien	Martyrologien
illustriere	illustriere
präsentiere	präsentiere
Verkehrsflugzeuge	Verkehrsflugzeuge
schluchzte	schluchzte
blitztet	blitztet
Fetten	Fetten
plärrt	plärrt
Füchsinnen	Füchsinnen
beleuchte	beleuchte
Fluorkohlenwasserstoff	Fluorkohlenwasserstoff
Theistinnen	Theistinnen
Aromastoffe	Aromastoffe
Dingen	Dingen
boykottierst	boykottierst
Beiblättern	Beiblättern
protestierst	protestierst
zelte	zelte
rekonstruieret	rekonstruieret
Generatoren	Generatoren
dienet	dienet
replizieret	replizieret
aufsteht	aufsteht
strecken	strecken
harmoniert	harmoniert
kühle	kühle
quatschen	quatschen
appellierte	appellierte
fabulierest	fabulierest
Hüfte	Hüfte
Zeithorizonten	Zeithorizonten
verfliegest	verfliegest
Indern	Indern
wehren	wehren
schautest	schautest
bewürben	bewürben
Vorstädten	Vorstädten
geschlummert	geschlummert
stiege	stiege
glaube	glaube
spähet	spähet
Senkung	Senkung
Sprachräumen	Sprachräumen
brachen	brachen
Animation	Animation
entert	entert
versteckend	versteckend
steckst	steckst
zuppst	zuppst
kritzelst	kritzelst
Reststoff	Reststoff
wollt	wollt
reizet	reizet
trotze	trotze
verunglimpfest	verunglimpfest
zerreißt	zerreißt
Schnipseln	Schnipseln
demoralisiere	demoralisiere
betrieben	betrieben
Übertretung	Übertretung
weinest	weinest
separieret	separieret
vertonten	vertonten
herrschten	herrschten
watet	watet
Gehorsams	Gehorsams
pharyngalisierten	pharyngalisierten
Aprikose	Aprikose
sinterte	sinterte
verkriechet	verkriechet
Golfplatz	Golfplatz
erforschet	erforschet
erlöse	erlöse
begrubt	begrubt
dechiffriere	dechiffriere
Volkslehren	Volkslehren
betreten	betreten
Bildpunkten	Bildpunkten
Mauten	Mauten
tunet	tunet
Autoklav	Autoklav
Gelobet	Gelobet
Bebauungsplänen	Bebauungsplänen
mopst	mopst
Blumensträußen	Blumensträußen
Reißnagel	Reißnagel
Störe	Störe
knutschst	knutschst
unterbrächest	unterbrächest
Gesamtmenge	Gesamtmenge
Ärztin	Ärztin
Telefonverkäufer	Telefonverkäufer
Dreieinigkeit	Dreieinigkeit
Aktienkurs	Aktienkurs
Untiefe	Untiefe
legst	legst
Ebenen	Ebenen
täuschet	täuschet
kabelte	kabelte
vertrieb	vertrieb
Paläste	Paläste
fallt	fallt
Quellflüssen	Quellflüssen
Falzen	Falzen
Wachteln	Wachteln
hintertriebe	hintertriebe
verstecken	verstecken
Grießen	Grießen
schlabberten	schlabberten
Vergrößerungen	Vergrößerungen
angehört	angehört
erfreu	erfreu
Almanache	Almanache
straftet	straftet
Deutung	Deutung
Rückwege	Rückwege
Hinkelsteine	Hinkelsteine
vertrauten	vertrauten
Leichenschauhäuser	Leichenschauhäuser
Einöde	Einöde
härte	härte
Toypudel	Toypudel
flöteten	flöteten
stolz	stolz
zensiere	zensiere
warntest	warntest
eiterten	eiterten
ruckeln	ruckeln
schlafet	schlafet
Leichnamen	Leichnamen
folgst	folgst
Funkfeuer	Funkfeuer
reagiert	reagiert
verwirrte	verwirrte
verdammte	verdammte
gafften	gafften
kremieren	kremieren
Anrufbeantworter	Anrufbeantworter
beanspruchte	beanspruchte
destabilisierst	destabilisierst
eggten	eggten
dümpelte	dümpelte
schwöret	schwöret
knusperten	knusperten
haschiert	haschiert
häufte	häufte
Graben	Graben
Wiedergutmachungen	Wiedergutmachungen
Weichseln	Weichseln
Kreisen	Kreisen
colorierend	colorierend
glaubten	glaubten
liegen	liegen
gewährtest	gewährtest
geleiteten	geleiteten
verbraucht	verbraucht
Gewinnungen	Gewinnungen
laute	laute
hängte	hängte
Alteritäten	Alteritäten
Gepäckträger	Gepäckträger
bombardiere	bombardiere
verhalte	verhalte
kehrte	kehrte
Bushaltestellen	Bushaltestellen
klumpt	klumpt
haltest	haltest
Privatsachen	Privatsachen
bedient	bedient
pfände	pfände
Fahret	Fahret
steigerten	steigerten
Geheimdienst	Geheimdienst
Ausbeutern	Ausbeutern
Sternen	Sternen
Fussel	Fussel
Schläfchens	Schläfchens
klettert	klettert
beweiset	beweiset
Ausländern	Ausländern
zeugt	zeugt
sterbt	sterbt
glaubend	glaubend
Blitzableiter	Blitzableiter
Sippe	Sippe
Geschreis	Geschreis
zerrissen	zerrissen
verwechseltet	verwechseltet
Fluorgehalt	Fluorgehalt
weissagst	weissagst
applizirst	applizirst
Puffersystemen	Puffersystemen
herrschen	herrschen
weiche	weiche
gewinnet	gewinnet
Abkömmlingen	Abkömmlingen
Isobar	Isobar
Leisten	Leisten
Farbstoffe	Farbstoffe
Rhodochrositen	Rhodochrositen
verspätest	verspätest
geliebt	geliebt
besucht	besucht
beanspruchet	beanspruchet
Nehmt	Nehmt
malet	malet
Kompromiss	Kompromiss
punktest	punktest
erzwinget	erzwinget
betätigtet	betätigtet
Schätze	Schätze
föchte	föchte
labert	labert
Gässchen	Gässchen
Gigapascaln	Gigapascaln
Fetzens	Fetzens
sedimentieret	sedimentieret
Tintenklecksen	Tintenklecksen
wälzet	wälzet
Fermium	Fermium
liebten	liebten
weine	weine
grüßest	grüßest
lade	lade
bekehrte	bekehrte
berührt	berührt
säumet	säumet
Greyerzer	Greyerzer
erforschest	erforschest
ermahnt	ermahnt
Schild	Schild
Assimilationen	Assimilationen
ausfuhren	ausfuhren
Lärche	Lärche
respektieren	respektieren
sprüht	sprüht
Pflichten	Pflichten
rammte	rammte
wähnt	wähnt
hantierte	hantierte
verziehe	verziehe
gewinne	gewinne
Locken	Locken
Kryostat	Kryostat
wachse	wachse
ummantle	ummantle
gewitterte	gewitterte
dekompilierten	dekompilierten
Anmelder	Anmelder
Kriegsenden	Kriegsenden
Empörungen	Empörungen
Affenbrotbaum	Affenbrotbaum
Halogenatom	Halogenatom
Malaysierinnen	Malaysierinnen
Unternehmensanwendungsintegrationen	Unternehmensanwendungsintegrationen
stützet	stützet
sortiert	sortiert
gezügelt	gezügelt
Arbeitsgruppen	Arbeitsgruppen
Kalifeldspat	Kalifeldspat
Wadenbeines	Wadenbeines
Ärzteblättern	Ärzteblättern
krieget	krieget
folterst	folterst
überwachest	überwachest
Charakteristikan	Charakteristikan
Lehrkörpers	Lehrkörpers
Freibrief	Freibrief
neigte	neigte
geschämt	geschämt
kapiert	kapiert
Magier	Magier
Fluoratomen	Fluoratomen
schaut	schaut
reizte	reizte
revoltieren	revoltieren
Psi	Psi
zittere	zittere
liebest	liebest
geherrscht	geherrscht
schwenkt	schwenkt
zuppe	zuppe
Bund	Bund
Skorpione	Skorpione
Kraftfahrzeuges	Kraftfahrzeuges
schmeicheln	schmeicheln
prostituierte	prostituierte
verwahrst	verwahrst
schaffte	schaffte
wachset	wachset
straften	straften
sprechet	sprechet
Girls	Girls
sedimentiere	sedimentiere
Prostylos	Prostylos
Geflecktheit	Geflecktheit
bewiest	bewiest
gestikuliere	gestikuliere
föchten	föchten
Hobbys	Hobbys
Montagmittag	Montagmittag
verforme	verforme
vergiftet	vergiftet
brauchst	brauchst
steig	steig
Oxalaten	Oxalaten
ankerst	ankerst
erben	erben
Kontraindikation	Kontraindikation
Pailletten	Pailletten
Blicksilber	Blicksilber
malochte	malochte
setzt	setzt
gedenkest	gedenkest
wünsche	wünsche
Heiratsgut	Heiratsgut
Mitwisserschaft	Mitwisserschaft
Blaumeise	Blaumeise
Melanteriten	Melanteriten
reife	reife
schießen	schießen
Überweisung	Überweisung
Alibi	Alibi
arrivierst	arrivierst
verfehle	verfehle
Polierstahl	Polierstahl
gebäret	gebäret
Schwestern	Schwestern
gehorchten	gehorchten
trauerten	trauerten
knüpfte	knüpfte
behaltest	behaltest
Paragraphenreiter	Paragraphenreiter
Gewalttätern	Gewalttätern
erwähnet	erwähnet
flitzen	flitzen
schiebest	schiebest
begnügt	begnügt
stigmatisierest	stigmatisierest
rufe	rufe
kriegte	kriegte
wichsten	wichsten
bildest	bildest
ernte	ernte
wünschen	wünschen
Pflicht	Pflicht
bestimmst	bestimmst
faschieret	faschieret
Pentaboraten	Pentaboraten
Kurkuma	Kurkuma
implodiere	implodiere
umhüllend	umhüllend
Kraftfahrzeugen	Kraftfahrzeugen
ersparen	ersparen
wähnet	wähnet
Gebete	Gebete
Sprechers	Sprechers
dümpelest	dümpelest
Prügelstrafen	Prügelstrafen
applizirte	applizirte
Mähnenwolf	Mähnenwolf
kauerten	kauerten
feiert	feiert
bezichtigt	bezichtigt
deklarierten	deklarierten
Durchbruch	Durchbruch
vandalieren	vandalieren
Sprecher	Sprecher
überprüftest	überprüftest
Äquatoren	Äquatoren
Rumänin	Rumänin
Irrtümern	Irrtümern
Ächselchen	Ächselchen
hievten	hievten
Streich	Streich
Wirtschaftswissenschaft	Wirtschaftswissenschaft
Hallelujas	Hallelujas
Flenser	Flenser
Beobachtung	Beobachtung
nähte	nähte
überfällst	überfällst
Grizzlybär	Grizzlybär
begnadigte	begnadigte
gebühren	gebühren
Kristalle	Kristalle
sintertest	sintertest
ruhe	ruhe
Uterus	Uterus
Anhang	Anhang
Füllfedern	Füllfedern
bestimmten	bestimmten
eggt	eggt
Herbstwinden	Herbstwinden
urbanisier	urbanisier
dirigiert	dirigiert
mühe	mühe
knackt	knackt
hämmerst	hämmerst
Fußboden	Fußboden
Firnis	Firnis
pilgert	pilgert
Strontiumamalgamen	Strontiumamalgamen
sinnst	sinnst
erwachte	erwachte
freiwillige	freiwillige
rinnt	rinnt
verbüßest	verbüßest
faul	faul
Kassiterits	Kassiterits
schmuggelte	schmuggelte
tatet	tatet
zähle	zähle
emigrieret	emigrieret
suchten	suchten
erweckt	erweckt
Linie	Linie
schaffe	schaffe
wollte	wollte
misstrauet	misstrauet
Spießen	Spießen
verdammten	verdammten
drängte	drängte
imkeret	imkeret
kurbelte	kurbelte
Erzherzogshüte	Erzherzogshüte
zentriert	zentriert
schaust	schaust
verkürze	verkürze
speiset	speiset
Totgeburten	Totgeburten
interpretierten	interpretierten
Brandbeschleuniger	Brandbeschleuniger
einigst	einigst
sahet	sahet
brillieren	brillieren
möpperst	möpperst
holet	holet
predigen	predigen
fehle	fehle
warntet	warntet
folgend	folgend
Langschwanzpinguin	Langschwanzpinguin
ärgertest	ärgertest
begehre	begehre
begrabe	begrabe
googelten	googelten
stürze	stürze
flambiert	flambiert
punktetest	punktetest
grüßet	grüßet
Maultier	Maultier
Atemgas	Atemgas
ärgere	ärgere
Omnibus	Omnibus
kürzten	kürzten
gebt	gebt
Dorsche	Dorsche
verkündet	verkündet
Asteroid	Asteroid
assimilieret	assimilieret
Weißflügelpinguin	Weißflügelpinguin
eiterte	eiterte
Achsel	Achsel
Meter	Meter
löstest	löstest
machest	machest
Kardinäle	Kardinäle
Molybdite	Molybdite
warnet	warnet
Klärung	Klärung
Laubbaum	Laubbaum
Küstenwachen	Küstenwachen
Abschirmung	Abschirmung
Gase	Gase
Mageninhalten	Mageninhalten
Kürasse	Kürasse
Aufpralle	Aufpralle
stapften	stapften
erlösen	erlösen
zeugte	zeugte
Herabsetzung	Herabsetzung
bemerket	bemerket
Jüngern	Jüngern
Kreise	Kreise
zeichnest	zeichnest
Epoxide	Epoxide
regiertest	regiertest
haarten	haarten
Grabe	Grabe
Lazarette	Lazarette
streiften	streiften
schimmerest	schimmerest
Kleptokratie	Kleptokratie
knistert	knistert
demütigte	demütigte
Bittersüß	Bittersüß
Däumlingen	Däumlingen
Schwirrvogel	Schwirrvogel
unterwirft	unterwirft
hobt	hobt
gehorchest	gehorchest
Epiker	Epiker
Gicht	Gicht
zeugtest	zeugtest
absolviertet	absolviertet
Aha-Erlebnisse	Aha-Erlebnisse
zeug	zeug
erklinge	erklinge
Aspartame	Aspartame
zeuget	zeuget
blättertet	blättertet
bölkte	bölkte
widmet	widmet
charakterisierend	charakterisierend
Fingerhüte	Fingerhüte
ortete	ortete
Weichloten	Weichloten
bedingten	bedingten
höbet	höbet
Abartigkeiten	Abartigkeiten
Autonomie	Autonomie
Polyphosphat	Polyphosphat
Coventrisierung	Coventrisierung
Weichlote	Weichlote
spielen	spielen
fegst	fegst
Fellhandschuh	Fellhandschuh
Nanoteslan	Nanoteslan
Türkenbünden	Türkenbünden
Festons	Festons
Hälmchen	Hälmchen
heulet	heulet
sterilisierte	sterilisierte
Coventrisierungen	Coventrisierungen
Arreste	Arreste
Bauwerken	Bauwerken
Verdacht	Verdacht
Adamsäpfeln	Adamsäpfeln
Einsatz	Einsatz
beauftragt	beauftragt
gehörten	gehörten
Maße	Maße
decket	decket
entrümpelest	entrümpelest
gravierst	gravierst
verkapselt	verkapselt
gebündelt	gebündelt
höben	höben
verbaseln	verbaseln
Adelungen	Adelungen
Massenanteil	Massenanteil
abalieniertest	abalieniertest
weg	weg
Vipernatter	Vipernatter
bündelten	bündelten
Gasen	Gasen
Geliebten	Geliebten
Kerzenfischen	Kerzenfischen
raubte	raubte
bestraft	bestraft
ertraget	ertraget
zählend	zählend
kritzele	kritzele
lös	lös
Männlein	Männlein
Abgaskatalysatoren	Abgaskatalysatoren
schubset	schubset
segmentierten	segmentierten
treffen	treffen
Händen	Händen
gelobest	gelobest
Politologen	Politologen
schummelst	schummelst
verleumdete	verleumdete
Krustentier	Krustentier
Kommet	Kommet
leget	leget
entrümpelst	entrümpelst
grüne	grüne
blitzen	blitzen
Shortcut	Shortcut
Alltag	Alltag
thematisierte	thematisierte
öle	öle
Halsabschneidern	Halsabschneidern
Reinelemente	Reinelemente
verallgemeinerest	verallgemeinerest
setzten	setzten
Bazzit	Bazzit
Ringeltauben	Ringeltauben
flitzte	flitzte
Firnisse	Firnisse
misstrauen	misstrauen
schmuggle	schmuggle
beeindruckt	beeindruckt
Berufe	Berufe
verfängt	verfängt
rangieret	rangieret
Döner	Döner
massakrierte	massakrierte
Bleigehalten	Bleigehalten
koexistierten	koexistierten
substituierend	substituierend
eingehest	eingehest
Lammfellhandschuhs	Lammfellhandschuhs
Effekten	Effekten
Freibergit	Freibergit
Tintenfisch	Tintenfisch
Aufprall	Aufprall
besorgest	besorgest
erpress	erpress
Polierstählen	Polierstählen
Streife	Streife
vollendete	vollendete
Wege	Wege
liehen	liehen
Gläubigen	Gläubigen
Arsch	Arsch
narren	narren
Puder	Puder
begehret	begehret
lodert	lodert
fällst	fällst
dürftet	dürftet
Käsereibe	Käsereibe
filzte	filzte
verantwortetest	verantwortetest
Macht	Macht
Bilderstürmer	Bilderstürmer
ehre	ehre
eroberte	eroberte
Schenken	Schenken
brausen	brausen
duckmäusere	duckmäusere
wispern	wispern
überdenkst	überdenkst
Linke	Linke
entfachten	entfachten
Rutheniumisotop	Rutheniumisotop
verschmelzen	verschmelzen
Sterne	Sterne
Beschleuniger	Beschleuniger
Greyerzern	Greyerzern
Polizeisprechern	Polizeisprechern
Rosinenkuchenmodell	Rosinenkuchenmodell
Tatsachenbeschöniger	Tatsachenbeschöniger
sagte	sagte
observierst	observierst
Amtsträger	Amtsträger
entwischten	entwischten
ahnten	ahnten
Insulaner	Insulaner
Chlorid	Chlorid
Bevölkerungsdichte	Bevölkerungsdichte
Rechenbrett	Rechenbrett
winkt	winkt
schlaget	schlaget
tendiertet	tendiertet
verkürztet	verkürztet
verziehen	verziehen
Quelle	Quelle
verführen	verführen
Bete	Bete
Judenrat	Judenrat
Füllen	Füllen
erlauben	erlauben
Abschußring	Abschußring
Augenglases	Augenglases
Ansichtskarte	Ansichtskarte
verstörten	verstörten
Libelle	Libelle
Flensern	Flensern
faule	faule
angehöret	angehöret
Kerzenlichtern	Kerzenlichtern
grabble	grabble
Bertrandite	Bertrandite
belauere	belauere
unterfordern	unterfordern
bejubelst	bejubelst
bummeltet	bummeltet
schleim	schleim
Anfechtungen	Anfechtungen
entsetzt	entsetzt
lostet	lostet
Mikrometern	Mikrometern
krösest	krösest
Pis	Pis
Spanne	Spanne
boß	boß
folgtet	folgtet
Campingplätzen	Campingplätzen
geknautscht	geknautscht
Raucherin	Raucherin
Bedenken	Bedenken
auflegt	auflegt
Chasar	Chasar
Beobachtungen	Beobachtungen
Strontiumamalgams	Strontiumamalgams
verkaufte	verkaufte
fladerst	fladerst
Stearat	Stearat
besprächen	besprächen
zerfetzte	zerfetzte
Spende	Spende
ehrte	ehrte
klemmt	klemmt
verbrauchet	verbrauchet
gedenkst	gedenkst
Hüftgelenken	Hüftgelenken
stürzt	stürzt
sichere	sichere
verurteile	verurteile
vertäte	vertäte
Argyroditen	Argyroditen
flirtest	flirtest
Luftschiff	Luftschiff
Provinzen	Provinzen
schnatternd	schnatternd
reichst	reichst
Mittelaltermarktes	Mittelaltermarktes
lochten	lochten
Freitagnachmittage	Freitagnachmittage
Urbare	Urbare
liste	liste
putzt	putzt
fahrest	fahrest
bequemte	bequemte
Kehret	Kehret
scheiterest	scheiterest
verdränget	verdränget
Seetaucher	Seetaucher
Schickse	Schickse
mehr	mehr
schleiß	schleiß
zürnst	zürnst
Laiben	Laiben
privatisiert	privatisiert
speisest	speisest
säuselest	säuselest
verkehrten	verkehrten
scheitertet	scheitertet
Erstarren	Erstarren
teilte	teilte
Kerls	Kerls
ölt	ölt
dunkelten	dunkelten
Arsenite	Arsenite
folge	folge
Transportwegen	Transportwegen
Kalb	Kalb
Lenkstange	Lenkstange
Öfchens	Öfchens
verfange	verfange
Gedränge	Gedränge
tappten	tappten
Briefköpfen	Briefköpfen
Heteroatom	Heteroatom
Mönchen	Mönchen
sinke	sinke
lehrest	lehrest
Geschichtsbücher	Geschichtsbücher
kupiert	kupiert
hupet	hupet
Stärket	Stärket
Gesetzen	Gesetzen
vertreiben	vertreiben
gähne	gähne
Sekretärinnen	Sekretärinnen
privilegierst	privilegierst
Geburtsnamen	Geburtsnamen
Rehbock	Rehbock
leiste	leiste
tat	tat
höhnte	höhnte
Halbgott	Halbgott
Pfählen	Pfählen
beschuldigt	beschuldigt
verknüpfet	verknüpfet
Thioestere	Thioestere
widerriefe	widerriefe
beschlügen	beschlügen
Anhängsel	Anhängsel
klemmen	klemmen
solle	solle
wechselwirkte	wechselwirkte
Technetiumatom	Technetiumatom
Eiszapfen	Eiszapfen
ernteten	ernteten
fistete	fistete
begehrtet	begehrtet
Altbau	Altbau
foppst	foppst
Somiten	Somiten
saget	saget
Dödeln	Dödeln
sinkest	sinkest
versuchte	versuchte
besser	besser
fahrt	fahrt
finanziert	finanziert
bewässerest	bewässerest
übersiehst	übersiehst
spaltest	spaltest
befestigte	befestigte
suchte	suchte
koste	koste
Komponistin	Komponistin
macht	macht
fritierten	fritierten
Körpergeruch	Körpergeruch
plagest	plagest
Farbstoffen	Farbstoffen
Riegel	Riegel
tattre	tattre
Ichs	Ichs
Brieföffners	Brieföffners
Konifere	Konifere
bewahrt	bewahrt
Krumen	Krumen
benähmen	benähmen
Spielen	Spielen
Pest	Pest
besorgend	besorgend
geboten	geboten
Genetikerin	Genetikerin
gönnest	gönnest
Flitzer	Flitzer
Eisstein	Eisstein
liebst	liebst
Linien	Linien
entschädiget	entschädiget
Mähnenwolfes	Mähnenwolfes
verlobte	verlobte
funzen	funzen
harrest	harrest
Spieße	Spieße
Maximierung	Maximierung
überquerst	überquerst
Möbelstoff	Möbelstoff
grünst	grünst
tätowiertet	tätowiertet
Erstlinge	Erstlinge
Atemluft	Atemluft
keulst	keulst
legt	legt
Fischen	Fischen
grünest	grünest
Raucherinnen	Raucherinnen
Planer	Planer
Holzquirl	Holzquirl
verknüpft	verknüpft
mopsend	mopsend
spritzet	spritzet
Sollst	Sollst
Kindergeld	Kindergeld
Gallan	Gallan
peiltest	peiltest
steinigte	steinigte
breche	breche
Sexte	Sexte
Hainbuche	Hainbuche
Pentaborat	Pentaborat
folgen	folgen
Kleinodien	Kleinodien
Elektrophil	Elektrophil
pflanzet	pflanzet
Außenministerium	Außenministerium
quietsche	quietsche
Halbmond	Halbmond
fladern	fladern
Erfahrungen	Erfahrungen
bemühet	bemühet
Blaumeisen	Blaumeisen
sehet	sehet
aufwachte	aufwachte
traueret	traueret
strömte	strömte
entwendete	entwendete
Unter	Unter
Berufen	Berufen
härtet	härtet
henken	henken
türmt	türmt
Höhle	Höhle
Fahrzeugkatalysator	Fahrzeugkatalysator
kommest	kommest
Primärenergien	Primärenergien
möppertet	möppertet
grübelten	grübelten
kürzt	kürzt
lobe	lobe
zensierten	zensierten
zeugest	zeugest
Enthärtungen	Enthärtungen
Mönche	Mönche
schwadronierten	schwadronierten
Substanz	Substanz
losest	losest
schmusen	schmusen
Pfleglinge	Pfleglinge
suchet	suchet
Einrädern	Einrädern
Adamsapfel	Adamsapfel
beteuerest	beteuerest
bezieht	bezieht
Früchtchen	Früchtchen
streifte	streifte
Gespenstern	Gespenstern
Aase	Aase
Zipfelmützen	Zipfelmützen
erntest	erntest
Friede	Friede
laden	laden
Basiliken	Basiliken
gehörst	gehörst
Gehirnwellen	Gehirnwellen
Großfürsten	Großfürsten
Einrad	Einrad
Kuttern	Kuttern
Abbindebeschleuniger	Abbindebeschleuniger
Zeithorizonte	Zeithorizonte
Ehre	Ehre
kugelten	kugelten
Schlager	Schlager
Bertrandit	Bertrandit
Ende	Ende
Last	Last
piesackest	piesackest
Petersfischen	Petersfischen
scheuchtest	scheuchtest
velarisiert	velarisiert
gebären	gebären
reif	reif
predige	predige
annektierst	annektierst
kugele	kugele
Aufträgen	Aufträgen
ersparte	ersparte
prostet	prostet
heil	heil
Argentit	Argentit
Gewicht	Gewicht
Carbid	Carbid
Ass	Ass
drängst	drängst
schmierte	schmierte
werde	werde
regieret	regieret
Darlegungen	Darlegungen
erzürnt	erzürnt
schlängelt	schlängelt
Asthenosphäre	Asthenosphäre
defragmentierten	defragmentierten
Erdboden	Erdboden
tendierst	tendierst
Palästen	Palästen
hasset	hasset
Denkmünze	Denkmünze
verallgemeinerst	verallgemeinerst
Berichterstattungen	Berichterstattungen
hintertreiben	hintertreiben
Gebern	Gebern
Forschungen	Forschungen
kräusle	kräusle
Anhänge	Anhänge
Videoaufzeichnung	Videoaufzeichnung
ausführe	ausführe
besprenget	besprenget
erhörest	erhörest
meine	meine
Apportierhunde	Apportierhunde
anzeige	anzeige
lösest	lösest
querte	querte
Leset	Leset
aufrichtet	aufrichtet
Recitativen	Recitativen
linsten	linsten
verladet	verladet
Judenräte	Judenräte
Recitativ	Recitativ
Pardelkatze	Pardelkatze
Werkzeuge	Werkzeuge
reifte	reifte
injizierest	injizierest
forschte	forschte
verzieret	verzieret
dramatisiert	dramatisiert
lautete	lautete
hänget	hänget
schämte	schämte
concessionieren	concessionieren
pflegte	pflegte
Vanadaten	Vanadaten
empörte	empörte
Schneidern	Schneidern
Kaufkraft	Kaufkraft
wallet	wallet
härten	härten
ermutigte	ermutigte
verunglimpfte	verunglimpfte
Schobern	Schobern
erhöhest	erhöhest
leistete	leistete
erkaltest	erkaltest
Hode	Hode
Leichtmetallen	Leichtmetallen
befestigt	befestigt
entzweit	entzweit
freiwilligen	freiwilligen
injiziert	injiziert
Ackerschachtelhalme	Ackerschachtelhalme
zweifeln	zweifeln
mehret	mehret
könnet	könnet
trompete	trompete
erwärmten	erwärmten
generiert	generiert
Schnitzeljagd	Schnitzeljagd
entmineralisierten	entmineralisierten
erbte	erbte
Geliebte	Geliebte
Präservativen	Präservativen
wallfahrest	wallfahrest
schießt	schießt
präsentier	präsentier
Langschwanzpinguinen	Langschwanzpinguinen
Tier	Tier
schautet	schautet
erklingt	erklingt
lüg	lüg
dürft	dürft
Lob	Lob
Massage	Massage
Seehechten	Seehechten
steigest	steigest
prosteten	prosteten
Gehorsam	Gehorsam
Fette	Fette
Polizeisprecher	Polizeisprecher
wohnte	wohnte
Gedächtnisse	Gedächtnisse
vier	vier
Lüste	Lüste
lauft	lauft
bejubelte	bejubelte
lieb	lieb
verzierten	verzierten
entstände	entstände
idealisieret	idealisieret
Randbemerkung	Randbemerkung
besitzest	besitzest
beschlaget	beschlaget
begehrst	begehrst
nähet	nähet
meinte	meinte
Wasserbades	Wasserbades
Fischotter	Fischotter
verfinstert	verfinstert
verlassen	verlassen
kreierten	kreierten
Zirkelschlüssen	Zirkelschlüssen
überprüfte	überprüfte
dirigieret	dirigieret
schöpfen	schöpfen
Dessous	Dessous
Tetraiodiden	Tetraiodiden
Düften	Düften
eskaliert	eskaliert
wehrte	wehrte
listeten	listeten
füllst	füllst
Atommasse	Atommasse
Gefängnisse	Gefängnisse
betrügen	betrügen
Ebene	Ebene
Chlorats	Chlorats
kehrst	kehrst
versagt	versagt
belüftet	belüftet
kooperierte	kooperierte
Fischzucht	Fischzucht
baute	baute
Kopfverletzungen	Kopfverletzungen
Bleiglanz	Bleiglanz
Atemlüfte	Atemlüfte
sehnte	sehnte
Berylle	Berylle
Fledermaus	Fledermaus
schämst	schämst
Briefwechsel	Briefwechsel
verabschiedetet	verabschiedetet
Antimusters	Antimusters
massierend	massierend
verewigt	verewigt
versuche	versuche
Kohlenstoffgehalten	Kohlenstoffgehalten
Streite	Streite
Überschüssen	Überschüssen
Exzentriker	Exzentriker
lodertet	lodertet
fasse	fasse
ausfuhr	ausfuhr
Schicksen	Schicksen
kauern	kauern
Sanatorien	Sanatorien
Fanmeile	Fanmeile
Bruchstriches	Bruchstriches
verkleide	verkleide
globalisieret	globalisieret
Herkunft	Herkunft
ritzten	ritzten
verfolgst	verfolgst
Kadavergehorsam	Kadavergehorsam
Jagdbomber	Jagdbomber
Bärenfelle	Bärenfelle
zerstreute	zerstreute
klingt	klingt
Marjellchen	Marjellchen
versagen	versagen
widerlegte	widerlegte
Fluoratom	Fluoratom
Arsenbergwerken	Arsenbergwerken
schimmerst	schimmerst
Mache	Mache
mühte	mühte
Bienen	Bienen
explodierst	explodierst
Fiasko	Fiasko
verwiesen	verwiesen
reanimiere	reanimiere
Unterschlagung	Unterschlagung
Seilen	Seilen
Aas	Aas
Schade	Schade
bedeckest	bedeckest
Büchereien	Büchereien
überreicht	überreicht
fertigte	fertigte
Reiterschwertern	Reiterschwertern
suche	suche
begliche	begliche
Pflanzenstoff	Pflanzenstoff
Radiergummi	Radiergummi
regeln	regeln
Arbeitskreis	Arbeitskreis
schwirret	schwirret
Dithiolane	Dithiolane
verließen	verließen
verjährest	verjährest
Nahrungsbestandteilen	Nahrungsbestandteilen
Omnibusse	Omnibusse
Galopps	Galopps
Aderhaut	Aderhaut
Roben	Roben
Homodimeren	Homodimeren
verklagst	verklagst
recycele	recycele
plagte	plagte
Argyrodite	Argyrodite
beichten	beichten
Ochsen	Ochsen
Strohhälmchen	Strohhälmchen
wärme	wärme
schlängelest	schlängelest
Staatsführungen	Staatsführungen
Sollte	Sollte
dissentierte	dissentierte
halltet	halltet
dividiert	dividiert
überbewertet	überbewertet
Trübsale	Trübsale
Campingplatzes	Campingplatzes
Deuterium	Deuterium
Obszönität	Obszönität
Kompassen	Kompassen
Oberlippe	Oberlippe
Charakteristika	Charakteristika
scheinest	scheinest
bandagierte	bandagierte
Schwirrvögel	Schwirrvögel
speiest	speiest
Fellachinnen	Fellachinnen
Notizen	Notizen
liebe	liebe
Rückweg	Rückweg
Gichten	Gichten
verletzte	verletzte
vereinbaren	vereinbaren
plumpse	plumpse
fabuliere	fabuliere
trotzt	trotzt
Paradiesapfel	Paradiesapfel
erkennest	erkennest
brause	brause
Füchsin	Füchsin
Antitranspiranten	Antitranspiranten
sitzt	sitzt
Schober	Schober
erriet	erriet
zerschlagt	zerschlagt
schlafest	schlafest
Gerücht	Gerücht
Besteck	Besteck
glänzten	glänzten
Anwendungsgebiet	Anwendungsgebiet
murmelten	murmelten
kapiertet	kapiertet
verschreibt	verschreibt
überreichst	überreichst
Stadtbezirke	Stadtbezirke
