Weichseln	Weichseln
kommet	kommet
referenzierte	referenzierte
faschierst	faschierst
Freitagnachmittagen	Freitagnachmittagen
manche	manche
drifte	drifte
Landwirt	Landwirt
Böreks	Böreks
attestierten	attestierten
Äxten	Äxten
trübe	trübe
Seines	Seines
bessere	bessere
pilgerte	pilgerte
Schlaraffenländern	Schlaraffenländern
besorg	besorg
frikassiert	frikassiert
weg	weg
Putschisten	Putschisten
blitzet	blitzet
entstände	entstände
pharyngalisierst	pharyngalisierst
karikieret	karikieret
beschrifte	beschrifte
räumen	räumen
entsetzen	entsetzen
Radiergummi	Radiergummi
lebest	lebest
Linien	Linien
Flossen	Flossen
ackerst	ackerst
Gewürze	Gewürze
Imperialismen	Imperialismen
versteckten	versteckten
gewähret	gewähret
Geburtsnamen	Geburtsnamen
einigte	einigte
versuchen	versuchen
klettert	klettert
Bärenfelle	Bärenfelle
entschädigte	entschädigte
weise	weise
Blütenachse	Blütenachse
löset	löset
geratest	geratest
Perlen	Perlen
parametrisierst	parametrisierst
besuchen	besuchen
Videoaufzeichnungen	Videoaufzeichnungen
Seilen	Seilen
keulte	keulte
verdammtet	verdammtet
offenbart	offenbart
bildest	bildest
Forschung	Forschung
Sabbatjahr	Sabbatjahr
Binden	Binden
beschuldigt	beschuldigt
verdeckt	verdeckt
argumentierten	argumentierten
gewünscht	gewünscht
Tore	Tore
blondiert	blondiert
binde	binde
bedürft	bedürft
Zeilen	Zeilen
bebten	bebten
lehre	lehre
durchwachen	durchwachen
Abschußring	Abschußring
Trinkgefäßen	Trinkgefäßen
verhungerte	verhungerte
Fahlflanken-Ameisenwürger	Fahlflanken-Ameisenwürger
Diethylether	Diethylether
Minischweine	Minischweine
Kurkumen	Kurkumen
schimmerest	schimmerest
Quellfluss	Quellfluss
Lautschrift	Lautschrift
Gespenstern	Gespenstern
Pentaborat	Pentaborat
bricht	bricht
Leiden	Leiden
emendierte	emendierte
entkäme	entkäme
spukest	spukest
extemporiere	extemporiere
schauend	schauend
Sünders	Sünders
stoßt	stoßt
kasernierte	kasernierte
deklarierte	deklarierte
Rotgüssen	Rotgüssen
Arbeitskreis	Arbeitskreis
Adlerbussarden	Adlerbussarden
Unserer	Unserer
Kannen	Kannen
erdacht	erdacht
wachen	wachen
Zeitbomben	Zeitbomben
zwölfte	zwölfte
verspielest	verspielest
beschuldiget	beschuldiget
erstaunst	erstaunst
beweisest	beweisest
flucht	flucht
bewahret	bewahret
zürn	zürn
sahet	sahet
stiftete	stiftete
Tasten	Tasten
Großstädter	Großstädter
Unterschlagung	Unterschlagung
rolltet	rolltet
meinte	meinte
frottierten	frottierten
bringet	bringet
beunruhige	beunruhige
Trioxid	Trioxid
Fingerhüte	Fingerhüte
Grizzlybär	Grizzlybär
umhüllt	umhüllt
begehret	begehret
bewiese	bewiese
lavierte	lavierte
Fokus	Fokus
dissentierten	dissentierten
reparierten	reparierten
drescht	drescht
fistet	fistet
verbündete	verbündete
verstecke	verstecke
separieret	separieret
entsetzten	entsetzten
Briten	Briten
begrub	begrub
Zensus	Zensus
zerstreuet	zerstreuet
schautest	schautest
bröckelten	bröckelten
konsumieren	konsumieren
Achsel	Achsel
kichern	kichern
Verwundeten	Verwundeten
Apostels	Apostels
Zähne	Zähne
fehlen	fehlen
frottier	frottier
schleimte	schleimte
Feldzug	Feldzug
tränkten	tränkten
Nährmedien	Nährmedien
herrschte	herrschte
dolmetschst	dolmetschst
aufhobt	aufhobt
eins	eins
zanket	zanket
Buben	Buben
verstehest	verstehest
Tretlager	Tretlager
machest	machest
wechselwirkt	wechselwirkt
moppte	moppte
verschafft	verschafft
fällte	fällte
Reststoffen	Reststoffen
gekröst	gekröst
dirigieret	dirigieret
Stiefmütterchen	Stiefmütterchen
ruhte	ruhte
neige	neige
dividiere	dividiere
Laufringen	Laufringen
Leuchtstoffen	Leuchtstoffen
Nanosatelliten	Nanosatelliten
versuche	versuche
Diesen	Diesen
gähne	gähne
Thioacetal	Thioacetal
lüftetet	lüftetet
Abarten	Abarten
Schlot	Schlot
frohlocke	frohlocke
geschämt	geschämt
vermutet	vermutet
könnet	könnet
Psi	Psi
rühmte	rühmte
Radiergummis	Radiergummis
klöne	klöne
Schreibern	Schreibern
gebührt	gebührt
äusserst	äusserst
Selbstversuchen	Selbstversuchen
fahrest	fahrest
Stücke	Stücke
fragmentierst	fragmentierst
Möbiusbändern	Möbiusbändern
Sekretärinnen	Sekretärinnen
UND-Gattern	UND-Gattern
durften	durften
konsolidierend	konsolidierend
beantragt	beantragt
sabbre	sabbre
Band	Band
verletzt	verletzt
Male	Male
schwellen	schwellen
stiegen	stiegen
Satzung	Satzung
trotzt	trotzt
bedurftest	bedurftest
formirend	formirend
verprügelte	verprügelte
immunisiere	immunisiere
grüßte	grüßte
Nanokondensatoren	Nanokondensatoren
Arbeitsbereichen	Arbeitsbereichen
Pimmel	Pimmel
wegführe	wegführe
stürzest	stürzest
destabilisierst	destabilisierst
Theologien	Theologien
demütig	demütig
Playlists	Playlists
trödeltest	trödeltest
kategorisierst	kategorisierst
verdeckst	verdeckst
pflügest	pflügest
enge	enge
meinen	meinen
Ausgangssperren	Ausgangssperren
steuerte	steuerte
Kerls	Kerls
unterfordern	unterfordern
Gleitzeiten	Gleitzeiten
verstehst	verstehst
Feind	Feind
verlassen	verlassen
predigte	predigte
redete	redete
knüpfte	knüpfte
schwelle	schwelle
Geigerzähler	Geigerzähler
analysiert	analysiert
viele	viele
reagierte	reagierte
ärgere	ärgere
Hinterwäldler	Hinterwäldler
Fellhandschuhen	Fellhandschuhen
tust	tust
Trümmersprache	Trümmersprache
hüpfen	hüpfen
maß	maß
reagiert	reagiert
verführest	verführest
Hin	Hin
helfet	helfet
verschlungen	verschlungen
bemächtigte	bemächtigte
Fellen	Fellen
brandeten	brandeten
überweisend	überweisend
ringet	ringet
urbanisier	urbanisier
loste	loste
Indern	Indern
Aufträgen	Aufträgen
reimte	reimte
übersteht	übersteht
erbringen	erbringen
kappten	kappten
Samarskit	Samarskit
Kandidaturen	Kandidaturen
Aachener	Aachener
Wehe	Wehe
nötige	nötige
Idolatrien	Idolatrien
gedenkest	gedenkest
dekoriere	dekoriere
heil	heil
Malaysierinnen	Malaysierinnen
zirpe	zirpe
vergaset	vergaset
treibst	treibst
entwendete	entwendete
vierte	vierte
Altbau	Altbau
herrschen	herrschen
Verwundete	Verwundete
Stoffwechselweg	Stoffwechselweg
Pfeilen	Pfeilen
Erbse	Erbse
Butike	Butike
Arm	Arm
Thioestere	Thioestere
Flöße	Flöße
Dödel	Dödel
Wunde	Wunde
Notärztin	Notärztin
bekannte	bekannte
schenket	schenket
Europameistern	Europameistern
sagt	sagt
schämst	schämst
Fusselbärten	Fusselbärten
flehst	flehst
erfüllst	erfüllst
demütiget	demütiget
produzierest	produzierest
Ass	Ass
trügen	trügen
ihnen	ihnen
brausen	brausen
Sprichwort	Sprichwort
Rhabarbern	Rhabarbern
Teufeln	Teufeln
Klüften	Klüften
entrümpelst	entrümpelst
Prozeduren	Prozeduren
inhalier	inhalier
Fäusten	Fäusten
hängte	hängte
Selbstversuche	Selbstversuche
Reflexionen	Reflexionen
zerrissen	zerrissen
glaube	glaube
Remisen	Remisen
blast	blast
lachte	lachte
nähret	nähret
stützet	stützet
Judenräte	Judenräte
Schreibtischtäter	Schreibtischtäter
respektiere	respektiere
Pflaumen	Pflaumen
sucht	sucht
Klotzes	Klotzes
verzögerten	verzögerten
losten	losten
fetten	fetten
Zinkat	Zinkat
Kontrollboxen	Kontrollboxen
Aspartame	Aspartame
eroberte	eroberte
More	More
Kanzlei	Kanzlei
herrschst	herrschst
pipettierten	pipettierten
leider	leider
schmetterst	schmetterst
entgegenkamen	entgegenkamen
entzweiest	entzweiest
Charakteristikan	Charakteristikan
möchtest	möchtest
Zeitungsenten	Zeitungsenten
blitztet	blitztet
besinnen	besinnen
Alte	Alte
Beten	Beten
griffe	griffe
teilte	teilte
lüftet	lüftet
Spirale	Spirale
Zainen	Zainen
verteidigte	verteidigte
Vogelscheuche	Vogelscheuche
Rechenbrett	Rechenbrett
bekennst	bekennst
flirtete	flirtete
Wiedergutmachung	Wiedergutmachung
verfolgt	verfolgt
spalten	spalten
hintertriebe	hintertriebe
erlabe	erlabe
überreicht	überreicht
leerst	leerst
gezählt	gezählt
mehr	mehr
Kirchhof	Kirchhof
kremieren	kremieren
wiederholten	wiederholten
erwärmten	erwärmten
berufen	berufen
folg	folg
koexistierten	koexistierten
Schuhe	Schuhe
stiften	stiften
Prüfbericht	Prüfbericht
tote	tote
vier	vier
folterst	folterst
verhalten	verhalten
Neuigkeit	Neuigkeit
flupptest	flupptest
dampfte	dampfte
punktest	punktest
Ackerschachtelhalm	Ackerschachtelhalm
fingieret	fingieret
erntete	erntete
umhüllst	umhüllst
Fällt	Fällt
besprachen	besprachen
Flamme	Flamme
Glatteis	Glatteis
interagierte	interagierte
kehren	kehren
Assistentin	Assistentin
evaluiert	evaluiert
Sabotagen	Sabotagen
leiten	leiten
Eutektikum	Eutektikum
zeugten	zeugten
Eingabe	Eingabe
Höhlen	Höhlen
Dorsch	Dorsch
zuhörte	zuhörte
Kopfsalat	Kopfsalat
Argyrodite	Argyrodite
Stärket	Stärket
standet	standet
Name	Name
streckte	streckte
scheiterest	scheiterest
ertönst	ertönst
widerrufe	widerrufe
Ställe	Ställe
Wunden	Wunden
entflöhen	entflöhen
Keiner	Keiner
müsse	müsse
erniedrigst	erniedrigst
einführen	einführen
Junge	Junge
wischt	wischt
Drehtüren	Drehtüren
Weichloten	Weichloten
Schläfchens	Schläfchens
Lehnen	Lehnen
kugelten	kugelten
malträtiere	malträtiere
lügt	lügt
formulierst	formulierst
geschlummert	geschlummert
feiern	feiern
zuteilte	zuteilte
gelobend	gelobend
erkältete	erkältete
reife	reife
verstrahlet	verstrahlet
Assimilationen	Assimilationen
Schwermetallion	Schwermetallion
blondieret	blondieret
Grüßet	Grüßet
Blitzen	Blitzen
konnte	konnte
Premieren	Premieren
Asteroide	Asteroide
produzierten	produzierten
Dochten	Dochten
Städten	Städten
Bettlers	Bettlers
bleibest	bleibest
Hälmchen	Hälmchen
wurdet	wurdet
Tauben	Tauben
Kalifeldspate	Kalifeldspate
Kadavergehorsam	Kadavergehorsam
vertreiben	vertreiben
Komponistin	Komponistin
glaubte	glaubte
übersiehst	übersiehst
Bär	Bär
widmeten	widmeten
Bete	Bete
Armband	Armband
mästest	mästest
Normdatum	Normdatum
weissagten	weissagten
Überziehen	Überziehen
mögt	mögt
auszogen	auszogen
Deine	Deine
Eines	Eines
Kronsbeere	Kronsbeere
führen	führen
nähernd	nähernd
schautet	schautet
inspirierest	inspirierest
eines	eines
beschlug	beschlug
Lautwandeln	Lautwandeln
Bergen	Bergen
reifst	reifst
Nahrungsbestandteilen	Nahrungsbestandteilen
Somiten	Somiten
Basiliken	Basiliken
Galeeren	Galeeren
erstehet	erstehet
häuftet	häuftet
meldeten	meldeten
Fahrt	Fahrt
Welpen	Welpen
liebst	liebst
Negermusik	Negermusik
Epidemien	Epidemien
sichere	sichere
rekrutiere	rekrutiere
scheuchen	scheuchen
Erste	Erste
schwimmen	schwimmen
steig	steig
egge	egge
zentriert	zentriert
Broten	Broten
bekehret	bekehret
stellst	stellst
entflieht	entflieht
Gehorsam	Gehorsam
hinterlegt	hinterlegt
spielte	spielte
zupfte	zupfte
Eisstein	Eisstein
Technikerinnen	Technikerinnen
Türkis	Türkis
abtrünnige	abtrünnige
Theistinnen	Theistinnen
Staatsführungen	Staatsführungen
ackerest	ackerest
Optimisten	Optimisten
sehet	sehet
gönnst	gönnst
häufte	häufte
fistete	fistete
Türklingeln	Türklingeln
Kuckucken	Kuckucken
Brechnüssen	Brechnüssen
plumpse	plumpse
Bruchstrich	Bruchstrich
Auszüge	Auszüge
Suchet	Suchet
bringst	bringst
Feierabende	Feierabende
fremde	fremde
Bleche	Bleche
Nagellackentferner	Nagellackentferner
beneidete	beneidete
Zwangsarbeiterin	Zwangsarbeiterin
obfuskierten	obfuskierten
speisen	speisen
lausche	lausche
Haarverlust	Haarverlust
entwaffnest	entwaffnest
entsetzte	entsetzte
Päderast	Päderast
möge	möge
liegen	liegen
transportierten	transportierten
Atemgas	Atemgas
legte	legte
liebtest	liebtest
streckst	streckst
angehört	angehört
sehnet	sehnet
mißverstehet	mißverstehet
Blitze	Blitze
kritzelst	kritzelst
Desserts	Desserts
Ei	Ei
Feuerteufel	Feuerteufel
gefällt	gefällt
gedachtest	gedachtest
verzehre	verzehre
Zeile	Zeile
backt	backt
erkälteten	erkälteten
Marjellchens	Marjellchens
überdächte	überdächte
foppst	foppst
wehr	wehr
beauftragt	beauftragt
Arsch	Arsch
verdammet	verdammet
knacktest	knacktest
speicherten	speicherten
Landesverräterinnen	Landesverräterinnen
Suffixen	Suffixen
werfet	werfet
Fische	Fische
malochte	malochte
Blumenstrauß	Blumenstrauß
foppten	foppten
widerriefe	widerriefe
Herkunft	Herkunft
verderbest	verderbest
Reinelemente	Reinelemente
ritze	ritze
nehmt	nehmt
Schau	Schau
glühten	glühten
Tritte	Tritte
anrichtet	anrichtet
Ektoplasmen	Ektoplasmen
Rast	Rast
säuselest	säuselest
Bauwerke	Bauwerke
linke	linke
analysierest	analysierest
kooperierst	kooperierst
bewähret	bewähret
Sorget	Sorget
Nervenzellen	Nervenzellen
Dorngesträuch	Dorngesträuch
billigte	billigte
Führet	Führet
duschte	duschte
Döner	Döner
respektieren	respektieren
Gebern	Gebern
Festen	Festen
Gedrängen	Gedrängen
Rückwege	Rückwege
frappierte	frappierte
Laib	Laib
Ausbeuterei	Ausbeuterei
schnüren	schnüren
Beziehungen	Beziehungen
Mischelement	Mischelement
backen	backen
deine	deine
der	der
trompete	trompete
desensibilisierten	desensibilisierten
drangen	drangen
Abkömmling	Abkömmling
funkeln	funkeln
Anhänge	Anhänge
Auguren	Auguren
Apfelbäume	Apfelbäume
Orgel	Orgel
Silberdrähten	Silberdrähten
Keilen	Keilen
ersparet	ersparet
bestimmt	bestimmt
Riesen	Riesen
Erlösungen	Erlösungen
verwaiset	verwaiset
Pi	Pi
nippend	nippend
erhebet	erhebet
Unwahrheit	Unwahrheit
eggt	eggt
Maß	Maß
aufwachte	aufwachte
brillierest	brillierest
Wehret	Wehret
Stücken	Stücken
Senkungen	Senkungen
Stätte	Stätte
Friede	Friede
feierte	feierte
Excimerlasern	Excimerlasern
Brettspiele	Brettspiele
Aluminaten	Aluminaten
Attentäter	Attentäter
misstrauen	misstrauen
Däumlingen	Däumlingen
Gäste	Gäste
Taufen	Taufen
Hirnstämme	Hirnstämme
Paralipse	Paralipse
dressieret	dressieret
Bleigehalten	Bleigehalten
Pailletten	Pailletten
warst	warst
gelobtest	gelobtest
gleitest	gleitest
explodierst	explodierst
rühmet	rühmet
jemanden	jemanden
lehret	lehret
Locken	Locken
ringen	ringen
treffen	treffen
Gase	Gase
funzt	funzt
torpedieret	torpedieret
gibst	gibst
vermag	vermag
Kommoden	Kommoden
Uranerz	Uranerz
Monaten	Monaten
stützen	stützen
koche	koche
anrichten	anrichten
lüg	lüg
Fusseln	Fusseln
tunet	tunet
Magiern	Magiern
schlummerte	schlummerte
addierte	addierte
Taschenwörterbuches	Taschenwörterbuches
bereitend	bereitend
Solchen	Solchen
beides	beides
aufhebt	aufhebt
Schafe	Schafe
Brüder	Brüder
anruft	anruft
füllen	füllen
Ypecaharalle	Ypecaharalle
absagen	absagen
darfst	darfst
schwächst	schwächst
meuterest	meuterest
überprüftest	überprüftest
Gram	Gram
Autonomien	Autonomien
emittiert	emittiert
Frommen	Frommen
hätten	hätten
Kleinod	Kleinod
surre	surre
gelobtet	gelobtet
gehören	gehören
Shortcuts	Shortcuts
rüstetest	rüstetest
Musters	Musters
keinem	keinem
zeug	zeug
Molybdit	Molybdit
glänzte	glänzte
schmuggle	schmuggle
Stempeluhren	Stempeluhren
zerstreute	zerstreute
denaturierte	denaturierte
Physikerin	Physikerin
Scheck	Scheck
Hackern	Hackern
schwebte	schwebte
schwadroniert	schwadroniert
Denn	Denn
Strafraum	Strafraum
gafften	gafften
Aufsätze	Aufsätze
umhüllend	umhüllend
diente	diente
schenkte	schenkte
erstaunte	erstaunte
Radfahrern	Radfahrern
planschest	planschest
leide	leide
Puder	Puder
Inauguration	Inauguration
beantrage	beantrage
denn	denn
Wanderfalken	Wanderfalken
Schnittlauch	Schnittlauch
verseifet	verseifet
folgtet	folgtet
wirst	wirst
schmeicheln	schmeicheln
Wühltischen	Wühltischen
Staatsanleihe	Staatsanleihe
schmuggele	schmuggele
bescheiße	bescheiße
verringert	verringert
überschattete	überschattete
greifet	greifet
motivierte	motivierte
strafet	strafet
ehrest	ehrest
Forschungen	Forschungen
sehnst	sehnst
Rücktrittbremsen	Rücktrittbremsen
wäre	wäre
überstehst	überstehst
Ebene	Ebene
Begrenzung	Begrenzung
Kaffeelöffel	Kaffeelöffel
versuchten	versuchten
Ästen	Ästen
Leichenschauhäusern	Leichenschauhäusern
beweist	beweist
rännen	rännen
Trotzkist	Trotzkist
Unterseite	Unterseite
balkanisierten	balkanisierten
stigmatisierst	stigmatisierst
brillieren	brillieren
Pinguinen	Pinguinen
Generation	Generation
lobe	lobe
Stärke	Stärke
radiertest	radiertest
bedingst	bedingst
bescheißt	bescheißt
arrivieren	arrivieren
Buchstabe	Buchstabe
stärken	stärken
warne	warne
Edelsteine	Edelsteine
ansehen	ansehen
traueret	traueret
reich	reich
bekannt	bekannt
blätteret	blätteret
Hüftgelenken	Hüftgelenken
Fluoratome	Fluoratome
Gehorchet	Gehorchet
Schwester	Schwester
stickt	stickt
Zahnfleischentzündungen	Zahnfleischentzündungen
Spieße	Spieße
verfinstert	verfinstert
Fragen	Fragen
vergiftet	vergiftet
entkämen	entkämen
erhebst	erhebst
Huflattich	Huflattich
knuffend	knuffend
folgt	folgt
Automatikgetrieben	Automatikgetrieben
entständen	entständen
knutschst	knutschst
hineinbrächte	hineinbrächte
unterrichtet	unterrichtet
verunglimpfen	verunglimpfen
spezialisierst	spezialisierst
härtet	härtet
Konfitüren	Konfitüren
frische	frische
Bademäntel	Bademäntel
reizte	reizte
Weiblein	Weiblein
Ausnahme	Ausnahme
besitze	besitze
Schale	Schale
Überfamilie	Überfamilie
heißest	heißest
Rehbock	Rehbock
Californium	Californium
Artischocken	Artischocken
Heptamolybdat	Heptamolybdat
reichtet	reichtet
Minimierungen	Minimierungen
Atomphysikern	Atomphysikern
Sippe	Sippe
speise	speise
Numerus	Numerus
tatet	tatet
taufet	taufet
leuchten	leuchten
lancierst	lancierst
bediene	bediene
bekennet	bekennet
Teekesseln	Teekesseln
Carbiden	Carbiden
Ende	Ende
Programmiererinnen	Programmiererinnen
Dessous	Dessous
NAND-Gatter	NAND-Gatter
Schrei	Schrei
rüstete	rüstete
restaurieret	restaurieret
liebend	liebend
schlachten	schlachten
erlöst	erlöst
jemand	jemand
flöteten	flöteten
Spitzen	Spitzen
scherze	scherze
Stall	Stall
wohnest	wohnest
erzürnet	erzürnet
kehrte	kehrte
Milchflasche	Milchflasche
konstatiertest	konstatiertest
bedeckest	bedeckest
Flensern	Flensern
gebühren	gebühren
ertragen	ertragen
ausgehst	ausgehst
umarmen	umarmen
Satzungen	Satzungen
Bromidquellen	Bromidquellen
heparinisierten	heparinisierten
Glaubst	Glaubst
Rückweg	Rückweg
ärgernd	ärgernd
eingehst	eingehst
schlaf	schlaf
Dithiolan	Dithiolan
Primatologen	Primatologen
Ochsen	Ochsen
sehn	sehn
rotten	rotten
Dominicanerin	Dominicanerin
Heeren	Heeren
Bärte	Bärte
vollendete	vollendete
Märkte	Märkte
Berylle	Berylle
Sinne	Sinne
ermutigte	ermutigte
erbet	erbet
Berufe	Berufe
lügen	lügen
trefft	trefft
begehrten	begehrten
Herde	Herde
Unterschlagungen	Unterschlagungen
Vorhäuten	Vorhäuten
Ölfasses	Ölfasses
ansehet	ansehet
verzeigt	verzeigt
erbest	erbest
Tintenklecks	Tintenklecks
aufwacht	aufwacht
Geschäfte	Geschäfte
Hummern	Hummern
gestatte	gestatte
kramten	kramten
Fokusse	Fokusse
Schnallen	Schnallen
verglühest	verglühest
hintertreibt	hintertreibt
Gibst	Gibst
Leugnung	Leugnung
inneren	inneren
Gefängnissen	Gefängnissen
Omnibusse	Omnibusse
seines	seines
malt	malt
Reichweiten	Reichweiten
Carbids	Carbids
Hirte	Hirte
pilgert	pilgert
Bevölkerungsdichte	Bevölkerungsdichte
Siglen	Siglen
Wahn	Wahn
parliere	parliere
putzte	putzte
Pedanten	Pedanten
bekannten	bekannten
begäben	begäben
verbleibet	verbleibet
planschtest	planschtest
eskaliert	eskaliert
Abfahrtsliste	Abfahrtsliste
reif	reif
geleite	geleite
Drohkulisse	Drohkulisse
genieret	genieret
Weste	Weste
bromiertet	bromiertet
rechten	rechten
misstrauest	misstrauest
freiwilligen	freiwilligen
zankte	zankte
Europameisters	Europameisters
Spannt	Spannt
Beilen	Beilen
verziehen	verziehen
narren	narren
verzweifelten	verzweifelten
entdecket	entdecket
desertierst	desertierst
lösest	lösest
parkierst	parkierst
Aussätzige	Aussätzige
Gurten	Gurten
beleuchteten	beleuchteten
Kost	Kost
Kerzenfische	Kerzenfische
emendieret	emendieret
rundet	rundet
antworte	antworte
streifte	streifte
läute	läute
initiierst	initiierst
Gallan	Gallan
diversifiziert	diversifiziert
reden	reden
jaule	jaule
gleite	gleite
schluchze	schluchze
Binde	Binde
spannt	spannt
vergibt	vergibt
Preisen	Preisen
Türkinnen	Türkinnen
mangelte	mangelte
mampfen	mampfen
klagen	klagen
Früchten	Früchten
Jungfernflug	Jungfernflug
Schwebfliegen	Schwebfliegen
fasset	fasset
tränke	tränke
Schild	Schild
bemühet	bemühet
jauchzte	jauchzte
jaget	jaget
repräsentieret	repräsentieret
Spektralbereichen	Spektralbereichen
dümpelst	dümpelst
orgelt	orgelt
Beteiligten	Beteiligten
brennen	brennen
hineinbrächten	hineinbrächten
Leset	Leset
Kräften	Kräften
wünschtest	wünschtest
Isolatoren	Isolatoren
Räte	Räte
pflanzt	pflanzt
fluchten	fluchten
machet	machet
beäugen	beäugen
Smaragdkehlkolibris	Smaragdkehlkolibris
sage	sage
separieren	separieren
sortiert	sortiert
Buchfink	Buchfink
verbärgen	verbärgen
legend	legend
flense	flense
eurer	eurer
Wüste	Wüste
Konifere	Konifere
Wiederauferstehungen	Wiederauferstehungen
Beryll	Beryll
trompetete	trompetete
erwähnet	erwähnet
Treppen	Treppen
Kohlen	Kohlen
Hypochlorit	Hypochlorit
säte	säte
Eissteinen	Eissteinen
tagen	tagen
wilden	wilden
streuen	streuen
Reliquiar	Reliquiar
schwimmst	schwimmst
seinen	seinen
knautsche	knautsche
Erdkruste	Erdkruste
bekennt	bekennt
verwechseltet	verwechseltet
Maultier	Maultier
Schneider	Schneider
peilst	peilst
Fetten	Fetten
Tetraiodiden	Tetraiodiden
Weichlote	Weichlote
opferte	opferte
wohnst	wohnst
bejubelte	bejubelte
kitzele	kitzele
Zeitbombe	Zeitbombe
habest	habest
scheltet	scheltet
erwähnten	erwähnten
markiere	markiere
Besteck	Besteck
ehrte	ehrte
Adeliepinguin	Adeliepinguin
höhnest	höhnest
Kardinäle	Kardinäle
Rückumlaute	Rückumlaute
liebe	liebe
dressierten	dressierten
Epoxide	Epoxide
steigeret	steigeret
Sei	Sei
gelegt	gelegt
wünschet	wünschet
bimmelten	bimmelten
Rechtsruck	Rechtsruck
Herd	Herd
opfern	opfern
entwickelten	entwickelten
pensionierest	pensionierest
Vipernatter	Vipernatter
Einen	Einen
verdinglichtest	verdinglichtest
Beiblättern	Beiblättern
Leichen	Leichen
Ihren	Ihren
Kohle	Kohle
verführten	verführten
rühmst	rühmst
mehrte	mehrte
haben	haben
dunkelten	dunkelten
Qualifikationen	Qualifikationen
Berber	Berber
Bote	Bote
aufheben	aufheben
Asylrechte	Asylrechte
Gewicht	Gewicht
sagten	sagten
sollst	sollst
Tust	Tust
billigen	billigen
Kassiterits	Kassiterits
anzeigen	anzeigen
zertifiziertest	zertifiziertest
gewinnet	gewinnet
Lebenskraft	Lebenskraft
Puffersystemen	Puffersystemen
Honigbär	Honigbär
Massage	Massage
Finanzministerien	Finanzministerien
gehörst	gehörst
Gehör	Gehör
werdest	werdest
streiten	streiten
Campingplätzen	Campingplätzen
waren	waren
Kleinodien	Kleinodien
Krumen	Krumen
spricht	spricht
rufst	rufst
Germanisten	Germanisten
falle	falle
Transportweg	Transportweg
schnelle	schnelle
junge	junge
Gemüseläden	Gemüseläden
nützt	nützt
Maße	Maße
Lichte	Lichte
lackieren	lackieren
gräbst	gräbst
Reizen	Reizen
warten	warten
Gebote	Gebote
Feldbett	Feldbett
Stör	Stör
dümpelest	dümpelest
spukte	spukte
übet	übet
lange	lange
Entsetzen	Entsetzen
aufhebest	aufhebest
dotierst	dotierst
laut	laut
strafen	strafen
Briefwechsel	Briefwechsel
kühl	kühl
idealisierten	idealisierten
Fluorkohlenwasserstoffe	Fluorkohlenwasserstoffe
gabelt	gabelt
stiege	stiege
labe	labe
beten	beten
eures	eures
protestierest	protestierest
frommen	frommen
Komponisten	Komponisten
erwischten	erwischten
bürsten	bürsten
ihrem	ihrem
Abkürzungsverzeichnisse	Abkürzungsverzeichnisse
Beine	Beine
erlasset	erlasset
verkriechet	verkriechet
strandeten	strandeten
Dochte	Dochte
Anführern	Anführern
Ärztin	Ärztin
wegen	wegen
bezahlest	bezahlest
stoßet	stoßet
vertreibe	vertreibe
zuppen	zuppen
verselbstständige	verselbstständige
schnorrtet	schnorrtet
Türkise	Türkise
Lazarette	Lazarette
Abhängen	Abhängen
Chemikerinnen	Chemikerinnen
Adamsapfel	Adamsapfel
verziehst	verziehst
betreibet	betreibet
Wasserbädern	Wasserbädern
schmelzen	schmelzen
transportiere	transportiere
umarmet	umarmet
Unterwerfungen	Unterwerfungen
Strontiumamalgams	Strontiumamalgams
löste	löste
beklagte	beklagte
schon	schon
widmest	widmest
hadertet	hadertet
Dewargefäße	Dewargefäße
Vorhäute	Vorhäute
bewässerst	bewässerst
erstarrten	erstarrten
lohnt	lohnt
Chlorwasserstoffmoleküls	Chlorwasserstoffmoleküls
wallfahrteten	wallfahrteten
verschränkest	verschränkest
entert	entert
Hahnenkämmen	Hahnenkämmen
spähet	spähet
gespeist	gespeist
Zwetschgen	Zwetschgen
grübelt	grübelt
Darlegung	Darlegung
streutet	streutet
Politologen	Politologen
malträtiert	malträtiert
kaserniert	kaserniert
Primärenergie	Primärenergie
sedimentiertet	sedimentiertet
log	log
Uterus	Uterus
erriet	erriet
einführt	einführt
schöben	schöben
beschlaget	beschlaget
vertiefe	vertiefe
Biene	Biene
Geber	Geber
Katz-und-Maus-Spiele	Katz-und-Maus-Spiele
filzen	filzen
Träumers	Träumers
Händedrücken	Händedrücken
skypst	skypst
erweckst	erweckst
gestaltest	gestaltest
Amokläuferinnen	Amokläuferinnen
Last	Last
betätigtet	betätigtet
Wadenbein	Wadenbein
Suffix	Suffix
ehret	ehret
läutetet	läutetet
gebietet	gebietet
konsolidierest	konsolidierest
hupet	hupet
stärke	stärke
wallet	wallet
Grönländer	Grönländer
schubset	schubset
denen	denen
Hochhäuser	Hochhäuser
rebellieren	rebellieren
Milzen	Milzen
Sauberfrauen	Sauberfrauen
Gauner	Gauner
widmend	widmend
Freizeitzentren	Freizeitzentren
aufkommt	aufkommt
klappten	klappten
ehren	ehren
Deuteriums	Deuteriums
Meerschweinchen	Meerschweinchen
Werke	Werke
privatisiert	privatisiert
Verehrer	Verehrer
Tut	Tut
Zebrahaies	Zebrahaies
Homodimeren	Homodimeren
untersagtest	untersagtest
Sehne	Sehne
Bajonetten	Bajonetten
Auszügen	Auszügen
rufest	rufest
Indianer	Indianer
malen	malen
Abfahrtslisten	Abfahrtslisten
dichten	dichten
zerrüttet	zerrüttet
begehrend	begehrend
bestellt	bestellt
Riegel	Riegel
Metallquirle	Metallquirle
Ein	Ein
schichtet	schichtet
vertraget	vertraget
Massenarbeitslosigkeit	Massenarbeitslosigkeit
referenzierst	referenzierst
Besuch	Besuch
Zipfelmützen	Zipfelmützen
beweisen	beweisen
weichet	weichet
träumen	träumen
Friedensforscherinnen	Friedensforscherinnen
Ahnen	Ahnen
Danket	Danket
Graphem	Graphem
träge	träge
handhaben	handhaben
gut	gut
Premierministerinnen	Premierministerinnen
Linken	Linken
Röcken	Röcken
Cyclodextrinen	Cyclodextrinen
Reinstoffen	Reinstoffen
fertig	fertig
beschert	beschert
scheinest	scheinest
Zeugen	Zeugen
belüftet	belüftet
besuche	besuche
offenbarten	offenbarten
Paradiesäpfeln	Paradiesäpfeln
springen	springen
Stühlen	Stühlen
Glaubet	Glaubet
Gemeinden	Gemeinden
Fiebermitteln	Fiebermitteln
Pflanzenwachstum	Pflanzenwachstum
legten	legten
Ich	Ich
Lenkstange	Lenkstange
borgst	borgst
vertonet	vertonet
Büchereien	Büchereien
Atemgasen	Atemgasen
verleumdete	verleumdete
Brieföffner	Brieföffner
anzögen	anzögen
plissiere	plissiere
suchte	suchte
Laubbaum	Laubbaum
krösest	krösest
rekonstruieret	rekonstruieret
Dobermännern	Dobermännern
rechte	rechte
mischt	mischt
hasset	hasset
durchwacht	durchwacht
spezialisiere	spezialisiere
bleiben	bleiben
Rücktritt	Rücktritt
stille	stille
diesen	diesen
verbesserten	verbesserten
Durchbruch	Durchbruch
Klappertöpfen	Klappertöpfen
Gehilfe	Gehilfe
radierte	radierte
säumet	säumet
bauest	bauest
Sucht	Sucht
zeugst	zeugst
sprecht	sprecht
bewürben	bewürben
Füße	Füße
zerbrechen	zerbrechen
Gesetze	Gesetze
erfreu	erfreu
Grabbeltischen	Grabbeltischen
Knüppels	Knüppels
Anzeichens	Anzeichens
Bebauungsplänen	Bebauungsplänen
strömt	strömt
erhöhest	erhöhest
vielen	vielen
genehmigt	genehmigt
revoltieren	revoltieren
vertuest	vertuest
versüße	versüße
Abschiedsbriefe	Abschiedsbriefe
Sphäre	Sphäre
Schlagzeuger	Schlagzeuger
griff	griff
Heiden	Heiden
Sanatorien	Sanatorien
Schaffe	Schaffe
eiterte	eiterte
decken	decken
Möbelstoff	Möbelstoff
versucht	versucht
Zeithorizonten	Zeithorizonten
Fremde	Fremde
Schreiben	Schreiben
gebündelt	gebündelt
tanzen	tanzen
Fellhandschuh	Fellhandschuh
Geschichtsbücher	Geschichtsbücher
Feinde	Feinde
gehorchest	gehorchest
schnitt	schnitt
verselbständigst	verselbständigst
Heuschrecken	Heuschrecken
brauche	brauche
Sportlerin	Sportlerin
Buchhalterinnen	Buchhalterinnen
kabelte	kabelte
Asteroid	Asteroid
strullerte	strullerte
Hehler	Hehler
Firnis	Firnis
messen	messen
generiertet	generiertet
Anliegen	Anliegen
ihres	ihres
knusperst	knusperst
Geliebten	Geliebten
habet	habet
Nahrungsbestandteil	Nahrungsbestandteil
bücktest	bücktest
aufnahmt	aufnahmt
Schafen	Schafen
erweckest	erweckest
Hochhäusern	Hochhäusern
vierten	vierten
besänftigtest	besänftigtest
Butzemänner	Butzemänner
falteten	falteten
schmeichelest	schmeichelest
täuschet	täuschet
Ringe	Ringe
instanziier	instanziier
begeben	begeben
Märchenbüchern	Märchenbüchern
kennest	kennest
ummantle	ummantle
Affenbrotbaum	Affenbrotbaum
Füllfederhalters	Füllfederhalters
Zeitschlitzen	Zeitschlitzen
Fusselbart	Fusselbart
überdenkest	überdenkest
Langeweile	Langeweile
Substanz	Substanz
urteilte	urteilte
Ränken	Ränken
rinnt	rinnt
wahr	wahr
gewärtigten	gewärtigten
Ionenaustauscher	Ionenaustauscher
gleiche	gleiche
trieben	trieben
Dorngesträuchen	Dorngesträuchen
Höfen	Höfen
Girls	Girls
kugele	kugele
kooperierte	kooperierte
Nussknackern	Nussknackern
Sportlerinnen	Sportlerinnen
Zwetschge	Zwetschge
Kissenschlacht	Kissenschlacht
Geringschätzung	Geringschätzung
Iberers	Iberers
verforme	verforme
Augen	Augen
eher	eher
Rekursionen	Rekursionen
hinterfragst	hinterfragst
warnet	warnet
Organisation	Organisation
Geldautomat	Geldautomat
spaltete	spaltete
Alterität	Alterität
vermeße	vermeße
war	war
überlebest	überlebest
verknüpft	verknüpft
Zeitüberschreitung	Zeitüberschreitung
Ratet	Ratet
listeten	listeten
selbst	selbst
verspäte	verspäte
leset	leset
begehre	begehre
zerreißt	zerreißt
inspirierten	inspirierten
Neuigkeiten	Neuigkeiten
Herden	Herden
lögest	lögest
drillest	drillest
wähnet	wähnet
redetet	redetet
Campingplatzes	Campingplatzes
tasteten	tasteten
verdeckten	verdeckten
offenbar	offenbar
handhabt	handhabt
Götze	Götze
webte	webte
tappst	tappst
erfahret	erfahret
Ringeltaube	Ringeltaube
Wolle	Wolle
Cyanat	Cyanat
Ackerschachtelhalme	Ackerschachtelhalme
Langzeichen	Langzeichen
erben	erben
verkröchet	verkröchet
fluktuierte	fluktuierte
zagt	zagt
Düfte	Düfte
Blutgefäß	Blutgefäß
parfümierte	parfümierte
liegst	liegst
Schuhen	Schuhen
trauerten	trauerten
verlasse	verlasse
Ingredienzen	Ingredienzen
Werdet	Werdet
wisperest	wisperest
Arreste	Arreste
unseres	unseres
überfischte	überfischte
Assistentinnen	Assistentinnen
schläft	schläft
Harpunen	Harpunen
legen	legen
trage	trage
Sigle	Sigle
verberge	verberge
kategorisierte	kategorisierte
vertraute	vertraute
auszieht	auszieht
Bertrandite	Bertrandite
Felle	Felle
Habe	Habe
sannen	sannen
lehrst	lehrst
fluppe	fluppe
optimierte	optimierte
Genkinit	Genkinit
Rinde	Rinde
prediget	prediget
entmineralisierten	entmineralisierten
Besprechungen	Besprechungen
belohnte	belohnte
Weile	Weile
Schlägst	Schlägst
Amen	Amen
schichteten	schichteten
Safran	Safran
krähte	krähte
kauern	kauern
Säcken	Säcken
Fluorkohlenwasserstoff	Fluorkohlenwasserstoff
koexistierte	koexistierte
Schlange	Schlange
aasend	aasend
bedenket	bedenket
Wachteln	Wachteln
tun	tun
Radsätzen	Radsätzen
reicht	reicht
pflegte	pflegte
würden	würden
deines	deines
Alles	Alles
Dewargefäß	Dewargefäß
Quellflüssen	Quellflüssen
späht	späht
gestalten	gestalten
schenkst	schenkst
aufkämen	aufkämen
forschet	forschet
Tiere	Tiere
knusperten	knusperten
flirre	flirre
strafest	strafest
Milchflaschen	Milchflaschen
mein	mein
Neumonde	Neumonde
Brötchen	Brötchen
Schauet	Schauet
erkennet	erkennet
gewinne	gewinne
lehrest	lehrest
Pferden	Pferden
Abkürzungsverzeichnis	Abkürzungsverzeichnis
Schleppern	Schleppern
angehöret	angehöret
Wert	Wert
verringerten	verringerten
Knabe	Knabe
grienest	grienest
verkapselten	verkapselten
pfände	pfände
Lopariten	Lopariten
prostet	prostet
Aas	Aas
trüge	trüge
Generationen	Generationen
erhörest	erhörest
Atemlüfte	Atemlüfte
benachrichtige	benachrichtige
kennet	kennet
pendelt	pendelt
schummelst	schummelst
regierte	regierte
Laufringe	Laufringe
erlabet	erlabet
Aderhäuten	Aderhäuten
empörte	empörte
Schlagern	Schlagern
Rabe	Rabe
Brechnuss	Brechnuss
Deinen	Deinen
deinem	deinem
brechet	brechet
schicke	schicke
gründe	gründe
zeltest	zeltest
Spektroskopie	Spektroskopie
Feuerteufels	Feuerteufels
Meine	Meine
ander	ander
Könige	Könige
amputierten	amputierten
Ach	Ach
zuppe	zuppe
verringertet	verringertet
Ion	Ion
Anfängern	Anfängern
Füllet	Füllet
sinterte	sinterte
wurdest	wurdest
verbarg	verbarg
Würze	Würze
quatschest	quatschest
heißet	heißet
schreie	schreie
führe	führe
brauchte	brauchte
schlabbere	schlabbere
Haben	Haben
Gefügen	Gefügen
Hornung	Hornung
heulte	heulte
Adelungen	Adelungen
plazierest	plazierest
verseucht	verseucht
gravierst	gravierst
verspäteten	verspäteten
Anfechtung	Anfechtung
vergaste	vergaste
Kochfeldern	Kochfeldern
generiert	generiert
leben	leben
Reißnagel	Reißnagel
Gichten	Gichten
fällen	fällen
Sichelzellenanämien	Sichelzellenanämien
Kanzleien	Kanzleien
karikierten	karikierten
blenden	blenden
Schlöte	Schlöte
lose	lose
teilet	teilet
Glühwürmchen	Glühwürmchen
privilegiere	privilegiere
seht	seht
stapften	stapften
Portale	Portale
Wir	Wir
würdet	würdet
bezahlst	bezahlst
Lümmeltüten	Lümmeltüten
unterdrücke	unterdrücke
Stäbe	Stäbe
Streich	Streich
stellet	stellet
Hüfte	Hüfte
Präservativen	Präservativen
War	War
Kirgisinnen	Kirgisinnen
bekehrten	bekehrten
unterstützten	unterstützten
einst	einst
gerne	gerne
folget	folget
Bis	Bis
Dienstgrade	Dienstgrade
tatteret	tatteret
schleißt	schleißt
Reisebüro	Reisebüro
lehren	lehren
Anführer	Anführer
Hornunges	Hornunges
meinet	meinet
Einheimische	Einheimische
Krustentier	Krustentier
leuchtete	leuchtete
kollidierte	kollidierte
berührt	berührt
lauten	lauten
Götzen	Götzen
dechiffriere	dechiffriere
halltet	halltet
Heben	Heben
formulieren	formulieren
Mops	Mops
legt	legt
scheue	scheue
sintertest	sintertest
hydrolysierest	hydrolysierest
eggten	eggten
klumpe	klumpe
Ölspur	Ölspur
Zeitschlitze	Zeitschlitze
kämmtet	kämmtet
Markise	Markise
Malaysierin	Malaysierin
Pardelkatze	Pardelkatze
Kornnattern	Kornnattern
spritzt	spritzt
regte	regte
Vordenkern	Vordenkern
mußten	mußten
kletteret	kletteret
Talisman	Talisman
Schnitzeljagd	Schnitzeljagd
verpufftest	verpufftest
bestanden	bestanden
Indianern	Indianern
holet	holet
verstehet	verstehet
Unternehmensanwendungsintegrationen	Unternehmensanwendungsintegrationen
schlag	schlag
Patres	Patres
Asylrechten	Asylrechten
gern	gern
weinen	weinen
gehört	gehört
berufe	berufe
Videoaufzeichnung	Videoaufzeichnung
gebieten	gebieten
gebt	gebt
Notizen	Notizen
ärgertest	ärgertest
Mönchen	Mönchen
verkürzest	verkürzest
verziehe	verziehe
Steinen	Steinen
Steuerberater	Steuerberater
wiederkamen	wiederkamen
Sitz	Sitz
Gemurmel	Gemurmel
Zeitplanes	Zeitplanes
maßen	maßen
präsentier	präsentier
Proton	Proton
brachen	brachen
finanzierest	finanzierest
fliehe	fliehe
hieltest	hieltest
begnügt	begnügt
stoppten	stoppten
tagest	tagest
füsilierten	füsilierten
überprüfte	überprüfte
ziert	ziert
klicket	klicket
Blässe	Blässe
egalisiertet	egalisiertet
ihn	ihn
Möbelstoffen	Möbelstoffen
Fußmatten	Fußmatten
schreibst	schreibst
Arbeitsgruppen	Arbeitsgruppen
fluppten	fluppten
jappte	jappte
verhalte	verhalte
quantisierte	quantisierte
mobilisieret	mobilisieret
Solch	Solch
verschärftet	verschärftet
befördert	befördert
geniertest	geniertest
porträtiere	porträtiere
heiße	heiße
Ihr	Ihr
Überschüsse	Überschüsse
Stoffwechselwegen	Stoffwechselwegen
unterstützet	unterstützet
quietsche	quietsche
Kopfsalaten	Kopfsalaten
grüble	grüble
vermöge	vermöge
Aphasien	Aphasien
gratuliere	gratuliere
konvergiere	konvergiere
Lärchen	Lärchen
sprüht	sprüht
Affenbrotbäumen	Affenbrotbäumen
attackieren	attackieren
schätzte	schätzte
bündelest	bündelest
Prügelstrafen	Prügelstrafen
jammerte	jammerte
einem	einem
bemühst	bemühst
klappest	klappest
setzt	setzt
schälte	schälte
entschleieret	entschleieret
Dieben	Dieben
Sprichwörtern	Sprichwörtern
Monarchien	Monarchien
Unterseiten	Unterseiten
Märkten	Märkten
machst	machst
verfügten	verfügten
verfolgst	verfolgst
triebe	triebe
Kriegsknechten	Kriegsknechten
verteidigt	verteidigt
Dann	Dann
erhörst	erhörst
Pforten	Pforten
bezieht	bezieht
driftete	driftete
dienet	dienet
siehst	siehst
Platte	Platte
Anlässe	Anlässe
Gar	Gar
verkaufst	verkaufst
reglementiert	reglementiert
sprichst	sprichst
Muhme	Muhme
Diagnostik	Diagnostik
Gehilfen	Gehilfen
Strahlentierchens	Strahlentierchens
illustriertet	illustriertet
verdreht	verdreht
Erfahrungen	Erfahrungen
schaut	schaut
Augengläsern	Augengläsern
Palisade	Palisade
brichst	brichst
Bazziten	Bazziten
vergast	vergast
herrschet	herrschet
bewiest	bewiest
lostet	lostet
könnte	könnte
segmentiere	segmentiere
einen	einen
Fürst	Fürst
übte	übte
amenagieren	amenagieren
hinterzögen	hinterzögen
Rehe	Rehe
Bausch	Bausch
wähnt	wähnt
Schlüchte	Schlüchte
murmelten	murmelten
Weihen	Weihen
Wechselstuben	Wechselstuben
Mache	Mache
Früchte	Früchte
verlobt	verlobt
schlagest	schlagest
Pfunden	Pfunden
widerlegte	widerlegte
verspätete	verspätete
grauten	grauten
stutzt	stutzt
Meinet	Meinet
freiwillige	freiwillige
Molybdite	Molybdite
verwahrst	verwahrst
Theologie	Theologie
Einsätzen	Einsätzen
traget	traget
Butzemann	Butzemann
wirft	wirft
stationierten	stationierten
schließen	schließen
Verselbstständigung	Verselbstständigung
Antitranspiranten	Antitranspiranten
duckmäusere	duckmäusere
sich	sich
Leide	Leide
begrübe	begrübe
springst	springst
Schwermetallionen	Schwermetallionen
parlieren	parlieren
Rosinenkuchenmodell	Rosinenkuchenmodell
Gesetzen	Gesetzen
aufrichtet	aufrichtet
Gespenst	Gespenst
gewöhnte	gewöhnte
frisch	frisch
Grab	Grab
tut	tut
dürfen	dürfen
murmelst	murmelst
begrübest	begrübest
Tollkirsche	Tollkirsche
Radfahrer	Radfahrer
weich	weich
straften	straften
bewiesen	bewiesen
maximiere	maximiere
Sabbate	Sabbate
Autoklaven	Autoklaven
verludet	verludet
prahlte	prahlte
geloben	geloben
allen	allen
grüße	grüße
Bademantel	Bademantel
ausführte	ausführte
konstatiere	konstatiere
piesackest	piesackest
Schulleiterin	Schulleiterin
Paragraphenreitern	Paragraphenreitern
Acht	Acht
Stufe	Stufe
bis	bis
Ausnahmen	Ausnahmen
Elfen	Elfen
zuppst	zuppst
besucht	besucht
Gummibaumes	Gummibaumes
verständig	verständig
Aprikosen	Aprikosen
Oxalate	Oxalate
Sachen	Sachen
entfolgte	entfolgte
koordinieret	koordinieret
behütetest	behütetest
gedenk	gedenk
amputiere	amputiere
Fromme	Fromme
peiltest	peiltest
Äther	Äther
selber	selber
Schlaraffenlandes	Schlaraffenlandes
versteigernd	versteigernd
vertonten	vertonten
zwang	zwang
finanzieret	finanzieret
kapiert	kapiert
verbot	verbot
stifte	stifte
fladerst	fladerst
erwachet	erwachet
konvertieren	konvertieren
fritierst	fritierst
erlösest	erlösest
entrümpelest	entrümpelest
entgegenkamst	entgegenkamst
schimmerst	schimmerst
Gummibäumen	Gummibäumen
lauft	lauft
zerfetzte	zerfetzte
Lötzinn	Lötzinn
Jahren	Jahren
Gefilden	Gefilden
verwiesen	verwiesen
liehen	liehen
Blitzableiter	Blitzableiter
parkierten	parkierten
Werk	Werk
unterbrächest	unterbrächest
anrufen	anrufen
verzweigst	verzweigst
fluchet	fluchet
spielet	spielet
taufst	taufst
nötigte	nötigte
analysieret	analysieret
naschst	naschst
Schober	Schober
Atommodelle	Atommodelle
reichtest	reichtest
Frage	Frage
Gitarrenspieler	Gitarrenspieler
Brauhaus	Brauhaus
auflegst	auflegst
verkürzte	verkürzte
Wembley-Toren	Wembley-Toren
zerstreust	zerstreust
brecht	brecht
frappiere	frappiere
entkörperlichten	entkörperlichten
pflügten	pflügten
Finanzministerium	Finanzministerium
Händen	Händen
gestikulierst	gestikulierst
globalisier	globalisier
Streite	Streite
blättertet	blättertet
schütze	schütze
Gicht	Gicht
weh	weh
Aromastoffe	Aromastoffe
Strontiumamalgamen	Strontiumamalgamen
Pläsier	Pläsier
kämpfen	kämpfen
übersehest	übersehest
Pfründe	Pfründe
Ecken	Ecken
drängest	drängest
nähe	nähe
gebäret	gebäret
weichen	weichen
mikrominiaturisiere	mikrominiaturisiere
chloroformiere	chloroformiere
Höhe	Höhe
schließt	schließt
gewurstelt	gewurstelt
Technetiumatom	Technetiumatom
schmuggelest	schmuggelest
abweichet	abweichet
Nachteilen	Nachteilen
Zerfällen	Zerfällen
Eutern	Eutern
könnest	könnest
überschatteten	überschatteten
Basilisken	Basilisken
hobt	hobt
Oberlippe	Oberlippe
föchten	föchten
Eistaucher	Eistaucher
Raucherin	Raucherin
imprägnieret	imprägnieret
Sprecher	Sprecher
könne	könne
tobet	tobet
setzte	setzte
verzierten	verzierten
beeinflusste	beeinflusste
Werken	Werken
Linie	Linie
Dezernaten	Dezernaten
süsst	süsst
Gerät	Gerät
schlagt	schlagt
Exzentriker	Exzentriker
legst	legst
Verdacht	Verdacht
Gemüt	Gemüt
pressiert	pressiert
Radsatzes	Radsatzes
krank	krank
downloadet	downloadet
Same	Same
Almanache	Almanache
Bazzit	Bazzit
musizieret	musizieret
verderbet	verderbet
Grenzen	Grenzen
Kristalle	Kristalle
klemmt	klemmt
Klappertopf	Klappertopf
Kleptokratie	Kleptokratie
Woge	Woge
Pfleglingen	Pfleglingen
Rücktrittes	Rücktrittes
wispern	wispern
Bevölkerungsdichten	Bevölkerungsdichten
sedimentierte	sedimentierte
Fanatiker	Fanatiker
stimmen	stimmen
piesacken	piesacken
seit	seit
Entrées	Entrées
raffinier	raffinier
Lasten	Lasten
brach	brach
Regenten	Regenten
harrest	harrest
Kronsbeeren	Kronsbeeren
Crescendo	Crescendo
Gehirnwellen	Gehirnwellen
dritten	dritten
überwiese	überwiese
Banknoten	Banknoten
Geflecktheit	Geflecktheit
nähre	nähre
Innenschau	Innenschau
kurbelte	kurbelte
frohlockte	frohlockte
blaset	blaset
Wehre	Wehre
colorierten	colorierten
analysiere	analysiere
Rubinen	Rubinen
verjährte	verjährte
Seehechten	Seehechten
Bürzel	Bürzel
beiden	beiden
Steuerborden	Steuerborden
Astat	Astat
Ansteckern	Ansteckern
erbrüte	erbrüte
sterbest	sterbest
verflog	verflog
verschränken	verschränken
duschten	duschten
besser	besser
addieren	addieren
baten	baten
Trockendocks	Trockendocks
Sonderbericht	Sonderbericht
speichertest	speichertest
Bällchen	Bällchen
vergibst	vergibst
Tiegel	Tiegel
Töpfe	Töpfe
Bushaltestelle	Bushaltestelle
blockiert	blockiert
Buchhalterin	Buchhalterin
Merkel-Rauten	Merkel-Rauten
bejubelst	bejubelst
aufrichte	aufrichte
zeugest	zeugest
Halbgott	Halbgott
langte	langte
Zwingburgen	Zwingburgen
begehren	begehren
Apportierhund	Apportierhund
bracht	bracht
lögen	lögen
Dachdeckerin	Dachdeckerin
Extrems	Extrems
lüge	lüge
Deckenzapfen	Deckenzapfen
gedachten	gedachten
schätzen	schätzen
belohnten	belohnten
Möbiusbänder	Möbiusbänder
dürfte	dürfte
Fotosynthese	Fotosynthese
Westen	Westen
kabbelnd	kabbelnd
konnten	konnten
geräuchert	geräuchert
losest	losest
restaurierten	restaurierten
erfreute	erfreute
Referenz	Referenz
Kraftfahrzeugen	Kraftfahrzeugen
Jünglingen	Jünglingen
forschte	forschte
desensibilisierte	desensibilisierte
Brandbeschleuniger	Brandbeschleuniger
zürntet	zürntet
schmiert	schmiert
Kriegen	Kriegen
querest	querest
Fahret	Fahret
deklarierten	deklarierten
Öfchen	Öfchen
regiere	regiere
aufnahmen	aufnahmen
kräusle	kräusle
fertigte	fertigte
führet	führet
wechseln	wechseln
schnappet	schnappet
leite	leite
predigen	predigen
scheiterst	scheiterst
stoppte	stoppte
Dolde	Dolde
Laubholz	Laubholz
Fellachinnen	Fellachinnen
Höschens	Höschens
Hinkelstein	Hinkelstein
zweifel	zweifel
platzt	platzt
Rhodochrositen	Rhodochrositen
betrüge	betrüge
bewies	bewies
Kautschuke	Kautschuke
überwachest	überwachest
fragmentiert	fragmentiert
Steuerberatern	Steuerberatern
liebten	liebten
liebte	liebte
trinkest	trinkest
Borkenkäfer	Borkenkäfer
grüßest	grüßest
Schwestern	Schwestern
verdinglichest	verdinglichest
meinem	meinem
halbierest	halbierest
Alteritäten	Alteritäten
Handbüchern	Handbüchern
verzehrt	verzehrt
Petersfisch	Petersfisch
protestiere	protestiere
rekrutierest	rekrutierest
Leuchtkäfern	Leuchtkäfern
Farbstoffe	Farbstoffe
Wolfesgrube	Wolfesgrube
Linguisten	Linguisten
Mikrometern	Mikrometern
spritzet	spritzet
Diäresen	Diäresen
nähert	nähert
erforscht	erforscht
wegführen	wegführen
gedenkst	gedenkst
verachtet	verachtet
kremierten	kremierten
Metallothioneinen	Metallothioneinen
faschieren	faschieren
hantierte	hantierte
beichteten	beichteten
Ersten	Ersten
denaturieret	denaturieret
Haltepunkten	Haltepunkten
vermischten	vermischten
keines	keines
Ångström	Ångström
zürntest	zürntest
zerrütteten	zerrütteten
bemerket	bemerket
handhabest	handhabest
Hehlern	Hehlern
bekriegtet	bekriegtet
wässerst	wässerst
Excimerlaser	Excimerlaser
glühende	glühende
umbrächten	umbrächten
beißt	beißt
changiere	changiere
Taube	Taube
Mikrowellenfilter	Mikrowellenfilter
verdunstet	verdunstet
Leichnamen	Leichnamen
Kaufkraft	Kaufkraft
zeichnest	zeichnest
platz	platz
Emmer	Emmer
verwirft	verwirft
zürnten	zürnten
verzeichnete	verzeichnete
Oxonium	Oxonium
Chinakohl	Chinakohl
Silbersulfidbelag	Silbersulfidbelag
entzogen	entzogen
wiederkamt	wiederkamt
gelost	gelost
freute	freute
beklage	beklage
Gründungsprivileg	Gründungsprivileg
wirfst	wirfst
Zeitungsente	Zeitungsente
vereinbaren	vereinbaren
Samstagnachmittagen	Samstagnachmittagen
vandaliere	vandaliere
enterten	enterten
Grabe	Grabe
Abszisse	Abszisse
labert	labert
umarbeiten	umarbeiten
schaffen	schaffen
massierst	massierst
Isobars	Isobars
Euter	Euter
verantwortetest	verantwortetest
Kaufleute	Kaufleute
Schlagzeugern	Schlagzeugern
Stufen	Stufen
kupieren	kupieren
Ösophagospasmus	Ösophagospasmus
unterbewertete	unterbewertete
Fette	Fette
jenen	jenen
Mischelementen	Mischelementen
entwischten	entwischten
fasse	fasse
Brote	Brote
Märtyrer	Märtyrer
Automatikgetriebe	Automatikgetriebe
wärt	wärt
verurteilen	verurteilen
rächte	rächte
lehrte	lehrte
Tumulten	Tumulten
Hunde	Hunde
Drachenblut	Drachenblut
Blaumeise	Blaumeise
sponsert	sponsert
deute	deute
producieret	producieret
jagst	jagst
schnitten	schnitten
Trägergasen	Trägergasen
quatschen	quatschen
Seit	Seit
Ding	Ding
gestatteten	gestatteten
ramme	ramme
Schlager	Schlager
Darlehen	Darlehen
assimilierten	assimilierten
ritten	ritten
segmentierten	segmentierten
ahne	ahne
Lümmeltüte	Lümmeltüte
lehnen	lehnen
Bittersüß	Bittersüß
klage	klage
tobend	tobend
wachet	wachet
blitzt	blitzt
verkleinern	verkleinern
behauptete	behauptete
ermordeten	ermordeten
Geldautomaten	Geldautomaten
stolz	stolz
Dingen	Dingen
hätte	hätte
Keile	Keile
tätowierest	tätowierest
preiset	preiset
meldet	meldet
verewiget	verewiget
Essen	Essen
Anachronismen	Anachronismen
Tintenfische	Tintenfische
Trockendock	Trockendock
warntest	warntest
Hörst	Hörst
Büstenhalters	Büstenhalters
bezahlt	bezahlt
eingehest	eingehest
ankerst	ankerst
verklagt	verklagt
Stadtbezirke	Stadtbezirke
Fledermaus	Fledermaus
müssest	müssest
gähnten	gähnten
Kaufleuten	Kaufleuten
recycelten	recycelten
besänne	besänne
zagest	zagest
könnt	könnt
Bauwerken	Bauwerken
Roben	Roben
suchet	suchet
Androiden	Androiden
grabbelten	grabbelten
Talismanen	Talismanen
huren	huren
zuppt	zuppt
rollten	rollten
Mutagenen	Mutagenen
Magier	Magier
Polarisation	Polarisation
links	links
hauest	hauest
Abschiedsbrief	Abschiedsbrief
leid	leid
Gebete	Gebete
glaubet	glaubet
Nullpunktes	Nullpunktes
wachsen	wachsen
Atommasse	Atommasse
rede	rede
bewieset	bewieset
verzweigt	verzweigt
gehet	gehet
zürnest	zürnest
Tun	Tun
Arsenit	Arsenit
unsere	unsere
heißt	heißt
drängte	drängte
Büsche	Büsche
Lusitaner	Lusitaner
polymerisierte	polymerisierte
Lehrkörpern	Lehrkörpern
Drillinge	Drillinge
Aktienkurs	Aktienkurs
finanziert	finanziert
Säuen	Säuen
verscheißert	verscheißert
filzst	filzst
sprachen	sprachen
still	still
Füllen	Füllen
vernehmest	vernehmest
Marokkanern	Marokkanern
ermahnet	ermahnet
greinen	greinen
Berufen	Berufen
verkleide	verkleide
Aller	Aller
Hirten	Hirten
lackiere	lackiere
Rehböcken	Rehböcken
malträtierte	malträtierte
Wiedergutmachungen	Wiedergutmachungen
klumpt	klumpt
tastet	tastet
Gewalttäter	Gewalttäter
Reinigungsschritten	Reinigungsschritten
benachrichtiget	benachrichtiget
toten	toten
Samen	Samen
Denkmünzen	Denkmünzen
verselbständigt	verselbständigt
Tintenfisch	Tintenfisch
Auge	Auge
wiederholte	wiederholte
kürzten	kürzten
langweilst	langweilst
bölkte	bölkte
Bundesgebiet	Bundesgebiet
kehrst	kehrst
kehret	kehret
Elementarzelle	Elementarzelle
sagen	sagen
Stilllegung	Stilllegung
regierest	regierest
wog	wog
respektiert	respektiert
Seine	Seine
Basilisk	Basilisk
harren	harren
changieren	changieren
merket	merket
kein	kein
Schauen	Schauen
Begünstigung	Begünstigung
borgte	borgte
Leitkegeln	Leitkegeln
wogen	wogen
Epoxiden	Epoxiden
Ausländer	Ausländer
Tumult	Tumult
Managementsystemen	Managementsystemen
Fallet	Fallet
bewahrest	bewahrest
arbeiten	arbeiten
Denen	Denen
kollidierten	kollidierten
Störe	Störe
Propheten	Propheten
imprägniere	imprägniere
knackt	knackt
unterscheide	unterscheide
erlauben	erlauben
Leichtmetalle	Leichtmetalle
Steuerwagen	Steuerwagen
blamierest	blamierest
Festons	Festons
Myriade	Myriade
höhnte	höhnte
Steuerwagens	Steuerwagens
Schanktischen	Schanktischen
Inder	Inder
ernteten	ernteten
schwebe	schwebe
Raute	Raute
Linguist	Linguist
krähen	krähen
maximierten	maximierten
Nukleinsäuren	Nukleinsäuren
frohlockten	frohlockten
fertige	fertige
fotzte	fotzte
Abschußringe	Abschußringe
zerstreuest	zerstreuest
flehte	flehte
schämten	schämten
Buntwaschmittel	Buntwaschmittel
plaziert	plaziert
haarten	haarten
Schnittlauche	Schnittlauche
Leuchtstoff	Leuchtstoff
erhört	erhört
Tiefschutzen	Tiefschutzen
Knechte	Knechte
drücken	drücken
Märtyrern	Märtyrern
erschütterte	erschütterte
hänget	hänget
armen	armen
Steuerbord	Steuerbord
wehen	wehen
verspätest	verspätest
verpuffe	verpuffe
weinte	weinte
verschreibt	verschreibt
Alkalien	Alkalien
Farbstoffen	Farbstoffen
interpretierten	interpretierten
exmatrikulierte	exmatrikulierte
Lusitaners	Lusitaners
sterbt	sterbt
beschottert	beschottert
Hahnenkämme	Hahnenkämme
Krusten	Krusten
beeindruckt	beeindruckt
außer	außer
filzte	filzte
billige	billige
ausziehst	ausziehst
prosteten	prosteten
suchten	suchten
grüßend	grüßend
verabschiedeten	verabschiedeten
revoltierte	revoltierte
schau	schau
spaltetest	spaltetest
benützt	benützt
Liebchen	Liebchen
Tukanen	Tukanen
köderet	köderet
leihe	leihe
Kontaktierungen	Kontaktierungen
Heide	Heide
prahlet	prahlet
vertrieb	vertrieb
Fiebermittel	Fiebermittel
Kerzenfischen	Kerzenfischen
verwahrt	verwahrt
Honigbären	Honigbären
Weinen	Weinen
Geschäften	Geschäften
verdammen	verdammen
Literaturen	Literaturen
parametrisierten	parametrisierten
Montagmittagen	Montagmittagen
Halter	Halter
schweigen	schweigen
Steine	Steine
Wucher	Wucher
vermögen	vermögen
knistert	knistert
vermutest	vermutest
klickte	klickte
Wänden	Wänden
Paradiesapfel	Paradiesapfel
achte	achte
Laufen	Laufen
protokollierst	protokollierst
Kehre	Kehre
Hypochlorite	Hypochlorite
gehörte	gehörte
protestierst	protestierst
Adler	Adler
Ängste	Ängste
babbelst	babbelst
wünschst	wünschst
Paläste	Paläste
Lammfellhandschuhs	Lammfellhandschuhs
Fremdwörter	Fremdwörter
infiziertet	infiziertet
Lobet	Lobet
Kuttern	Kuttern
Gammastrahlen	Gammastrahlen
Wespen	Wespen
versteckte	versteckte
Kleinoden	Kleinoden
glaubst	glaubst
belauerten	belauerten
wärme	wärme
Augur	Augur
Rundbriefen	Rundbriefen
Vorstädte	Vorstädte
transportierte	transportierte
annektierst	annektierst
Konzentrat	Konzentrat
Beobachtung	Beobachtung
Zement	Zement
Solches	Solches
eigenen	eigenen
Ärgernisse	Ärgernisse
Gasen	Gasen
verdamme	verdamme
Provinzen	Provinzen
Otaviten	Otaviten
beide	beide
boßte	boßte
gewitterte	gewitterte
Zebrahai	Zebrahai
umhüll	umhüll
Kutter	Kutter
Trümmersprachen	Trümmersprachen
wehe	wehe
Päckchen	Päckchen
Linke	Linke
verstörte	verstörte
Massagen	Massagen
sichten	sichten
Kernladungszahlen	Kernladungszahlen
verlautete	verlautete
begehrte	begehrte
ersparte	ersparte
Dithiolane	Dithiolane
Freeganer	Freeganer
verifizieret	verifizieret
Aerosole	Aerosole
Monate	Monate
Teile	Teile
flitzen	flitzen
Aase	Aase
wärst	wärst
sollte	sollte
Übertretung	Übertretung
setztet	setztet
Krokus	Krokus
greife	greife
dissentierte	dissentierte
schmelzt	schmelzt
nächste	nächste
designiertet	designiertet
leertet	leertet
zweifelte	zweifelte
amenagierst	amenagierst
schlafet	schlafet
strandend	strandend
füsilierte	füsilierte
Tetraiodide	Tetraiodide
Gnaden	Gnaden
illustriere	illustriere
setzen	setzen
Gurt	Gurt
zweiten	zweiten
Pflichten	Pflichten
hüpfest	hüpfest
Säcke	Säcke
bezichtigt	bezichtigt
Astats	Astats
Geräte	Geräte
Reizt	Reizt
Hektare	Hektare
rangieret	rangieret
salzen	salzen
stolze	stolze
Abschreckung	Abschreckung
Speere	Speere
grause	grause
Apotheose	Apotheose
verbluteten	verbluteten
Gässchen	Gässchen
formirte	formirte
wolle	wolle
Lobgesänge	Lobgesänge
koste	koste
sortierte	sortierte
bewahrt	bewahrt
Notärztinnen	Notärztinnen
Klassenzimmern	Klassenzimmern
Leisten	Leisten
Rutheniumkomplexen	Rutheniumkomplexen
Datentypen	Datentypen
schabst	schabst
flieh	flieh
Greyerzern	Greyerzern
Schenken	Schenken
Angabe	Angabe
begleicht	begleicht
Sphären	Sphären
begehrtest	begehrtest
verlötest	verlötest
Halsabschneider	Halsabschneider
reichte	reichte
Bienenzüchter	Bienenzüchter
Stimme	Stimme
fragst	fragst
wer	wer
jungen	jungen
Zeug	Zeug
Schwirrvogel	Schwirrvogel
verschmelze	verschmelze
Fehlen	Fehlen
Stämme	Stämme
Testamenten	Testamenten
Abkömmlingen	Abkömmlingen
beteuerest	beteuerest
Nährmediums	Nährmediums
Gefäße	Gefäße
lieben	lieben
transportierst	transportierst
Anrufbeantworter	Anrufbeantworter
Küsserei	Küsserei
lochtest	lochtest
vermischen	vermischen
Reiseleitern	Reiseleitern
Operationssaal	Operationssaal
lehnte	lehnte
empört	empört
glawbten	glawbten
Kohlenstoffgehalt	Kohlenstoffgehalt
Werkzeuge	Werkzeuge
hintertreiben	hintertreiben
mache	mache
kurze	kurze
vertrage	vertrage
inszeniere	inszeniere
Schläfchen	Schläfchen
Betten	Betten
Hüllenelektronen	Hüllenelektronen
schlafe	schlafe
ummantelten	ummantelten
Ärztinnen	Ärztinnen
befehlen	befehlen
irren	irren
Vanadaten	Vanadaten
Bombardierungen	Bombardierungen
einführte	einführte
erliegen	erliegen
Versorgungen	Versorgungen
Planern	Planern
Kriegsenden	Kriegsenden
dringst	dringst
kickend	kickend
Rehen	Rehen
Halle	Halle
bewahrheitete	bewahrheitete
Verdachtes	Verdachtes
verklagst	verklagst
griechischen	griechischen
besorgten	besorgten
Chelatkomplex	Chelatkomplex
reim	reim
beider	beider
Türme	Türme
Kaufhäusern	Kaufhäusern
Böse	Böse
warnt	warnt
manövrieret	manövrieret
verunzierte	verunzierte
siegen	siegen
wehrt	wehrt
arrivierst	arrivierst
Kontraindikationen	Kontraindikationen
elfte	elfte
geahnt	geahnt
Milz	Milz
Unglauben	Unglauben
schnattert	schnattert
merkte	merkte
konvertiere	konvertiere
Lautschriften	Lautschriften
weinst	weinst
Generatoren	Generatoren
erziehen	erziehen
dramatisieren	dramatisieren
wir	wir
Ställen	Ställen
Regent	Regent
gehörten	gehörten
Kortholt	Kortholt
Atombomben	Atombomben
Eins	Eins
Beinen	Beinen
bauten	bauten
klone	klone
zittertest	zittertest
entfolgst	entfolgst
grünet	grünet
Einrad	Einrad
Brieftaubenzüchters	Brieftaubenzüchters
Kardinal	Kardinal
sprühend	sprühend
nütze	nütze
Decket	Decket
unterwirft	unterwirft
pensionierten	pensionierten
keine	keine
Tanne	Tanne
Hirsche	Hirsche
überlieferten	überlieferten
stoße	stoße
salz	salz
Fahrzeugkatalysatoren	Fahrzeugkatalysatoren
betrüben	betrüben
fahret	fahret
drängst	drängst
begehrest	begehrest
sieht	sieht
Boten	Boten
Bonzen	Bonzen
Treibhausgase	Treibhausgase
Marjellchen	Marjellchen
drosselt	drosselt
balkanisierte	balkanisierte
dienest	dienest
Flame	Flame
Am	Am
verallgemeinerst	verallgemeinerst
gelobet	gelobet
nähte	nähte
concessioniert	concessioniert
Komponistinnen	Komponistinnen
Dich	Dich
Thioacetalen	Thioacetalen
Buchfinken	Buchfinken
Bunde	Bunde
helft	helft
Gedicht	Gedicht
lest	lest
besetzen	besetzen
seufzest	seufzest
batet	batet
schneidet	schneidet
klappen	klappen
Flöten	Flöten
verlautet	verlautet
sabbelt	sabbelt
Crescendos	Crescendos
wärmet	wärmet
dunkelt	dunkelt
Strahlentierchen	Strahlentierchen
Falltürme	Falltürme
versuchest	versuchest
steiget	steiget
Treppe	Treppe
gehöre	gehöre
Schade	Schade
Stierkämpfe	Stierkämpfe
wässerten	wässerten
deckst	deckst
Schwänzchen	Schwänzchen
kabeln	kabeln
sitzet	sitzet
beichten	beichten
zerschlagt	zerschlagt
trüb	trüb
Kupferkiese	Kupferkiese
Laie	Laie
hinterfragten	hinterfragten
Reisebüros	Reisebüros
nagelest	nagelest
Kürasse	Kürasse
Zäune	Zäune
besorgend	besorgend
Leichenschauhäuser	Leichenschauhäuser
solchen	solchen
Elementen	Elementen
welchen	welchen
betrieben	betrieben
Einstufung	Einstufung
verbündet	verbündet
Selbstversuch	Selbstversuch
aufrichten	aufrichten
Spurensicherung	Spurensicherung
Gedränge	Gedränge
Fäuste	Fäuste
zelte	zelte
verurteile	verurteile
veranstalten	veranstalten
gedenkt	gedenkt
Warten	Warten
grüne	grüne
vollendest	vollendest
Schnipseln	Schnipseln
begehr	begehr
Schlüchten	Schlüchten
höbest	höbest
bereiteten	bereiteten
überbewertet	überbewertet
Karikaturistinnen	Karikaturistinnen
betrübte	betrübte
Schiffen	Schiffen
klappst	klappst
bereite	bereite
Arsenite	Arsenite
Däumlings	Däumlings
Retter	Retter
Schickse	Schickse
Insulaner	Insulaner
Blechen	Blechen
Erstlingen	Erstlingen
vernehmen	vernehmen
durchzuckest	durchzuckest
wisperten	wisperten
bombardiere	bombardiere
Penis	Penis
speiest	speiest
Entree	Entree
verbaselt	verbaselt
steckst	steckst
Küchenmaschinen	Küchenmaschinen
verscheißerte	verscheißerte
Baisers	Baisers
regieren	regieren
anfingst	anfingst
bat	bat
föhnten	föhnten
Amt	Amt
grau	grau
Ebenen	Ebenen
verwaisten	verwaisten
Heiratsgütern	Heiratsgütern
Buntspechte	Buntspechte
Fällen	Fällen
schreist	schreist
verwirrt	verwirrt
jappten	jappten
erforschet	erforschet
Deck	Deck
bimmelte	bimmelte
rauschte	rauschte
Worte	Worte
trieb	trieb
Volkslehren	Volkslehren
zentrifugierst	zentrifugierst
anzöge	anzöge
löst	löst
geknautscht	geknautscht
Schlepper	Schlepper
polymerisier	polymerisier
Piratensender	Piratensender
mampfte	mampfte
Euren	Euren
Plumpsen	Plumpsen
Katamaranen	Katamaranen
verschont	verschont
Königreichen	Königreichen
gravierten	gravierten
verdränget	verdränget
versuchst	versuchst
Anhängsel	Anhängsel
verließen	verließen
Zankapfel	Zankapfel
holst	holst
aber	aber
benütztest	benütztest
knufften	knufften
all	all
dividiert	dividiert
Karer	Karer
flambiert	flambiert
meißelt	meißelt
verkleidete	verkleidete
Frettchen	Frettchen
trägt	trägt
zensiere	zensiere
extemporieret	extemporieret
Dürre	Dürre
Melanteriten	Melanteriten
erhöht	erhöht
nippst	nippst
entfachten	entfachten
Portal	Portal
Gehörst	Gehörst
Großfürst	Großfürst
Schotten	Schotten
laufe	laufe
colorierend	colorierend
rodet	rodet
heiß	heiß
Älteste	Älteste
Gallanen	Gallanen
Grizzlybären	Grizzlybären
gelangen	gelangen
nagelte	nagelte
Büschen	Büschen
Gläubigern	Gläubigern
Bienen	Bienen
erkaltest	erkaltest
Lüsten	Lüsten
unseren	unseren
gefällst	gefällst
ahnten	ahnten
unterwerft	unterwerft
putzt	putzt
Den	Den
schleiß	schleiß
Katz-und-Maus-Spielen	Katz-und-Maus-Spielen
feierten	feierten
Nachweisreagenzien	Nachweisreagenzien
Flussbett	Flussbett
Sitzfleisch	Sitzfleisch
Bärenfellen	Bärenfellen
Serverzugriffe	Serverzugriffe
verkaufe	verkaufe
schmettern	schmettern
Halsabschneidern	Halsabschneidern
beanspruchte	beanspruchte
Fanmeilen	Fanmeilen
verwechsele	verwechsele
Grufti	Grufti
harmoniert	harmoniert
Schnute	Schnute
anzeigt	anzeigt
Gründungsprivilegien	Gründungsprivilegien
Schwarzseherin	Schwarzseherin
Galopps	Galopps
bauet	bauet
trotze	trotze
tabuisiert	tabuisiert
optimiert	optimiert
Zitronensaft	Zitronensaft
zeichnet	zeichnet
Verbrechen	Verbrechen
Trioxiden	Trioxiden
lockerte	lockerte
Herzchen	Herzchen
fällst	fällst
Aktivisten	Aktivisten
Effekten	Effekten
wehrten	wehrten
inhalierest	inhalierest
Adhäsionen	Adhäsionen
überschneidet	überschneidet
Kompromiss	Kompromiss
Einem	Einem
sinke	sinke
Hanse	Hanse
Sekten	Sekten
halt	halt
sterilisiert	sterilisiert
enträtselten	enträtselten
stellen	stellen
mühte	mühte
verfinstere	verfinstere
bromiert	bromiert
Exilanten	Exilanten
Kontrollkästchen	Kontrollkästchen
Gigapascal	Gigapascal
sinnst	sinnst
velarisierend	velarisierend
erkannten	erkannten
heischten	heischten
Wille	Wille
fritierten	fritierten
Kapitalverkehr	Kapitalverkehr
vertrieben	vertrieben
Eine	Eine
Heringe	Heringe
befehle	befehle
replizieret	replizieret
weiche	weiche
Welteninsel	Welteninsel
scheuchtest	scheuchtest
Meinem	Meinem
malet	malet
aufstehet	aufstehet
begehrtet	begehrtet
lodert	lodert
Reiterschwert	Reiterschwert
Sorge	Sorge
Mähnenwolf	Mähnenwolf
baute	baute
Unrechten	Unrechten
Zwingburg	Zwingburg
verachtend	verachtend
oben	oben
Ränke	Ränke
beteuerten	beteuerten
gedächtet	gedächtet
befestigten	befestigten
hebräische	hebräische
Klauen	Klauen
erratet	erratet
stürzte	stürzte
Anfechtungen	Anfechtungen
behalte	behalte
Aerosolen	Aerosolen
reiftet	reiftet
Drachen	Drachen
Falzen	Falzen
Nanoteslan	Nanoteslan
skypet	skypet
reichen	reichen
Augenglases	Augenglases
Pflanzenstoff	Pflanzenstoff
filtern	filtern
vergiften	vergiften
tragt	tragt
Schote	Schote
schaffet	schaffet
Sonnenfinsternis	Sonnenfinsternis
bewässern	bewässern
Muster	Muster
Briefe	Briefe
Anmelder	Anmelder
Aussätzigen	Aussätzigen
ruckelst	ruckelst
erlöse	erlöse
steige	steige
tabuisierten	tabuisierten
Einheimischen	Einheimischen
entsetzet	entsetzet
prostituieret	prostituieret
möpperst	möpperst
mischst	mischst
fragen	fragen
Werde	Werde
blondierten	blondierten
Antitranspirante	Antitranspirante
Reiterschwertern	Reiterschwertern
mögest	mögest
Antimusters	Antimusters
Spende	Spende
Gefangenen	Gefangenen
raubet	raubet
respektierten	respektierten
auszögen	auszögen
vernichtest	vernichtest
Kupferkiesen	Kupferkiesen
türmen	türmen
Halbmond	Halbmond
hebräischen	hebräischen
Äquatoren	Äquatoren
Metallspiegeln	Metallspiegeln
Kraftfahrzeuges	Kraftfahrzeuges
ehre	ehre
Samarskite	Samarskite
löse	löse
Erzherzogshüten	Erzherzogshüten
Heiratsgut	Heiratsgut
ihren	ihren
ausfuhr	ausfuhr
hattest	hattest
vereinbarten	vereinbarten
Eiland	Eiland
erklingt	erklingt
danke	danke
simulierst	simulierst
Markisen	Markisen
babbeltet	babbeltet
winke	winke
anrichte	anrichte
bewässerest	bewässerest
filzten	filzten
Teppiche	Teppiche
Finanzminister	Finanzminister
fluktuiert	fluktuiert
suchest	suchest
Worten	Worten
Bankettes	Bankettes
Rooibos	Rooibos
Wege	Wege
konntest	konntest
wehrte	wehrte
Bajonette	Bajonette
Dünungen	Dünungen
fresse	fresse
Nachruf	Nachruf
Acetat	Acetat
grüßten	grüßten
Lobgesängen	Lobgesängen
Jungfernflüge	Jungfernflüge
Mensch	Mensch
Stierkämpfen	Stierkämpfen
Rasterkraftmikroskop	Rasterkraftmikroskop
gelobte	gelobte
bekehrst	bekehrst
Ecke	Ecke
brause	brause
Naturen	Naturen
Keine	Keine
Regiert	Regiert
quantisiere	quantisiere
begründest	begründest
Chlorat	Chlorat
süsse	süsse
Substanzen	Substanzen
Gehirnwelle	Gehirnwelle
Malaysier	Malaysier
ab	ab
Kurkuma	Kurkuma
Gasgemisch	Gasgemisch
leistest	leistest
Narkotikum	Narkotikum
Genie	Genie
kochte	kochte
tattre	tattre
zittere	zittere
lösend	lösend
Bienenstöcke	Bienenstöcke
fallen	fallen
verringeret	verringeret
Orgeln	Orgeln
Ärgernissen	Ärgernissen
erste	erste
gewarnt	gewarnt
erlagst	erlagst
schnürest	schnürest
bürsteten	bürsteten
überreichst	überreichst
unterschieden	unterschieden
Zeitplan	Zeitplan
Arsenolithen	Arsenolithen
versteckst	versteckst
sedimentiert	sedimentiert
reformieren	reformieren
Seile	Seile
Jüngern	Jüngern
Leitkegel	Leitkegel
bölket	bölket
sezierst	sezierst
dramatisiert	dramatisiert
Grüße	Grüße
faschieret	faschieret
Großfürsten	Großfürsten
Schuldner	Schuldner
verknüpfet	verknüpfet
Türkin	Türkin
brandet	brandet
demütige	demütige
erbrütet	erbrütet
Suchanfragen	Suchanfragen
neigest	neigest
schnatternd	schnatternd
Hebet	Hebet
Äste	Äste
Elf	Elf
Gerücht	Gerücht
Kuckucke	Kuckucke
bedingten	bedingten
Wisset	Wisset
assimilieret	assimilieret
verkürztet	verkürztet
gesellt	gesellt
taufe	taufe
älteste	älteste
kontaktieret	kontaktieret
Alltag	Alltag
Zwergschwan	Zwergschwan
Hirschen	Hirschen
stürzen	stürzen
betrübtest	betrübtest
boß	boß
wälzet	wälzet
duckt	duckt
hättet	hättet
Adlerbussard	Adlerbussard
Bande	Bande
kühle	kühle
warntet	warntet
begnadigte	begnadigte
Hinkelsteine	Hinkelsteine
Sagen	Sagen
zerfetzt	zerfetzt
sonderte	sonderte
Gebeinen	Gebeinen
fladerest	fladerest
blase	blase
erhöhet	erhöhet
wehrtest	wehrtest
Reliquiare	Reliquiare
betrübe	betrübe
Garten	Garten
Handbuch	Handbuch
Einsatz	Einsatz
schwängen	schwängen
Monde	Monde
ankern	ankern
Vergeltungen	Vergeltungen
Spektralbereich	Spektralbereich
ladest	ladest
hörest	hörest
Suchanfrage	Suchanfrage
Gegenleistungen	Gegenleistungen
koordinierte	koordinierte
helle	helle
gestattest	gestattest
Pfählen	Pfählen
annektierten	annektierten
Zementen	Zementen
würdest	würdest
Preisanstieg	Preisanstieg
konnotierst	konnotierst
Vaginen	Vaginen
wälzt	wälzt
Maxima	Maxima
bestellte	bestellte
verrostet	verrostet
Reinigungsschrittes	Reinigungsschrittes
entkörperlichte	entkörperlichte
addierest	addierest
pflügen	pflügen
Flamingo	Flamingo
implodiere	implodiere
enträtselst	enträtselst
installiert	installiert
Pest	Pest
überfischt	überfischt
kriegte	kriegte
Funkfeuern	Funkfeuern
wohnte	wohnte
Aufpralle	Aufpralle
Erstlinge	Erstlinge
grünte	grünte
gedurft	gedurft
lade	lade
Wollt	Wollt
Gebirge	Gebirge
beschrifteten	beschrifteten
verleumdetest	verleumdetest
konsumiere	konsumiere
Gasgemischen	Gasgemischen
bestand	bestand
kämpfet	kämpfet
verspielte	verspielte
füllte	füllte
heben	heben
Gewichten	Gewichten
verzieht	verzieht
Zeithorizonte	Zeithorizonte
erst	erst
rufe	rufe
regiertest	regiertest
erkalten	erkalten
zürnst	zürnst
führte	führte
am	am
Atommodellen	Atommodellen
emigriert	emigriert
bereitet	bereitet
Testamente	Testamente
schneidend	schneidend
Rufen	Rufen
ungehorsam	ungehorsam
teil	teil
Sterne	Sterne
Seelöwe	Seelöwe
Zeugnissen	Zeugnissen
Gebot	Gebot
hinterlege	hinterlege
Ausstiegstüren	Ausstiegstüren
spannte	spannte
bequemtet	bequemtet
Seil	Seil
Eingeweiden	Eingeweiden
überreichend	überreichend
Helmen	Helmen
zensierten	zensierten
Stimmen	Stimmen
entschädiget	entschädiget
Herabsetzungen	Herabsetzungen
losen	losen
puddelst	puddelst
erbringst	erbringst
mopsend	mopsend
Sexten	Sexten
Empfängnisverhütungen	Empfängnisverhütungen
kämpfte	kämpfte
weist	weist
Hälsen	Hälsen
Kühen	Kühen
schaffte	schaffte
amen	amen
Chlorid	Chlorid
begruben	begruben
knitterte	knitterte
machte	machte
ausführen	ausführen
wach	wach
Stolze	Stolze
Anmeldern	Anmeldern
Stühle	Stühle
Letzte	Letzte
kostet	kostet
Gut	Gut
wart	wart
substituierten	substituierten
Langschwanzpinguinen	Langschwanzpinguinen
porträtiert	porträtiert
erschrickst	erschrickst
Essigsäurechloriden	Essigsäurechloriden
überschattet	überschattet
Apfelbäumen	Apfelbäumen
dehydrierten	dehydrierten
erstehen	erstehen
säumen	säumen
überführen	überführen
Schilden	Schilden
Gelobet	Gelobet
stehet	stehet
Hacker	Hacker
stürzt	stürzt
besicheret	besicheret
besänftiget	besänftiget
Zipfelmütze	Zipfelmütze
täuschte	täuschte
Vorstoß	Vorstoß
Zitronensäften	Zitronensäften
hupen	hupen
Abfertigungsgebäude	Abfertigungsgebäude
Gedächtnisse	Gedächtnisse
idealisierest	idealisierest
schickte	schickte
Joche	Joche
vibrierend	vibrierend
Firnisse	Firnisse
raubest	raubest
schauet	schauet
argumentierest	argumentierest
Fülle	Fülle
strafe	strafe
erweckt	erweckt
häufe	häufe
ringe	ringe
gebot	gebot
Mobilfunknetzen	Mobilfunknetzen
verallgemeinerest	verallgemeinerest
öle	öle
Banketten	Banketten
bräunst	bräunst
hintertrieben	hintertrieben
Mein	Mein
wünschest	wünschest
Wissen	Wissen
gewährtest	gewährtest
Kontraindikation	Kontraindikation
zählten	zählten
Landstreichereien	Landstreichereien
Donor	Donor
fette	fette
evakuierte	evakuierte
reizt	reizt
Knüppeln	Knüppeln
Android	Android
gequasselt	gequasselt
musizierte	musizierte
verdrängt	verdrängt
Eingeweide	Eingeweide
Tier	Tier
Freibrief	Freibrief
verwirfst	verwirfst
Füchsin	Füchsin
appellierte	appellierte
liebt	liebt
Wirte	Wirte
sponsertest	sponsertest
niemanden	niemanden
Regierung	Regierung
Totenglocke	Totenglocke
sponseret	sponseret
schaben	schaben
gefügt	gefügt
Telefonverkäufer	Telefonverkäufer
irgendein	irgendein
Wären	Wären
erlöset	erlöset
lebet	lebet
Donnerstagabenden	Donnerstagabenden
betrügen	betrügen
Schwan	Schwan
replizierten	replizierten
begraben	begraben
prangte	prangte
nehmest	nehmest
eingehet	eingehet
stand	stand
fegst	fegst
Meines	Meines
Früchtchen	Früchtchen
alles	alles
destabilisierte	destabilisierte
Bestechungsgelder	Bestechungsgelder
scheucht	scheucht
Bestecken	Bestecken
Kernspaltungen	Kernspaltungen
ehrst	ehrst
privilegierst	privilegierst
wollest	wollest
konntet	konntet
ruckeln	ruckeln
verfehle	verfehle
Licht	Licht
nimmst	nimmst
Herkünften	Herkünften
Hubschraubern	Hubschraubern
privatisierest	privatisierest
zersetzte	zersetzte
Leiche	Leiche
Fellachin	Fellachin
Märchenbuches	Märchenbuches
Schneepflug	Schneepflug
Teilnehmerin	Teilnehmerin
Mäppchen	Mäppchen
drängten	drängten
behauptest	behauptest
belüftete	belüftete
wallfahrest	wallfahrest
kämmt	kämmt
zerrisset	zerrisset
behaltest	behaltest
Zankapfels	Zankapfels
Erzeugung	Erzeugung
erfüllet	erfüllet
grüßet	grüßet
Maultiere	Maultiere
Privatsachen	Privatsachen
Borhydride	Borhydride
deinen	deinen
Kassettenrekordern	Kassettenrekordern
interagiert	interagiert
verseift	verseift
glaubten	glaubten
prostete	prostete
gratuliert	gratuliert
Ärzteblatt	Ärzteblatt
unterforderten	unterforderten
Rundbriefe	Rundbriefe
Renegat	Renegat
Maultieren	Maultieren
Obszönität	Obszönität
frohlockest	frohlockest
Wachtel	Wachtel
Kaufhäuser	Kaufhäuser
seine	seine
überqueren	überqueren
Krankenschein	Krankenschein
überliefere	überliefere
Ausbeutern	Ausbeutern
besorgt	besorgt
kürzt	kürzt
Chasaren	Chasaren
Griechen	Griechen
Konzentrate	Konzentrate
Münzsammlung	Münzsammlung
nahte	nahte
unsrer	unsrer
klonet	klonet
Feiertage	Feiertage
strullerst	strullerst
beäugst	beäugst
lieget	lieget
Rauten	Rauten
Signal	Signal
Füchse	Füchse
Anlass	Anlass
bange	bange
verschicket	verschicket
Stärkungsmittel	Stärkungsmittel
Jude	Jude
entmineralisierst	entmineralisierst
verklärt	verklärt
suchen	suchen
beschlügen	beschlügen
buddelten	buddelten
Aha-Erlebnis	Aha-Erlebnis
teile	teile
mehret	mehret
hurst	hurst
verdeckte	verdeckte
Randbemerkung	Randbemerkung
wallfahrten	wallfahrten
Silberdrahts	Silberdrahts
Unter	Unter
weichest	weichest
Tukans	Tukans
gelobten	gelobten
Trägerwellen	Trägerwellen
Arbeitsunfähigkeit	Arbeitsunfähigkeit
reichst	reichst
gedolmetscht	gedolmetscht
kappet	kappet
Abtrünnige	Abtrünnige
Meere	Meere
möppertet	möppertet
Metallspiegel	Metallspiegel
taufen	taufen
Pausbacke	Pausbacke
leere	leere
Bilderstürmer	Bilderstürmer
sondern	sondern
Ambiguität	Ambiguität
Beobachtungen	Beobachtungen
halten	halten
haste	haste
rammte	rammte
addieret	addieret
dringen	dringen
Höhen	Höhen
verdammend	verdammend
Messies	Messies
vorn	vorn
haderte	haderte
niemand	niemand
Acetaten	Acetaten
sagte	sagte
anrührt	anrührt
Geschrei	Geschrei
lachen	lachen
glühenden	glühenden
streiften	streiften
Montagmittag	Montagmittag
sticke	sticke
verfliegest	verfliegest
liebtet	liebtet
schwöret	schwöret
andere	andere
begrabe	begrabe
Rutheniumisotop	Rutheniumisotop
zürnet	zürnet
Kannst	Kannst
leiste	leiste
Brettspielen	Brettspielen
wichste	wichste
Gibt	Gibt
begrabt	begrabt
Domänen	Domänen
trotzest	trotzest
bekriegt	bekriegt
zertifizierst	zertifizierst
verwirrte	verwirrte
besichert	besichert
bereits	bereits
Katamaran	Katamaran
Blumensträußen	Blumensträußen
hängen	hängen
begnügte	begnügte
bete	bete
produzierte	produzierte
Bezeugungen	Bezeugungen
Gute	Gute
schlaft	schlaft
generalisiert	generalisiert
moppet	moppet
zerbricht	zerbricht
schmusen	schmusen
amenagier	amenagier
beherrschest	beherrschest
Sprachraum	Sprachraum
umbrächte	umbrächte
schläfst	schläfst
funzen	funzen
säet	säet
prophezeie	prophezeie
ermordet	ermordet
fastetet	fastetet
Kühe	Kühe
drücke	drücke
Bildpunkt	Bildpunkt
erinnerest	erinnerest
Temperaturanstieg	Temperaturanstieg
Geliebte	Geliebte
Bäche	Bäche
Bienenstock	Bienenstock
impfte	impfte
Hadithe	Hadithe
Gemeinde	Gemeinde
bekotete	bekotete
rächest	rächest
Palästen	Palästen
Dattel	Dattel
Sehnen	Sehnen
Soll	Soll
Teppichen	Teppichen
faul	faul
Altären	Altären
fahrt	fahrt
gezügelt	gezügelt
versklavt	versklavt
Helme	Helme
Abgaskatalysatoren	Abgaskatalysatoren
Recitativen	Recitativen
Trickbetrüger	Trickbetrüger
Perle	Perle
fragest	fragest
Pflicht	Pflicht
bitten	bitten
dürftet	dürftet
tat	tat
sagtet	sagtet
verrosteten	verrosteten
duzen	duzen
schenke	schenke
moppen	moppen
Jünger	Jünger
neidest	neidest
brechen	brechen
sicherst	sicherst
Ablösung	Ablösung
Arsenbergwerk	Arsenbergwerk
verkürzt	verkürzt
Trinker	Trinker
Galeere	Galeere
Verbindungsdrähten	Verbindungsdrähten
decket	decket
lockerst	lockerst
pflücktet	pflücktet
Futtermittel	Futtermittel
leistete	leistete
sehest	sehest
Türkenbund	Türkenbund
erwache	erwache
pflanze	pflanze
Kacke	Kacke
beleidige	beleidige
Vergrößerungen	Vergrößerungen
reparieret	reparieret
googelest	googelest
bekehrte	bekehrte
initiierten	initiierten
präsentiere	präsentiere
erwärmte	erwärmte
Riese	Riese
kühlen	kühlen
Wehr	Wehr
Blockflöten	Blockflöten
Rußen	Rußen
oxidierst	oxidierst
Sprödmetall	Sprödmetall
gelang	gelang
parametrisierte	parametrisierte
hassest	hassest
Schaffet	Schaffet
scheitern	scheitern
spaltest	spaltest
Schicksen	Schicksen
besprichst	besprichst
Öfchens	Öfchens
haust	haust
betrübest	betrübest
begliche	begliche
Weg	Weg
grübelte	grübelte
Wachen	Wachen
kritzelet	kritzelet
Kürass	Kürass
sabbere	sabbere
pressierten	pressierten
schenkest	schenkest
kaufest	kaufest
Untier	Untier
Garben	Garben
begehrst	begehrst
Mähnenwölfen	Mähnenwölfen
Korrosionsschutz	Korrosionsschutz
Schlössern	Schlössern
verliere	verliere
Teilen	Teilen
braust	braust
versagt	versagt
schiebest	schiebest
Hektaren	Hektaren
jauchzt	jauchzt
tendiertet	tendiertet
Unwahrheiten	Unwahrheiten
Anhängseln	Anhängseln
Feiertagen	Feiertagen
implodier	implodier
Büstenhaltern	Büstenhaltern
erwürgest	erwürgest
schlabberten	schlabberten
ruhe	ruhe
Sauberfrau	Sauberfrau
Sanatoriums	Sanatoriums
Prostylos	Prostylos
Peptids	Peptids
Abnahmen	Abnahmen
Friesen	Friesen
Händedruck	Händedruck
kramen	kramen
repräsentierten	repräsentierten
vernickele	vernickele
Technetaten	Technetaten
Germanist	Germanist
Safrane	Safrane
Apportierhunde	Apportierhunde
gehorchet	gehorchet
Maximierung	Maximierung
Nadelbäumen	Nadelbäumen
beschwören	beschwören
Rotzinkerzen	Rotzinkerzen
Wandergesellen	Wandergesellen
hauen	hauen
plärrt	plärrt
helfest	helfest
Biokraftstoffes	Biokraftstoffes
Zäumen	Zäumen
Blaumeisen	Blaumeisen
ausrufest	ausrufest
Energiespeicher	Energiespeicher
führest	führest
Gepäckträgern	Gepäckträgern
unterwerfe	unterwerfe
Botokuden	Botokuden
Aufsätzen	Aufsätzen
versuchet	versuchet
henken	henken
außen	außen
ölt	ölt
schiesst	schiesst
kommest	kommest
defragmentierten	defragmentierten
bombardiert	bombardiert
ihr	ihr
Für	Für
verprügelet	verprügelet
auflöst	auflöst
sei	sei
Notstand	Notstand
Gedanke	Gedanke
Innenministerien	Innenministerien
Autokraten	Autokraten
Edelsteinen	Edelsteinen
härten	härten
Adenosin	Adenosin
rebelliertet	rebelliertet
Soge	Soge
verformen	verformen
Metonymie	Metonymie
Einöde	Einöde
Träumer	Träumer
Laufring	Laufring
glaubtet	glaubtet
applizirte	applizirte
Vorstädten	Vorstädten
erdachten	erdachten
reifte	reifte
fingiere	fingiere
Samstagnachmittag	Samstagnachmittag
Stechpalmen	Stechpalmen
umgäben	umgäben
Dampfschiffen	Dampfschiffen
vergrabest	vergrabest
Pudern	Pudern
Würzen	Würzen
sitzen	sitzen
glaubest	glaubest
langweiltest	langweiltest
läuten	läuten
Coventrisierungen	Coventrisierungen
pflüget	pflüget
wünscht	wünscht
Benzol	Benzol
zählet	zählet
Somite	Somite
unterbrächen	unterbrächen
erkanntet	erkanntet
Hochsommern	Hochsommern
beliefen	beliefen
stärkte	stärkte
Eilande	Eilande
beneidest	beneidest
gaffest	gaffest
Pianos	Pianos
thematisierten	thematisierten
Zuschauer	Zuschauer
Geckos	Geckos
wurde	wurde
verarbeite	verarbeite
hadere	hadere
überführt	überführt
solch	solch
hegt	hegt
allem	allem
meinst	meinst
Untiefe	Untiefe
Massenanteilen	Massenanteilen
Zahnfleischentzündung	Zahnfleischentzündung
Gesamtmenge	Gesamtmenge
Kerzenlichter	Kerzenlichter
Euphemismen	Euphemismen
Domäne	Domäne
Panamaer	Panamaer
Kaktusfeige	Kaktusfeige
gesagt	gesagt
feiere	feiere
bemühten	bemühten
Kriege	Kriege
Ringeltauben	Ringeltauben
predigten	predigten
Volkslehre	Volkslehre
Schenke	Schenke
Heringen	Heringen
Schwächungen	Schwächungen
verkündet	verkündet
Bombardierung	Bombardierung
regierst	regierst
verjährest	verjährest
Eiszapfens	Eiszapfens
zählte	zählte
Taschenwörterbuch	Taschenwörterbuch
Welteninseln	Welteninseln
verifizierten	verifizierten
erwürgten	erwürgten
ringst	ringst
Geheimdienst	Geheimdienst
fehlet	fehlet
Rückumschlages	Rückumschlages
entwickele	entwickele
harrten	harrten
überdenkend	überdenkend
Sonnenfinsternissen	Sonnenfinsternissen
wechselte	wechselte
vereinigte	vereinigte
besorgest	besorgest
hetzte	hetzte
kickst	kickst
erlassen	erlassen
versuchtet	versuchtet
knüpfet	knüpfet
Kernspaltung	Kernspaltung
klaget	klaget
stimmte	stimmte
Aktenkoffer	Aktenkoffer
Operationssälen	Operationssälen
tragen	tragen
unschuldige	unschuldige
regen	regen
Sabbaten	Sabbaten
wünschen	wünschen
wehte	wehte
Kerfe	Kerfe
Aggressor	Aggressor
erfahrt	erfahrt
Afrikaner	Afrikaner
Hände	Hände
demoralisiere	demoralisiere
buddeln	buddeln
Selbstsicherheit	Selbstsicherheit
gebet	gebet
Epiker	Epiker
verbitterten	verbitterten
Kerl	Kerl
Ölfässern	Ölfässern
ersten	ersten
bröckeln	bröckeln
führst	führst
Strafräume	Strafräume
jappen	jappen
Krankenscheinen	Krankenscheinen
verschärfst	verschärfst
reichet	reichet
beleuchte	beleuchte
gelobe	gelobe
notlandet	notlandet
Homodimere	Homodimere
Chasar	Chasar
Nukleinsäure	Nukleinsäure
deponierte	deponierte
Menschenhandel	Menschenhandel
Zain	Zain
zerstreuten	zerstreuten
alle	alle
räumet	räumet
fünften	fünften
zuhört	zuhört
Eisenkräutern	Eisenkräutern
Pausbacken	Pausbacken
Schobern	Schobern
Päckchens	Päckchens
Erdbirnen	Erdbirnen
ausfuhren	ausfuhren
betrübtet	betrübtet
Senkung	Senkung
Bächen	Bächen
ein	ein
heilte	heilte
gabelst	gabelst
Panzerschreck	Panzerschreck
Paragraphenreiter	Paragraphenreiter
Minischwein	Minischwein
werft	werft
Ruße	Ruße
lohnten	lohnten
funkelet	funkelet
wende	wende
erlaube	erlaube
Zirkelschlüssen	Zirkelschlüssen
Waren	Waren
verzeichne	verzeichne
Theistin	Theistin
punkten	punkten
Beschuldigung	Beschuldigung
pflügte	pflügte
Weh	Weh
weichst	weichst
eiterten	eiterten
wollte	wollte
verunziere	verunziere
Bund	Bund
Otavit	Otavit
Spiralen	Spiralen
bequemest	bequemest
merken	merken
Koniferen	Koniferen
Bilderstürmers	Bilderstürmers
Bluffs	Bluffs
Iberer	Iberer
Landstreicher	Landstreicher
Entsetzet	Entsetzet
letzten	letzten
verkehrten	verkehrten
Linguistinnen	Linguistinnen
Äxte	Äxte
finanziere	finanziere
Mobilfunknetze	Mobilfunknetze
rufen	rufen
kontaktiere	kontaktiere
Gefängnisse	Gefängnisse
Werkzeugen	Werkzeugen
strömte	strömte
Unrecht	Unrecht
vandalieren	vandalieren
misstrauet	misstrauet
hebe	hebe
tagten	tagten
Vesper	Vesper
beförderet	beförderet
Geschichtsbüchern	Geschichtsbüchern
Rumänin	Rumänin
erschrickt	erschrickt
Zähnen	Zähnen
Signalen	Signalen
alarmiere	alarmiere
vertreibt	vertreibt
verkauften	verkauften
brillieret	brillieret
vermöget	vermöget
Zeugnisse	Zeugnisse
hievst	hievst
veranstaltest	veranstaltest
trinken	trinken
schwenkt	schwenkt
Schreiber	Schreiber
Schätzen	Schätzen
Fetzens	Fetzens
verdrängen	verdrängen
Tollkirschen	Tollkirschen
Entsetzt	Entsetzt
Kehret	Kehret
verunreinigst	verunreinigst
verliert	verliert
bleibst	bleibst
Bagger	Bagger
Recitativ	Recitativ
sitzest	sitzest
wichsten	wichsten
verglühte	verglühte
verbaselte	verbaselte
speist	speist
Greyerzer	Greyerzer
Anarchisten	Anarchisten
Leitungsweg	Leitungsweg
Oberbegriff	Oberbegriff
Abfertigungsschalter	Abfertigungsschalter
eng	eng
Wurzelwachstum	Wurzelwachstum
vertagt	vertagt
schwirrt	schwirrt
Technetate	Technetate
vibriere	vibriere
Animation	Animation
ärger	ärger
Aacheners	Aacheners
schmierte	schmierte
Collagen	Collagen
Flitzer	Flitzer
Menschen	Menschen
fünfte	fünfte
straftet	straftet
besprengen	besprengen
zwingst	zwingst
Mutagen	Mutagen
desertiertet	desertiertet
schreiet	schreiet
Wollte	Wollte
glaubt	glaubt
Flenser	Flenser
Jagdhund	Jagdhund
Abartigkeit	Abartigkeit
Cholesterin	Cholesterin
simuliertet	simuliertet
Fingerhüten	Fingerhüten
egalisierten	egalisierten
schwöllen	schwöllen
lautete	lautete
feire	feire
unterbewerte	unterbewerte
Gruftis	Gruftis
lärmte	lärmte
ziehet	ziehet
bollerest	bollerest
Kerzenlichtern	Kerzenlichtern
Weinet	Weinet
verkriechst	verkriechst
eurem	eurem
Lammfellhandschuhen	Lammfellhandschuhen
Kunstgeschichte	Kunstgeschichte
Dudelsack	Dudelsack
lodertet	lodertet
Fingerspitze	Fingerspitze
panaschieren	panaschieren
Gegebenheit	Gegebenheit
Fußbodens	Fußbodens
Mageninhalt	Mageninhalt
beweiset	beweiset
Gaschromatographie	Gaschromatographie
schätzt	schätzt
Kleptokratien	Kleptokratien
Fallt	Fallt
Uranerzen	Uranerzen
versüßtet	versüßtet
Fussel	Fussel
wurden	wurden
Begünstigungen	Begünstigungen
Seetauchers	Seetauchers
Lehne	Lehne
graben	graben
Gymnasien	Gymnasien
wollten	wollten
Barbareien	Barbareien
Aprikose	Aprikose
zeugtest	zeugtest
quasselten	quasselten
recycele	recycele
verbirgt	verbirgt
plissieren	plissieren
unserer	unserer
Mischung	Mischung
Atombombe	Atombombe
Andrologie	Andrologie
partitionierten	partitionierten
bebte	bebte
zürnte	zürnte
verachte	verachte
demütigte	demütigte
folgst	folgst
blockierten	blockierten
fehle	fehle
Tintenklecksen	Tintenklecksen
zerbrechest	zerbrechest
kabbelet	kabbelet
erfüllt	erfüllt
Ehre	Ehre
Silbererzen	Silbererzen
sagst	sagst
verstanden	verstanden
ertraget	ertraget
bedeckt	bedeckt
Fittiche	Fittiche
diese	diese
köderte	köderte
Rhodochrosite	Rhodochrosite
zeugen	zeugen
Tatsachenbeschöniger	Tatsachenbeschöniger
segelte	segelte
verirrt	verirrt
Sorgen	Sorgen
Denunziationen	Denunziationen
assimilierte	assimilierte
preisen	preisen
wetzte	wetzte
Kerf	Kerf
Elektrophil	Elektrophil
spannen	spannen
dekompilierten	dekompilierten
Scherzen	Scherzen
deren	deren
Funkfeuer	Funkfeuer
entdeckst	entdeckst
unterrichten	unterrichten
Königen	Königen
blitzte	blitzte
pflanzest	pflanzest
Efeu	Efeu
jammern	jammern
dich	dich
Wärt	Wärt
sinkest	sinkest
produziert	produziert
Autonomie	Autonomie
Asiatin	Asiatin
Dank	Dank
kurz	kurz
wilde	wilde
ratet	ratet
erpress	erpress
schrecken	schrecken
Hubschrauber	Hubschrauber
werdet	werdet
imkeret	imkeret
Abhänge	Abhänge
füllst	füllst
werde	werde
notlande	notlande
betrübt	betrübt
Laien	Laien
Panzerschrecke	Panzerschrecke
kauerten	kauerten
schlafest	schlafest
Heuhaufen	Heuhaufen
türmt	türmt
bombardiertet	bombardiertet
demütigst	demütigst
Dichten	Dichten
Brieföffners	Brieföffners
Jahre	Jahre
Metapher	Metapher
Quelle	Quelle
stammelest	stammelest
kosten	kosten
lösen	lösen
unser	unser
verklärest	verklärest
revoltiert	revoltiert
querte	querte
löge	löge
malten	malten
Türkenbünden	Türkenbünden
Zäunen	Zäunen
Deckenfarbe	Deckenfarbe
baust	baust
Traggasen	Traggasen
haare	haare
bandagiert	bandagiert
dürft	dürft
Gegebenheiten	Gegebenheiten
reizest	reizest
gehst	gehst
setzet	setzet
Dienstgrad	Dienstgrad
Ärschen	Ärschen
betrübet	betrübet
Weil	Weil
Steigen	Steigen
Wembley-Tore	Wembley-Tore
Jagdhunden	Jagdhunden
lachet	lachet
Uteri	Uteri
reinige	reinige
Europium	Europium
kauten	kauten
watet	watet
Grabbeltisch	Grabbeltisch
ziehst	ziehst
Ehren	Ehren
baue	baue
hickste	hickste
interpretiert	interpretiert
Tausche	Tausche
heile	heile
verglichest	verglichest
filteret	filteret
halben	halben
fressen	fressen
äussern	äussern
schauspieleren	schauspieleren
zerbräche	zerbräche
imkernd	imkernd
Einfältigkeiten	Einfältigkeiten
Übelkeit	Übelkeit
Seiten	Seiten
Streichen	Streichen
zierte	zierte
Meeren	Meeren
verstrahlten	verstrahlten
drückte	drückte
laben	laben
Halogenatom	Halogenatom
eure	eure
überweist	überweist
Hunden	Hunden
protokollieren	protokollieren
Achatschnecken	Achatschnecken
seist	seist
begräbt	begräbt
Verkehrsflugzeug	Verkehrsflugzeug
Graben	Graben
dotiere	dotiere
funktioniertest	funktioniertest
verführt	verführt
mobilisierten	mobilisierten
Löwen	Löwen
fastetest	fastetest
schonte	schonte
Toren	Toren
wehre	wehre
Hinterwäldlern	Hinterwäldlern
widerlegest	widerlegest
Schal	Schal
Maut	Maut
Effekt	Effekt
Bären	Bären
Bilderstürmereien	Bilderstürmereien
Grenzwert	Grenzwert
Aktivist	Aktivist
untersagest	untersagest
Futtermitteln	Futtermitteln
Dachdeckerinnen	Dachdeckerinnen
dürfe	dürfe
Ausländern	Ausländern
löstet	löstet
thematisierte	thematisierte
Wechselstube	Wechselstube
Sonderberichte	Sonderberichte
setzten	setzten
unsre	unsre
Flaschenhälsen	Flaschenhälsen
downloadete	downloadete
Traubenlese	Traubenlese
Version	Version
Frieden	Frieden
Krieg	Krieg
Minimierung	Minimierung
Schaden	Schaden
Schnipsel	Schnipsel
bereue	bereue
Anwendungsgebiet	Anwendungsgebiet
Gerichten	Gerichten
Karern	Karern
Raben	Raben
beziehen	beziehen
Hardwareentwicklerin	Hardwareentwicklerin
weinet	weinet
weisen	weisen
hastete	hastete
Enthärtungen	Enthärtungen
glänzen	glänzen
ehe	ehe
Biokraftstoff	Biokraftstoff
posiert	posiert
negierest	negierest
Wogen	Wogen
lesen	lesen
häufen	häufen
Warte	Warte
glänzten	glänzten
bestimmst	bestimmst
Oheim	Oheim
Drang	Drang
rittest	rittest
Referenzen	Referenzen
erwürgtest	erwürgtest
Helden	Helden
Kompass	Kompass
manchen	manchen
harmoniere	harmoniere
Buch	Buch
glawbte	glawbte
schenken	schenken
Äthern	Äthern
benähmen	benähmen
explodierten	explodierten
beseht	beseht
reanimierten	reanimierten
Abschreckungen	Abschreckungen
Wände	Wände
greinet	greinet
Plüschtier	Plüschtier
Trinken	Trinken
grünt	grünt
Zehnt	Zehnt
Hansen	Hansen
punkteten	punkteten
Abschirmungen	Abschirmungen
jaulst	jaulst
Rechten	Rechten
Bist	Bist
Sekte	Sekte
zeugt	zeugt
tyrannisiertest	tyrannisiertest
Brüdern	Brüdern
lös	lös
anzeige	anzeige
umkämen	umkämen
erliegst	erliegst
verwechselet	verwechselet
Taufe	Taufe
Königreiche	Königreiche
merke	merke
Außenministerium	Außenministerium
auflegt	auflegt
auflegte	auflegte
Fetzen	Fetzen
Esset	Esset
lispelten	lispelten
Kleinode	Kleinode
kritzeln	kritzeln
Haltepunkt	Haltepunkt
löstest	löstest
scheitertet	scheitertet
Lehrbücher	Lehrbücher
Wiederauferstehung	Wiederauferstehung
Gästen	Gästen
bewässertet	bewässertet
Macht	Macht
jene	jene
Chlorats	Chlorats
Geschwindigkeitsmesser	Geschwindigkeitsmesser
Raucherinnen	Raucherinnen
sprechet	sprechet
Gefangene	Gefangene
vernichtete	vernichtete
Eiszapfen	Eiszapfen
verlaß	verlaß
weisest	weisest
zwölften	zwölften
knurrt	knurrt
dampfst	dampfst
Machet	Machet
Hallen	Hallen
strafst	strafst
Oberlandesgericht	Oberlandesgericht
regeln	regeln
Volltreffer	Volltreffer
Breiten	Breiten
Sage	Sage
verwirklicht	verwirklicht
haltest	haltest
gedachte	gedachte
suche	suche
Eure	Eure
Deutung	Deutung
verwirrest	verwirrest
emigrieret	emigrieret
touchiere	touchiere
Polierstahl	Polierstahl
unserem	unserem
Sprechers	Sprechers
wünsche	wünsche
hättest	hättest
mikrominiaturisierten	mikrominiaturisierten
mißversteht	mißversteht
eingeht	eingeht
stapele	stapele
Schönredner	Schönredner
Armen	Armen
reiche	reiche
verfängt	verfängt
schwirret	schwirret
Bürzeln	Bürzeln
kaufe	kaufe
Rekursion	Rekursion
freuet	freuet
Alle	Alle
seinem	seinem
imitiert	imitiert
Pfandgeld	Pfandgeld
bespracht	bespracht
Mitwisserschaft	Mitwisserschaft
raten	raten
bleibet	bleibet
missverstände	missverstände
steuerst	steuerst
nahest	nahest
heiligest	heiligest
versteigerest	versteigerest
neigte	neigte
Sitzfleisches	Sitzfleisches
berühret	berühret
stammeln	stammeln
klingest	klingest
Amnestie	Amnestie
Ärzteblättern	Ärzteblättern
Prüfberichten	Prüfberichten
nähet	nähet
setze	setze
ermächtigest	ermächtigest
Abfertigungsschalters	Abfertigungsschalters
Zapfen	Zapfen
folgen	folgen
Erstarren	Erstarren
Arme	Arme
wechselwirkte	wechselwirkte
versuchte	versuchte
kaufte	kaufte
bestimmten	bestimmten
Tiefschutz	Tiefschutz
Weinberge	Weinberge
Klassenzimmer	Klassenzimmer
reizen	reizen
Bundesgebieten	Bundesgebieten
Wachet	Wachet
ritzten	ritzten
Nehmet	Nehmet
Hertz	Hertz
Buchstaben	Buchstaben
erziehst	erziehst
Messiassen	Messiassen
Erfahrung	Erfahrung
verdammst	verdammst
bückest	bückest
überschnitten	überschnitten
Erzherzogshüte	Erzherzogshüte
rebelliere	rebelliere
Fettsäcken	Fettsäcken
eigene	eigene
nötig	nötig
Fermium	Fermium
schämet	schämet
Katalanen	Katalanen
Alkine	Alkine
nahe	nahe
Ochs	Ochs
Orte	Orte
Freibergit	Freibergit
Pflanzung	Pflanzung
eggte	eggte
möchten	möchten
Überschüssen	Überschüssen
verbüßest	verbüßest
forschen	forschen
entgehst	entgehst
Körpergeruch	Körpergeruch
erfahrest	erfahrest
schießt	schießt
lebst	lebst
Apostel	Apostel
fallet	fallet
gewitterest	gewitterest
Meinst	Meinst
Gläubige	Gläubige
ermächtige	ermächtige
Pfleglinge	Pfleglinge
Massenanteil	Massenanteil
fassest	fassest
Buntspechten	Buntspechten
Braunralle	Braunralle
Aggressoren	Aggressoren
überfällst	überfällst
Beschleuniger	Beschleuniger
Fallturm	Fallturm
Halte	Halte
Irrtumes	Irrtumes
Schwärmereien	Schwärmereien
plagen	plagen
massierend	massierend
Bleigehalt	Bleigehalt
Jahr	Jahr
Playlist	Playlist
haltet	haltet
Fallen	Fallen
säusele	säusele
Röcke	Röcke
grien	grien
achten	achten
Alten	Alten
kreieren	kreieren
versteckend	versteckend
scheinet	scheinet
heilige	heilige
entzweit	entzweit
predigend	predigend
dringest	dringest
verführtest	verführtest
verbrauchte	verbrauchte
Polizeisprechern	Polizeisprechern
erhebest	erhebest
narret	narret
Schiffe	Schiffe
erstarre	erstarre
verbündest	verbündest
injizierest	injizierest
verfehlten	verfehlten
verkapselt	verkapselt
fluppst	fluppst
substituierend	substituierend
Mauten	Mauten
Urheimaten	Urheimaten
Republikflucht	Republikflucht
Solcher	Solcher
Politologe	Politologe
Streiten	Streiten
Gerichte	Gerichte
blitz	blitz
Antimustern	Antimustern
emittierte	emittierte
Grießen	Grießen
stiftest	stiftest
Anzeichen	Anzeichen
einigst	einigst
Türmen	Türmen
Sprödmetallen	Sprödmetallen
kriegen	kriegen
funktionierte	funktionierte
Judenrat	Judenrat
gute	gute
fabulierte	fabulierte
liebest	liebest
Genetikerin	Genetikerin
Preisanstiegen	Preisanstiegen
abalieniertest	abalieniertest
gedächten	gedächten
referenziere	referenziere
zeuge	zeuge
ducktest	ducktest
hilfst	hilfst
Hälse	Hälse
steigen	steigen
Rechenbrettern	Rechenbrettern
UND-Gatter	UND-Gatter
umkäme	umkäme
Dominicanerinnen	Dominicanerinnen
halbierte	halbierte
holte	holte
grabe	grabe
heftetest	heftetest
Hummer	Hummer
Schläge	Schläge
erzürnt	erzürnt
Chlorwasserstoffmolekül	Chlorwasserstoffmolekül
Schilde	Schilde
foppte	foppte
würde	würde
keiner	keiner
tätowiertet	tätowiertet
Oxalaten	Oxalaten
halle	halle
verabschiedetet	verabschiedetet
Denkmünze	Denkmünze
schlängelest	schlängelest
Prophet	Prophet
willen	willen
linken	linken
Fortsetzungen	Fortsetzungen
Philerast	Philerast
leer	leer
besitzet	besitzet
Kohlenstoffgehalten	Kohlenstoffgehalten
fraget	fraget
verlasset	verlasset
hatte	hatte
Präservativs	Präservativs
Zöpfen	Zöpfen
erscheine	erscheine
Membran	Membran
Reiseleiter	Reiseleiter
besichtiget	besichtiget
fokussieret	fokussieret
Kalb	Kalb
anderen	anderen
überfallen	überfallen
speiste	speiste
soll	soll
steigest	steigest
Hochzeitstorten	Hochzeitstorten
Feierabend	Feierabend
gibt	gibt
zeiget	zeiget
betonierte	betonierte
Glauben	Glauben
trinket	trinket
Verwaltungsakten	Verwaltungsakten
Briefen	Briefen
vermagst	vermagst
Gebäcken	Gebäcken
aufstanden	aufstanden
Brotkästen	Brotkästen
Kirgisin	Kirgisin
Seehechte	Seehechte
negierte	negierte
zuteil	zuteil
folgte	folgte
Trickbetrügern	Trickbetrügern
räucheret	räucheret
verlobte	verlobte
Katamarane	Katamarane
pendele	pendele
Kompassen	Kompassen
Füchsen	Füchsen
schaute	schaute
scheute	scheute
Hochsommer	Hochsommer
Halleluja	Halleluja
strafend	strafend
Hat	Hat
gepuddelt	gepuddelt
entwendet	entwendet
Fluorgehalt	Fluorgehalt
Sprüchen	Sprüchen
Ludwigsburger	Ludwigsburger
bezichtigten	bezichtigten
verbasele	verbasele
Adventskalender	Adventskalender
zeugte	zeugte
mogelest	mogelest
Nanosatellit	Nanosatellit
bollerte	bollerte
verbirgst	verbirgst
wollt	wollt
gewinnen	gewinnen
wurstelten	wurstelten
hegst	hegst
Leitungswegs	Leitungswegs
Tiefen	Tiefen
Sollten	Sollten
Küstenwachen	Küstenwachen
wild	wild
Provinz	Provinz
bemüht	bemüht
fabuliert	fabuliert
Asthenosphäre	Asthenosphäre
messet	messet
Deinem	Deinem
spurtest	spurtest
beansprucht	beansprucht
Adeliepinguins	Adeliepinguins
Einrädern	Einrädern
steinigst	steinigst
Dudelsäcken	Dudelsäcken
Solche	Solche
ortete	ortete
Kriegsschauplatz	Kriegsschauplatz
näht	näht
funktionalisierte	funktionalisierte
Landwirte	Landwirte
Tische	Tische
erstürmet	erstürmet
Arbeitsbereich	Arbeitsbereich
regelet	regelet
Fremden	Fremden
abzieht	abzieht
Tieren	Tieren
stirbt	stirbt
befestigt	befestigt
Wache	Wache
Zirkelschluss	Zirkelschluss
blamierte	blamierte
Halogenatomen	Halogenatomen
fallt	fallt
erzwinget	erzwinget
Bube	Bube
erschüttere	erschüttere
gewöhnt	gewöhnt
Aktienkursen	Aktienkursen
schäumt	schäumt
überweiset	überweiset
velarisiert	velarisiert
Anschläge	Anschläge
zerfielest	zerfielest
Decken	Decken
Fluorgehalte	Fluorgehalte
grausten	grausten
Atomphysiker	Atomphysiker
Polyphosphat	Polyphosphat
substituierest	substituierest
ungehorsame	ungehorsame
Monden	Monden
Kopfverletzungen	Kopfverletzungen
gebäre	gebäre
nächsten	nächsten
gelobst	gelobst
befestigte	befestigte
geherrscht	geherrscht
Reichweite	Reichweite
Gewinnungen	Gewinnungen
schießen	schießen
leiden	leiden
Lob	Lob
scheuchten	scheuchten
Habt	Habt
Aha-Erlebnisse	Aha-Erlebnisse
Tiefe	Tiefe
Dans	Dans
Gänge	Gänge
wehret	wehret
Färsen	Färsen
Fluoratomen	Fluoratomen
lege	lege
Verwaltungsakte	Verwaltungsakte
Falz	Falz
steinigte	steinigte
Marokkaners	Marokkaners
bummeltet	bummeltet
Einfältigkeit	Einfältigkeit
Fröschen	Fröschen
Klotz	Klotz
ringelten	ringelten
verwirren	verwirren
glaubend	glaubend
prophezeiet	prophezeiet
massakrierte	massakrierte
Diamantringen	Diamantringen
Skorpionen	Skorpionen
vertäte	vertäte
Fluoratom	Fluoratom
boykottierten	boykottierten
abziehen	abziehen
Freunde	Freunde
Atommassen	Atommassen
rauben	rauben
Ächselchen	Ächselchen
gelobest	gelobest
heulet	heulet
entheilige	entheilige
watete	watete
begründetest	begründetest
Pläsieren	Pläsieren
Kreise	Kreise
lauf	lauf
motivierten	motivierten
Organistin	Organistin
Alibis	Alibis
Loparite	Loparite
Mäuse	Mäuse
Spanne	Spanne
Tyrann	Tyrann
reinstitutionalisiert	reinstitutionalisiert
Alkali	Alkali
Aufprall	Aufprall
Atemluft	Atemluft
erwachte	erwachte
Ölspuren	Ölspuren
punktetest	punktetest
Zur-Schau-Stellen	Zur-Schau-Stellen
emaillieret	emaillieret
posierst	posierst
Elementarzellen	Elementarzellen
tyrannisierte	tyrannisierte
Trägergas	Trägergas
pharyngalisierten	pharyngalisierten
Fadenlauf	Fadenlauf
schummelten	schummelten
Fett	Fett
bedrückest	bedrückest
unschuldigen	unschuldigen
jedes	jedes
schaffst	schaffst
Pfahl	Pfahl
hieltet	hieltet
predigtest	predigtest
Silbererze	Silbererze
Bildpunkten	Bildpunkten
Stearat	Stearat
taufte	taufte
fremden	fremden
Stolz	Stolz
Weinbergen	Weinbergen
Unternehmung	Unternehmung
Schaffnerinnen	Schaffnerinnen
Nigger	Nigger
fotzt	fotzt
Verkehrsflugzeuge	Verkehrsflugzeuge
Organisationen	Organisationen
reizet	reizet
nehmet	nehmet
Mikrometer	Mikrometer
erliegest	erliegest
begebe	begebe
hantiert	hantiert
Scheißkerl	Scheißkerl
gelobt	gelobt
assimiliertest	assimiliertest
beißet	beißet
Rutheniumkomplex	Rutheniumkomplex
Trinkgefäße	Trinkgefäße
flirtest	flirtest
hievten	hievten
Hadith	Hadith
Telefonnummer	Telefonnummer
herrschten	herrschten
bestrafe	bestrafe
aufrichtest	aufrichtest
laufet	laufet
Geschwindigkeitsmessern	Geschwindigkeitsmessern
Abtrünnigen	Abtrünnigen
globalisieret	globalisieret
Saget	Saget
pressiere	pressiere
Rotzinkerz	Rotzinkerz
suchst	suchst
Sündern	Sündern
Kompromissen	Kompromissen
Lebenskräften	Lebenskräften
verblutete	verblutete
fabulierest	fabulierest
decke	decke
Serverzugriffen	Serverzugriffen
ersparen	ersparen
Überweisung	Überweisung
jede	jede
verzehrst	verzehrst
Setzet	Setzet
bang	bang
verfanget	verfanget
Gebirgen	Gebirgen
tappten	tappten
Fiasko	Fiasko
Setzt	Setzt
Saiblinge	Saiblinge
folterte	folterte
Barschaften	Barschaften
pflanzte	pflanzte
verbaseln	verbaseln
Letzten	Letzten
Hörspiel	Hörspiel
föchte	föchte
fladerten	fladerten
Fanmeile	Fanmeile
Pentaboraten	Pentaboraten
Planer	Planer
anrührte	anrührte
behütet	behütet
vermeßest	vermeßest
absolviertet	absolviertet
Münzsammlungen	Münzsammlungen
verreisest	verreisest
rauschen	rauschen
tattert	tattert
verboten	verboten
Protonen	Protonen
speisend	speisend
zupftet	zupftet
schmuste	schmuste
Gasflasche	Gasflasche
wachse	wachse
diskutierst	diskutierst
duzet	duzet
verschlingt	verschlingt
Baiser	Baiser
blondieren	blondieren
posiertet	posiertet
Sollst	Sollst
entwaffneten	entwaffneten
Kommet	Kommet
erwärmst	erwärmst
Scherzes	Scherzes
letzte	letzte
verkleinerest	verkleinerest
verbrauchten	verbrauchten
Anfänger	Anfänger
sortierest	sortierest
durfte	durfte
Schlägen	Schlägen
missversteht	missversteht
Höfe	Höfe
Kassiteriten	Kassiteriten
schauspielert	schauspielert
bereitete	bereitete
Wasserquelle	Wasserquelle
schlabberte	schlabberte
bedürftet	bedürftet
malochet	malochet
innere	innere
strafte	strafte
schlachtet	schlachtet
rüstetet	rüstetet
ernte	ernte
schnappt	schnappt
beben	beben
Ha	Ha
Fremdwort	Fremdwort
Zerfall	Zerfall
spielen	spielen
fallest	fallest
zuppte	zuppte
Held	Held
redetest	redetest
verschickte	verschickte
werden	werden
ältesten	ältesten
herrschest	herrschest
verließet	verließet
blasen	blasen
erscheinest	erscheinest
Eingaben	Eingaben
Geboten	Geboten
pulsiert	pulsiert
Hast	Hast
beanspruchest	beanspruchest
fülle	fülle
bedenken	bedenken
Bleiglanz	Bleiglanz
Neumonden	Neumonden
Introjektion	Introjektion
bewahrst	bewahrst
Druckfehlern	Druckfehlern
Zapfhähnen	Zapfhähnen
berücksichtiget	berücksichtiget
bedeckst	bedeckst
Pinguin	Pinguin
Schaffnerin	Schaffnerin
Tausch	Tausch
Nehmt	Nehmt
rufet	rufet
charakterisierend	charakterisierend
Welchen	Welchen
verhören	verhören
Badezimmers	Badezimmers
werte	werte
bestellten	bestellten
folgend	folgend
Beteiligte	Beteiligte
Donoren	Donoren
ermutigt	ermutigt
streue	streue
schluchzte	schluchzte
Haarshampoos	Haarshampoos
Gedächtnissen	Gedächtnissen
Taschendieb	Taschendieb
knistern	knistern
Pis	Pis
verstecken	verstecken
prostituierte	prostituierte
reifen	reifen
Zirkelbeweis	Zirkelbeweis
Kakao	Kakao
saht	saht
zentrifugieren	zentrifugieren
Streife	Streife
zerbrichst	zerbrichst
stapfst	stapfst
Schlangen	Schlangen
Ärzte	Ärzte
belauere	belauere
Rechte	Rechte
sterilisierten	sterilisierten
Zapfhahn	Zapfhahn
elften	elften
wären	wären
kaufst	kaufst
konnotieret	konnotieret
faltest	faltest
flenstet	flenstet
umgaben	umgaben
hingehst	hingehst
saget	saget
Diese	Diese
idealisieret	idealisieret
Stadtbezirken	Stadtbezirken
kram	kram
verschlimmere	verschlimmere
entsetzt	entsetzt
erbauet	erbauet
Laubbläser	Laubbläser
dirigiert	dirigiert
schwächend	schwächend
besichtigt	besichtigt
erforschest	erforschest
bebet	bebet
verschonet	verschonet
Prostyloi	Prostyloi
Ring	Ring
Borhydrid	Borhydrid
käbbelnd	käbbelnd
dümpelte	dümpelte
Wasserbades	Wasserbades
Mönche	Mönche
fladern	fladern
generalisiere	generalisiere
Pfeile	Pfeile
stellte	stellte
Gesamtmengen	Gesamtmengen
schweiget	schweiget
gedenke	gedenke
heparinisiere	heparinisiere
Felsboden	Felsboden
werten	werten
Tübinger	Tübinger
mineralisierten	mineralisierten
babbelten	babbelten
verwirkliche	verwirkliche
lang	lang
Freitagnachmittage	Freitagnachmittage
mühe	mühe
bilden	bilden
sagest	sagest
reinstitutionalisierten	reinstitutionalisierten
kommst	kommst
Trübsale	Trübsale
Huren	Huren
vergrubt	vergrubt
Laubbläsern	Laubbläsern
beherrscht	beherrscht
Männlein	Männlein
Willst	Willst
Cola	Cola
enttäusche	enttäusche
denaturierten	denaturierten
wünschte	wünschte
emailliert	emailliert
Schreibtischtätern	Schreibtischtätern
installierten	installierten
Spitze	Spitze
erkundigte	erkundigte
abtrünnigen	abtrünnigen
Gläubiger	Gläubiger
Bluff	Bluff
tage	tage
fluppen	fluppen
begrabet	begrabet
beeinflusst	beeinflusst
bekehrt	bekehrt
Monarchie	Monarchie
Pedant	Pedant
Nanotesla	Nanotesla
blamierten	blamierten
liehe	liehe
motivieren	motivieren
diskutiere	diskutiere
speisest	speisest
begebet	begebet
glänzt	glänzt
Einöden	Einöden
Trinket	Trinket
Deutungen	Deutungen
substituieren	substituieren
jeder	jeder
Rotgusses	Rotgusses
Ratsherr	Ratsherr
Finanzministern	Finanzministern
Kommst	Kommst
Hie	Hie
Alibi	Alibi
Stäben	Stäben
gedenken	gedenken
mästet	mästet
Ratsherren	Ratsherren
ernten	ernten
beunruhigte	beunruhigte
verkehrte	verkehrte
Wahnen	Wahnen
jedem	jedem
besprenget	besprenget
mußt	mußt
betätigest	betätigest
Anker	Anker
Beschuldigungen	Beschuldigungen
folge	folge
meines	meines
schlaget	schlaget
geraten	geraten
weine	weine
prangest	prangest
Mäusen	Mäusen
unsres	unsres
erklinge	erklinge
Grieße	Grieße
Elle	Elle
höbet	höbet
aller	aller
Komplexionen	Komplexionen
irre	irre
Stämmen	Stämmen
klingt	klingt
gönnest	gönnest
obfuskieren	obfuskieren
verblute	verblute
scherzt	scherzt
Kälber	Kälber
plärrtest	plärrtest
baggerte	baggerte
Wandergewerbe	Wandergewerbe
Gehorcht	Gehorcht
betrübst	betrübst
Gaunern	Gaunern
grünest	grünest
Isobar	Isobar
widmet	widmet
Geflecktheiten	Geflecktheiten
überweis	überweis
Hallelujas	Hallelujas
strecken	strecken
verladet	verladet
Drillingen	Drillingen
Zehen	Zehen
zweifeln	zweifeln
Lehrkörpers	Lehrkörpers
erlaubest	erlaubest
urbanisiert	urbanisiert
Robe	Robe
kristallisierest	kristallisierest
Fußballweltmeisterschaftsqualifikationsspiel	Fußballweltmeisterschaftsqualifikationsspiel
offenbare	offenbare
Füßen	Füßen
Petersfischen	Petersfischen
keinen	keinen
Jungen	Jungen
Pfunde	Pfunde
Coventrisierung	Coventrisierung
kapiertet	kapiertet
Geschreis	Geschreis
zähle	zähle
Jagdbomber	Jagdbomber
liege	liege
ihre	ihre
Nadel	Nadel
schließe	schließe
Rheumatismus	Rheumatismus
Quellen	Quellen
Gehorsams	Gehorsams
Wäre	Wäre
solle	solle
griffen	griffen
höbe	höbe
sorgte	sorgte
Trotzkisten	Trotzkisten
observiertest	observiertest
Kindergeld	Kindergeld
Kindergeldern	Kindergeldern
Hummel	Hummel
grabble	grabble
verbluten	verbluten
beschotterten	beschotterten
Genkinits	Genkinits
schäumtest	schäumtest
Saiblingen	Saiblingen
Gängen	Gängen
deaktiviere	deaktiviere
hicksest	hicksest
bündelet	bündelet
Stätten	Stätten
Elektronenschale	Elektronenschale
Scheißkerlen	Scheißkerlen
Trübsal	Trübsal
grünen	grünen
erstände	erstände
Frösche	Frösche
zerrüttete	zerrüttete
Wegen	Wegen
schwangt	schwangt
arbeit	arbeit
Autoklav	Autoklav
Zunge	Zunge
infizieret	infizieret
fälle	fälle
Abbildern	Abbildern
Jochen	Jochen
Füllfeder	Füllfeder
Argyroditen	Argyroditen
zähltet	zähltet
Trichter	Trichter
Halbzeiten	Halbzeiten
ritt	ritt
Seelöwen	Seelöwen
reinigst	reinigst
Vetter	Vetter
Waldbränden	Waldbränden
Kristallen	Kristallen
wenden	wenden
verdunsten	verdunsten
babbelt	babbelt
Atmosphäre	Atmosphäre
beschottre	beschottre
Arresten	Arresten
absagt	absagt
fegte	fegte
Sprachräumen	Sprachräumen
bist	bist
flambierten	flambierten
stillest	stillest
WebHook	WebHook
spekuliere	spekuliere
hinterzöge	hinterzöge
hüte	hüte
verstörten	verstörten
verletzte	verletzte
diversifiziere	diversifiziere
Thioester	Thioester
brauste	brauste
Berichterstattungen	Berichterstattungen
Aderhaut	Aderhaut
steckte	steckte
reglementierte	reglementierte
Lüste	Lüste
Traubenlesen	Traubenlesen
sedimentiere	sedimentiere
predig	predig
setzest	setzest
murmeln	murmeln
amenagiere	amenagiere
Backpflaumen	Backpflaumen
trinkst	trinkst
Wiederbelebung	Wiederbelebung
Küstenwache	Küstenwache
fällt	fällt
Schätze	Schätze
Gefäßen	Gefäßen
Schreiet	Schreiet
Noseans	Noseans
regelten	regelten
Agoraphobien	Agoraphobien
bündelten	bündelten
Altäre	Altäre
pflegst	pflegst
wachset	wachset
Schwänzen	Schwänzen
Herabsetzung	Herabsetzung
Hirnstämmen	Hirnstämmen
Kaliumdichromat	Kaliumdichromat
aktualisiere	aktualisiere
Flussbetten	Flussbetten
imitiertet	imitiertet
grüßt	grüßt
Sagte	Sagte
Wühltische	Wühltische
weissagst	weissagst
Besuchen	Besuchen
verbraucht	verbraucht
versklavte	versklavte
dechiffrierend	dechiffrierend
Fischotters	Fischotters
Metaphern	Metaphern
auflöste	auflöste
Mopp	Mopp
Urologe	Urologe
kehre	kehre
konjugiere	konjugiere
posierten	posierten
Schneepflüge	Schneepflüge
schnorrest	schnorrest
Bruchstriches	Bruchstriches
verzieh	verzieh
enttäuschtest	enttäuschtest
regieret	regieret
Seetaucher	Seetaucher
Ichs	Ichs
streite	streite
Leichtmetallen	Leichtmetallen
Kavalier	Kavalier
Knechten	Knechten
Mäusespeck	Mäusespeck
Ältesten	Ältesten
bedient	bedient
Willen	Willen
Mittelaltermarkt	Mittelaltermarkt
begrabest	begrabest
jeden	jeden
urteilen	urteilen
lobte	lobte
hydrolysierend	hydrolysierend
ballaste	ballaste
zügelten	zügelten
käbbelte	käbbelte
Regenwald	Regenwald
Argentits	Argentits
Aspartamen	Aspartamen
Martyrologium	Martyrologium
Irrtümern	Irrtümern
Reinstoff	Reinstoff
gedacht	gedacht
abalienierest	abalienierest
Bertrandit	Bertrandit
Adelung	Adelung
beleidigst	beleidigst
entmineralisieren	entmineralisieren
laden	laden
fügt	fügt
verfange	verfange
Falle	Falle
föhnest	föhnest
dritte	dritte
Höschen	Höschen
Welche	Welche
verdränge	verdränge
Ankern	Ankern
Angaben	Angaben
Gebäck	Gebäck
Bergsteiger	Bergsteiger
zerfielen	zerfielen
ziehest	ziehest
höret	höret
Vogelscheuchen	Vogelscheuchen
Mammut	Mammut
Hirt	Hirt
appellierst	appellierst
Anspielungen	Anspielungen
tief	tief
Vollkornbrot	Vollkornbrot
Steige	Steige
pflücke	pflücke
Weihe	Weihe
betrete	betrete
Hure	Hure
überdenkst	überdenkst
zirpen	zirpen
erobern	erobern
sezierte	sezierte
zeigst	zeigst
Aromastoffen	Aromastoffen
sorgen	sorgen
träumte	träumte
Freizeitzentrum	Freizeitzentrum
Ängsten	Ängsten
naschten	naschten
Gleitzeit	Gleitzeit
Normdaten	Normdaten
Brikette	Brikette
Dorsche	Dorsche
Schreien	Schreien
Sinnen	Sinnen
Hode	Hode
Leichname	Leichname
Werte	Werte
verwahret	verwahret
Leid	Leid
parfümierst	parfümierst
Bedenken	Bedenken
Azubi	Azubi
kürze	kürze
sehnte	sehnte
Taschendiebe	Taschendiebe
Empörung	Empörung
vergliche	vergliche
Treibhausgasen	Treibhausgasen
Knöllchens	Knöllchens
Mageninhalten	Mageninhalten
strecke	strecke
Deuterium	Deuterium
Buche	Buche
drillte	drillte
defragmentierest	defragmentierest
macht	macht
Lesen	Lesen
evaluierten	evaluierten
Urbaren	Urbaren
fragte	fragte
Grieche	Grieche
unterwerfest	unterwerfest
Kriegsschauplätze	Kriegsschauplätze
Pater	Pater
säume	säume
Kakadu	Kakadu
oxidierte	oxidierte
Fettes	Fettes
halte	halte
denaturiert	denaturiert
wohnet	wohnet
zählend	zählend
Fußmatte	Fußmatte
Sizilianer	Sizilianer
legest	legest
Charakteristika	Charakteristika
Maßen	Maßen
verunglimpftet	verunglimpftet
Herbstwinden	Herbstwinden
Weinstöcke	Weinstöcke
hüten	hüten
haschiert	haschiert
Orten	Orten
bemerken	bemerken
Schwänze	Schwänze
Kosten	Kosten
verdammten	verdammten
hydrogentartrat	hydrogentartrat
lochten	lochten
Löwe	Löwe
deponiere	deponiere
dringt	dringt
Klärung	Klärung
Juden	Juden
schlage	schlage
Tischen	Tischen
Pflaume	Pflaume
heftete	heftete
hure	hure
Bette	Bette
entgehe	entgehe
Ochse	Ochse
berücksichtigt	berücksichtigt
gehorcht	gehorcht
hingeht	hingeht
Entmachtung	Entmachtung
Pfarrerinnen	Pfarrerinnen
lispelt	lispelt
Fischotter	Fischotter
benehme	benehme
Dein	Dein
Abflug	Abflug
Anhang	Anhang
Arsenbergwerken	Arsenbergwerken
stimme	stimme
Fieberanfall	Fieberanfall
Decks	Decks
meine	meine
Ösophagospasmen	Ösophagospasmen
beschotteret	beschotteret
Teufel	Teufel
widerstand	widerstand
verdammt	verdammt
überquerst	überquerst
Käsereiben	Käsereiben
Blattgewebe	Blattgewebe
Abnahme	Abnahme
Malaysiers	Malaysiers
Empörungen	Empörungen
erpresst	erpresst
solchem	solchem
Rechnungen	Rechnungen
erbaust	erbaust
fromme	fromme
Käsereibe	Käsereibe
hänge	hänge
spracht	spracht
Stiefvater	Stiefvater
harrtest	harrtest
schnell	schnell
gebären	gebären
Peptid	Peptid
rodete	rodete
möchte	möchte
fritiert	fritiert
geleitet	geleitet
Amputierten	Amputierten
quietschest	quietschest
geboten	geboten
sorge	sorge
Ärzten	Ärzten
Konfitüre	Konfitüre
Würfelspiel	Würfelspiel
kürzest	kürzest
essen	essen
rebellieret	rebellieret
Leugnungen	Leugnungen
feiert	feiert
Rechnung	Rechnung
Sogen	Sogen
Flammen	Flammen
Achseln	Achseln
ob	ob
besitzest	besitzest
verkürze	verkürze
begrubt	begrubt
auszöge	auszöge
bummelet	bummelet
kichert	kichert
möget	möget
deaktivierst	deaktivierst
verbrauchet	verbrauchet
ferne	ferne
kristallisiertest	kristallisiertest
grüntet	grüntet
hilft	hilft
schöpfte	schöpfte
Sexte	Sexte
Ambiguitäten	Ambiguitäten
Fahlflanken-Ameisenwürgern	Fahlflanken-Ameisenwürgern
Enden	Enden
schaust	schaust
Plüschtiere	Plüschtiere
Drache	Drache
Zubrötchen	Zubrötchen
Heteroatom	Heteroatom
feierst	feierst
Laufet	Laufet
Untern	Untern
schämte	schämte
Bleiglanzes	Bleiglanzes
schleim	schleim
Loben	Loben
Epidemie	Epidemie
Druckfehler	Druckfehler
verwechselst	verwechselst
gehorchte	gehorchte
kennst	kennst
Harpune	Harpune
umarbeitest	umarbeitest
murmelte	murmelte
Fußballweltmeisterschaftsqualifikationsspielen	Fußballweltmeisterschaftsqualifikationsspielen
Backenbärten	Backenbärten
trägst	trägst
schreckt	schreckt
Steiget	Steiget
plumpsten	plumpsten
Räten	Räten
wallte	wallte
Anachronismus	Anachronismus
klagte	klagte
sterbet	sterbet
stelle	stelle
hell	hell
alarmieren	alarmieren
hasse	hasse
durchzuck	durchzuck
Schneepflügen	Schneepflügen
kabelten	kabelten
Wehklage	Wehklage
gewärtigt	gewärtigt
offenbarest	offenbarest
Piratensendern	Piratensendern
stigmatisierest	stigmatisierest
Floß	Floß
verschaffte	verschaffte
Weinstöcken	Weinstöcken
Abfertigungsgebäuden	Abfertigungsgebäuden
Totgeburten	Totgeburten
Gasflaschen	Gasflaschen
essest	essest
Metallothionein	Metallothionein
applizirst	applizirst
verständige	verständige
christianisiere	christianisiere
fließen	fließen
ausrufen	ausrufen
Briketten	Briketten
endlagern	endlagern
verselbstständigest	verselbstständigest
grünend	grünend
klemmen	klemmen
Halbzeit	Halbzeit
schauen	schauen
verkaufte	verkaufte
torpediert	torpediert
Rufet	Rufet
brauchst	brauchst
Gemütes	Gemütes
Akkadierinnen	Akkadierinnen
versteckt	versteckt
lieb	lieb
stürze	stürze
bequemen	bequemen
schreien	schreien
tanze	tanze
verführen	verführen
Langschwanzpinguin	Langschwanzpinguin
ach	ach
rote	rote
schmuggelte	schmuggelte
kreierten	kreierten
kritzele	kritzele
Busen	Busen
rekonstruieren	rekonstruieren
gereichte	gereichte
pfänden	pfänden
wachte	wachte
Suche	Suche
regierten	regierten
erstürmt	erstürmt
bestraft	bestraft
Gelobt	Gelobt
puste	puste
Hobbys	Hobbys
eskalieret	eskalieret
Membranen	Membranen
pulsiere	pulsiere
schäme	schäme
verdrehet	verdrehet
Regieren	Regieren
gelangt	gelangt
ringele	ringele
pflanzet	pflanzet
Kassettenrekorder	Kassettenrekorder
seufzt	seufzt
Amtsträger	Amtsträger
laute	laute
bewährt	bewährt
Türklingel	Türklingel
erwachend	erwachend
Nullpunkt	Nullpunkt
chloroformieret	chloroformieret
verführte	verführte
verzögerte	verzögerte
sterilisierte	sterilisierte
lügst	lügst
unterdrückte	unterdrückte
aufsteht	aufsteht
ausgeht	ausgeht
höben	höben
Anwendungsgebiete	Anwendungsgebiete
Darlegungen	Darlegungen
knutschest	knutschest
Gepäckträger	Gepäckträger
Zäume	Zäume
Holzquirl	Holzquirl
Zinkionen	Zinkionen
fastete	fastete
sitzt	sitzt
Reinelementen	Reinelementen
gedenket	gedenket
erntest	erntest
spiele	spiele
Fischer	Fischer
mopst	mopst
Tritt	Tritt
Mitschuld	Mitschuld
Fischen	Fischen
reanimiere	reanimiere
verewigt	verewigt
scheinen	scheinen
Blockflöte	Blockflöte
mußte	mußte
Großstädtern	Großstädtern
schweigst	schweigst
Ellen	Ellen
Rhabarber	Rhabarber
wehren	wehren
zersetzet	zersetzet
brenne	brenne
Arbeitsleistung	Arbeitsleistung
Einwirkungen	Einwirkungen
Rückumschlägen	Rückumschlägen
Kreisen	Kreisen
knurrtet	knurrtet
neiden	neiden
breche	breche
Martyrologien	Martyrologien
rundest	rundest
Funktionalität	Funktionalität
entschleiert	entschleiert
Amputierte	Amputierte
zieren	zieren
Flamen	Flamen
entfachet	entfachet
hebräisch	hebräisch
Krume	Krume
Haue	Haue
schubse	schubse
Notständen	Notständen
Rubine	Rubine
habt	habt
injiziert	injiziert
flambierest	flambierest
Schnarchralle	Schnarchralle
erniedrigt	erniedrigt
siegte	siegte
erwärmet	erwärmet
Ausbeuter	Ausbeuter
erstehst	erstehst
boykottierst	boykottierst
enttäuschet	enttäuschet
Sprüche	Sprüche
Rotscheitelreiher	Rotscheitelreiher
Kräfte	Kräfte
schlängelt	schlängelt
raffiniere	raffiniere
fabuliere	fabuliere
Blicksilber	Blicksilber
Zehnten	Zehnten
greifen	greifen
Flöte	Flöte
Ente	Ente
Schatten	Schatten
bewahrheitetet	bewahrheitetet
Meter	Meter
säst	säst
harmonierest	harmonierest
Lärche	Lärche
Filzläusen	Filzläusen
haarte	haarte
Brite	Brite
rüste	rüste
euren	euren
solche	solche
Bettler	Bettler
lebte	lebte
geliebt	geliebt
Erzeugungen	Erzeugungen
sollten	sollten
flötete	flötete
gehorchst	gehorchst
überwachten	überwachten
Fittichen	Fittichen
Pumpellyiten	Pumpellyiten
grabest	grabest
Als	Als
Überziehens	Überziehens
Freibergits	Freibergits
schwadronierten	schwadronierten
abweichest	abweichest
trödele	trödele
Fehden	Fehden
binden	binden
halbe	halbe
Tübingern	Tübingern
vertiefet	vertiefet
Klüfte	Klüfte
Transportwegen	Transportwegen
irgendeine	irgendeine
einer	einer
Herbstwinde	Herbstwinde
Hurriter	Hurriter
Malen	Malen
fresset	fresset
Entmachtungen	Entmachtungen
stehest	stehest
Eisenkraut	Eisenkraut
lostest	lostest
Ionen	Ionen
gehetzt	gehetzt
Gewinnung	Gewinnung
gedächte	gedächte
Dürren	Dürren
schöpfe	schöpfe
esset	esset
Stiefvätern	Stiefvätern
exmatrikuliertet	exmatrikuliertet
Knöllchen	Knöllchen
Palme	Palme
Skorpione	Skorpione
Gewalttätern	Gewalttätern
WebHooks	WebHooks
Futur	Futur
kräuselten	kräuselten
schreiben	schreiben
Töpfen	Töpfen
Polizeisprecher	Polizeisprecher
blende	blende
linsten	linsten
Strohhälmchen	Strohhälmchen
anzeigte	anzeigte
Abbild	Abbild
verzieret	verzieret
verwerten	verwerten
Spießen	Spießen
Wadenbeines	Wadenbeines
schöpfen	schöpfen
Alkin	Alkin
Berge	Berge
Seinen	Seinen
Nussknacker	Nussknacker
Schanktisch	Schanktisch
liste	liste
manövrierte	manövrierte
formiret	formiret
willst	willst
verdammte	verdammte
Dreieinigkeit	Dreieinigkeit
unterschiede	unterschiede
Braunrallen	Braunrallen
massakrierten	massakrierten
Golfplatz	Golfplatz
Meldezettel	Meldezettel
Bäusche	Bäusche
Füchsinnen	Füchsinnen
Düften	Düften
kaufet	kaufet
Galoppen	Galoppen
zentrierest	zentrierest
Wüsten	Wüsten
entwischtet	entwischtet
ausführe	ausführe
Rutheniumisotopen	Rutheniumisotopen
plagte	plagte
absolviere	absolviere
Bifurkationen	Bifurkationen
wert	wert
verbitterest	verbitterest
stoßest	stoßest
Leuchtkäfer	Leuchtkäfer
bedrücktest	bedrücktest
plissierten	plissierten
inszenierst	inszenierst
verunglimpfte	verunglimpfte
Kruste	Kruste
Mop	Mop
preist	preist
irrte	irrte
kupiert	kupiert
googelten	googelten
Erbsen	Erbsen
beweise	beweise
Libelle	Libelle
hatten	hatten
Städte	Städte
Pflanzungen	Pflanzungen
Schneidern	Schneidern
Schwirrvögel	Schwirrvögel
grüßen	grüßen
stärket	stärket
Stellen	Stellen
verseuchen	verseuchen
hydrogentartrate	hydrogentartrate
Schalen	Schalen
Kernladungszahl	Kernladungszahl
beanspruchet	beanspruchet
Schamentzündungen	Schamentzündungen
charakterisiert	charakterisiert
Weißt	Weißt
welche	welche
Schwächung	Schwächung
initiieret	initiieret
Almanachen	Almanachen
verführe	verführe
Anschlägen	Anschlägen
Eselsohren	Eselsohren
offenbartest	offenbartest
Dachdecker	Dachdecker
Erdboden	Erdboden
evakuieret	evakuieret
protestieret	protestieret
Ranzigkeit	Ranzigkeit
stillte	stillte
stickten	stickten
Würfelspiele	Würfelspiele
aase	aase
Bildschirmfoto	Bildschirmfoto
Verbindungsdraht	Verbindungsdraht
harmonierte	harmonierte
Teekessel	Teekessel
observierst	observierst
lösten	lösten
Tannen	Tannen
aufstand	aufstand
taten	taten
Brieftaubenzüchter	Brieftaubenzüchter
Blättchen	Blättchen
keulst	keulst
klönen	klönen
verzweifelt	verzweifelt
spekulieren	spekulieren
teilen	teilen
Kohlrübe	Kohlrübe
bereiten	bereiten
verhörest	verhörest
Kriegsknechte	Kriegsknechte
verhungert	verhungert
baggerst	baggerst
kramst	kramst
zappten	zappten
vor	vor
Primärenergien	Primärenergien
verschmelzen	verschmelzen
Sternen	Sternen
Weißflügelpinguin	Weißflügelpinguin
batest	batest
bandagierte	bandagierte
widerstanden	widerstanden
schwöre	schwöre
Wimpertierchen	Wimpertierchen
befürchtet	befürchtet
entzögen	entzögen
anders	anders
Chronisten	Chronisten
Remis	Remis
gewähr	gewähr
hattet	hattet
instrumentalisierest	instrumentalisierest
Wehklagen	Wehklagen
vergleichet	vergleichet
treibest	treibest
dekompiliertest	dekompiliertest
Leiste	Leiste
kranken	kranken
Ihre	Ihre
erbte	erbte
Gangster	Gangster
Weiß	Weiß
Dezernat	Dezernat
Abbindebeschleunigern	Abbindebeschleunigern
endlagerten	endlagerten
Trübsalen	Trübsalen
concessionieren	concessionieren
krieget	krieget
Grenze	Grenze
Plumpse	Plumpse
besprächen	besprächen
vereinigt	vereinigt
Lunisolarkalender	Lunisolarkalender
betreten	betreten
Küchenmaschine	Küchenmaschine
Heuschrecke	Heuschrecke
aufkäme	aufkäme
Bedeutung	Bedeutung
Ruß	Ruß
Herrn	Herrn
kabelst	kabelst
ziere	ziere
Ypecaharallen	Ypecaharallen
Ringen	Ringen
Banden	Banden
Herr	Herr
verkürzten	verkürzten
anzeigest	anzeigest
geleitest	geleitest
Kairiner	Kairiner
geselle	geselle
Mähnenwolfes	Mähnenwolfes
liebet	liebet
wahre	wahre
Polierstählen	Polierstählen
Gefilde	Gefilde
Unglaube	Unglaube
henket	henket
aufhoben	aufhoben
Bushaltestellen	Bushaltestellen
grünst	grünst
Lehrbüchern	Lehrbüchern
tiefe	tiefe
solches	solches
Kryostat	Kryostat
begehrt	begehrt
designierst	designierst
Tote	Tote
Dunkelkammern	Dunkelkammern
fluchte	fluchte
Lotterien	Lotterien
schämest	schämest
heilet	heilet
fern	fern
verstört	verstört
verschlimmerte	verschlimmerte
Namen	Namen
dürften	dürften
Abartigkeiten	Abartigkeiten
lobet	lobet
Lautwandel	Lautwandel
drosselten	drosselten
gare	gare
Libellen	Libellen
beläufst	beläufst
funktionalisiertest	funktionalisiertest
schaffe	schaffe
verunreinigt	verunreinigt
Wasserquellen	Wasserquellen
Managementsystem	Managementsystem
leget	leget
hoben	hoben
Speeren	Speeren
reformierten	reformierten
verkauft	verkauft
vernickelte	vernickelte
Trichtern	Trichtern
Zwergschwanes	Zwergschwanes
verlieren	verlieren
kautest	kautest
Jünglinge	Jünglinge
hebet	hebet
verweise	verweise
errötest	errötest
Höhle	Höhle
betrübten	betrübten
Gipfeltreffen	Gipfeltreffen
danket	danket
winkt	winkt
Puffersystem	Puffersystem
Wirst	Wirst
Argentit	Argentit
Mittelaltermarktes	Mittelaltermarktes
verunglimpfest	verunglimpfest
Begrenzungen	Begrenzungen
erlösen	erlösen
könnten	könnten
beeindrucket	beeindrucket
Korrosionsschutzen	Korrosionsschutzen
Betainen	Betainen
Einzelgänger	Einzelgänger
Säue	Säue
eine	eine
sollt	sollt
pustet	pustet
zerschlaget	zerschlaget
beschwindele	beschwindele
Stilllegungen	Stilllegungen
gründen	gründen
Dinge	Dinge
gewährte	gewährte
arme	arme
schätze	schätze
regiert	regiert
härte	härte
erzürnst	erzürnst
besehet	besehet
Toypudel	Toypudel
Tatsachenbeschönigern	Tatsachenbeschönigern
haschieret	haschieret
Moren	Moren
Lobe	Lobe
Klaue	Klaue
Diebe	Diebe
entmineralisieret	entmineralisieret
ausführt	ausführt
überweise	überweise
Kakaos	Kakaos
entheiligten	entheiligten
Briefköpfen	Briefköpfen
erfreuen	erfreuen
möchtet	möchtet
Impedanz	Impedanz
stimmet	stimmet
Aphasie	Aphasie
deckte	deckte
hingehet	hingehet
Euphemismus	Euphemismus
überreichen	überreichen
zappen	zappen
duckmäuseret	duckmäuseret
überstehend	überstehend
bewerbet	bewerbet
deutete	deutete
blitzen	blitzen
erzwangt	erzwangt
surrst	surrst
Nadelbäume	Nadelbäume
steigerten	steigerten
hämmerte	hämmerte
Dödeln	Dödeln
Schamentzündung	Schamentzündung
Industrienation	Industrienation
Telefonnummern	Telefonnummern
kitzeln	kitzeln
schauest	schauest
schaue	schaue
Abbindebeschleuniger	Abbindebeschleuniger
Recht	Recht
Freunden	Freunden
Führe	Führe
ermordetest	ermordetest
ruhest	ruhest
Sollte	Sollte
blitze	blitze
Durchbruches	Durchbruches
Nachteile	Nachteile
Elastomer	Elastomer
dresche	dresche
lauschte	lauschte
verblieben	verblieben
Höret	Höret
tobte	tobte
Gigapascaln	Gigapascaln
Meinen	Meinen
Gewürzen	Gewürzen
pflanzen	pflanzen
sorget	sorget
Urbare	Urbare
bereuest	bereuest
Gegenleistung	Gegenleistung
raubte	raubte
tragest	tragest
fluppt	fluppt
webet	webet
Heere	Heere
Beziehung	Beziehung
Badezimmer	Badezimmer
habe	habe
Abschirmung	Abschirmung
verwertete	verwertete
konvergierest	konvergierest
fluche	fluche
Bromidquelle	Bromidquelle
Blattgeweben	Blattgeweben
Gammastrahl	Gammastrahl
gelangte	gelangte
loben	loben
Dilettanten	Dilettanten
Wirtschaftswissenschaft	Wirtschaftswissenschaft
den	den
zerstreut	zerstreut
fritieret	fritieret
Einer	Einer
Hobby	Hobby
Inkarnationen	Inkarnationen
grübelten	grübelten
Toten	Toten
läutet	läutet
schöpfest	schöpfest
Physikerinnen	Physikerinnen
hebst	hebst
bitte	bitte
glauben	glauben
nimmt	nimmt
dümpelt	dümpelt
Toypudeln	Toypudeln
Rückumlauten	Rückumlauten
Preis	Preis
fokussierten	fokussierten
flitzte	flitzte
lanciertet	lanciertet
plagest	plagest
Shortcut	Shortcut
gehorchten	gehorchten
besetzest	besetzest
zweite	zweite
Raten	Raten
Gebeine	Gebeine
schützt	schützt
Spielen	Spielen
Beiblätter	Beiblätter
dürfest	dürfest
Halt	Halt
Metallquirlen	Metallquirlen
Unsere	Unsere
Lazarett	Lazarett
instanziiere	instanziiere
erinnre	erinnre
erkennest	erkennest
Sabbatjahre	Sabbatjahre
Bildschirmfotos	Bildschirmfotos
seien	seien
verlöteten	verlöteten
solcher	solcher
Körpergeruches	Körpergeruches
Schönrednern	Schönrednern
warte	warte
Drohkulissen	Drohkulissen
Kalifeldspat	Kalifeldspat
attestiertet	attestiertet
Basilikum	Basilikum
feiertest	feiertest
knüpfen	knüpfen
Gebeten	Gebeten
ermahnt	ermahnt
aufkommen	aufkommen
Flosse	Flosse
bescherten	bescherten
rangierst	rangierst
Laiben	Laiben
Paillette	Paillette
grünten	grünten
geleiteten	geleiteten
Wer	Wer
Besprechung	Besprechung
spanne	spanne
dankte	dankte
verkürztest	verkürztest
Hainbuche	Hainbuche
linstest	linstest
Mopps	Mopps
Agoraphobie	Agoraphobie
Zehe	Zehe
erntet	erntet
arm	arm
Kein	Kein
befehlt	befehlt
griechisch	griechisch
gleich	gleich
Rücktrittbremse	Rücktrittbremse
sabbelten	sabbelten
verstand	verstand
Noseanen	Noseanen
wehrend	wehrend
verbündeten	verbündeten
zwänget	zwänget
hegten	hegten
Temperaturanstiege	Temperaturanstiege
scheu	scheu
versagen	versagen
stirbst	stirbst
Genies	Genies
gereicht	gereicht
Luftschiff	Luftschiff
zürne	zürne
dein	dein
fehlte	fehlte
tendierst	tendierst
verlaßt	verlaßt
überbewerte	überbewerte
Fiesling	Fiesling
panaschieret	panaschieret
grün	grün
Halbmonden	Halbmonden
mogelten	mogelten
Silbergeschirr	Silbergeschirr
Omnibus	Omnibus
stapelten	stapelten
Klärungen	Klärungen
vertagest	vertagest
Kettenraucher	Kettenraucher
schaffest	schaffest
Adamsäpfeln	Adamsäpfeln
verdamm	verdamm
Citrat	Citrat
Fußboden	Fußboden
verderben	verderben
Knaben	Knaben
faule	faule
predigt	predigt
Kanzlerinnen	Kanzlerinnen
touchierte	touchierte
Essigsäurechlorid	Essigsäurechlorid
bräunen	bräunen
Pforte	Pforte
begnadigst	begnadigst
Kautschuken	Kautschuken
Füllfederhalter	Füllfederhalter
Einbrecher	Einbrecher
verstecktet	verstecktet
Ansichtskarte	Ansichtskarte
sedimentieret	sedimentieret
anfinge	anfinge
Subspezies	Subspezies
ärgerst	ärgerst
auszogst	auszogst
verbündend	verbündend
schauten	schauten
dekorieren	dekorieren
wache	wache
Gaschromatographien	Gaschromatographien
er	er
Extremen	Extremen
impfst	impfst
meißeltest	meißeltest
bemächtigest	bemächtigest
vertrauten	vertrauten
ersparten	ersparten
Golfplätzen	Golfplätzen
Beile	Beile
speiset	speiset
Heteroatome	Heteroatome
zeuget	zeuget
lavierend	lavierend
Außenministerien	Außenministerien
All	All
attackieret	attackieret
sagtest	sagtest
weinest	weinest
beschwöre	beschwöre
Carbid	Carbid
wacht	wacht
verantwortet	verantwortet
Würfen	Würfen
Fischzucht	Fischzucht
schneide	schneide
ärgerte	ärgerte
Laken	Laken
frikassierend	frikassierend
segeln	segeln
erkannte	erkannte
Renegaten	Renegaten
setztest	setztest
gestikuliere	gestikuliere
Gläubigen	Gläubigen
meuternd	meuternd
mangeln	mangeln
hämmerst	hämmerst
dirigieren	dirigieren
Fettsack	Fettsack
Elstern	Elstern
fließt	fließt
Gedanken	Gedanken
moppst	moppst
Füllfedern	Füllfedern
Werden	Werden
Vordenker	Vordenker
Feste	Feste
Reststoff	Reststoff
Pferde	Pferde
streute	streute
ermordetet	ermordetet
Quatsch	Quatsch
zwängtet	zwängtet
Prozedur	Prozedur
Ansteckers	Ansteckers
predige	predige
preise	preise
Tyrannen	Tyrannen
Haarverlusten	Haarverlusten
bequemte	bequemte
betrübend	betrübend
Zöpfe	Zöpfe
dehydrierte	dehydrierte
Fahrzeugkatalysator	Fahrzeugkatalysator
verbitterte	verbitterte
