täckes	täckes
Ställ	Ställ
mark	mark
avvända	avvända
hölje	hölje
fiskare	fiskare
svalt	svalt
undantagen	undantagen
jagade	jagade
omringade	omringade
ära	ära
utrotades	utrotades
förleda	förleda
plågade	plågade
klädd	klädd
hysa	hysa
fältet	fältet
fördolde	fördolde
trälarbetet	trälarbetet
ökade	ökade
stillas	stillas
trycka	trycka
binde	binde
tillspillogiven	tillspillogiven
väckas	väckas
namnet	namnet
rycka	rycka
blyges	blyges
linda	linda
behövs	behövs
pressar	pressar
ödmjukas	ödmjukas
böjes	böjes
brunne	brunne
göras	göras
blåste	blåste
ryka	ryka
ringa	ringa
öppnades	öppnades
utröna	utröna
snår	snår
råder	råder
finne	finne
beloppet	beloppet
förstörde	förstörde
betryckta	betryckta
besatte	besatte
år	år
tillsättes	tillsättes
svin	svin
övertäcka	övertäcka
talade	talade
buds	buds
överdragen	överdragen
förhindrades	förhindrades
vrida	vrida
upphäves	upphäves
draga	draga
sätet	sätet
köpt	köpt
enes	enes
klöv	klöv
axet	axet
agade	agade
sanna	sanna
blindas	blindas
övermodet	övermodet
armes	armes
fattas	fattas
tysta	tysta
genomsökt	genomsökt
träffades	träffades
våldet	våldet
drog	drog
skapade	skapade
vare	vare
plugg	plugg
stengolv	stengolv
logarna	logarna
vätas	vätas
råds	råds
bortföra	bortföra
styrkas	styrkas
bok	bok
följeslagare	följeslagare
nederlaget	nederlaget
ödelägges	ödelägges
fetmas	fetmas
budordet	budordet
dödade	dödade
upptage	upptage
hållen	hållen
Benjamin	Benjamin
fåren	fåren
förödda	förödda
utsända	utsända
sliten	sliten
släppa	släppa
förtorkades	förtorkades
uppföra	uppföra
släta	släta
räta	räta
uppgiva	uppgiva
ristade	ristade
fördolda	fördolda
skålarna	skålarna
städer	städer
vallar	vallar
tycke	tycke
retas	retas
rädd	rädd
slita	slita
lugna	lugna
Leas	Leas
ek	ek
hembäre	hembäre
lindade	lindade
beskärt	beskärt
åka	åka
fyllas	fyllas
Folk	Folk
förstöres	förstöres
daglönare	daglönare
dräpes	dräpes
bestänkt	bestänkt
störes	störes
tröstade	tröstade
fyllt	fyllt
förfäras	förfäras
fälles	fälles
höljas	höljas
bud	bud
murbruket	murbruket
omgiva	omgiva
drivas	drivas
svänga	svänga
uppförde	uppförde
nedbryta	nedbryta
torn	torn
utgjuta	utgjuta
antändes	antändes
Antikrists	Antikrists
eder	eder
förres	förres
utkräva	utkräva
bortkastat	bortkastat
spenabarnet	spenabarnet
förutbestämt	förutbestämt
moderssköte	moderssköte
giva	giva
järnet	järnet
anställda	anställda
uppröres	uppröres
vette	vette
mister	mister
omskära	omskära
födes	födes
Antikrist	Antikrist
stekt	stekt
före	före
utlysa	utlysa
förkunnades	förkunnades
förvarade	förvarade
sen	sen
vett	vett
förbytt	förbytt
övergivna	övergivna
fetma	fetma
budet	budet
skilda	skilda
uppslukade	uppslukade
vetekornet	vetekornet
plågas	plågas
närande	närande
fört	fört
bära	bära
Israels	Israels
svarande	svarande
slags	slags
tillreds	tillreds
vänt	vänt
anklagade	anklagade
finnes	finnes
köpebrevet	köpebrevet
bundna	bundna
bedriva	bedriva
upphöjda	upphöjda
drucken	drucken
resas	resas
lärde	lärde
rättas	rättas
område	område
säkra	säkra
uppgivna	uppgivna
fullbordades	fullbordades
förkunnade	förkunnade
lovade	lovade
borttappade	borttappade
fare	fare
välvt	välvt
röra	röra
lidande	lidande
utbytte	utbytte
uppsatte	uppsatte
omvända	omvända
Vars	Vars
hållna	hållna
läras	läras
boks	boks
fläkt	fläkt
renat	renat
fast	fast
upprörd	upprörd
vårdare	vårdare
valvet	valvet
nedbrytes	nedbrytes
sås	sås
födda	födda
upplagda	upplagda
lycka	lycka
hornet	hornet
bröllopet	bröllopet
trälarbete	trälarbete
höres	höres
uppsöka	uppsöka
döda	döda
uppgives	uppgives
förlösa	förlösa
utbredde	utbredde
driven	driven
budens	budens
rätta	rätta
Edens	Edens
byta	byta
manas	manas
blive	blive
mätte	mätte
tyckes	tyckes
hala	hala
klädda	klädda
välva	välva
armen	armen
besöka	besöka
ark	ark
avsöndrades	avsöndrades
skänkt	skänkt
lutade	lutade
gränserna	gränserna
utsläcka	utsläcka
löses	löses
dödsriket	dödsriket
uppföda	uppföda
ene	ene
moln	moln
bjudes	bjudes
bedrage	bedrage
fallen	fallen
komma	komma
frågade	frågade
sitta	sitta
förrättade	förrättade
miste	miste
blåses	blåses
stärkt	stärkt
predikat	predikat
torg	torg
drive	drive
spridde	spridde
Ord	Ord
förtrycka	förtrycka
väckes	väckes
bitarna	bitarna
slungade	slungade
fördömda	fördömda
nästa	nästa
öppnade	öppnade
förgäta	förgäta
gripes	gripes
gode	gode
fadern	fadern
förlåtna	förlåtna
glädes	glädes
avmäta	avmäta
mods	mods
vakar	vakar
bereda	bereda
förlika	förlika
friköpa	friköpa
strålade	strålade
mätt	mätt
rullas	rullas
upprört	upprört
man	man
stänga	stänga
förbrännes	förbrännes
fälla	fälla
vitt	vitt
stört	stört
fördärvades	fördärvades
borrade	borrade
byggnadsverk	byggnadsverk
antända	antända
aktades	aktades
sakerna	sakerna
slätt	slätt
minska	minska
fria	fria
sänkas	sänkas
leva	leva
göra	göra
göres	göres
alltings	alltings
Gud	Gud
dragen	dragen
ålägga	ålägga
sprida	sprida
förgjorda	förgjorda
jagades	jagades
bortförda	bortförda
hämtades	hämtades
hjulet	hjulet
gäckas	gäckas
utsläckes	utsläckes
släktet	släktet
segrar	segrar
bäre	bäre
vars	vars
gästabud	gästabud
sändebudet	sändebudet
Vårt	Vårt
knyte	knyte
beredde	beredde
förfares	förfares
bjuda	bjuda
upplysa	upplysa
hörsamma	hörsamma
fårs	fårs
ringare	ringare
snöret	snöret
säljes	säljes
förbudet	förbudet
fläka	fläka
sänkt	sänkt
dammarna	dammarna
bakhållet	bakhållet
avskilda	avskilda
födas	födas
smältas	smältas
namn	namn
fots	fots
jubelår	jubelår
täcka	täcka
upplöses	upplöses
togs	togs
strålande	strålande
klagoropet	klagoropet
uppförd	uppförd
rena	rena
frambära	frambära
följd	följd
uppgiven	uppgiven
lösa	lösa
kläder	kläder
fylld	fylld
betäckt	betäckt
Esters	Esters
övergiva	övergiva
dukade	dukade
sköta	sköta
vant	vant
taga	taga
slagen	slagen
uppståndna	uppståndna
loven	loven
spenabarn	spenabarn
modet	modet
hölja	hölja
bohag	bohag
jämnas	jämnas
löftet	löftet
Talar	Talar
talades	talades
uppenbarade	uppenbarade
möta	möta
betrodda	betrodda
stige	stige
beredda	beredda
släckt	släckt
Israel	Israel
avfallen	avfallen
avvändes	avvändes
satte	satte
överlämnade	överlämnade
bedrives	bedrives
hon	hon
påbud	påbud
skadade	skadade
undantagna	undantagna
sträckt	sträckt
Vare	Vare
vise	vise
väges	väges
firade	firade
altare	altare
utstakade	utstakade
förjagade	förjagade
minnes	minnes
övrigas	övrigas
viskas	viskas
många	många
Vaken	Vaken
påskalamm	påskalamm
hacka	hacka
väcka	väcka
vända	vända
uppfödde	uppfödde
åts	åts
röres	röres
bitens	bitens
arks	arks
snara	snara
djur	djur
förtryckt	förtryckt
döva	döva
strids	strids
kända	kända
förtorkade	förtorkade
utkräves	utkräves
Faraos	Faraos
förleder	förleder
konungadöme	konungadöme
murar	murar
beskärd	beskärd
svävande	svävande
funne	funne
saknas	saknas
livet	livet
gudsfruktans	gudsfruktans
böjde	böjde
mista	mista
tankar	tankar
främmande	främmande
kärl	kärl
stötes	stötes
flyttades	flyttades
förståndet	förståndet
sänka	sänka
bådas	bådas
bälte	bälte
tändas	tändas
vätt	vätt
täckt	täckt
hemsökes	hemsökes
dolda	dolda
hoppas	hoppas
trampade	trampade
tystade	tystade
Mana	Mana
skäras	skäras
give	give
smide	smide
säges	säges
fästas	fästas
tage	tage
stickade	stickade
upphöjd	upphöjd
utstött	utstött
tårarna	tårarna
uppbygga	uppbygga
näst	näst
utdelade	utdelade
stormades	stormades
falle	falle
inrättades	inrättades
förgöres	förgöres
uppdraget	uppdraget
anstiftades	anstiftades
Hela	Hela
modersskötet	modersskötet
backar	backar
betryckte	betryckte
märkt	märkt
eds	eds
värde	värde
inbyggare	inbyggare
överdragna	överdragna
loge	loge
smälte	smälte
gjuta	gjuta
vanärade	vanärade
dräpa	dräpa
Simma	Simma
bönerna	bönerna
upplöst	upplöst
svävade	svävade
släckes	släckes
edens	edens
sjuka	sjuka
förstörda	förstörda
fiskar	fiskar
förda	förda
synas	synas
upptända	upptända
gods	gods
stjäla	stjäla
skarpa	skarpa
oxens	oxens
träd	träd
förstånd	förstånd
utsprida	utsprida
hyst	hyst
klädde	klädde
inrättade	inrättade
tankarna	tankarna
vädurens	vädurens
armod	armod
byar	byar
drogs	drogs
skuren	skuren
stycken	stycken
äta	äta
församlas	församlas
agat	agat
anklagades	anklagades
sitter	sitter
ort	ort
upprättade	upprättade
lyfta	lyfta
rättfärdiga	rättfärdiga
nästas	nästas
blodbad	blodbad
kännes	kännes
rike	rike
Heles	Heles
förfärade	förfärade
bygges	bygges
övergive	övergive
vilddjur	vilddjur
anställa	anställa
rörande	rörande
tränga	tränga
stoderna	stoderna
sons	sons
ställa	ställa
gemak	gemak
förenade	förenade
sändas	sändas
torget	torget
utföra	utföra
Benjamins	Benjamins
förskräcka	förskräcka
givna	givna
berömde	berömde
log	log
fördömd	fördömd
kallas	kallas
trygga	trygga
sköljes	sköljes
stupade	stupade
syns	syns
födde	födde
kokte	kokte
ödmjukade	ödmjukade
följda	följda
murbruk	murbruk
berg	berg
klippa	klippa
domarna	domarna
dricka	dricka
kallade	kallade
odjur	odjur
ålägges	ålägges
vrides	vrides
befästas	befästas
röras	röras
komme	komme
anskaffade	anskaffade
Farao	Farao
hembära	hembära
släktens	släktens
utstakat	utstakat
utdelat	utdelat
Asas	Asas
hålles	hålles
bältet	bältet
pålägga	pålägga
retade	retade
rätas	rätas
fästa	fästa
våldföres	våldföres
Surs	Surs
släppt	släppt
utbredda	utbredda
upptändes	upptändes
rovet	rovet
räckt	räckt
hylla	hylla
vakttornet	vakttornet
Lea	Lea
berget	berget
pressade	pressade
lammet	lammet
Båda	Båda
utsträcka	utsträcka
breda	breda
befästa	befästa
plågades	plågades
drabbades	drabbades
åker	åker
anskaffades	anskaffades
klövarna	klövarna
upptagna	upptagna
övermod	övermod
bryta	bryta
segrare	segrare
sakens	sakens
drives	drives
lämnades	lämnades
tryggade	tryggade
beredd	beredd
bortförd	bortförd
upplåten	upplåten
lära	lära
gjorda	gjorda
Faders	Faders
fällas	fällas
snärjas	snärjas
stjäle	stjäle
blottade	blottade
dyrkade	dyrkade
råkade	råkade
träda	träda
borrar	borrar
avsats	avsats
halt	halt
omfånget	omfånget
hemsöka	hemsöka
räddas	räddas
ödelägga	ödelägga
järn	järn
tiger	tiger
seendes	seendes
berömda	berömda
lagade	lagade
förbund	förbund
skäl	skäl
lidandes	lidandes
Man	Man
utslaget	utslaget
mjölet	mjölet
upplagt	upplagt
uppenbara	uppenbara
skapades	skapades
döpes	döpes
styrka	styrka
livs	livs
råd	råd
svans	svans
tornet	tornet
ansedde	ansedde
faste	faste
arme	arme
kysst	kysst
lärda	lärda
tjänade	tjänade
korna	korna
bevarade	bevarade
församlade	församlade
råka	råka
fält	fält
fara	fara
egyptiers	egyptiers
söks	söks
visade	visade
drypa	drypa
uppbådade	uppbådade
blodbadet	blodbadet
räknade	räknade
uppbygges	uppbygges
druckna	druckna
mördade	mördade
ekar	ekar
uddar	uddar
valkares	valkares
förskräckte	förskräckte
brevet	brevet
ryggas	ryggas
stilla	stilla
lamm	lamm
skäres	skäres
kors	kors
fallna	fallna
utsätta	utsätta
snåret	snåret
smälta	smälta
tusental	tusental
upptecknade	upptecknade
renas	renas
böjt	böjt
lämnade	lämnade
säte	säte
förblive	förblive
viskade	viskade
korsfästa	korsfästa
uttåget	uttåget
gästabudet	gästabudet
palatset	palatset
överlämnades	överlämnades
klagorop	klagorop
vaken	vaken
läka	läka
beskärde	beskärde
kärvarna	kärvarna
helgades	helgades
ökades	ökades
förmörkades	förmörkades
fiskade	fiskade
utfärdade	utfärdade
krönt	krönt
förtäres	förtäres
platserna	platserna
fortfare	fortfare
nedgjorda	nedgjorda
fjättrar	fjättrar
utgöres	utgöres
jubelåret	jubelåret
rövare	rövare
egyptierna	egyptierna
räckas	räckas
sjukt	sjukt
båda	båda
förbränna	förbränna
gud	gud
stallet	stallet
ställda	ställda
brytes	brytes
smida	smida
snart	snart
betänkte	betänkte
stadgar	stadgar
sälja	sälja
stänkt	stänkt
rötter	rötter
kokt	kokt
föreläsa	föreläsa
palats	palats
borgare	borgare
stenröset	stenröset
granne	granne
öppnas	öppnas
skildes	skildes
avskäres	avskäres
tryckte	tryckte
huset	huset
gudarna	gudarna
väta	väta
avståndet	avståndet
avsatt	avsatt
mångas	mångas
bete	bete
våra	våra
budord	budord
huvudet	huvudet
böja	böja
avsatserna	avsatserna
vingar	vingar
helgade	helgade
resande	resande
hus	hus
möte	möte
frätas	frätas
slaktdjur	slaktdjur
omfång	omfång
Lamm	Lamm
fullbordade	fullbordade
utrotade	utrotade
betänka	betänka
drage	drage
lyftas	lyftas
driva	driva
fot	fot
krossade	krossade
beta	beta
arv	arv
grav	grav
glada	glada
struts	struts
tackade	tackade
resa	resa
avsöndrade	avsöndrade
berömt	berömt
förslag	förslag
täckas	täckas
kärve	kärve
inställde	inställde
befäl	befäl
tillreda	tillreda
inbyggares	inbyggares
brännes	brännes
korsfästes	korsfästes
benet	benet
antal	antal
mött	mött
Ana	Ana
betänkt	betänkt
mönstrades	mönstrades
mönstrade	mönstrade
funna	funna
vände	vände
lända	lända
kullar	kullar
lida	lida
förströdda	förströdda
förhindrade	förhindrade
dödas	dödas
marks	marks
tillsätta	tillsätta
förbundet	förbundet
smältes	smältes
avsatte	avsatte
förstöra	förstöra
folket	folket
talar	talar
rulla	rulla
upptecknades	upptecknades
förstörd	förstörd
fäste	fäste
värden	värden
renades	renades
trätt	trätt
släkt	släkt
handlade	handlade
uttåg	uttåg
åt	åt
räknades	räknades
gjordes	gjordes
övertäckt	övertäckt
betrycktes	betrycktes
fyllde	fyllde
undersöka	undersöka
näpst	näpst
spridda	spridda
knyta	knyta
bestänka	bestänka
genomsöka	genomsöka
sålde	sålde
offrades	offrades
ingångens	ingångens
tillfrisknade	tillfrisknade
skylde	skylde
vana	vana
mätta	mätta
format	format
räddades	räddades
inställa	inställa
uppresa	uppresa
beskära	beskära
huggen	huggen
rista	rista
ed	ed
bredd	bredd
predikades	predikades
sträva	sträva
huggna	huggna
gives	gives
född	född
slunga	slunga
gravarna	gravarna
vattnas	vattnas
spände	spände
förmörkade	förmörkade
burna	burna
sann	sann
avlämnade	avlämnade
svängde	svängde
klipper	klipper
förstörs	förstörs
samlas	samlas
vara	vara
klagande	klagande
uppstånden	uppstånden
slagna	slagna
byarna	byarna
vanna	vanna
Råd	Råd
plats	plats
aktade	aktade
stadgas	stadgas
föra	föra
utsatte	utsatte
spik	spik
utstöta	utstöta
skänka	skänka
lösas	lösas
skydda	skydda
namns	namns
sättes	sättes
uppfylles	uppfylles
dödande	dödande
vänd	vänd
Folket	Folket
avstånd	avstånd
klappa	klappa
rikes	rikes
nederlag	nederlag
hjul	hjul
sträcka	sträcka
kriget	kriget
märka	märka
försåtet	försåtet
hålla	hålla
bars	bars
stänkes	stänkes
fyllda	fyllda
lidandet	lidandet
stadier	stadier
bäckens	bäckens
förtälja	förtälja
amma	amma
torka	torka
vetekorn	vetekorn
gladas	gladas
äppelträdet	äppelträdet
djuret	djuret
besatta	besatta
känna	känna
pålägges	pålägges
ställt	ställt
upprest	upprest
dräpt	dräpt
området	området
markerna	markerna
rättfärdigas	rättfärdigas
Ordet	Ordet
avfallna	avfallna
befälet	befälet
Satan	Satan
brännsår	brännsår
dricke	dricke
upplåtna	upplåtna
förbyta	förbyta
uppfört	uppfört
gäckade	gäckade
invånares	invånares
tyget	tyget
vilddjuret	vilddjuret
rörde	rörde
tjäna	tjäna
bränna	bränna
vattnade	vattnade
fotbladet	fotbladet
rötterna	rötterna
stärka	stärka
utvaldas	utvaldas
bindes	bindes
förskräckes	förskräckes
altaret	altaret
utlyst	utlyst
nämnda	nämnda
fikonträdet	fikonträdet
upprätta	upprätta
utbyta	utbyta
råda	råda
damm	damm
slites	slites
blottas	blottas
armodet	armodet
följeslagares	följeslagares
domar	domar
tända	tända
hugga	hugga
Landet	Landet
påskalammet	påskalammet
fördömde	fördömde
fördöma	fördöma
bliva	bliva
sårande	sårande
mjöl	mjöl
Både	Både
valla	valla
stormade	stormade
horn	horn
Svärd	Svärd
skälet	skälet
väns	väns
förskräckt	förskräckt
Ester	Ester
sätta	sätta
förra	förra
Rådet	Rådet
avhålle	avhålle
vita	vita
avmätt	avmätt
utgjutes	utgjutes
utplånades	utplånades
vingarna	vingarna
höljes	höljes
förökade	förökade
gjutes	gjutes
gudsfruktan	gudsfruktan
tryckes	tryckes
hörsammade	hörsammade
lyftes	lyftes
upphöja	upphöja
föres	föres
vakade	vakade
fattat	fattat
hoppade	hoppade
använda	använda
hugges	hugges
förrättades	förrättades
ödmjuka	ödmjuka
lamms	lamms
svala	svala
lider	lider
omstörtades	omstörtades
faders	faders
rov	rov
rykte	rykte
stadga	stadga
sändes	sändes
förgjordes	förgjordes
besökt	besökt
sjunge	sjunge
kränkt	kränkt
års	års
köpa	köpa
slaktades	slaktades
visen	visen
beten	beten
kalla	kalla
binda	binda
friköpt	friköpt
utgöra	utgöra
bindas	bindas
förtrycktas	förtrycktas
vårdar	vårdar
fikonträd	fikonträd
utsatta	utsatta
utslag	utslag
borttappat	borttappat
lår	lår
behöves	behöves
våldföra	våldföra
försonas	försonas
omgives	omgives
rest	rest
stickas	stickas
rygga	rygga
eländet	eländet
bortkastade	bortkastade
torkade	torkade
ryckes	ryckes
beseglade	beseglade
förödes	förödes
vika	vika
blåst	blåst
konungadömet	konungadömet
skött	skött
anställde	anställde
tagna	tagna
arvet	arvet
trängd	trängd
offrade	offrade
hindrade	hindrade
nät	nät
kos	kos
saknade	saknade
övrigt	övrigt
moderlivet	moderlivet
valv	valv
murare	murare
slås	slås
grannarna	grannarna
skylt	skylt
vederkvicka	vederkvicka
garnet	garnet
given	given
släcka	släcka
vila	vila
upphäva	upphäva
Tala	Tala
hals	hals
strutsarna	strutsarna
köpebrev	köpebrev
lärt	lärt
kläda	kläda
Helt	Helt
rövar	rövar
lovar	lovar
dövas	dövas
hela	hela
spjutet	spjutet
fotblad	fotblad
gifta	gifta
tröstar	tröstar
tänka	tänka
like	like
låret	låret
lägga	lägga
skrapa	skrapa
vittnesbörd	vittnesbörd
ax	ax
äppelträd	äppelträd
taket	taket
uppslukades	uppslukades
förbjudes	förbjudes
tillspillogivna	tillspillogivna
friade	friade
sökt	sökt
molnet	molnet
stod	stod
Svärdet	Svärdet
strida	strida
spjut	spjut
vanära	vanära
klövs	klövs
ben	ben
smides	smides
fogade	fogade
täcke	täcke
kastades	kastades
öst	öst
brodern	brodern
ordspråket	ordspråket
vädurarna	vädurarna
nämnde	nämnde
förtära	förtära
upploppet	upploppet
hackade	hackade
uppläst	uppläst
tår	tår
uppfylla	uppfylla
låta	låta
antalet	antalet
kallades	kallades
fattade	fattade
döpt	döpt
falla	falla
stötte	stötte
uppbådades	uppbådades
förlåte	förlåte
säga	säga
Sur	Sur
tungas	tungas
förlåten	förlåten
förskingrades	förskingrades
nära	nära
buren	buren
omringades	omringades
ändamålet	ändamålet
löfte	löfte
krig	krig
stall	stall
tagen	tagen
mäta	mäta
Simmas	Simmas
undersökt	undersökt
minskade	minskade
valkare	valkare
förordnade	förordnade
träta	träta
fördriva	fördriva
byggnadsverket	byggnadsverket
fylla	fylla
upplopp	upplopp
avlat	avlat
kyssa	kyssa
insatte	insatte
skilde	skilde
förökades	förökades
formade	formade
inmönstrade	inmönstrade
svansarna	svansarna
gläds	gläds
avskära	avskära
låte	låte
slån	slån
svalka	svalka
ena	ena
uppenbarades	uppenbarades
trampa	trampa
både	både
Gudarna	Gudarna
uppväcka	uppväcka
förena	förena
hälsades	hälsades
uppsatta	uppsatta
borgar	borgar
dyrkar	dyrkar
tunga	tunga
falls	falls
fogades	fogades
predikade	predikade
fattades	fattades
behöva	behöva
hälsa	hälsa
uppenbaras	uppenbaras
räcka	räcka
omgiven	omgiven
stupa	stupa
sjuke	sjuke
nödgas	nödgas
påbudet	påbudet
försonade	försonade
träffas	träffas
vinn	vinn
bjude	bjude
koka	koka
förskingrade	förskingrade
trängde	trängde
dödades	dödades
beskärda	beskärda
slaktade	slaktade
sända	sända
bäres	bäres
död	död
förre	förre
mottages	mottages
tröstare	tröstare
vårt	vårt
bön	bön
stött	stött
förlåta	förlåta
nödgade	nödgade
invånare	invånare
trängt	trängt
användas	användas
gemaket	gemaket
utsändes	utsändes
drabbade	drabbade
blåsa	blåsa
mördande	mördande
blinde	blinde
upprättades	upprättades
broders	broders
strävade	strävade
upplösa	upplösa
luta	luta
beställt	beställt
vittnesbördet	vittnesbördet
förvandlades	förvandlades
skugga	skugga
spända	spända
maka	maka
förrådshus	förrådshus
tacka	tacka
avlämnades	avlämnades
funnes	funnes
uppsökte	uppsökte
lever	lever
löst	löst
make	make
steka	steka
tåga	tåga
fördrives	fördrives
förlikt	förlikt
svarade	svarade
kon	kon
väckt	väckt
vikt	vikt
folk	folk
dom	dom
dryckerna	dryckerna
upptages	upptages
bröllop	bröllop
betade	betade
svalkas	svalkas
bygga	bygga
visa	visa
utplånade	utplånade
ordspråk	ordspråk
hälsade	hälsade
blygas	blygas
kullarna	kullarna
utföres	utföres
förjagades	förjagades
näpsa	näpsa
huvud	huvud
bortförde	bortförde
förtryckes	förtryckes
handlar	handlar
ingångarna	ingångarna
försåt	försåt
penningarna	penningarna
bunden	bunden
bestämde	bestämde
sticka	sticka
utbreda	utbreda
kröna	kröna
bytte	bytte
förgöra	förgöra
året	året
saker	saker
förutbestämde	förutbestämde
fästes	fästes
betar	betar
axens	axens
tycka	tycka
hyllade	hyllade
dragna	dragna
vindarna	vindarna
tog	tog
sports	sports
fortfara	fortfara
styrkt	styrkt
nätet	nätet
son	son
brunnarna	brunnarna
bestämda	bestämda
vändes	vändes
förbliva	förbliva
gifte	gifte
uppdrag	uppdrag
vakttorn	vakttorn
lägges	lägges
styrkes	styrkes
spikarna	spikarna
avhålla	avhålla
snöre	snöre
ringas	ringas
anstiftade	anstiftade
utsättes	utsättes
skyarna	skyarna
gripna	gripna
dammet	dammet
arms	arms
mången	mången
allting	allting
stänka	stänka
insatt	insatt
utvalde	utvalde
mottaga	mottaga
fråga	fråga
skarpt	skarpt
förvarades	förvarades
avla	avla
bevekt	bevekt
hos	hos
kärlet	kärlet
markens	markens
rådde	rådde
Eder	Eder
upphöjde	upphöjde
läkt	läkt
föda	föda
låga	låga
inmönstrades	inmönstrades
brunnens	brunnens
förbud	förbud
betrodde	betrodde
hörsammades	hörsammades
Land	Land
tages	tages
upphöjt	upphöjt
lärd	lärd
sena	sena
Satans	Satans
Vakna	Vakna
bevarades	bevarades
förfara	förfara
upplyste	upplyste
gömma	gömma
korsfästas	korsfästas
beskäres	beskäres
hemsökt	hemsökt
stänger	stänger
borgen	borgen
tänkt	tänkt
hjälpt	hjälpt
bedraga	bedraga
ändamål	ändamål
bäckarna	bäckarna
skurna	skurna
kastade	kastade
uppväckt	uppväckt
helas	helas
förtäljes	förtäljes
liden	liden
Hagars	Hagars
bohaget	bohaget
dödsrike	dödsrike
skyddade	skyddade
samlades	samlades
mana	mana
kränka	kränka
lugnade	lugnade
svinet	svinet
slitna	slitna
förgäte	förgäte
klagade	klagade
gripa	gripa
ställd	ställd
hindrades	hindrades
lika	lika
läses	läses
gap	gap
viska	viska
brännsåret	brännsåret
blygs	blygs
söka	söka
omskäres	omskäres
moderliv	moderliv
vaka	vaka
jämna	jämna
ätes	ätes
upptagen	upptagen
krossades	krossades
nämnes	nämnes
vilade	vilade
laga	laga
förbytes	förbytes
skrapade	skrapade
främmandes	främmandes
helade	helade
förödande	förödande
agas	agas
tillredes	tillredes
vändas	vändas
blottades	blottades
våld	våld
Stället	Stället
odjuret	odjuret
sändebud	sändebud
stöta	stöta
visas	visas
tiga	tiga
stycke	stycke
användes	användes
följande	följande
flyga	flyga
marker	marker
Visa	Visa
bortfört	bortfört
förrådshuset	förrådshuset
räddade	räddade
vann	vann
dolde	dolde
tränges	tränges
äte	äte
äras	äras
släkte	släkte
stenröse	stenröse
dryck	dryck
betrycktas	betrycktas
sjunga	sjunga
tabernakel	tabernakel
ansedda	ansedda
utspridde	utspridde
tågade	tågade
betäcka	betäcka
hämtade	hämtade
lyckas	lyckas
bortkastad	bortkastad
avskilde	avskilde
länder	länder
ringar	ringar
firades	firades
skuggade	skuggade
bara	bara
sålda	sålda
Asa	Asa
sport	sport
fjättrade	fjättrade
Anas	Anas
frambäres	frambäres
böjd	böjd
tak	tak
drivna	drivna
övriga	övriga
omgivna	omgivna
Hagar	Hagar
Visar	Visar
skära	skära
flottar	flottar
fören	fören
belopp	belopp
nedgjorde	nedgjorde
ställde	ställde
elände	elände
skada	skada
städ	städ
läsa	läsa
ammade	ammade
anställd	anställd
utsläckt	utsläckt
gapet	gapet
brev	brev
plåga	plåga
låge	låge
gripen	gripen
ösa	ösa
backarna	backarna
fördärvade	fördärvade
dukat	dukat
bytt	bytt
klappade	klappade
handla	handla
omstörtade	omstörtade
blinda	blinda
pluggarna	pluggarna
upptaga	upptaga
garn	garn
aga	aga
skål	skål
stadiers	stadiers
släkterna	släkterna
förslaget	förslaget
vinna	vinna
tabernakels	tabernakels
näste	näste
Våra	Våra
skölja	skölja
tusentals	tusentals
minne	minne
flyge	flyge
stillade	stillade
tillfrisknat	tillfrisknat
fostrades	fostrades
daglönares	daglönares
stengolvet	stengolvet
vägs	vägs
fostrade	fostrade
rört	rört
förordnades	förordnades
vind	vind
kände	kände
säkras	säkras
utvalda	utvalda
sökte	sökte
utsträckt	utsträckt
tyg	tyg
vederkvickt	vederkvickt
bakhåll	bakhåll
satta	satta
rädda	rädda
betryckt	betryckt
beseglades	beseglades
antändas	antändas
föröda	föröda
gräns	gräns
mättas	mättas
manades	manades
slaktdjuret	slaktdjuret
gömmas	gömmas
blotta	blotta
snärja	snärja
döpa	döpa
renade	renade
sabbat	sabbat
Guds	Guds
enas	enas
uppläsa	uppläsa
flyttade	flyttade
Lammet	Lammet
förlöst	förlöst
seende	seende
utrönt	utrönt
äktenskapsbrottet	äktenskapsbrottet
manade	manade
äktenskapsbrott	äktenskapsbrott
föreläses	föreläses
mötes	mötes
övergiven	övergiven
drype	drype
sån	sån
förgjorde	förgjorde
oxarna	oxarna
förras	förras
årens	årens
stillades	stillades
visar	visar
flotta	flotta
fräta	fräta
höra	höra
udd	udd
förtryckta	förtryckta
hjälpa	hjälpa
sårade	sårade
förvandlade	förvandlade
omvände	omvände
trampas	trampas
orterna	orterna
sabbaterna	sabbaterna
sky	sky
drages	drages
täckte	täckte
bevekande	bevekande
upptändas	upptändas
förströdde	förströdde
rikt	rikt
beställa	beställa
läst	läst
stiga	stiga
penningar	penningar
dyrkades	dyrkades
rövade	rövade
förbjuda	förbjuda
utfärdades	utfärdades
Fadern	Fadern
