Feind	Feind
Carbids	Carbids
Ruße	Ruße
inspirierten	inspirierten
referenzierst	referenzierst
Ihr	Ihr
widerlegest	widerlegest
Nahrungsbestandteilen	Nahrungsbestandteilen
Putschisten	Putschisten
Piratensendern	Piratensendern
Ruß	Ruß
Aphasien	Aphasien
anfinge	anfinge
Kopfsalaten	Kopfsalaten
lüftetet	lüftetet
solchen	solchen
Pumpellyiten	Pumpellyiten
unterbrächen	unterbrächen
torpediert	torpediert
Berufen	Berufen
bröckelten	bröckelten
kosten	kosten
Berber	Berber
Meldezettel	Meldezettel
entfachten	entfachten
zeugest	zeugest
velarisiert	velarisiert
puste	puste
Wirte	Wirte
Buchhalterinnen	Buchhalterinnen
entfolgte	entfolgte
balkanisierten	balkanisierten
beeinflusste	beeinflusste
lautete	lautete
wiederkamt	wiederkamt
reagiert	reagiert
Irrtümern	Irrtümern
erzeigt	erzeigt
welche	welche
Heringe	Heringe
gewährte	gewährte
Diagnostik	Diagnostik
parfümierst	parfümierst
frommen	frommen
sehnte	sehnte
überwachest	überwachest
dechiffrierend	dechiffrierend
Acht	Acht
Quellfluss	Quellfluss
Reinstoffen	Reinstoffen
Orgel	Orgel
schlabberten	schlabberten
hineinbrächten	hineinbrächten
Tanne	Tanne
Kardinal	Kardinal
diversifiziere	diversifiziere
Polyphosphat	Polyphosphat
versuchtet	versuchtet
dürften	dürften
heiligem	heiligem
meinen	meinen
Ihre	Ihre
erfreu	erfreu
beben	beben
Mikrowellenfilter	Mikrowellenfilter
Grufti	Grufti
Preisanstieg	Preisanstieg
Bademäntel	Bademäntel
verbarg	verbarg
stimmen	stimmen
einen	einen
klemmen	klemmen
Trickbetrügern	Trickbetrügern
verhören	verhören
flenstet	flenstet
jede	jede
initiierst	initiierst
zensierten	zensierten
parkierst	parkierst
Jagdhund	Jagdhund
hinterzöge	hinterzöge
schließt	schließt
klonet	klonet
gebühren	gebühren
blitzet	blitzet
Verselbstständigung	Verselbstständigung
Eisenkraut	Eisenkraut
Falzen	Falzen
verkürztest	verkürztest
Metallspiegel	Metallspiegel
Crescendo	Crescendo
Außenministerien	Außenministerien
Zur-Schau-Stellen	Zur-Schau-Stellen
leiden	leiden
Abkürzungsverzeichnisse	Abkürzungsverzeichnisse
überdenkest	überdenkest
Schlangen	Schlangen
wichsten	wichsten
grübelte	grübelte
Genetikerin	Genetikerin
Blattgeweben	Blattgeweben
verifizierten	verifizierten
Sonderberichte	Sonderberichte
grienest	grienest
Rückwege	Rückwege
Fahrzeugkatalysatoren	Fahrzeugkatalysatoren
Afrikaner	Afrikaner
ärgerst	ärgerst
Kristallen	Kristallen
Emmer	Emmer
Reizt	Reizt
Mönche	Mönche
Knüppels	Knüppels
Möbiusbändern	Möbiusbändern
ringele	ringele
greifen	greifen
Lunisolarkalender	Lunisolarkalender
Politologe	Politologe
pensionierest	pensionierest
eskaliert	eskaliert
Wir	Wir
Montagmittag	Montagmittag
Leitkegeln	Leitkegeln
ehren	ehren
fritierst	fritierst
bimmelte	bimmelte
stimmet	stimmet
Kanzlerinnen	Kanzlerinnen
deutete	deutete
sprüht	sprüht
zeltest	zeltest
Rücktritt	Rücktritt
Ölspuren	Ölspuren
Fermium	Fermium
Kaliumdichromat	Kaliumdichromat
Argentit	Argentit
Dichten	Dichten
Managementsystemen	Managementsystemen
verkürze	verkürze
Erlösungen	Erlösungen
begrübe	begrübe
Füllen	Füllen
Gefängnisse	Gefängnisse
fließen	fließen
brillieret	brillieret
spalten	spalten
werden	werden
Wärt	Wärt
Hirte	Hirte
mampfen	mampfen
querest	querest
Neumonde	Neumonde
Abnahmen	Abnahmen
inhalierest	inhalierest
streutet	streutet
Großstädter	Großstädter
Atommodellen	Atommodellen
bereiten	bereiten
Gegebenheit	Gegebenheit
entsündigen	entsündigen
heftete	heftete
besäet	besäet
zittertest	zittertest
halle	halle
Amtsträger	Amtsträger
Apfelbäume	Apfelbäume
bewässern	bewässern
Lotterien	Lotterien
substituierten	substituierten
gezügelt	gezügelt
vergrubt	vergrubt
Schlagzeuger	Schlagzeuger
warntet	warntet
werten	werten
weich	weich
Gasflaschen	Gasflaschen
Rehbock	Rehbock
Funktionalität	Funktionalität
Kannst	Kannst
schaut	schaut
Panzerschreck	Panzerschreck
Sorgen	Sorgen
meines	meines
bemühet	bemühet
Konifere	Konifere
Gässchen	Gässchen
würde	würde
schäme	schäme
brandet	brandet
Dithiolane	Dithiolane
verlassen	verlassen
Transportweg	Transportweg
predigt	predigt
Rückumschlägen	Rückumschlägen
klemmt	klemmt
träge	träge
verdränget	verdränget
schwenkt	schwenkt
begrabet	begrabet
Schneepflügen	Schneepflügen
Hochsommern	Hochsommern
schenkest	schenkest
glänzten	glänzten
malt	malt
trägst	trägst
rebellieren	rebellieren
Eine	Eine
benütztest	benütztest
erbringst	erbringst
enge	enge
Baiser	Baiser
Apostels	Apostels
schöpfte	schöpfte
Kerls	Kerls
Großfürst	Großfürst
Leuchtstoffen	Leuchtstoffen
Zäume	Zäume
zertifiziertest	zertifiziertest
Halbzeiten	Halbzeiten
stickten	stickten
überwachten	überwachten
wärst	wärst
Unwahrheit	Unwahrheit
Felle	Felle
rekrutiere	rekrutiere
Laufringen	Laufringen
Landstreicher	Landstreicher
beschotterten	beschotterten
Petersfisch	Petersfisch
bereite	bereite
Katamarane	Katamarane
erntete	erntete
transportiere	transportiere
verjährte	verjährte
Händedruck	Händedruck
überschnitten	überschnitten
bereuest	bereuest
karikierten	karikierten
Stühle	Stühle
bedürft	bedürft
teilte	teilte
Helme	Helme
beleidigst	beleidigst
schwöret	schwöret
Malaysierinnen	Malaysierinnen
kitzeln	kitzeln
gafften	gafften
befehlt	befehlt
Gummibäumen	Gummibäumen
verzweifelten	verzweifelten
sündigst	sündigst
beanspruchte	beanspruchte
Rückweg	Rückweg
erschrickst	erschrickst
reiche	reiche
Gammastrahl	Gammastrahl
sterilisiert	sterilisiert
schlabberte	schlabberte
ungeistlichen	ungeistlichen
predigten	predigten
Mähnenwölfen	Mähnenwölfen
Meinet	Meinet
leistest	leistest
Gründungsprivileg	Gründungsprivileg
Knöllchen	Knöllchen
manövrieret	manövrieret
schweigst	schweigst
scheucht	scheucht
ankerst	ankerst
wetzte	wetzte
vergaste	vergaste
Sonderbericht	Sonderbericht
haschieret	haschieret
gibst	gibst
dekorieren	dekorieren
sündigten	sündigten
auszogst	auszogst
entwischten	entwischten
assimilieret	assimilieret
gebäre	gebäre
Metapher	Metapher
werte	werte
bücktest	bücktest
erwürgtest	erwürgtest
angehören	angehören
Stolze	Stolze
Abschiedsbriefe	Abschiedsbriefe
Alkali	Alkali
schmetterst	schmetterst
zerstücken	zerstücken
Gibt	Gibt
lieb	lieb
Prozeduren	Prozeduren
Homodimeren	Homodimeren
inspirierest	inspirierest
Aufsätze	Aufsätze
lös	lös
velarisierend	velarisierend
Rechten	Rechten
erkältete	erkältete
schöpfest	schöpfest
Verwaltungsakte	Verwaltungsakte
fabulierte	fabulierte
dividiert	dividiert
Tatsachenbeschöniger	Tatsachenbeschöniger
Laib	Laib
Erste	Erste
bebten	bebten
maximierten	maximierten
versuche	versuche
Ektoplasmen	Ektoplasmen
Fehlen	Fehlen
Quellflüssen	Quellflüssen
erlauben	erlauben
Ionenaustauscher	Ionenaustauscher
Haarverlusten	Haarverlusten
Hüftgelenken	Hüftgelenken
Klappertopf	Klappertopf
Campingplatzes	Campingplatzes
Wespen	Wespen
Hebet	Hebet
Haben	Haben
verführe	verführe
suchst	suchst
Stierkämpfen	Stierkämpfen
sorgen	sorgen
denaturierten	denaturierten
brachen	brachen
Alkin	Alkin
blitzt	blitzt
Fingerhüte	Fingerhüte
Band	Band
Anliegen	Anliegen
Pinguinen	Pinguinen
Hummel	Hummel
optimiert	optimiert
Strafraum	Strafraum
Heteroatom	Heteroatom
Hanse	Hanse
Bilderstürmers	Bilderstürmers
drifte	drifte
verspielte	verspielte
weissagst	weissagst
geleite	geleite
Kairiner	Kairiner
Nachteile	Nachteile
gewarnt	gewarnt
kugelten	kugelten
Kontraindikation	Kontraindikation
Schwänzen	Schwänzen
kriegte	kriegte
verkürztet	verkürztet
Bären	Bären
verselbständigst	verselbständigst
dürft	dürft
nötig	nötig
Raucherin	Raucherin
Gasflasche	Gasflasche
strecken	strecken
Serverzugriffe	Serverzugriffe
Flame	Flame
zerbrichst	zerbrichst
Autonomien	Autonomien
nimmt	nimmt
klappst	klappst
Gnaden	Gnaden
Orte	Orte
Versorgungen	Versorgungen
vertagt	vertagt
kritzelst	kritzelst
Westen	Westen
beziehen	beziehen
verdamm	verdamm
sehnet	sehnet
anzeigest	anzeigest
ummantelten	ummantelten
tabuisierten	tabuisierten
Pudern	Pudern
aufnahmen	aufnahmen
reglementierte	reglementierte
chloroformiere	chloroformiere
weichst	weichst
gesagt	gesagt
Öfchen	Öfchen
spannt	spannt
benachrichtige	benachrichtige
interagiert	interagiert
fluppen	fluppen
Hallelujas	Hallelujas
Dödel	Dödel
analysieret	analysieret
gedolmetscht	gedolmetscht
wünschet	wünschet
verifizieret	verifizieret
geräuchert	geräuchert
Gefügen	Gefügen
würdet	würdet
darfst	darfst
erlabe	erlabe
Honigbären	Honigbären
verkriechet	verkriechet
Halogenatomen	Halogenatomen
Prüfbericht	Prüfbericht
vandaliere	vandaliere
schnitten	schnitten
malochte	malochte
bedrückest	bedrückest
Blockflöten	Blockflöten
Mäusen	Mäusen
schnürest	schnürest
Gefilden	Gefilden
ringst	ringst
Mageninhalt	Mageninhalt
Klotzes	Klotzes
folg	folg
Adler	Adler
Wucher	Wucher
thematisierte	thematisierte
Butzemänner	Butzemänner
losen	losen
pflüget	pflüget
Alles	Alles
Heiratsgütern	Heiratsgütern
Kleinod	Kleinod
Felsboden	Felsboden
Tintenklecks	Tintenklecks
Herabsetzungen	Herabsetzungen
scherzt	scherzt
Kleinode	Kleinode
übersehest	übersehest
Tetraiodide	Tetraiodide
Braunrallen	Braunrallen
prostituierte	prostituierte
linken	linken
funzt	funzt
schnappt	schnappt
schwöllen	schwöllen
Hubschraubern	Hubschraubern
egge	egge
Kopfverletzungen	Kopfverletzungen
gelobe	gelobe
Rinde	Rinde
folget	folget
befördert	befördert
eurer	eurer
blondieret	blondieret
Schickse	Schickse
parametrisierst	parametrisierst
köderte	köderte
regierten	regierten
Hälmchen	Hälmchen
Apportierhund	Apportierhund
Blitzableiter	Blitzableiter
verwerten	verwerten
Sanatoriums	Sanatoriums
stiftest	stiftest
Effekten	Effekten
lege	lege
Hainbuche	Hainbuche
griechisch	griechisch
zerfetzt	zerfetzt
Gehorsams	Gehorsams
gut	gut
fraget	fraget
glauben	glauben
bescheißt	bescheißt
maximiere	maximiere
erzeigte	erzeigte
gedenk	gedenk
klöne	klöne
verführten	verführten
rekonstruieren	rekonstruieren
karikieret	karikieret
hätte	hätte
mischt	mischt
Nanosatelliten	Nanosatelliten
verziehe	verziehe
Ablösung	Ablösung
Dorngesträuchen	Dorngesträuchen
Brauhaus	Brauhaus
bereitet	bereitet
schimmerst	schimmerst
Rosinenkuchenmodell	Rosinenkuchenmodell
verzierten	verzierten
traueret	traueret
verschlingt	verschlingt
Sippe	Sippe
Ausbeuter	Ausbeuter
liste	liste
lebte	lebte
erben	erben
dingt	dingt
Deckenfarbe	Deckenfarbe
verblute	verblute
nachwandelte	nachwandelte
Bär	Bär
negierte	negierte
Quellen	Quellen
Regenwald	Regenwald
rundest	rundest
vertonet	vertonet
changieren	changieren
absagen	absagen
urbanisier	urbanisier
pustet	pustet
Autoklaven	Autoklaven
füllen	füllen
Palme	Palme
dingten	dingten
Strafräume	Strafräume
Betten	Betten
angehöre	angehöre
Seit	Seit
Oxonium	Oxonium
Weinstöcken	Weinstöcken
Reichweite	Reichweite
Brechnüssen	Brechnüssen
genieret	genieret
beantrage	beantrage
fritierten	fritierten
motivierten	motivierten
wilden	wilden
Moren	Moren
Lesen	Lesen
eures	eures
taufst	taufst
arm	arm
zersetzet	zersetzet
Sichelzellenanämien	Sichelzellenanämien
rolltet	rolltet
schaust	schaust
Decket	Decket
Plüschtier	Plüschtier
schummelten	schummelten
pipettierten	pipettierten
Anachronismus	Anachronismus
frikassiert	frikassiert
applizirte	applizirte
touchiere	touchiere
Sitzfleisch	Sitzfleisch
schwadroniert	schwadroniert
Drang	Drang
Türklingeln	Türklingeln
krieget	krieget
scheiterest	scheiterest
gedenket	gedenket
Pflicht	Pflicht
Asteroid	Asteroid
drillte	drillte
Ochsen	Ochsen
Wahn	Wahn
greinen	greinen
Schlägst	Schlägst
Schlüchte	Schlüchte
begnadigte	begnadigte
Botokuden	Botokuden
spezialisiere	spezialisiere
Aufprall	Aufprall
unterstützten	unterstützten
Laubbläsern	Laubbläsern
schauest	schauest
explodierten	explodierten
pfänden	pfänden
googelten	googelten
gewitterest	gewitterest
tyrannisiertest	tyrannisiertest
pulsiert	pulsiert
Oberlandesgericht	Oberlandesgericht
Chlorwasserstoffmolekül	Chlorwasserstoffmolekül
zählet	zählet
grüntet	grüntet
erlagst	erlagst
grau	grau
Provinzen	Provinzen
versklavt	versklavt
Zeitungsenten	Zeitungsenten
panaschieret	panaschieret
sitzest	sitzest
Zwingburg	Zwingburg
Signal	Signal
Ångström	Ångström
Kurkuma	Kurkuma
Staatsführungen	Staatsführungen
weichet	weichet
Schuhe	Schuhe
Preisen	Preisen
sortierte	sortierte
demoralisiere	demoralisiere
füsilierte	füsilierte
Telefonnummern	Telefonnummern
Fußboden	Fußboden
Schreiet	Schreiet
Laufring	Laufring
zähltet	zähltet
loste	loste
lieben	lieben
nächsten	nächsten
reparierten	reparierten
Türkinnen	Türkinnen
Schotten	Schotten
bezieht	bezieht
hättest	hättest
entgegenkamst	entgegenkamst
setzten	setzten
junge	junge
erbringen	erbringen
Introjektion	Introjektion
Tumult	Tumult
peiltest	peiltest
Euter	Euter
prosteten	prosteten
raffinier	raffinier
toten	toten
Bildschirmfoto	Bildschirmfoto
Amen	Amen
führest	führest
Zwetschge	Zwetschge
kurz	kurz
gewährtest	gewährtest
abtrünnigen	abtrünnigen
War	War
unschuldige	unschuldige
Organistin	Organistin
schälte	schälte
Festen	Festen
Dienstgrade	Dienstgrade
leben	leben
Schreien	Schreien
Wer	Wer
Weiß	Weiß
verfehle	verfehle
Technetaten	Technetaten
Wasserquellen	Wasserquellen
Rehe	Rehe
ihren	ihren
predigen	predigen
attestiertet	attestiertet
bat	bat
Ecke	Ecke
willst	willst
Hände	Hände
verdammte	verdammte
hieltet	hieltet
herrschest	herrschest
implodier	implodier
Hunde	Hunde
euren	euren
kram	kram
Geboten	Geboten
zerrüttet	zerrüttet
Fetten	Fetten
feierten	feierten
schneidend	schneidend
fällen	fällen
warte	warte
vermeße	vermeße
Dorsch	Dorsch
ermordet	ermordet
bandagierte	bandagierte
Gehirnwelle	Gehirnwelle
Entsetzet	Entsetzet
Bette	Bette
Raute	Raute
Molybdit	Molybdit
Rekursionen	Rekursionen
Einöden	Einöden
weissagten	weissagten
lockerte	lockerte
fertig	fertig
vertilgte	vertilgte
reglementiert	reglementiert
gähnten	gähnten
verdunstet	verdunstet
durften	durften
Krokus	Krokus
Volkslehre	Volkslehre
hattest	hattest
wähnt	wähnt
Selbstversuch	Selbstversuch
Blässe	Blässe
Füllfederhalter	Füllfederhalter
würdest	würdest
ummantle	ummantle
hegten	hegten
punktest	punktest
Einzelgänger	Einzelgänger
frohlockest	frohlockest
widmet	widmet
verbrauchte	verbrauchte
Asteroide	Asteroide
Ställen	Ställen
Alten	Alten
arrivierst	arrivierst
Darlegung	Darlegung
Woge	Woge
zürnet	zürnet
heben	heben
verselbstständigest	verselbstständigest
Mittelaltermarktes	Mittelaltermarktes
Pflaumen	Pflaumen
trauerten	trauerten
downloadete	downloadete
Als	Als
Trichter	Trichter
leide	leide
meinte	meinte
rauben	rauben
imitiert	imitiert
absagt	absagt
Siglen	Siglen
Hertz	Hertz
Überschüssen	Überschüssen
handhabest	handhabest
Gänge	Gänge
bist	bist
zwang	zwang
Wahnen	Wahnen
Rotgusses	Rotgusses
lösest	lösest
Diethylether	Diethylether
schlachten	schlachten
Almanachen	Almanachen
Linien	Linien
bedingst	bedingst
Panamaer	Panamaer
suchte	suchte
Auszügen	Auszügen
gelobst	gelobst
kugele	kugele
Metonymie	Metonymie
tun	tun
Volkslehren	Volkslehren
Haltepunkt	Haltepunkt
irren	irren
sticke	sticke
Schild	Schild
Gäste	Gäste
tobte	tobte
ungehorsame	ungehorsame
entkörperlichte	entkörperlichte
klönen	klönen
verwirft	verwirft
entsündigten	entsündigten
kabelte	kabelte
ihres	ihres
Kernladungszahlen	Kernladungszahlen
säumen	säumen
glaubten	glaubten
Elementarzelle	Elementarzelle
Gebern	Gebern
Raucherinnen	Raucherinnen
Durchbruch	Durchbruch
Negermusik	Negermusik
Silberdrahts	Silberdrahts
verständig	verständig
Spitzen	Spitzen
Handbuch	Handbuch
Feldzug	Feldzug
kontaktiere	kontaktiere
versuchst	versuchst
denaturieret	denaturieret
glaubend	glaubend
emaillieret	emaillieret
verliere	verliere
Chronisten	Chronisten
Dich	Dich
widmend	widmend
Scherzen	Scherzen
Adenosin	Adenosin
strafe	strafe
verringerten	verringerten
mußten	mußten
zagest	zagest
entwickele	entwickele
Arsenbergwerk	Arsenbergwerk
sedimentiertet	sedimentiertet
unterdrücke	unterdrücke
Gallanen	Gallanen
dolmetschst	dolmetschst
liebte	liebte
unterwerft	unterwerft
beneidest	beneidest
schlummerte	schlummerte
zertifizierst	zertifizierst
quatschen	quatschen
Einen	Einen
preist	preist
regeln	regeln
blitz	blitz
Desserts	Desserts
vereinbarten	vereinbarten
einem	einem
Quelle	Quelle
erntest	erntest
überfischt	überfischt
Trinkgefäße	Trinkgefäße
zensiere	zensiere
Martyrologien	Martyrologien
schwelle	schwelle
kristallisiertest	kristallisiertest
Schlange	Schlange
jappten	jappten
Maßen	Maßen
verklagt	verklagt
Fromme	Fromme
Klüfte	Klüfte
Flussbett	Flussbett
Backenbärten	Backenbärten
brillierest	brillierest
geleitet	geleitet
Leichenschauhäuser	Leichenschauhäuser
wir	wir
Excimerlasern	Excimerlasern
Teekesseln	Teekesseln
Hat	Hat
Aktenkoffer	Aktenkoffer
Brettspielen	Brettspielen
Einöde	Einöde
Karern	Karern
letzte	letzte
feiert	feiert
Gesetze	Gesetze
Denn	Denn
Begrenzung	Begrenzung
jappen	jappen
Beschuldigung	Beschuldigung
scheue	scheue
besucht	besucht
missversteht	missversteht
erzeigten	erzeigten
verwechselst	verwechselst
Blaumeise	Blaumeise
Bildschirmfotos	Bildschirmfotos
boßte	boßte
Planer	Planer
stoppte	stoppte
Kakadu	Kakadu
beeinflusst	beeinflusst
Bajonette	Bajonette
Früchten	Früchten
habet	habet
Angaben	Angaben
aufrichtest	aufrichtest
kapiertet	kapiertet
Worten	Worten
Portale	Portale
beides	beides
meldeten	meldeten
Geschichtsbücher	Geschichtsbücher
Darlegungen	Darlegungen
Zeilen	Zeilen
Warten	Warten
entschädigte	entschädigte
markiere	markiere
gepuddelt	gepuddelt
hintertrieben	hintertrieben
Monarchie	Monarchie
Gehilfen	Gehilfen
tyrannisierte	tyrannisierte
ruckeln	ruckeln
grüßten	grüßten
verzögerten	verzögerten
solchem	solchem
teil	teil
kupieren	kupieren
Außenministerium	Außenministerium
Wogen	Wogen
Steiget	Steiget
ölt	ölt
warnt	warnt
zerfielen	zerfielen
Mönchen	Mönchen
Zubrötchen	Zubrötchen
Halt	Halt
googelest	googelest
prahlet	prahlet
Linguist	Linguist
ernteten	ernteten
Renegat	Renegat
trüb	trüb
gleich	gleich
Buntspechte	Buntspechte
formirte	formirte
Pflichten	Pflichten
versteckend	versteckend
Willst	Willst
Schläfchen	Schläfchen
moppst	moppst
Fiebermittel	Fiebermittel
bracht	bracht
lögen	lögen
recycele	recycele
trieb	trieb
Wühltische	Wühltische
dritte	dritte
Marokkanern	Marokkanern
Ypecaharallen	Ypecaharallen
schauet	schauet
tagen	tagen
Lautschriften	Lautschriften
bummelet	bummelet
Epiker	Epiker
Charakteristikan	Charakteristikan
hattet	hattet
Jungfernflug	Jungfernflug
betrügen	betrügen
Samarskite	Samarskite
gedachtest	gedachtest
Verkehrsflugzeug	Verkehrsflugzeug
meldet	meldet
unser	unser
knacktest	knacktest
aufkommen	aufkommen
Töpfen	Töpfen
substituierend	substituierend
teilet	teilet
beider	beider
Abfahrtsliste	Abfahrtsliste
erlösen	erlösen
speisen	speisen
überreichend	überreichend
Dessous	Dessous
versteckt	versteckt
grüßen	grüßen
zeugst	zeugst
Kohlrübe	Kohlrübe
Fettsack	Fettsack
pflücke	pflücke
verknüpft	verknüpft
vibrierend	vibrierend
lügt	lügt
Kunstgeschichte	Kunstgeschichte
zwingst	zwingst
Zunge	Zunge
Schnitzeljagd	Schnitzeljagd
dekoriere	dekoriere
prostete	prostete
begrub	begrub
Seetaucher	Seetaucher
desertierst	desertierst
Lümmeltüte	Lümmeltüte
verbitterest	verbitterest
schnüren	schnüren
Lehrkörpers	Lehrkörpers
Reflexionen	Reflexionen
beschrifteten	beschrifteten
jenen	jenen
weisen	weisen
Buchfinken	Buchfinken
Eisenkräutern	Eisenkräutern
verzeichnete	verzeichnete
Zankapfels	Zankapfels
denaturiert	denaturiert
anzeigt	anzeigt
Rhabarber	Rhabarber
winke	winke
wünschest	wünschest
Zeitschlitze	Zeitschlitze
umgäben	umgäben
schauspieleren	schauspieleren
erbte	erbte
Robe	Robe
Rufen	Rufen
bildest	bildest
unsere	unsere
Asiatin	Asiatin
Erbse	Erbse
klicket	klicket
spähet	spähet
Schaffnerin	Schaffnerin
Kontraindikationen	Kontraindikationen
Android	Android
prangte	prangte
Feierabend	Feierabend
Orten	Orten
Geringschätzung	Geringschätzung
schöben	schöben
gewurstelt	gewurstelt
plagte	plagte
überprüfte	überprüfte
wehr	wehr
Decks	Decks
Schlagzeugern	Schlagzeugern
gelangt	gelangt
Mageninhalten	Mageninhalten
Wände	Wände
Adeliepinguins	Adeliepinguins
torpedieret	torpedieret
rufet	rufet
Hie	Hie
Klärung	Klärung
Drohkulissen	Drohkulissen
Seines	Seines
Päckchen	Päckchen
Überweisung	Überweisung
Gaschromatographie	Gaschromatographie
Otaviten	Otaviten
sollst	sollst
ermächtigest	ermächtigest
Joche	Joche
unsre	unsre
Feierabende	Feierabende
gedächtet	gedächtet
fragst	fragst
kategorisierte	kategorisierte
Füllfedern	Füllfedern
untersagtest	untersagtest
plärrt	plärrt
Nukleinsäure	Nukleinsäure
skypet	skypet
befürchtet	befürchtet
Charakteristika	Charakteristika
gebührt	gebührt
Massage	Massage
bang	bang
ausgereckter	ausgereckter
pflügest	pflügest
lavierte	lavierte
verderben	verderben
mästet	mästet
schlagest	schlagest
Wandergewerbe	Wandergewerbe
Bebauungsplänen	Bebauungsplänen
backt	backt
ermächtige	ermächtige
Gewürzen	Gewürzen
Büchereien	Büchereien
scheinest	scheinest
Oheim	Oheim
Managementsystem	Managementsystem
evakuierte	evakuierte
glaubst	glaubst
Kapitalverkehr	Kapitalverkehr
langweilst	langweilst
Mops	Mops
hebräisch	hebräisch
schneidet	schneidet
Thioestere	Thioestere
Koniferen	Koniferen
Wunde	Wunde
Ackerschachtelhalm	Ackerschachtelhalm
Carbiden	Carbiden
Pianos	Pianos
Denunziationen	Denunziationen
Verehrer	Verehrer
trübe	trübe
beweisen	beweisen
dampfst	dampfst
Kompromissen	Kompromissen
verspätete	verspätete
verdammend	verdammend
gelang	gelang
nachwandeln	nachwandeln
Firnis	Firnis
Notständen	Notständen
Verwundete	Verwundete
wahre	wahre
Altbau	Altbau
eggte	eggte
verbirgst	verbirgst
blondiert	blondiert
aufhebt	aufhebt
Pausbacke	Pausbacke
bleibst	bleibst
vor	vor
Uterus	Uterus
brandeten	brandeten
kurze	kurze
keiner	keiner
Sabbaten	Sabbaten
Beobachtungen	Beobachtungen
krähte	krähte
ahnten	ahnten
bewies	bewies
Hüllenelektronen	Hüllenelektronen
forschen	forschen
reinigst	reinigst
Unsere	Unsere
initiierten	initiierten
spannte	spannte
Schwermetallion	Schwermetallion
solche	solche
Diesen	Diesen
geniertest	geniertest
schabst	schabst
offenbar	offenbar
fragen	fragen
Werde	Werde
Name	Name
sterilisierten	sterilisierten
leget	leget
erwachend	erwachend
Älteste	Älteste
gern	gern
sprühend	sprühend
verlöteten	verlöteten
Generation	Generation
mobilisierten	mobilisierten
frevler	frevler
Schnipsel	Schnipsel
vereinbaren	vereinbaren
Rückumlaute	Rückumlaute
Bestechungsgelder	Bestechungsgelder
strafend	strafend
Ölfasses	Ölfasses
Kleptokratie	Kleptokratie
Buntspechten	Buntspechten
Enthärtungen	Enthärtungen
wehrend	wehrend
fabuliert	fabuliert
ihre	ihre
demütige	demütige
Berufe	Berufe
Königen	Königen
vertiefe	vertiefe
hämmerst	hämmerst
zürntet	zürntet
parametrisierte	parametrisierte
Prostylos	Prostylos
all	all
Silbergeschirr	Silbergeschirr
fluppten	fluppten
ersparen	ersparen
Welche	Welche
dekompiliertest	dekompiliertest
beunruhige	beunruhige
prophezeie	prophezeie
mampfte	mampfte
Grizzlybär	Grizzlybär
letzten	letzten
behauptete	behauptete
Bis	Bis
einigst	einigst
lebst	lebst
Ränke	Ränke
löset	löset
nähernd	nähernd
Geldautomat	Geldautomat
Bushaltestelle	Bushaltestelle
hämmerte	hämmerte
jeder	jeder
evaluiert	evaluiert
bemächtigte	bemächtigte
hegst	hegst
Notärztinnen	Notärztinnen
beanspruchest	beanspruchest
umbrächten	umbrächten
streiften	streiften
Nussknackern	Nussknackern
Gewalttäter	Gewalttäter
Pläsieren	Pläsieren
eng	eng
Autokraten	Autokraten
duzet	duzet
bölkte	bölkte
Schanktisch	Schanktisch
bollerte	bollerte
lobte	lobte
Mittelaltermarkt	Mittelaltermarkt
demütig	demütig
pilgert	pilgert
Toren	Toren
neidest	neidest
Maximierung	Maximierung
Zäumen	Zäumen
leid	leid
Bombardierungen	Bombardierungen
blasen	blasen
Zeithorizonte	Zeithorizonte
Suffix	Suffix
Amputierte	Amputierte
Germanist	Germanist
Eutektikum	Eutektikum
verjährest	verjährest
Steuerwagen	Steuerwagen
Aha-Erlebnisse	Aha-Erlebnisse
Chlorwasserstoffmoleküls	Chlorwasserstoffmoleküls
blondieren	blondieren
verbärgen	verbärgen
Chlorat	Chlorat
Fröschen	Fröschen
scheltet	scheltet
Erfahrung	Erfahrung
unterwirft	unterwirft
Libellen	Libellen
stigmatisierst	stigmatisierst
anzöge	anzöge
weist	weist
Adlerbussarden	Adlerbussarden
Dinge	Dinge
tragen	tragen
Eselsohren	Eselsohren
benähmen	benähmen
Pardelkatze	Pardelkatze
niemand	niemand
Anzeichen	Anzeichen
Eissteinen	Eissteinen
Paralipse	Paralipse
Alle	Alle
harren	harren
seist	seist
inneren	inneren
schonte	schonte
Töpfe	Töpfe
Renegaten	Renegaten
Beobachtung	Beobachtung
Frommen	Frommen
Bedeutung	Bedeutung
Radfahrer	Radfahrer
Gute	Gute
ratschlagt	ratschlagt
Erstlinge	Erstlinge
Türklingel	Türklingel
vergiftet	vergiftet
Treibhausgase	Treibhausgase
wässerst	wässerst
Andrologie	Andrologie
Mischung	Mischung
hebe	hebe
Antitranspirante	Antitranspirante
heftetest	heftetest
verfehlten	verfehlten
desensibilisierte	desensibilisierte
Futtermitteln	Futtermitteln
entsündigte	entsündigte
reichet	reichet
gräbst	gräbst
zuppte	zuppte
Kissenschlacht	Kissenschlacht
dirigieret	dirigieret
Hirt	Hirt
Bürzeln	Bürzeln
Dochte	Dochte
Götzen	Götzen
haltet	haltet
elften	elften
erkalten	erkalten
Paillette	Paillette
Totenglocke	Totenglocke
ratschlaget	ratschlaget
Leid	Leid
laut	laut
Safrane	Safrane
wehrte	wehrte
speisend	speisend
Träumer	Träumer
schämte	schämte
Zeitbombe	Zeitbombe
Zehnten	Zehnten
log	log
entschleiert	entschleiert
revoltiert	revoltiert
WebHook	WebHook
gedenkst	gedenkst
Weichloten	Weichloten
eiterte	eiterte
stellen	stellen
geliebt	geliebt
ziert	ziert
Konzentrat	Konzentrat
verknüpfet	verknüpfet
Arme	Arme
argumentierten	argumentierten
glaubtet	glaubtet
kreierten	kreierten
kämmt	kämmt
verblutete	verblutete
zeugt	zeugt
redete	redete
Briketten	Briketten
Playlists	Playlists
Pfleglinge	Pfleglinge
löstest	löstest
argumentierest	argumentierest
einführen	einführen
tanze	tanze
dringest	dringest
Rauten	Rauten
Anarchisten	Anarchisten
Tun	Tun
zürne	zürne
offenbart	offenbart
Videoaufzeichnung	Videoaufzeichnung
aufkämen	aufkämen
blitzte	blitzte
enttäusche	enttäusche
gönnst	gönnst
wog	wog
solcher	solcher
erlaubest	erlaubest
anhangt	anhangt
Theologien	Theologien
mogelest	mogelest
tiefe	tiefe
lehnen	lehnen
funktionierte	funktionierte
Fotosynthese	Fotosynthese
Füchse	Füchse
zweifelte	zweifelte
schauspielert	schauspielert
hickste	hickste
füllte	füllte
Rheumatismus	Rheumatismus
schwirrt	schwirrt
bewiest	bewiest
Stücken	Stücken
Dorngesträuch	Dorngesträuch
stellte	stellte
sedimentieret	sedimentieret
Zeugnissen	Zeugnissen
berücksichtiget	berücksichtiget
kaserniert	kaserniert
tränke	tränke
hintertreibt	hintertreibt
bestanden	bestanden
Abschreckungen	Abschreckungen
griffe	griffe
Küchenmaschine	Küchenmaschine
erliegest	erliegest
Musters	Musters
Herkunft	Herkunft
Schlöte	Schlöte
Chasaren	Chasaren
Gewürze	Gewürze
schenkte	schenkte
Gerichte	Gerichte
Schläge	Schläge
offenbarest	offenbarest
entsetzen	entsetzen
tagest	tagest
hinterfragst	hinterfragst
sagtest	sagtest
verkündigest	verkündigest
Gammastrahlen	Gammastrahlen
liebst	liebst
durfte	durfte
Mauten	Mauten
Einer	Einer
Metallothioneinen	Metallothioneinen
beschotteret	beschotteret
verdrehet	verdrehet
vermöge	vermöge
Mitschuld	Mitschuld
stammelest	stammelest
fügt	fügt
messen	messen
knüpfte	knüpfte
austilge	austilge
Zeitungsente	Zeitungsente
bollerest	bollerest
Markisen	Markisen
Schulleiterin	Schulleiterin
knüpfet	knüpfet
Klappertöpfen	Klappertöpfen
verkleidete	verkleidete
prostituieret	prostituieret
Könige	Könige
liebet	liebet
schwöre	schwöre
Radsätzen	Radsätzen
Bete	Bete
verderbest	verderbest
Arsenolithen	Arsenolithen
fehlen	fehlen
verschaffte	verschaffte
Ratet	Ratet
Seetauchers	Seetauchers
beliefen	beliefen
concessionieren	concessionieren
Auguren	Auguren
extemporieret	extemporieret
Trotzkist	Trotzkist
reichtet	reichtet
Haltepunkten	Haltepunkten
Abartigkeit	Abartigkeit
lauten	lauten
verarbeite	verarbeite
Anschläge	Anschläge
kauten	kauten
Heere	Heere
frohlockte	frohlockte
Nullpunktes	Nullpunktes
Domänen	Domänen
observiertest	observiertest
Schuldner	Schuldner
quantisiere	quantisiere
Reinelemente	Reinelemente
rüste	rüste
manche	manche
Pailletten	Pailletten
Kraftfahrzeugen	Kraftfahrzeugen
hievst	hievst
schließen	schließen
Metaphern	Metaphern
frisch	frisch
widerstanden	widerstanden
bediene	bediene
dunkelten	dunkelten
wisperten	wisperten
spracht	spracht
verzieret	verzieret
blättertet	blättertet
Weinstöcke	Weinstöcke
bündelet	bündelet
kichern	kichern
Nahrungsbestandteil	Nahrungsbestandteil
Polierstahl	Polierstahl
leiste	leiste
durchzuck	durchzuck
Toten	Toten
Treppe	Treppe
Pläsier	Pläsier
gelangte	gelangte
zürnest	zürnest
tasteten	tasteten
sich	sich
geloben	geloben
Ärzte	Ärzte
Grießen	Grießen
rufst	rufst
höbest	höbest
Petersfischen	Petersfischen
desensibilisierten	desensibilisierten
ausführen	ausführen
Traggasen	Traggasen
Wunden	Wunden
mopsend	mopsend
verkleinern	verkleinern
Beteiligte	Beteiligte
protokollieren	protokollieren
Mäppchen	Mäppchen
analysiert	analysiert
Somiten	Somiten
idealisierest	idealisierest
Gründungsprivilegien	Gründungsprivilegien
Nussknacker	Nussknacker
irre	irre
kristallisierest	kristallisierest
Chlorats	Chlorats
Frettchen	Frettchen
Hackern	Hackern
naschten	naschten
Gedanke	Gedanke
Einsätzen	Einsätzen
lärmte	lärmte
siehst	siehst
Dank	Dank
verwaisten	verwaisten
glaubet	glaubet
Gipfeltreffen	Gipfeltreffen
Sogen	Sogen
Hektaren	Hektaren
Drohkulisse	Drohkulisse
Essigsäurechloriden	Essigsäurechloriden
predigend	predigend
Fetzen	Fetzen
entzögen	entzögen
Argyroditen	Argyroditen
emendierte	emendierte
Einrad	Einrad
egalisierten	egalisierten
Ebene	Ebene
löste	löste
naschst	naschst
käbbelnd	käbbelnd
entzweit	entzweit
verallgemeinerest	verallgemeinerest
achten	achten
kämpfet	kämpfet
zeugtest	zeugtest
nachwandelt	nachwandelt
Fluorkohlenwasserstoffe	Fluorkohlenwasserstoffe
Abschirmung	Abschirmung
schlachtet	schlachtet
stapften	stapften
löst	löst
Gerücht	Gerücht
Gummibaumes	Gummibaumes
Fremdwort	Fremdwort
boykottierst	boykottierst
Brotkästen	Brotkästen
wähnet	wähnet
Sprecher	Sprecher
Aachener	Aachener
verlieren	verlieren
Weißflügelpinguin	Weißflügelpinguin
hebst	hebst
lackiere	lackiere
Operationssaal	Operationssaal
sponsert	sponsert
steuerte	steuerte
Radfahrern	Radfahrern
Wechselstuben	Wechselstuben
dürfte	dürfte
regiertest	regiertest
Verbrechen	Verbrechen
herrschten	herrschten
verwiesen	verwiesen
Blättchen	Blättchen
sagen	sagen
Für	Für
Blutgefäß	Blutgefäß
sponsertest	sponsertest
Abszisse	Abszisse
zirpen	zirpen
Blaumeisen	Blaumeisen
segmentierten	segmentierten
Fellen	Fellen
bromiert	bromiert
bequemtet	bequemtet
Glaubst	Glaubst
Tollkirsche	Tollkirsche
kramen	kramen
Stierkämpfe	Stierkämpfe
Gallan	Gallan
begruben	begruben
ersparte	ersparte
begehre	begehre
Speeren	Speeren
Aphasie	Aphasie
Untern	Untern
Prozedur	Prozedur
malet	malet
lang	lang
zerbrechen	zerbrechen
seinen	seinen
bekriegt	bekriegt
dissentierte	dissentierte
deckte	deckte
Habe	Habe
Bleigehalt	Bleigehalt
glühten	glühten
Soll	Soll
stimmte	stimmte
schau	schau
bröckeln	bröckeln
Sprödmetall	Sprödmetall
protestierst	protestierst
Arsenbergwerken	Arsenbergwerken
Heuschrecken	Heuschrecken
würden	würden
gleitest	gleitest
Konfitüre	Konfitüre
gestatte	gestatte
haderte	haderte
beanspruchet	beanspruchet
vertilgen	vertilgen
schmeichelest	schmeichelest
Datentypen	Datentypen
verbleibet	verbleibet
lobet	lobet
Literaturen	Literaturen
gelobte	gelobte
schon	schon
untersagest	untersagest
Atombombe	Atombombe
durchzuckest	durchzuckest
gelangen	gelangen
Leugnungen	Leugnungen
bedient	bedient
merken	merken
Acetat	Acetat
Zitronensaft	Zitronensaft
präsentiere	präsentiere
verschärftet	verschärftet
Kriegsschauplätze	Kriegsschauplätze
Laken	Laken
Rubinen	Rubinen
Seehechte	Seehechte
Stechpalmen	Stechpalmen
Letzte	Letzte
Arbeitsbereich	Arbeitsbereich
Telefonnummer	Telefonnummer
zählten	zählten
Eistaucher	Eistaucher
Sizilianer	Sizilianer
pressierten	pressierten
Abarten	Abarten
Galopps	Galopps
sagest	sagest
Arsch	Arsch
Bächen	Bächen
Beiblätter	Beiblätter
Rücktrittbremsen	Rücktrittbremsen
betrüben	betrüben
bimmelten	bimmelten
Herbstwinde	Herbstwinde
Schlüchten	Schlüchten
Schnallen	Schnallen
Tasten	Tasten
antworte	antworte
Fluorkohlenwasserstoff	Fluorkohlenwasserstoff
gequasselt	gequasselt
lachet	lachet
Danket	Danket
vertreiben	vertreiben
fabuliere	fabuliere
Trümmersprache	Trümmersprache
Zehen	Zehen
jammerte	jammerte
berücksichtigt	berücksichtigt
Fußballweltmeisterschaftsqualifikationsspiel	Fußballweltmeisterschaftsqualifikationsspiel
Extremen	Extremen
grübelt	grübelt
traget	traget
predige	predige
benehme	benehme
Gedächtnisse	Gedächtnisse
ritzten	ritzten
Brechnuss	Brechnuss
Seine	Seine
Würzen	Würzen
verführest	verführest
Jünglinge	Jünglinge
filtern	filtern
konntest	konntest
geleitest	geleitest
Europameistern	Europameistern
hüpfest	hüpfest
wünschen	wünschen
feiere	feiere
rote	rote
bekannten	bekannten
halt	halt
diskutierst	diskutierst
Aerosole	Aerosole
verliert	verliert
Smaragdkehlkolibris	Smaragdkehlkolibris
strandeten	strandeten
Aha-Erlebnis	Aha-Erlebnis
Bärenfelle	Bärenfelle
Roben	Roben
verfliegest	verfliegest
entfolgst	entfolgst
rotten	rotten
Denkmünze	Denkmünze
bereitete	bereitete
Pfeilen	Pfeilen
zentrierest	zentrierest
hinterfragten	hinterfragten
Rundbriefe	Rundbriefe
wünschte	wünschte
Otavit	Otavit
Mopp	Mopp
meißelt	meißelt
foppte	foppte
spaltetest	spaltetest
gespeist	gespeist
unschuldigen	unschuldigen
Sekretärinnen	Sekretärinnen
Forschungen	Forschungen
wehre	wehre
assimilierte	assimilierte
Heeren	Heeren
Festons	Festons
verachtet	verachtet
erzwangt	erzwangt
schleim	schleim
umhüllend	umhüllend
Auszüge	Auszüge
liegen	liegen
Spende	Spende
versteigernd	versteigernd
lehrest	lehrest
Märkten	Märkten
Euren	Euren
Tukans	Tukans
entkämen	entkämen
blätteret	blätteret
parametrisierten	parametrisierten
Flossen	Flossen
Komponistin	Komponistin
erwärmet	erwärmet
addieren	addieren
Fetzens	Fetzens
Glauben	Glauben
Tore	Tore
zupfte	zupfte
Safran	Safran
verselbständigt	verselbständigt
Aluminaten	Aluminaten
vergleichet	vergleichet
heparinisiere	heparinisiere
Bergsteiger	Bergsteiger
Küchenmaschinen	Küchenmaschinen
heißest	heißest
ermutigte	ermutigte
Dezernaten	Dezernaten
knufften	knufften
Aggressor	Aggressor
ertraget	ertraget
analysiere	analysiere
Zensus	Zensus
addierest	addierest
schäumtest	schäumtest
verschränkest	verschränkest
Beiblättern	Beiblättern
wäre	wäre
entmineralisieren	entmineralisieren
Flaschenhälsen	Flaschenhälsen
greinet	greinet
entflieht	entflieht
erntet	erntet
Graphem	Graphem
bebet	bebet
Lautwandeln	Lautwandeln
Reliquiare	Reliquiare
Eingabe	Eingabe
brecht	brecht
Übelkeit	Übelkeit
Friedensforscherinnen	Friedensforscherinnen
einigte	einigte
trinken	trinken
Deckenzapfen	Deckenzapfen
Kalifeldspat	Kalifeldspat
losten	losten
hätten	hätten
Wisset	Wisset
Streich	Streich
Recitativen	Recitativen
Arbeitsgruppen	Arbeitsgruppen
Stämme	Stämme
unserem	unserem
zerreißt	zerreißt
bedrücktest	bedrücktest
Abfertigungsschalter	Abfertigungsschalter
Hehler	Hehler
Unterseite	Unterseite
besprengen	besprengen
verfängt	verfängt
Hurriter	Hurriter
peilst	peilst
Stätte	Stätte
verflog	verflog
kickst	kickst
mogelten	mogelten
föchten	föchten
Sanatorien	Sanatorien
Haue	Haue
Landwirt	Landwirt
Habt	Habt
Bonzen	Bonzen
Taschenwörterbuches	Taschenwörterbuches
Buchfink	Buchfink
gezählt	gezählt
Pflaume	Pflaume
kämpfen	kämpfen
dressieret	dressieret
Geldautomaten	Geldautomaten
begebe	begebe
Kleptokratien	Kleptokratien
zürnte	zürnte
klappen	klappen
Armband	Armband
Herzchen	Herzchen
mobilisieret	mobilisieret
Schwebfliegen	Schwebfliegen
Philerast	Philerast
grüße	grüße
malten	malten
Kürasse	Kürasse
bandagiert	bandagiert
lange	lange
Citrat	Citrat
planschtest	planschtest
Reiterschwertern	Reiterschwertern
porträtiert	porträtiert
Zinkat	Zinkat
erkaltest	erkaltest
privatisiert	privatisiert
begehrend	begehrend
wurde	wurde
zentrifugieren	zentrifugieren
Physikerin	Physikerin
Grenzwert	Grenzwert
verschmelzen	verschmelzen
Freibrief	Freibrief
Kassettenrekordern	Kassettenrekordern
stäupen	stäupen
Unternehmensanwendungsintegrationen	Unternehmensanwendungsintegrationen
straften	straften
Stilllegungen	Stilllegungen
Bällchen	Bällchen
linsten	linsten
Hode	Hode
Dürren	Dürren
Malaysiers	Malaysiers
Bärte	Bärte
herrschet	herrschet
Heringen	Heringen
schwängen	schwängen
konsumieren	konsumieren
filzte	filzte
schauen	schauen
Fahrzeugkatalysator	Fahrzeugkatalysator
arrivieren	arrivieren
zürnten	zürnten
Ass	Ass
Stoffwechselwegen	Stoffwechselwegen
Ringeltaube	Ringeltaube
beleuchteten	beleuchteten
Gicht	Gicht
einer	einer
Scherzes	Scherzes
denen	denen
Finanzministerien	Finanzministerien
Lautschrift	Lautschrift
lesen	lesen
Spitze	Spitze
Durchbruches	Durchbruches
chloroformieret	chloroformieret
sündigt	sündigt
labert	labert
dissentierten	dissentierten
Chelatkomplex	Chelatkomplex
graben	graben
Reinigungsschritten	Reinigungsschritten
fällt	fällt
Hobbys	Hobbys
entrümpelest	entrümpelest
leuchtete	leuchtete
tastet	tastet
Äther	Äther
versteckte	versteckte
Zwergschwanes	Zwergschwanes
assimilierten	assimilierten
putzte	putzte
Impedanz	Impedanz
Höschens	Höschens
mehr	mehr
wert	wert
hatte	hatte
surre	surre
Urbaren	Urbaren
Wirtschaftswissenschaft	Wirtschaftswissenschaft
Loben	Loben
schaben	schaben
Trotzkisten	Trotzkisten
trägt	trägt
leihe	leihe
saget	saget
observierst	observierst
Proton	Proton
injizierest	injizierest
verprügelet	verprügelet
Elastomer	Elastomer
Butzemann	Butzemann
verfange	verfange
vermöget	vermöget
vertäte	vertäte
Steuerbord	Steuerbord
Kompromiss	Kompromiss
abzieht	abzieht
stimme	stimme
heilte	heilte
setztet	setztet
Sorge	Sorge
Vorhäute	Vorhäute
bewiese	bewiese
Reiterschwert	Reiterschwert
fluppt	fluppt
Plumpse	Plumpse
ansehet	ansehet
umbrächte	umbrächte
Kassiterits	Kassiterits
der	der
überbewerte	überbewerte
plagest	plagest
ratschlagte	ratschlagte
wünschtest	wünschtest
läutetet	läutetet
schiesst	schiesst
wilde	wilde
trieben	trieben
Dingen	Dingen
verschlimmerte	verschlimmerte
schiebest	schiebest
Feldbett	Feldbett
regieren	regieren
Herrn	Herrn
amenagiere	amenagiere
legend	legend
interagierte	interagierte
Carbid	Carbid
anrichtet	anrichtet
Rücktrittes	Rücktrittes
Schlager	Schlager
besetzen	besetzen
verschicket	verschicket
verdammen	verdammen
emigriert	emigriert
winkt	winkt
Geheimdienst	Geheimdienst
gedenkt	gedenkt
hättet	hättet
Penis	Penis
weiche	weiche
still	still
klagen	klagen
Rutheniumkomplex	Rutheniumkomplex
Haarshampoos	Haarshampoos
prangest	prangest
Seehechten	Seehechten
hydrolysierest	hydrolysierest
regierst	regierst
gedächten	gedächten
Adeliepinguin	Adeliepinguin
Aacheners	Aacheners
verallgemeinerst	verallgemeinerst
Lautwandel	Lautwandel
entmineralisieret	entmineralisieret
weichen	weichen
Klassenzimmer	Klassenzimmer
bete	bete
heiliget	heiliget
gerne	gerne
Pfahl	Pfahl
Primärenergien	Primärenergien
Galeere	Galeere
Sportlerin	Sportlerin
Früchtchen	Früchtchen
Stücke	Stücke
Strontiumamalgamen	Strontiumamalgamen
bewahrheitetet	bewahrheitetet
jauchzt	jauchzt
langte	langte
Sollten	Sollten
verreisest	verreisest
orgelt	orgelt
Hinterwäldlern	Hinterwäldlern
fladerten	fladerten
entsetzten	entsetzten
alarmiere	alarmiere
Geräte	Geräte
verwirrest	verwirrest
eher	eher
Bärenfellen	Bärenfellen
möchtet	möchtet
Kupferkiese	Kupferkiese
hüpfen	hüpfen
Adventskalender	Adventskalender
Gerät	Gerät
Ion	Ion
Wüsten	Wüsten
seinem	seinem
dirigieren	dirigieren
Geliebten	Geliebten
wehrt	wehrt
überschatteten	überschatteten
Uranerzen	Uranerzen
Kompassen	Kompassen
Weißt	Weißt
verlähmte	verlähmte
wachen	wachen
Verdachtes	Verdachtes
urteilen	urteilen
schützt	schützt
Laubbläser	Laubbläser
Korrosionsschutzen	Korrosionsschutzen
frohlocke	frohlocke
Nanosatellit	Nanosatellit
tränkten	tränkten
Schönrednern	Schönrednern
reichen	reichen
grabbelten	grabbelten
koexistierte	koexistierte
lauf	lauf
ungefälschtem	ungefälschtem
versuchen	versuchen
erstehst	erstehst
erratet	erratet
rodet	rodet
belohnten	belohnten
bestrafe	bestrafe
öle	öle
Augenglases	Augenglases
Namen	Namen
Wären	Wären
erlaube	erlaube
protestieret	protestieret
erkannte	erkannte
dotierst	dotierst
gare	gare
frikassierend	frikassierend
Unter	Unter
Flöße	Flöße
flitzte	flitzte
Pforte	Pforte
Meeren	Meeren
Pest	Pest
Vaginen	Vaginen
reicht	reicht
löstet	löstet
Zement	Zement
einführt	einführt
Kandidaturen	Kandidaturen
begehrten	begehrten
gebündelt	gebündelt
lochtest	lochtest
Sitzfleisches	Sitzfleisches
eines	eines
Molybdite	Molybdite
besänftiget	besänftiget
schnorrtet	schnorrtet
jemanden	jemanden
haben	haben
injiziert	injiziert
lüftet	lüftet
Suchanfrage	Suchanfrage
Innenministerien	Innenministerien
spekuliere	spekuliere
scheuchtest	scheuchtest
belüftete	belüftete
Dachdeckerinnen	Dachdeckerinnen
gedurft	gedurft
Ausstiegstüren	Ausstiegstüren
strandend	strandend
Scheißkerl	Scheißkerl
entfachet	entfachet
hydrogentartrat	hydrogentartrat
vierte	vierte
Obszönität	Obszönität
Fluoratomen	Fluoratomen
Platte	Platte
Myriade	Myriade
Psi	Psi
konnten	konnten
Teppiche	Teppiche
Exilanten	Exilanten
wünschst	wünschst
Referenzen	Referenzen
Kronsbeere	Kronsbeere
Serverzugriffen	Serverzugriffen
schenken	schenken
fragmentierst	fragmentierst
ärgernd	ärgernd
Aspartamen	Aspartamen
rittest	rittest
Apotheose	Apotheose
Kautschuken	Kautschuken
polymerisier	polymerisier
ruckelst	ruckelst
Alltag	Alltag
unserer	unserer
suchen	suchen
Entmachtungen	Entmachtungen
Ochs	Ochs
posiert	posiert
wärt	wärt
Germanisten	Germanisten
verführte	verführte
Schreiben	Schreiben
käbbelte	käbbelte
gekröst	gekröst
grünen	grünen
Ahnen	Ahnen
transportierten	transportierten
welchen	welchen
Hadith	Hadith
Gaunern	Gaunern
Nukleinsäuren	Nukleinsäuren
Edelsteinen	Edelsteinen
fluktuiert	fluktuiert
Hast	Hast
gewähr	gewähr
besprichst	besprichst
folgst	folgst
punkten	punkten
explodierst	explodierst
Türkenbünden	Türkenbünden
Heiden	Heiden
Tote	Tote
watet	watet
ungehorsam	ungehorsam
Ausnahmen	Ausnahmen
ob	ob
Deck	Deck
enttäuschet	enttäuschet
faule	faule
redetest	redetest
grübelten	grübelten
murmelst	murmelst
verspäteten	verspäteten
Schläfchens	Schläfchens
verstecken	verstecken
Tumulten	Tumulten
Hektare	Hektare
alles	alles
Messies	Messies
deaktiviere	deaktiviere
bemühten	bemühten
gute	gute
zwölfte	zwölfte
zeichnet	zeichnet
bejubelte	bejubelte
buddeln	buddeln
Bruchstriches	Bruchstriches
drosselten	drosselten
zuppt	zuppt
knuffend	knuffend
entgehe	entgehe
fegte	fegte
Denen	Denen
Hornung	Hornung
Excimerlaser	Excimerlaser
Spektroskopie	Spektroskopie
geherrscht	geherrscht
Tübinger	Tübinger
schlaf	schlaf
lavierend	lavierend
vermeßest	vermeßest
haarten	haarten
Omnibusse	Omnibusse
Atommassen	Atommassen
zuteil	zuteil
sorget	sorget
austilgen	austilgen
pflücktet	pflücktet
Iberers	Iberers
bereue	bereue
Stoffwechselweg	Stoffwechselweg
dringst	dringst
Stadtbezirken	Stadtbezirken
zählte	zählte
Wiederauferstehung	Wiederauferstehung
kasernierte	kasernierte
installierten	installierten
grünest	grünest
verkündet	verkündet
strafst	strafst
verbrauchet	verbrauchet
Gewalttätern	Gewalttätern
unseren	unseren
kautest	kautest
baggerst	baggerst
entsetzt	entsetzt
kehrst	kehrst
verbündeten	verbündeten
Drache	Drache
egalisiertet	egalisiertet
erwähnet	erwähnet
trompetete	trompetete
touchierte	touchierte
besser	besser
kooperierst	kooperierst
Chinakohl	Chinakohl
leertet	leertet
Rotgüssen	Rotgüssen
herrschte	herrschte
achte	achte
konnte	konnte
urbanisiert	urbanisiert
verglichest	verglichest
pharyngalisierten	pharyngalisierten
innere	innere
Bildpunkten	Bildpunkten
nachwandelst	nachwandelst
baten	baten
Eingeweide	Eingeweide
sterilisierte	sterilisierte
Vetter	Vetter
Fußballweltmeisterschaftsqualifikationsspielen	Fußballweltmeisterschaftsqualifikationsspielen
Kerzenlichter	Kerzenlichter
Finanzministerium	Finanzministerium
konnotierst	konnotierst
Hinterwäldler	Hinterwäldler
Rutheniumkomplexen	Rutheniumkomplexen
Bezeugungen	Bezeugungen
erklingt	erklingt
handhaben	handhaben
vermögen	vermögen
Schlagern	Schlagern
betätigest	betätigest
massakrierten	massakrierten
Republikflucht	Republikflucht
Schneidern	Schneidern
Knechten	Knechten
gelobt	gelobt
fluktuierte	fluktuierte
Treibhausgasen	Treibhausgasen
beiden	beiden
Knabe	Knabe
Sündern	Sündern
vermahnte	vermahnte
Keile	Keile
Prostyloi	Prostyloi
Solchen	Solchen
nähet	nähet
trödele	trödele
implodiere	implodiere
Einbrecher	Einbrecher
verdammt	verdammt
obfuskierten	obfuskierten
wallfahrest	wallfahrest
lockerst	lockerst
verziehen	verziehen
legen	legen
Bleiglanzes	Bleiglanzes
billigte	billigte
weisest	weisest
überweisend	überweisend
idealisieret	idealisieret
verrosteten	verrosteten
Eilande	Eilande
Meinen	Meinen
Effekt	Effekt
Hirnstämmen	Hirnstämmen
lehrst	lehrst
schwangt	schwangt
scheinen	scheinen
Untiefe	Untiefe
Marokkaners	Marokkaners
Buchstabe	Buchstabe
Vordenker	Vordenker
Nagellackentferner	Nagellackentferner
erwärmten	erwärmten
Dein	Dein
zerrüttete	zerrüttete
regelet	regelet
Fallet	Fallet
reinstitutionalisiert	reinstitutionalisiert
entwischtet	entwischtet
Streichen	Streichen
dekompilierten	dekompilierten
stäupt	stäupt
Gemütes	Gemütes
Schwirrvögel	Schwirrvögel
Kristalle	Kristalle
flieh	flieh
unterbewertete	unterbewertete
den	den
inhalier	inhalier
verzieht	verzieht
Freitagnachmittage	Freitagnachmittage
Verbindungsdrähten	Verbindungsdrähten
bombardiertet	bombardiertet
preisen	preisen
überreicht	überreicht
backen	backen
Kriegsschauplatz	Kriegsschauplatz
Muster	Muster
grünte	grünte
dehydrierte	dehydrierte
führet	führet
weinet	weinet
erschüttere	erschüttere
Anspielungen	Anspielungen
Schwan	Schwan
Stilllegung	Stilllegung
Bilderstürmer	Bilderstürmer
Märchenbuches	Märchenbuches
Nachweisreagenzien	Nachweisreagenzien
irrte	irrte
sabbelt	sabbelt
Borkenkäfer	Borkenkäfer
hantierte	hantierte
Silbererzen	Silbererzen
Lehrkörpern	Lehrkörpern
seit	seit
vernickele	vernickele
stärken	stärken
Bäche	Bäche
grüßest	grüßest
enträtselst	enträtselst
Wurzelwachstum	Wurzelwachstum
Bajonetten	Bajonetten
Gewinnungen	Gewinnungen
Fellachinnen	Fellachinnen
beichteten	beichteten
Puffersystem	Puffersystem
mein	mein
Adamsäpfeln	Adamsäpfeln
sedimentiert	sedimentiert
erwachet	erwachet
schlaft	schlaft
fastetet	fastetet
stellet	stellet
pharyngalisierst	pharyngalisierst
folgt	folgt
blondierten	blondierten
Gehorsam	Gehorsam
Vergrößerungen	Vergrößerungen
liebend	liebend
Knöllchens	Knöllchens
allem	allem
Gefängnissen	Gefängnissen
verbüßest	verbüßest
rufest	rufest
erfreute	erfreute
fistet	fistet
Helmen	Helmen
Extrems	Extrems
Kohlenstoffgehalt	Kohlenstoffgehalt
essest	essest
auszogen	auszogen
Knechte	Knechte
heischten	heischten
tief	tief
Krustentier	Krustentier
pfände	pfände
Imperialismen	Imperialismen
batest	batest
verbirgt	verbirgt
glaubte	glaubte
überfällst	überfällst
Sagte	Sagte
taufte	taufte
Hobby	Hobby
Würfelspiel	Würfelspiel
Zehe	Zehe
Hummern	Hummern
entstände	entstände
erpress	erpress
Nadelbäumen	Nadelbäumen
misstrauen	misstrauen
begrübest	begrübest
verleumdete	verleumdete
verteidigte	verteidigte
besorg	besorg
geschlummert	geschlummert
Strontiumamalgams	Strontiumamalgams
aufkommt	aufkommt
Bestecken	Bestecken
verschärfst	verschärfst
grien	grien
keine	keine
Pis	Pis
Remisen	Remisen
Attentäter	Attentäter
Trägergas	Trägergas
überquerst	überquerst
klone	klone
gedächte	gedächte
keinen	keinen
Weil	Weil
zentrifugierst	zentrifugierst
Stärkungsmittel	Stärkungsmittel
verbesserten	verbesserten
vertuest	vertuest
verführt	verführt
Oberbegriff	Oberbegriff
grüßend	grüßend
Katamaran	Katamaran
denaturierte	denaturierte
sedimentierte	sedimentierte
Blütenachse	Blütenachse
zierte	zierte
streifte	streifte
Gegenleistungen	Gegenleistungen
Zebrahaies	Zebrahaies
warne	warne
brausen	brausen
verhörest	verhörest
zerbräche	zerbräche
Tintenklecksen	Tintenklecksen
Monde	Monde
Cyanat	Cyanat
verzieh	verzieh
mischst	mischst
porträtiere	porträtiere
strullerst	strullerst
Wachtel	Wachtel
Irrtumes	Irrtumes
Kurkumen	Kurkumen
essen	essen
blitze	blitze
betrübte	betrübte
blamierest	blamierest
Homodimere	Homodimere
Dilettanten	Dilettanten
konvertiere	konvertiere
Rundbriefen	Rundbriefen
schaffst	schaffst
Kalifeldspate	Kalifeldspate
pflanzen	pflanzen
narret	narret
begräbt	begräbt
Besprechungen	Besprechungen
fabulierest	fabulierest
eurem	eurem
Substanzen	Substanzen
schauten	schauten
solle	solle
manchen	manchen
Leset	Leset
Erfahrungen	Erfahrungen
decken	decken
reparieret	reparieret
analysierest	analysierest
verließen	verließen
schautest	schautest
heparinisierten	heparinisierten
Bazzit	Bazzit
erliegst	erliegst
Abbindebeschleunigern	Abbindebeschleunigern
warst	warst
applizirst	applizirst
Dochten	Dochten
liehe	liehe
läuten	läuten
vermutet	vermutet
Gehirnwellen	Gehirnwellen
Lebenskräften	Lebenskräften
Sabbate	Sabbate
köderet	köderet
betrübest	betrübest
Schober	Schober
widerstand	widerstand
tobend	tobend
plumpsten	plumpsten
erwürgest	erwürgest
keinem	keinem
Zwangsarbeiterin	Zwangsarbeiterin
Schauet	Schauet
Geber	Geber
deponiere	deponiere
Steige	Steige
dresche	dresche
wirst	wirst
häufen	häufen
reichtest	reichtest
Lärchen	Lärchen
Begrenzungen	Begrenzungen
warntest	warntest
späht	späht
verkündige	verkündige
Anwendungsgebiet	Anwendungsgebiet
scherze	scherze
Erstlingen	Erstlingen
Deinem	Deinem
wer	wer
Halbgott	Halbgott
Spielen	Spielen
föhnten	föhnten
Finanzministern	Finanzministern
frevle	frevle
widerrufe	widerrufe
verwirfst	verwirfst
feiern	feiern
Meter	Meter
Berichterstattungen	Berichterstattungen
Gedächtnissen	Gedächtnissen
hadertet	hadertet
Gästen	Gästen
Aktienkursen	Aktienkursen
Trioxid	Trioxid
Den	Den
haste	haste
knackt	knackt
Holzquirl	Holzquirl
aufheben	aufheben
Senkungen	Senkungen
Ingredienzen	Ingredienzen
Zöpfen	Zöpfen
Gurt	Gurt
Kryostat	Kryostat
aufhoben	aufhoben
bessere	bessere
ritze	ritze
lochten	lochten
Anmelder	Anmelder
durchläuterte	durchläuterte
rufen	rufen
möppertet	möppertet
ihrem	ihrem
zerrisset	zerrisset
kehren	kehren
umkäme	umkäme
besorgt	besorgt
Libelle	Libelle
verkapselten	verkapselten
klettert	klettert
bräunen	bräunen
verwirrte	verwirrte
Ausländer	Ausländer
sabbelten	sabbelten
Gemüseläden	Gemüseläden
Strahlentierchen	Strahlentierchen
watete	watete
Mammut	Mammut
Einfältigkeit	Einfältigkeit
Subspezies	Subspezies
Hirnstämme	Hirnstämme
bewahrheitete	bewahrheitete
revoltierte	revoltierte
Frösche	Frösche
Leiden	Leiden
entwaffnest	entwaffnest
überlebest	überlebest
Meere	Meere
lodertet	lodertet
Fallen	Fallen
setzte	setzte
Toypudel	Toypudel
narren	narren
Scheißkerlen	Scheißkerlen
evaluierten	evaluierten
reizest	reizest
ansehen	ansehen
Bundesgebieten	Bundesgebieten
Geburtsnamen	Geburtsnamen
grause	grause
Freitagnachmittagen	Freitagnachmittagen
Bist	Bist
respektieren	respektieren
harrest	harrest
Efeu	Efeu
unterfordern	unterfordern
schlabbere	schlabbere
heißet	heißet
kritzelet	kritzelet
betrübend	betrübend
fastetest	fastetest
Flenser	Flenser
Bürzel	Bürzel
schichteten	schichteten
Transportwegen	Transportwegen
parfümierte	parfümierte
Polizeisprechern	Polizeisprechern
beförderet	beförderet
ersparet	ersparet
Suffixen	Suffixen
Letzten	Letzten
Äste	Äste
Trichtern	Trichtern
ungeistlich	ungeistlich
Pedant	Pedant
henken	henken
Gebäcken	Gebäcken
streuen	streuen
Metallquirlen	Metallquirlen
ankern	ankern
säusele	säusele
rebelliertet	rebelliertet
Kraftfahrzeuges	Kraftfahrzeuges
halbierest	halbierest
Tübingern	Tübingern
triebe	triebe
Empfängnisverhütungen	Empfängnisverhütungen
Kaufleuten	Kaufleuten
Düften	Düften
Greyerzer	Greyerzer
Fiebermitteln	Fiebermitteln
Vorhäuten	Vorhäuten
repräsentierten	repräsentierten
Reinelementen	Reinelementen
schubset	schubset
verbündend	verbündend
Ecken	Ecken
Assistentinnen	Assistentinnen
Schätzen	Schätzen
Selbstversuche	Selbstversuche
entschädiget	entschädiget
Judenräte	Judenräte
stutzt	stutzt
Betainen	Betainen
Solcher	Solcher
Vorstädten	Vorstädten
Kirgisinnen	Kirgisinnen
Anschlägen	Anschlägen
verstecktet	verstecktet
abtrünnige	abtrünnige
begliche	begliche
Uteri	Uteri
defragmentierten	defragmentierten
betrübtet	betrübtet
Wäre	Wäre
Mobilfunknetzen	Mobilfunknetzen
fastete	fastete
Entree	Entree
ärgerte	ärgerte
Forschung	Forschung
Kassiteriten	Kassiteriten
Rooibos	Rooibos
sollten	sollten
verzeigt	verzeigt
ehret	ehret
betrübt	betrübt
gereicht	gereicht
bange	bange
segelte	segelte
demütigte	demütigte
Azubi	Azubi
Taube	Taube
Preis	Preis
verwechselet	verwechselet
Verkehrsflugzeuge	Verkehrsflugzeuge
Futur	Futur
Theistin	Theistin
Drillingen	Drillingen
Sauberfrau	Sauberfrau
bewieset	bewieset
kitzele	kitzele
Animation	Animation
besichert	besichert
Kakaos	Kakaos
Druckfehler	Druckfehler
sprachen	sprachen
überfischte	überfischte
Fokus	Fokus
haltest	haltest
emittierte	emittierte
Gruftis	Gruftis
beeindruckt	beeindruckt
konntet	konntet
Ha	Ha
Abnahme	Abnahme
Abbindebeschleuniger	Abbindebeschleuniger
Haarverlust	Haarverlust
gratuliert	gratuliert
Entrées	Entrées
knurrtet	knurrtet
Biokraftstoffes	Biokraftstoffes
kramten	kramten
Tut	Tut
schöpfen	schöpfen
bummeltet	bummeltet
eine	eine
wischt	wischt
Sigle	Sigle
Zerfall	Zerfall
Unterschlagungen	Unterschlagungen
verantwortet	verantwortet
Werden	Werden
Sprechers	Sprechers
fragmentiert	fragmentiert
Hinkelstein	Hinkelstein
Zeithorizonten	Zeithorizonten
massakrierte	massakrierte
Adelung	Adelung
Hacker	Hacker
regierte	regierte
verdinglichtest	verdinglichtest
Wegen	Wegen
nippend	nippend
Politologen	Politologen
Technikerinnen	Technikerinnen
denn	denn
scheiterst	scheiterst
Agoraphobie	Agoraphobie
verhungert	verhungert
zählend	zählend
initiieret	initiieret
kapiert	kapiert
fünften	fünften
knutschst	knutschst
Dünungen	Dünungen
aber	aber
beleuchte	beleuchte
helle	helle
Taschenwörterbuch	Taschenwörterbuch
möpperst	möpperst
tagten	tagten
Einem	Einem
Eingaben	Eingaben
Tritte	Tritte
Preisanstiegen	Preisanstiegen
Kacke	Kacke
Linguistinnen	Linguistinnen
entmineralisierst	entmineralisierst
Epoxide	Epoxide
schmettern	schmettern
reizte	reizte
Füllfederhalters	Füllfederhalters
vollendest	vollendest
Plumpsen	Plumpsen
löse	löse
Erbsen	Erbsen
angehört	angehört
spaltest	spaltest
reinige	reinige
am	am
halten	halten
Rhabarbern	Rhabarbern
drescht	drescht
scheitertet	scheitertet
Gauner	Gauner
fertigte	fertigte
ersparten	ersparten
oxidierst	oxidierst
Schamentzündungen	Schamentzündungen
bezichtigt	bezichtigt
Autonomie	Autonomie
Chasar	Chasar
Märtyrer	Märtyrer
Anhang	Anhang
Polierstählen	Polierstählen
krähen	krähen
Jagdbomber	Jagdbomber
fliehe	fliehe
wurdet	wurdet
deren	deren
Geflecktheit	Geflecktheit
Zebrahai	Zebrahai
Schönredner	Schönredner
Thioacetalen	Thioacetalen
pressiere	pressiere
Suchanfragen	Suchanfragen
hebräische	hebräische
verantwortetest	verantwortetest
verführen	verführen
concessioniert	concessioniert
Fluoratom	Fluoratom
Räten	Räten
begehrte	begehrte
Biene	Biene
Halogenatom	Halogenatom
verdrängen	verdrängen
aufkäme	aufkäme
Beten	Beten
illustriere	illustriere
formulierst	formulierst
regelten	regelten
Herbstwinden	Herbstwinden
wehren	wehren
colorierten	colorierten
pilgerte	pilgerte
Dezernat	Dezernat
steuerst	steuerst
Rehböcken	Rehböcken
ermordeten	ermordeten
Fusselbart	Fusselbart
bejubelst	bejubelst
Sprachräumen	Sprachräumen
griffen	griffen
gravierten	gravierten
Aerosolen	Aerosolen
Öfchens	Öfchens
Epidemien	Epidemien
verunglimpftet	verunglimpftet
protestiere	protestiere
leider	leider
kremieren	kremieren
Assistentin	Assistentin
Wissen	Wissen
Neuigkeit	Neuigkeit
illustriertet	illustriertet
Lötzinn	Lötzinn
erschütterte	erschütterte
kühle	kühle
Löwe	Löwe
lose	lose
überprüftest	überprüftest
Organisation	Organisation
querte	querte
Sabbatjahr	Sabbatjahr
appellierst	appellierst
teilen	teilen
zagt	zagt
Schreibtischtäter	Schreibtischtäter
Reisebüros	Reisebüros
inszenierst	inszenierst
Ellen	Ellen
bündelten	bündelten
Fett	Fett
Gehörst	Gehörst
Krumen	Krumen
Kohlenstoffgehalten	Kohlenstoffgehalten
Sei	Sei
kontaktieret	kontaktieret
verlähmt	verlähmt
appellierte	appellierte
Schwärmereien	Schwärmereien
feierst	feierst
schleimte	schleimte
fladern	fladern
Aufsätzen	Aufsätzen
speisest	speisest
Flamen	Flamen
jungen	jungen
Trinket	Trinket
verseucht	verseucht
Geschäfte	Geschäfte
ringet	ringet
beschottert	beschottert
zerstückte	zerstückte
Kaktusfeige	Kaktusfeige
Fremdwörter	Fremdwörter
wachte	wachte
fritieret	fritieret
Döner	Döner
Flöte	Flöte
grünten	grünten
verachtend	verachtend
bequemte	bequemte
gähne	gähne
erzwinget	erzwinget
entflöhen	entflöhen
Röcke	Röcke
Lobgesänge	Lobgesänge
erstaunte	erstaunte
Monaten	Monaten
betreibet	betreibet
bezichtigten	bezichtigten
Gigapascal	Gigapascal
rinnt	rinnt
Silbererze	Silbererze
imprägnieret	imprägnieret
Lobet	Lobet
reife	reife
Adlerbussard	Adlerbussard
Rotzinkerz	Rotzinkerz
Fahlflanken-Ameisenwürger	Fahlflanken-Ameisenwürger
Königreichen	Königreichen
Unterwerfungen	Unterwerfungen
Vesper	Vesper
jene	jene
Innenschau	Innenschau
Großfürsten	Großfürsten
stoppten	stoppten
stifte	stifte
entgegenkamen	entgegenkamen
Rabe	Rabe
Sünders	Sünders
zweiten	zweiten
Neuigkeiten	Neuigkeiten
stärket	stärket
Malaysierin	Malaysierin
fritiert	fritiert
verseifet	verseifet
Raben	Raben
Gegenleistung	Gegenleistung
Mobilfunknetze	Mobilfunknetze
Blockflöte	Blockflöte
Ringeltauben	Ringeltauben
entkörperlichten	entkörperlichten
Patres	Patres
Feste	Feste
Einstufung	Einstufung
plärrtest	plärrtest
Türkin	Türkin
sahet	sahet
rüstetet	rüstetet
Klüften	Klüften
segeln	segeln
versteigerest	versteigerest
Zahnfleischentzündung	Zahnfleischentzündung
Kindergeldern	Kindergeldern
Dewargefäße	Dewargefäße
plissierten	plissierten
Stiefmütterchen	Stiefmütterchen
begrubt	begrubt
baggerte	baggerte
Dödeln	Dödeln
Kleinodien	Kleinodien
härten	härten
Anzeichens	Anzeichens
überwiese	überwiese
zweite	zweite
laute	laute
Rechte	Rechte
beäugst	beäugst
verschlimmere	verschlimmere
schäumt	schäumt
hievten	hievten
Besprechung	Besprechung
Schatten	Schatten
Palisade	Palisade
Wolfesgrube	Wolfesgrube
zentriert	zentriert
Regenten	Regenten
Räte	Räte
notlandet	notlandet
produzierten	produzierten
kupiert	kupiert
haschiert	haschiert
verselbstständige	verselbstständige
Ei	Ei
verdrängt	verdrängt
erlabet	erlabet
ermordetet	ermordetet
christianisiere	christianisiere
bescherten	bescherten
harrtest	harrtest
Theologie	Theologie
verirrt	verirrt
schnitt	schnitt
brillieren	brillieren
regierest	regierest
drillest	drillest
knistert	knistert
siegen	siegen
unterwerfe	unterwerfe
Schilden	Schilden
Hardwareentwicklerin	Hardwareentwicklerin
zeichnest	zeichnest
speist	speist
Asylrechte	Asylrechte
Panzerschrecke	Panzerschrecke
ander	ander
zieren	zieren
Färsen	Färsen
Heuschrecke	Heuschrecke
Farbstoffe	Farbstoffe
Schwänze	Schwänze
vermutest	vermutest
folgtet	folgtet
Ackerschachtelhalme	Ackerschachtelhalme
zeugten	zeugten
Ankern	Ankern
Fortsetzungen	Fortsetzungen
stützen	stützen
Märtyrern	Märtyrern
leuchten	leuchten
zeug	zeug
sintertest	sintertest
Gichten	Gichten
reformierten	reformierten
Plüschtiere	Plüschtiere
Donor	Donor
steigest	steigest
aufrichtet	aufrichtet
Zipfelmützen	Zipfelmützen
Bevölkerungsdichte	Bevölkerungsdichte
beherrschest	beherrschest
Grizzlybären	Grizzlybären
Stör	Stör
Vollkornbrot	Vollkornbrot
Zipfelmütze	Zipfelmütze
eiterten	eiterten
Selbstversuchen	Selbstversuchen
Pflanzenwachstum	Pflanzenwachstum
feire	feire
verzweifelt	verzweifelt
Rechenbrett	Rechenbrett
Braunralle	Braunralle
Schwermetallionen	Schwermetallionen
frappierte	frappierte
wallfahrten	wallfahrten
rüstete	rüstete
Bleiglanz	Bleiglanz
übrigbleiben	übrigbleiben
Märchenbüchern	Märchenbüchern
ermutigt	ermutigt
vorn	vorn
aufstanden	aufstanden
Grabbeltischen	Grabbeltischen
strullerte	strullerte
massierst	massierst
anrufen	anrufen
Paradiesäpfeln	Paradiesäpfeln
unterbrächest	unterbrächest
Hubschrauber	Hubschrauber
Abfertigungsgebäude	Abfertigungsgebäude
elfte	elfte
reifen	reifen
Massagen	Massagen
meine	meine
Weiblein	Weiblein
kollidierten	kollidierten
überdenkend	überdenkend
Gesetzen	Gesetzen
Unglaube	Unglaube
Gurten	Gurten
Am	Am
Abgaskatalysatoren	Abgaskatalysatoren
Thioacetal	Thioacetal
Adamsapfel	Adamsapfel
härtet	härtet
inszeniere	inszeniere
klappest	klappest
schämest	schämest
Deinen	Deinen
verständige	verständige
Stellen	Stellen
ritten	ritten
murmelten	murmelten
waren	waren
kürzten	kürzten
verblieben	verblieben
kämmtet	kämmtet
Metallothionein	Metallothionein
losest	losest
Fürst	Fürst
Fellachin	Fellachin
unsrer	unsrer
platz	platz
Generationen	Generationen
Füchsen	Füchsen
Decken	Decken
Rast	Rast
Monarchien	Monarchien
tatteret	tatteret
erdacht	erdacht
infiziertet	infiziertet
quantisierte	quantisierte
knutschest	knutschest
föhnest	föhnest
produzierte	produzierte
ratschlagten	ratschlagten
unehrt	unehrt
erwärmst	erwärmst
Röcken	Röcken
besprächen	besprächen
Leitkegel	Leitkegel
laden	laden
destabilisierte	destabilisierte
Böreks	Böreks
versuchet	versuchet
Atommodelle	Atommodelle
idealisierten	idealisierten
spritzt	spritzt
liegst	liegst
härte	härte
Katalanen	Katalanen
Bienen	Bienen
putzt	putzt
Dienstgrad	Dienstgrad
Rücktrittbremse	Rücktrittbremse
sollt	sollt
Erstarren	Erstarren
Mopps	Mopps
Besteck	Besteck
Kannen	Kannen
Soge	Soge
Gewinnung	Gewinnung
flambiert	flambiert
lösend	lösend
Elektrophil	Elektrophil
moppen	moppen
produziert	produziert
simuliertet	simuliertet
Teppichen	Teppichen
hebräischen	hebräischen
Ärztin	Ärztin
überreichen	überreichen
Vordenkern	Vordenkern
leistete	leistete
Fiesling	Fiesling
Rumänin	Rumänin
Arbeitsunfähigkeit	Arbeitsunfähigkeit
ihr	ihr
begehr	begehr
Fingerhüten	Fingerhüten
Lehrbücher	Lehrbücher
foppst	foppst
überweis	überweis
feierte	feierte
Referenz	Referenz
zürntest	zürntest
Finanzminister	Finanzminister
erbrütet	erbrütet
nagelte	nagelte
strafet	strafet
begraben	begraben
zappten	zappten
aufhobt	aufhobt
Cola	Cola
Scheck	Scheck
speiset	speiset
wisperest	wisperest
Geflecktheiten	Geflecktheiten
sponseret	sponseret
Anlässe	Anlässe
annektierst	annektierst
vermahnen	vermahnen
angehöret	angehöret
enttäuschtest	enttäuschtest
Briefwechsel	Briefwechsel
Langschwanzpinguin	Langschwanzpinguin
meuternd	meuternd
Schuhen	Schuhen
Malaysier	Malaysier
rüstetest	rüstetest
hinterzögen	hinterzögen
Androiden	Androiden
wurdest	wurdest
reichte	reichte
dürftet	dürftet
Schicksen	Schicksen
verbraucht	verbraucht
schnorrest	schnorrest
Rubine	Rubine
spezialisierst	spezialisierst
kein	kein
Artischocken	Artischocken
schmuggele	schmuggele
beantragt	beantragt
Butike	Butike
Traubenlesen	Traubenlesen
Vorstädte	Vorstädte
Schlaraffenlandes	Schlaraffenlandes
sagtet	sagtet
Abschiedsbrief	Abschiedsbrief
viele	viele
steigerten	steigerten
Gängen	Gängen
thematisierten	thematisierten
Gleitzeiten	Gleitzeiten
kremierten	kremierten
Blicksilber	Blicksilber
Metallspiegeln	Metallspiegeln
sedimentiere	sedimentiere
vergaset	vergaset
Blattgewebe	Blattgewebe
Zeitschlitzen	Zeitschlitzen
harrten	harrten
Tausche	Tausche
geahnt	geahnt
Agoraphobien	Agoraphobien
gestatteten	gestatteten
Astats	Astats
lostest	lostest
vertilge	vertilge
hydrogentartrate	hydrogentartrate
beteuerten	beteuerten
glühenden	glühenden
reizet	reizet
reimte	reimte
unterschiede	unterschiede
verkröchet	verkröchet
schleiß	schleiß
redetet	redetet
laufet	laufet
Donoren	Donoren
Jungfernflüge	Jungfernflüge
räumen	räumen
plumpse	plumpse
geschämt	geschämt
abweichest	abweichest
Adelungen	Adelungen
foppten	foppten
reanimierten	reanimierten
vergibt	vergibt
planschest	planschest
vernickelte	vernickelte
Linguisten	Linguisten
Automatikgetriebe	Automatikgetriebe
Playlist	Playlist
Hirten	Hirten
einführte	einführte
ab	ab
Würze	Würze
deine	deine
anrichten	anrichten
schnappet	schnappet
kappten	kappten
Entsetzt	Entsetzt
besetzest	besetzest
Tetraiodiden	Tetraiodiden
Schneepflug	Schneepflug
tobet	tobet
Brettspiele	Brettspiele
ertragen	ertragen
harmoniert	harmoniert
Pater	Pater
Dreieinigkeit	Dreieinigkeit
Barbareien	Barbareien
liebtet	liebtet
konvertieren	konvertieren
Kortholt	Kortholt
Elle	Elle
Rechnungen	Rechnungen
kritzele	kritzele
unsres	unsres
verabschiedetet	verabschiedetet
piesacken	piesacken
quietschest	quietschest
Buchstaben	Buchstaben
Kaufhäusern	Kaufhäusern
Spurensicherung	Spurensicherung
gleiche	gleiche
infizieret	infizieret
Unserer	Unserer
Recht	Recht
kühl	kühl
boykottierten	boykottierten
Arbeitsleistung	Arbeitsleistung
mineralisierten	mineralisierten
setztest	setztest
Fledermaus	Fledermaus
Spektralbereichen	Spektralbereichen
wurstelten	wurstelten
Hansen	Hansen
verscheißert	verscheißert
liehen	liehen
stigmatisierest	stigmatisierest
stürzt	stürzt
verberge	verberge
bereitend	bereitend
vibriere	vibriere
begnügt	begnügt
zeuge	zeuge
Ölspur	Ölspur
Bienenzüchter	Bienenzüchter
Anwendungsgebiete	Anwendungsgebiete
Füchsin	Füchsin
folgte	folgte
Barschaften	Barschaften
Neumonden	Neumonden
aufrichten	aufrichten
Bademantel	Bademantel
Muhme	Muhme
Metallquirle	Metallquirle
Shortcut	Shortcut
Fallturm	Fallturm
skypst	skypst
Überschüsse	Überschüsse
Farbstoffen	Farbstoffen
jedes	jedes
schämten	schämten
koordinierte	koordinierte
Küsserei	Küsserei
schütze	schütze
Kavalier	Kavalier
mästest	mästest
jappte	jappte
tragest	tragest
Wiederauferstehungen	Wiederauferstehungen
zelte	zelte
Vanadaten	Vanadaten
Geschreis	Geschreis
Mähnenwolf	Mähnenwolf
Trioxiden	Trioxiden
Speere	Speere
massierend	massierend
Montagmittagen	Montagmittagen
Kerf	Kerf
Epoxiden	Epoxiden
Alibis	Alibis
erstürmt	erstürmt
Tiefschutzen	Tiefschutzen
Großstädtern	Großstädtern
Geschwindigkeitsmesser	Geschwindigkeitsmesser
WebHooks	WebHooks
reanimiere	reanimiere
Fluoratome	Fluoratome
Freibergit	Freibergit
Pinguin	Pinguin
spritzet	spritzet
listeten	listeten
installiert	installiert
zeugen	zeugen
Europameisters	Europameisters
widmest	widmest
tunet	tunet
verfügten	verfügten
opfern	opfern
Fanatiker	Fanatiker
Katz-und-Maus-Spiele	Katz-und-Maus-Spiele
flense	flense
verteidigt	verteidigt
wiederholten	wiederholten
liebtest	liebtest
Gedränge	Gedränge
rebellieret	rebellieret
jammern	jammern
Regierung	Regierung
Brieföffners	Brieföffners
Zwergschwan	Zwergschwan
lösten	lösten
kabelten	kabelten
vielen	vielen
Coventrisierung	Coventrisierung
schautet	schautet
gelobet	gelobet
zähle	zähle
kichert	kichert
Fette	Fette
Toypudeln	Toypudeln
verbrauchten	verbrauchten
Gut	Gut
kabeln	kabeln
fokussierten	fokussierten
Inkarnationen	Inkarnationen
betrübe	betrübe
stammeln	stammeln
höbe	höbe
Ein	Ein
zersetzte	zersetzte
Teilnehmerin	Teilnehmerin
Früchte	Früchte
malträtiere	malträtiere
Zwingburgen	Zwingburgen
sehnst	sehnst
Rotzinkerzen	Rotzinkerzen
Filzläusen	Filzläusen
Zeitüberschreitung	Zeitüberschreitung
griechischen	griechischen
warnet	warnet
forschet	forschet
wachsen	wachsen
urteilte	urteilte
deinem	deinem
Tust	Tust
Ösophagospasmen	Ösophagospasmen
funzen	funzen
überdächte	überdächte
begründetest	begründetest
trödeltest	trödeltest
dirigiert	dirigiert
seien	seien
bekannt	bekannt
Nadelbäume	Nadelbäume
Meinem	Meinem
hebet	hebet
Assimilationen	Assimilationen
Überziehens	Überziehens
linstest	linstest
Teekessel	Teekessel
kreieren	kreieren
zuteilte	zuteilte
scheuchten	scheuchten
koste	koste
parkierten	parkierten
stapelten	stapelten
frottierten	frottierten
Unglauben	Unglauben
gelobtest	gelobtest
Einfältigkeiten	Einfältigkeiten
quatschest	quatschest
schaue	schaue
Stühlen	Stühlen
trinkest	trinkest
Königreiche	Königreiche
tage	tage
Geschrei	Geschrei
schauend	schauend
Protonen	Protonen
Klassenzimmern	Klassenzimmern
hängte	hängte
Druckfehlern	Druckfehlern
tote	tote
plissiere	plissiere
verrostet	verrostet
haare	haare
Klotz	Klotz
überweiset	überweiset
Physikerinnen	Physikerinnen
höben	höben
Amt	Amt
Halte	Halte
grüßet	grüßet
ducktest	ducktest
Augengläsern	Augengläsern
begehrt	begehrt
verunglimpfest	verunglimpfest
erwischten	erwischten
Mutagen	Mutagen
verurteile	verurteile
faltest	faltest
Indianern	Indianern
Bäusche	Bäusche
Hehlern	Hehlern
amputiere	amputiere
Apportierhunde	Apportierhunde
Drehtüren	Drehtüren
Wasserbades	Wasserbades
häufe	häufe
halltet	halltet
Schneider	Schneider
kostet	kostet
setzt	setzt
erfreuen	erfreuen
oben	oben
Mischelementen	Mischelementen
schleißt	schleißt
assimiliertest	assimiliertest
Achsel	Achsel
Oxalate	Oxalate
erstürmet	erstürmet
flirre	flirre
lispelt	lispelt
speiste	speiste
duckmäuseret	duckmäuseret
träumen	träumen
kabelst	kabelst
zwölften	zwölften
verzögerte	verzögerte
gewärtigten	gewärtigten
Fahlflanken-Ameisenwürgern	Fahlflanken-Ameisenwürgern
besorgten	besorgten
erliegen	erliegen
Abfertigungsschalters	Abfertigungsschalters
Ausgangssperren	Ausgangssperren
Schwestern	Schwestern
Jochen	Jochen
bestand	bestand
Aromastoffen	Aromastoffen
Monden	Monden
Insulaner	Insulaner
gehörst	gehörst
Ärschen	Ärschen
Verdacht	Verdacht
Wasserbädern	Wasserbädern
extemporiere	extemporiere
billigen	billigen
jaule	jaule
Ente	Ente
lehret	lehret
folgen	folgen
leerst	leerst
Peptid	Peptid
Brötchen	Brötchen
rundet	rundet
Hunden	Hunden
schmusen	schmusen
Pfleglingen	Pfleglingen
versagt	versagt
Büstenhalters	Büstenhalters
gelobten	gelobten
beteuerest	beteuerest
reifte	reifte
glaubest	glaubest
Firnisse	Firnisse
Solche	Solche
Zankapfel	Zankapfel
erlöset	erlöset
flitzen	flitzen
linke	linke
Schau	Schau
niemanden	niemanden
Kautschuke	Kautschuke
säuselest	säuselest
Paradiesapfel	Paradiesapfel
bekotete	bekotete
Besuchen	Besuchen
Herr	Herr
verschickte	verschickte
fluppst	fluppst
Vergeltungen	Vergeltungen
babbeltet	babbeltet
keines	keines
Pforten	Pforten
Mop	Mop
Verwundeten	Verwundeten
aufnahmt	aufnahmt
Freibergits	Freibergits
bleiben	bleiben
Tausch	Tausch
Kerzenlichtern	Kerzenlichtern
Garten	Garten
reich	reich
schmuste	schmuste
schlaget	schlaget
Ränken	Ränken
jeden	jeden
beläufst	beläufst
Wechselstube	Wechselstube
erzeigest	erzeigest
Gibst	Gibst
sannen	sannen
Gemurmel	Gemurmel
Gebot	Gebot
Kompass	Kompass
Epidemie	Epidemie
murmeln	murmeln
Aufpralle	Aufpralle
Menschenhandel	Menschenhandel
Wiedergutmachungen	Wiedergutmachungen
betätigtet	betätigtet
pendele	pendele
betrüge	betrüge
gönnest	gönnest
überstehst	überstehst
Vorstoß	Vorstoß
konvergiere	konvergiere
schläft	schläft
verschlungen	verschlungen
aasend	aasend
Deine	Deine
Kaffeelöffel	Kaffeelöffel
dunkelt	dunkelt
posierten	posierten
negierest	negierest
Denkmünzen	Denkmünzen
imitiertet	imitiertet
Minimierungen	Minimierungen
Einwirkungen	Einwirkungen
Aggressoren	Aggressoren
kollidierte	kollidierte
Senkung	Senkung
Überfamilie	Überfamilie
legten	legten
gestalten	gestalten
erlasset	erlasset
malen	malen
Gedanken	Gedanken
fladerst	fladerst
Isolatoren	Isolatoren
widerriefe	widerriefe
bewürben	bewürben
Leuchtkäfern	Leuchtkäfern
lögest	lögest
umkämen	umkämen
generiert	generiert
erlassen	erlassen
bekriegtet	bekriegtet
sehn	sehn
konnotieret	konnotieret
stillest	stillest
offenbartest	offenbartest
moppet	moppet
Buchhalterin	Buchhalterin
verschreibt	verschreibt
beschert	beschert
Schwirrvogel	Schwirrvogel
nähert	nähert
gewähret	gewähret
ratschlagen	ratschlagen
Massenarbeitslosigkeit	Massenarbeitslosigkeit
erbrüte	erbrüte
Überziehen	Überziehen
dehydrierten	dehydrierten
Treppen	Treppen
fließt	fließt
blamierten	blamierten
Kontrollboxen	Kontrollboxen
Reinigungsschrittes	Reinigungsschrittes
Höschen	Höschen
Reisebüro	Reisebüro
Funkfeuer	Funkfeuer
verführtest	verführtest
duzen	duzen
vergrabest	vergrabest
verdammet	verdammet
segmentiere	segmentiere
ritt	ritt
Briten	Briten
befehlen	befehlen
bestraft	bestraft
Pfründe	Pfründe
alle	alle
Ausbeuterei	Ausbeuterei
Schlägen	Schlägen
vermahnt	vermahnt
colorierend	colorierend
verbündest	verbündest
verwechsele	verwechsele
verbluteten	verbluteten
Steuerwagens	Steuerwagens
Harpune	Harpune
herrschen	herrschen
Dieben	Dieben
verkündiget	verkündiget
Bedenken	Bedenken
Kürass	Kürass
Brüdern	Brüdern
zweifel	zweifel
Aderhaut	Aderhaut
sagt	sagt
erwürgten	erwürgten
Hummer	Hummer
Wühltischen	Wühltischen
herrschst	herrschst
knistern	knistern
erst	erst
Privatsachen	Privatsachen
Götze	Götze
Falz	Falz
soll	soll
Ansteckern	Ansteckern
Tollkirschen	Tollkirschen
prophezeiet	prophezeiet
Wasserquelle	Wasserquelle
Futtermittel	Futtermittel
polymerisierte	polymerisierte
Schlaraffenländern	Schlaraffenländern
entschleieret	entschleieret
instrumentalisierest	instrumentalisierest
beschottre	beschottre
gelost	gelost
verewigt	verewigt
fegst	fegst
mikrominiaturisiere	mikrominiaturisiere
Mikrometern	Mikrometern
Chemikerinnen	Chemikerinnen
Würfen	Würfen
Breiten	Breiten
zeuget	zeuget
Schanktischen	Schanktischen
Anführern	Anführern
Erdbirnen	Erdbirnen
Abfertigungsgebäuden	Abfertigungsgebäuden
annektierten	annektierten
regiere	regiere
Elementen	Elementen
beweist	beweist
fladerest	fladerest
grünst	grünst
blamierte	blamierte
überschattete	überschattete
schlag	schlag
Schote	Schote
Möbelstoff	Möbelstoff
verzeichne	verzeichne
Thioester	Thioester
verewiget	verewiget
Ach	Ach
Amnestie	Amnestie
Puder	Puder
ehrst	ehrst
Coventrisierungen	Coventrisierungen
balkanisierte	balkanisierte
vertonten	vertonten
Qualifikationen	Qualifikationen
Atmosphäre	Atmosphäre
halbe	halbe
schimmerest	schimmerest
Flöten	Flöten
koordinieret	koordinieret
Pfandgeld	Pfandgeld
Langeweile	Langeweile
Lobgesängen	Lobgesängen
Geigerzähler	Geigerzähler
Apfelbäumen	Apfelbäumen
verstrahlten	verstrahlten
sortierest	sortierest
Korrosionsschutz	Korrosionsschutz
Gebete	Gebete
Affenbrotbäumen	Affenbrotbäumen
möchten	möchten
Abschußringe	Abschußringe
Entmachtung	Entmachtung
Schamentzündung	Schamentzündung
lachte	lachte
versuchte	versuchte
pressiert	pressiert
Zeugnisse	Zeugnisse
filzten	filzten
zerfielest	zerfielest
Essigsäurechlorid	Essigsäurechlorid
überfallen	überfallen
Flussbetten	Flussbetten
links	links
Jahr	Jahr
anzögen	anzögen
motivieren	motivieren
heißt	heißt
verschmelze	verschmelze
Rutheniumisotop	Rutheniumisotop
Erzeugungen	Erzeugungen
knüpfen	knüpfen
Stempeluhren	Stempeluhren
Technetate	Technetate
verseift	verseift
erzeige	erzeige
Sachen	Sachen
Glühwürmchen	Glühwürmchen
deines	deines
verprügelte	verprügelte
schreiet	schreiet
henket	henket
Jünglingen	Jünglingen
entwaffneten	entwaffneten
Schal	Schal
war	war
faul	faul
Schwächungen	Schwächungen
Automatikgetrieben	Automatikgetrieben
begehren	begehren
Nervenzellen	Nervenzellen
aktualisiere	aktualisiere
Baisers	Baisers
Gehilfe	Gehilfe
malochet	malochet
Zapfhähnen	Zapfhähnen
beschlug	beschlug
kritzeln	kritzeln
reagierte	reagierte
entständen	entständen
süsst	süsst
grauten	grauten
ach	ach
grabest	grabest
finanziere	finanziere
Generatoren	Generatoren
Jahren	Jahren
rangierst	rangierst
verdammst	verdammst
anfingst	anfingst
straftet	straftet
repräsentieret	repräsentieret
Eins	Eins
verbitterte	verbitterte
Gewicht	Gewicht
Ausnahme	Ausnahme
ladest	ladest
gratuliere	gratuliere
deckst	deckst
Gitarrenspieler	Gitarrenspieler
Ställe	Ställe
äussern	äussern
Bande	Bande
konstatiertest	konstatiertest
möchte	möchte
Retter	Retter
Minimierung	Minimierung
harmonierte	harmonierte
jauchzte	jauchzte
überschattet	überschattet
verstecke	verstecke
überführt	überführt
saht	saht
moppte	moppte
Feinde	Feinde
filteret	filteret
Tiefschutz	Tiefschutz
verdamme	verdamme
pflügten	pflügten
Basiliken	Basiliken
Abartigkeiten	Abartigkeiten
UND-Gattern	UND-Gattern
Kakao	Kakao
Maut	Maut
referenziere	referenziere
Mein	Mein
Zapfen	Zapfen
hintertreiben	hintertreiben
predigte	predigte
Ärzten	Ärzten
Schaffnerinnen	Schaffnerinnen
Männlein	Männlein
lauft	lauft
Münzsammlungen	Münzsammlungen
spricht	spricht
Diese	Diese
simulierst	simulierst
Orgeln	Orgeln
nippst	nippst
Steigen	Steigen
verbasele	verbasele
Hüfte	Hüfte
Hochsommer	Hochsommer
Freunden	Freunden
zerrütteten	zerrütteten
imprägniere	imprägniere
defragmentierest	defragmentierest
steigen	steigen
drangen	drangen
blitztet	blitztet
Beschuldigungen	Beschuldigungen
punktetest	punktetest
regiert	regiert
Seiten	Seiten
Prüfberichten	Prüfberichten
Eure	Eure
verschafft	verschafft
bilden	bilden
Ausländern	Ausländern
Sollte	Sollte
Bildpunkt	Bildpunkt
substituieren	substituieren
Testamenten	Testamenten
Abschreckung	Abschreckung
solch	solch
Maße	Maße
erpresst	erpresst
Hochhäusern	Hochhäusern
Domäne	Domäne
besorgest	besorgest
Sphären	Sphären
impfte	impfte
glawbten	glawbten
streckst	streckst
heiße	heiße
Briefen	Briefen
konvergierest	konvergierest
heiligest	heiligest
Oxalaten	Oxalaten
Oberlippe	Oberlippe
rechten	rechten
Entsetzen	Entsetzen
entrümpelst	entrümpelst
ernte	ernte
Wille	Wille
zerfetzte	zerfetzte
wiederkamen	wiederkamen
glaubt	glaubt
Leuchtstoff	Leuchtstoff
seine	seine
halbierte	halbierte
sagten	sagten
schreckt	schreckt
Wiederbelebung	Wiederbelebung
lohnt	lohnt
Somite	Somite
unterdrückte	unterdrückte
wachet	wachet
pflanzet	pflanzet
unterstützet	unterstützet
Strahlentierchens	Strahlentierchens
vertreibe	vertreibe
kriegen	kriegen
Anhänge	Anhänge
Zitronensäften	Zitronensäften
bemächtigest	bemächtigest
Urbare	Urbare
Apostel	Apostel
Rotscheitelreiher	Rotscheitelreiher
vertagest	vertagest
eggt	eggt
brach	brach
verpufftest	verpufftest
Kindergeld	Kindergeld
wehrten	wehrten
Galeeren	Galeeren
raten	raten
Glatteis	Glatteis
Ihren	Ihren
Premieren	Premieren
beäugen	beäugen
verkürzten	verkürzten
Brieftaubenzüchter	Brieftaubenzüchter
Konzentrate	Konzentrate
steigeret	steigeret
besäest	besäest
wurden	wurden
Ältesten	Ältesten
Kaufleute	Kaufleute
demütigst	demütigst
Bevölkerungsdichten	Bevölkerungsdichten
kappet	kappet
lehnte	lehnte
reiftet	reiftet
Übertretung	Übertretung
Marjellchen	Marjellchen
Sagen	Sagen
überschneidet	überschneidet
Zahnfleischentzündungen	Zahnfleischentzündungen
Genkinit	Genkinit
spielet	spielet
verbaseln	verbaseln
Sonnenfinsternissen	Sonnenfinsternissen
Kirchhof	Kirchhof
Halter	Halter
Sportlerinnen	Sportlerinnen
zügelten	zügelten
hineinbrächte	hineinbrächte
wässerten	wässerten
Gemüt	Gemüt
rekonstruieret	rekonstruieret
predig	predig
Weile	Weile
Sauberfrauen	Sauberfrauen
nächste	nächste
begehrst	begehrst
trüge	trüge
kooperierte	kooperierte
Dudelsack	Dudelsack
Hinkelsteine	Hinkelsteine
Karikaturistinnen	Karikaturistinnen
Biokraftstoff	Biokraftstoff
Grieße	Grieße
gaffest	gaffest
Kassettenrekorder	Kassettenrekorder
heiß	heiß
schenket	schenket
warten	warten
Herabsetzung	Herabsetzung
optimierte	optimierte
Shortcuts	Shortcuts
versüßtet	versüßtet
übrigbleibet	übrigbleibet
dressierten	dressierten
verscheißerte	verscheißerte
besprenget	besprenget
Pedanten	Pedanten
veranstalten	veranstalten
finanzieret	finanzieret
Abschußring	Abschußring
vertiefet	vertiefet
duschte	duschte
grüßte	grüßte
Waldbränden	Waldbränden
Verwaltungsakten	Verwaltungsakten
betreten	betreten
vernehmen	vernehmen
verklagst	verklagst
verlötest	verlötest
begebet	begebet
Bushaltestellen	Bushaltestellen
begnügte	begnügte
Sterne	Sterne
vernehmest	vernehmest
weinest	weinest
weinen	weinen
Ösophagospasmus	Ösophagospasmus
diversifiziert	diversifiziert
gewinnen	gewinnen
beherrscht	beherrscht
halben	halben
Stall	Stall
Rehen	Rehen
erschrickt	erschrickt
ballaste	ballaste
halte	halte
impfst	impfst
Laiben	Laiben
verzweigt	verzweigt
setze	setze
Wachet	Wachet
jaulst	jaulst
unseres	unseres
Füllet	Füllet
reifst	reifst
Mähnenwolfes	Mähnenwolfes
Kernladungszahl	Kernladungszahl
quasselten	quasselten
Maxima	Maxima
loben	loben
hoben	hoben
grabble	grabble
verspielest	verspielest
übersteht	übersteht
Membranen	Membranen
klingest	klingest
reim	reim
Saget	Saget
willen	willen
Katz-und-Maus-Spielen	Katz-und-Maus-Spielen
Radsatzes	Radsatzes
Talismanen	Talismanen
Bilderstürmereien	Bilderstürmereien
Operationssälen	Operationssälen
Pausbacken	Pausbacken
Rechnung	Rechnung
verringertet	verringertet
Nullpunkt	Nullpunkt
Käsereiben	Käsereiben
vergast	vergast
Trinker	Trinker
Freeganer	Freeganer
Reststoffen	Reststoffen
bedurftest	bedurftest
privatisierest	privatisierest
Gaschromatographien	Gaschromatographien
Heteroatome	Heteroatome
Handbüchern	Handbüchern
Honigbär	Honigbär
falteten	falteten
Wüste	Wüste
schmeicheln	schmeicheln
lieget	lieget
durchläutert	durchläutert
verdränge	verdränge
bromiertet	bromiertet
Ausbeutern	Ausbeutern
Trübsale	Trübsale
Sabbatjahre	Sabbatjahre
Fokusse	Fokusse
Unternehmung	Unternehmung
verfinstere	verfinstere
Meerschweinchen	Meerschweinchen
seines	seines
grünend	grünend
emigrieret	emigrieret
Erzeugung	Erzeugung
wahr	wahr
messet	messet
Wänden	Wänden
austilgest	austilgest
lohnten	lohnten
Zeile	Zeile
räumet	räumet
Primatologen	Primatologen
zürn	zürn
Mitwisserschaft	Mitwisserschaft
Argentits	Argentits
versklavte	versklavte
dümpelte	dümpelte
substituierest	substituierest
Piratensender	Piratensender
destabilisierst	destabilisierst
rodete	rodete
grüßt	grüßt
Kardinäle	Kardinäle
Päckchens	Päckchens
preiset	preiset
pflanzte	pflanzte
Fettsäcken	Fettsäcken
anderen	anderen
Weichseln	Weichseln
erklinge	erklinge
Brieftaubenzüchters	Brieftaubenzüchters
gedachten	gedachten
deponierte	deponierte
Arm	Arm
Zapfhahn	Zapfhahn
plissieren	plissieren
häuftet	häuftet
generalisiere	generalisiere
Hornunges	Hornunges
tappst	tappst
Briefe	Briefe
Kornnattern	Kornnattern
Amputierten	Amputierten
sitzen	sitzen
verlaßt	verlaßt
rännen	rännen
Urheimaten	Urheimaten
beschlügen	beschlügen
verabschiedeten	verabschiedeten
missverstände	missverstände
Angabe	Angabe
wünscht	wünscht
Einsatz	Einsatz
Akkadierinnen	Akkadierinnen
bölket	bölket
arme	arme
bedürftet	bedürftet
Schilde	Schilde
Silbersulfidbelag	Silbersulfidbelag
Argyrodite	Argyrodite
hatten	hatten
Bertrandit	Bertrandit
Solches	Solches
Traubenlese	Traubenlese
pendelt	pendelt
zittere	zittere
pflanzt	pflanzt
flambierest	flambierest
diesen	diesen
erste	erste
Schnute	Schnute
gestattest	gestattest
stapele	stapele
Borhydrid	Borhydrid
Sprachraum	Sprachraum
Büstenhaltern	Büstenhaltern
Bruchstrich	Bruchstrich
strömt	strömt
begleicht	begleicht
beansprucht	beansprucht
babbelten	babbelten
Hadithe	Hadithe
Briefköpfen	Briefköpfen
Greyerzern	Greyerzern
verweise	verweise
Rußen	Rußen
Gegebenheiten	Gegebenheiten
Notärztin	Notärztin
revoltieren	revoltieren
sinterte	sinterte
entgehst	entgehst
überführen	überführen
sieht	sieht
Schlepper	Schlepper
Autoklav	Autoklav
klaget	klaget
Langzeichen	Langzeichen
träumte	träumte
harmonierest	harmonierest
anzeigte	anzeigte
Bienenstöcke	Bienenstöcke
Dürre	Dürre
besorgend	besorgend
verschränken	verschränken
evakuieret	evakuieret
Händen	Händen
protestierest	protestierest
höbet	höbet
Energiespeicher	Energiespeicher
alarmieren	alarmieren
Gar	Gar
Rufet	Rufet
Floß	Floß
tattert	tattert
generalisiert	generalisiert
Ambiguitäten	Ambiguitäten
Waren	Waren
Warte	Warte
Aktienkurs	Aktienkurs
präsentier	präsentier
murmelte	murmelte
partitionierten	partitionierten
schubse	schubse
ziere	ziere
schaffen	schaffen
Banden	Banden
raffiniere	raffiniere
Gebeten	Gebeten
ersten	ersten
Provinz	Provinz
aßet	aßet
nimmst	nimmst
Fussel	Fussel
reformieren	reformieren
Telefonverkäufer	Telefonverkäufer
verfinstert	verfinstert
begrabe	begrabe
aase	aase
verkriechst	verkriechst
ratet	ratet
ausgereckt	ausgereckt
schaute	schaute
mußte	mußte
Atomphysikern	Atomphysikern
werde	werde
dringt	dringt
boß	boß
Beschleuniger	Beschleuniger
Märkte	Märkte
Melanteriten	Melanteriten
bewässertet	bewässertet
Totgeburten	Totgeburten
Untier	Untier
läute	läute
hadere	hadere
Besuch	Besuch
Nachteilen	Nachteilen
emailliert	emailliert
Kirgisin	Kirgisin
schaffest	schaffest
Pflanzenstoff	Pflanzenstoff
entmineralisierten	entmineralisierten
verließet	verließet
duckt	duckt
Darlehen	Darlehen
gelegt	gelegt
Fadenlauf	Fadenlauf
Händedrücken	Händedrücken
Notstand	Notstand
Verbindungsdraht	Verbindungsdraht
ringen	ringen
überdenkst	überdenkst
vertilgest	vertilgest
ertönst	ertönst
eigene	eigene
vier	vier
Leuchtkäfer	Leuchtkäfer
Laubbaum	Laubbaum
föchte	föchte
Wandergesellen	Wandergesellen
Ärztinnen	Ärztinnen
Ansteckers	Ansteckers
Samarskit	Samarskit
Schwänzchen	Schwänzchen
pflügen	pflügen
standet	standet
schmuggelte	schmuggelte
Hochzeitstorten	Hochzeitstorten
vertilgst	vertilgst
reizen	reizen
dampfte	dampfte
reichst	reichst
Tiegel	Tiegel
Trümmersprachen	Trümmersprachen
Wirst	Wirst
Bombardierung	Bombardierung
gedenken	gedenken
er	er
glaube	glaube
Spektralbereich	Spektralbereich
Geschäften	Geschäften
zappen	zappen
beichten	beichten
dringen	dringen
Stämmen	Stämmen
hydrolysierend	hydrolysierend
Langschwanzpinguinen	Langschwanzpinguinen
kabbelet	kabbelet
begnadigst	begnadigst
siegte	siegte
allen	allen
Eingeweiden	Eingeweiden
beschlaget	beschlaget
Hin	Hin
Eisstein	Eisstein
Signalen	Signalen
Achatschnecken	Achatschnecken
puddelst	puddelst
Substanz	Substanz
sichten	sichten
amenagieren	amenagieren
Würfelspiele	Würfelspiele
erstaunst	erstaunst
beunruhigte	beunruhigte
setzen	setzen
verdinglichest	verdinglichest
bereiteten	bereiteten
Möbelstoffen	Möbelstoffen
umgaben	umgaben
Bertrandite	Bertrandite
Campingplätzen	Campingplätzen
besuchen	besuchen
Stadtbezirke	Stadtbezirke
gelobend	gelobend
verwertete	verwertete
Aspartame	Aspartame
erkannten	erkannten
verbündete	verbündete
konjugiere	konjugiere
lüg	lüg
strafest	strafest
Alte	Alte
Abfahrtslisten	Abfahrtslisten
Drachenblut	Drachenblut
privilegiere	privilegiere
lehren	lehren
hobt	hobt
hastete	hastete
Benzol	Benzol
wichste	wichste
eskalieret	eskalieret
stärkte	stärkte
gewinnet	gewinnet
emendieret	emendieret
replizieret	replizieret
Primärenergie	Primärenergie
brauste	brauste
Premierministerinnen	Premierministerinnen
eins	eins
fern	fern
Unwahrheiten	Unwahrheiten
Komponisten	Komponisten
verkündigst	verkündigst
aßest	aßest
bückest	bückest
Streife	Streife
zeugte	zeugte
Badezimmer	Badezimmer
Heide	Heide
Monate	Monate
Reststoff	Reststoff
verderbet	verderbet
Elementarzellen	Elementarzellen
Zeitbomben	Zeitbomben
Videoaufzeichnungen	Videoaufzeichnungen
Kerl	Kerl
Klärungen	Klärungen
krösest	krösest
Mischelement	Mischelement
Ypecaharalle	Ypecaharalle
schummelst	schummelst
überbewertet	überbewertet
wehrtest	wehrtest
zuppe	zuppe
gehört	gehört
geleiteten	geleiteten
Aderhäuten	Aderhäuten
Idolatrien	Idolatrien
gedacht	gedacht
verzweigst	verzweigst
unterwerfest	unterwerfest
Dobermännern	Dobermännern
Laubholz	Laubholz
duckmäusere	duckmäusere
Falltürme	Falltürme
Schwarzseherin	Schwarzseherin
greifet	greifet
betrübtest	betrübtest
unterforderten	unterforderten
anhangen	anhangen
Kaufhäuser	Kaufhäuser
gewitterte	gewitterte
erstehet	erstehet
Keine	Keine
Rückumschlages	Rückumschlages
Rekursion	Rekursion
Gleitzeit	Gleitzeit
spaltete	spaltete
dich	dich
Zwetschgen	Zwetschgen
werdest	werdest
Reliquiar	Reliquiar
Weste	Weste
Atomphysiker	Atomphysiker
Wege	Wege
begehrtest	begehrtest
Basilikum	Basilikum
funktioniertest	funktioniertest
äusserst	äusserst
blaset	blaset
Reinstoff	Reinstoff
kletteret	kletteret
begründest	begründest
Rechtsruck	Rechtsruck
begehrest	begehrest
Ächselchen	Ächselchen
folge	folge
gebären	gebären
Alkalien	Alkalien
Münzsammlung	Münzsammlung
wechselwirkt	wechselwirkt
Staatsanleihe	Staatsanleihe
schlagt	schlagt
Schätze	Schätze
beten	beten
langweiltest	langweiltest
lösen	lösen
faschierst	faschierst
Sabotagen	Sabotagen
erziehst	erziehst
faschieret	faschieret
reinstitutionalisierten	reinstitutionalisierten
Dominicanerin	Dominicanerin
opferte	opferte
fragte	fragte
konstatiere	konstatiere
sage	sage
Leugnung	Leugnung
Hochhäuser	Hochhäuser
Mäuse	Mäuse
Wachen	Wachen
Ionen	Ionen
Pimmel	Pimmel
privilegierst	privilegierst
bewiesen	bewiesen
protokollierst	protokollierst
verkleide	verkleide
heiligte	heiligte
beweisest	beweisest
Urologe	Urologe
neiden	neiden
Willen	Willen
Halleluja	Halleluja
Zuschauer	Zuschauer
Remis	Remis
Bundesgebiet	Bundesgebiet
bedingten	bedingten
oxidierte	oxidierte
Diebe	Diebe
Reißnagel	Reißnagel
fingieret	fingieret
Welchen	Welchen
deklarierten	deklarierten
läutet	läutet
Exzentriker	Exzentriker
deklarierte	deklarierte
Silberdrähten	Silberdrähten
wehret	wehret
liebt	liebt
legte	legte
Lehrbüchern	Lehrbüchern
vandalieren	vandalieren
deaktivierst	deaktivierst
Gefangene	Gefangene
Flensern	Flensern
Omnibus	Omnibus
klagte	klagte
Worte	Worte
tattre	tattre
verpuffe	verpuffe
gelobest	gelobest
hantiert	hantiert
Kälber	Kälber
bereits	bereits
duschten	duschten
Bleigehalten	Bleigehalten
Pfählen	Pfählen
Seinen	Seinen
zerbrechest	zerbrechest
stapfst	stapfst
grünet	grünet
betonierte	betonierte
Anachronismen	Anachronismen
ärgertest	ärgertest
belüftet	belüftet
Schlössern	Schlössern
Kalb	Kalb
Almanache	Almanache
Gebote	Gebote
säumet	säumet
Tauben	Tauben
heiligten	heiligten
Mutagenen	Mutagenen
malträtiert	malträtiert
Trickbetrüger	Trickbetrüger
möchtest	möchtest
betrieben	betrieben
Keilen	Keilen
Markise	Markise
drosselt	drosselt
dingte	dingte
Dachdeckerin	Dachdeckerin
Helden	Helden
Pfeile	Pfeile
lispelten	lispelten
Abkürzungsverzeichnis	Abkürzungsverzeichnis
Talisman	Talisman
Gefilde	Gefilde
Aller	Aller
spurtest	spurtest
Rutheniumisotopen	Rutheniumisotopen
Ebenen	Ebenen
mußt	mußt
Dithiolan	Dithiolan
Nanokondensatoren	Nanokondensatoren
Lümmeltüten	Lümmeltüten
Schleppern	Schleppern
Erzherzogshüten	Erzherzogshüten
bewerbet	bewerbet
folgend	folgend
Aromastoffe	Aromastoffe
Trübsal	Trübsal
Ersten	Ersten
verurteilen	verurteilen
Linie	Linie
knitterte	knitterte
Solch	Solch
surrst	surrst
Sitz	Sitz
lostet	lostet
scheitern	scheitern
Drachen	Drachen
Nigger	Nigger
Dampfschiffen	Dampfschiffen
Rasterkraftmikroskop	Rasterkraftmikroskop
besänftigtest	besänftigtest
Wimpertierchen	Wimpertierchen
Ästen	Ästen
stand	stand
wegführe	wegführe
glawbte	glawbte
Bausch	Bausch
vollendete	vollendete
verseuchen	verseuchen
fokussieret	fokussieret
Schlot	Schlot
beneidete	beneidete
verdreht	verdreht
Arbeitsbereichen	Arbeitsbereichen
Dewargefäß	Dewargefäß
lachen	lachen
Kontaktierungen	Kontaktierungen
Geschwindigkeitsmessern	Geschwindigkeitsmessern
näht	näht
grünt	grünt
habest	habest
stille	stille
entzogen	entzogen
erdachten	erdachten
knurrt	knurrt
anhanget	anhanget
eigenen	eigenen
dümpelst	dümpelst
bombardiere	bombardiere
Trinken	Trinken
Gedrängen	Gedrängen
deute	deute
vergibst	vergibst
verhungerte	verhungerte
dramatisieren	dramatisieren
abziehen	abziehen
Dominicanerinnen	Dominicanerinnen
frohlockten	frohlockten
deinen	deinen
meinet	meinet
Eines	Eines
versüße	versüße
scheuchen	scheuchen
spielen	spielen
Heben	Heben
obfuskieren	obfuskieren
beschrifte	beschrifte
Knaben	Knaben
wach	wach
Fusseln	Fusseln
diskutiere	diskutiere
haust	haust
abweichet	abweichet
raubet	raubet
bräunst	bräunst
Garben	Garben
Recitativ	Recitativ
strafen	strafen
Gebäck	Gebäck
Funkfeuern	Funkfeuern
verleumdetest	verleumdetest
eure	eure
referenzierte	referenzierte
kühlen	kühlen
filzen	filzen
Komponistinnen	Komponistinnen
wache	wache
brechen	brechen
Zainen	Zainen
verkapselt	verkapselt
Optimisten	Optimisten
Zinkionen	Zinkionen
anzeigen	anzeigen
Konfitüren	Konfitüren
anruft	anruft
sagst	sagst
Diamantringen	Diamantringen
Peptids	Peptids
rechte	rechte
Nachruf	Nachruf
Galoppen	Galoppen
Judenrat	Judenrat
ferne	ferne
Programmiererinnen	Programmiererinnen
amen	amen
Atombomben	Atombomben
finanziert	finanziert
Anführer	Anführer
taufen	taufen
predigtest	predigtest
Ambiguität	Ambiguität
Gangster	Gangster
Fettes	Fettes
kabbelnd	kabbelnd
Kerfe	Kerfe
Fusselbärten	Fusselbärten
exmatrikulierte	exmatrikulierte
Tannen	Tannen
Cholesterin	Cholesterin
Gefangenen	Gefangenen
Paragraphenreitern	Paragraphenreitern
UND-Gatter	UND-Gatter
Türkenbund	Türkenbund
Raten	Raten
wegführen	wegführen
exmatrikuliertet	exmatrikuliertet
Californium	Californium
Reizen	Reizen
stürzest	stürzest
Alibi	Alibi
schneide	schneide
Tukanen	Tukanen
fromme	fromme
changiere	changiere
panaschieren	panaschieren
beschwindele	beschwindele
Beziehungen	Beziehungen
producieret	producieret
Füllfeder	Füllfeder
stürzen	stürzen
Grabbeltisch	Grabbeltisch
Edelsteine	Edelsteine
leset	leset
strafte	strafte
jemand	jemand
Genkinits	Genkinits
hauen	hauen
Wert	Wert
Zementen	Zementen
Zerfällen	Zerfällen
blitzen	blitzen
Beziehung	Beziehung
entzweiest	entzweiest
rekrutierest	rekrutierest
Einrädern	Einrädern
Schwester	Schwester
streue	streue
attestierten	attestierten
lackieren	lackieren
zwänget	zwänget
Anlass	Anlass
ausgereckte	ausgereckte
dürfen	dürfen
Kupferkiesen	Kupferkiesen
Wachteln	Wachteln
zupftet	zupftet
errötest	errötest
schichtet	schichtet
erkanntet	erkanntet
klickte	klickte
hell	hell
beweiset	beweiset
Ölfässern	Ölfässern
Atommasse	Atommasse
andere	andere
verlaß	verlaß
scheu	scheu
Mikrometer	Mikrometer
Fingerspitze	Fingerspitze
Beteiligten	Beteiligten
bewässerst	bewässerst
dotiere	dotiere
tanzen	tanzen
rollten	rollten
füsilierten	füsilierten
Trübsalen	Trübsalen
Asylrechten	Asylrechten
versteckst	versteckst
Pi	Pi
bescheiße	bescheiße
heil	heil
Tatsachenbeschönigern	Tatsachenbeschönigern
überqueren	überqueren
grabe	grabe
Organisationen	Organisationen
Dolde	Dolde
sprichst	sprichst
tatet	tatet
Jahre	Jahre
ringelten	ringelten
Meinst	Meinst
gelobtet	gelobtet
klappten	klappten
Antitranspiranten	Antitranspiranten
Fallt	Fallt
Alkine	Alkine
stützet	stützet
Achseln	Achseln
kickend	kickend
werdet	werdet
Schnipseln	Schnipseln
wiederholte	wiederholte
glänzt	glänzt
bespracht	bespracht
amputierten	amputierten
Kein	Kein
ein	ein
Äthern	Äthern
feiertest	feiertest
mehrte	mehrte
widmeten	widmeten
Eiland	Eiland
attackieren	attackieren
downloadet	downloadet
glühende	glühende
trompete	trompete
Bazziten	Bazziten
dramatisiert	dramatisiert
zuppst	zuppst
verdammten	verdammten
schrecken	schrecken
desertiertet	desertiertet
notlande	notlande
Kadavergehorsam	Kadavergehorsam
respektiere	respektiere
Brieföffner	Brieföffner
brechet	brechet
frappiere	frappiere
emittiert	emittiert
anders	anders
kategorisierst	kategorisierst
Harpunen	Harpunen
spannen	spannen
finanzierest	finanzierest
überstehend	überstehend
umhüllst	umhüllst
verkündigten	verkündigten
bewässerest	bewässerest
zirpe	zirpe
tabuisiert	tabuisiert
Vipernatter	Vipernatter
replizierten	replizierten
betrete	betrete
aufstand	aufstand
Messiassen	Messiassen
hegt	hegt
vertreibt	vertreibt
beeindrucket	beeindrucket
flambierten	flambierten
Flosse	Flosse
konsolidierend	konsolidierend
gibt	gibt
Europium	Europium
lodert	lodert
designierst	designierst
vergiften	vergiften
Martyrologium	Martyrologium
Löwen	Löwen
Anker	Anker
driftete	driftete
verbluten	verbluten
Donnerstagabenden	Donnerstagabenden
verkürzte	verkürzte
besprachen	besprachen
glänzen	glänzen
erziehen	erziehen
meuterest	meuterest
Brüder	Brüder
Dattel	Dattel
besicheret	besicheret
Geschichtsbüchern	Geschichtsbüchern
Paragraphenreiter	Paragraphenreiter
legest	legest
Sternen	Sternen
Ochse	Ochse
Leichenschauhäusern	Leichenschauhäusern
dichten	dichten
vergliche	vergliche
Backpflaumen	Backpflaumen
dritten	dritten
Unterschlagung	Unterschlagung
Füchsinnen	Füchsinnen
merket	merket
meinem	meinem
fingiere	fingiere
Gram	Gram
Kutter	Kutter
Fischer	Fischer
Iberer	Iberer
Äquatoren	Äquatoren
ehe	ehe
frevles	frevles
ernten	ernten
liebest	liebest
zwängtet	zwängtet
Steuerborden	Steuerborden
fehlte	fehlte
Inauguration	Inauguration
übersiehst	übersiehst
führen	führen
Augur	Augur
Puffersystemen	Puffersystemen
Indianer	Indianer
Laufringe	Laufringe
Meine	Meine
schreien	schreien
Riegel	Riegel
tappten	tappten
zerbricht	zerbricht
behauptest	behauptest
erwähnten	erwähnten
Naturen	Naturen
meinst	meinst
Huflattich	Huflattich
zerstückt	zerstückt
zuppen	zuppen
pensionierten	pensionierten
Randbemerkung	Randbemerkung
Gigapascaln	Gigapascaln
Kochfeldern	Kochfeldern
Rückumlauten	Rückumlauten
solches	solches
sei	sei
Krume	Krume
generiertet	generiertet
beauftragt	beauftragt
Zöpfe	Zöpfe
offenbarten	offenbarten
klingt	klingt
hängen	hängen
verkleinerest	verkleinerest
tat	tat
fünfte	fünfte
Hörspiel	Hörspiel
Gewichten	Gewichten
liebten	liebten
Luftschiff	Luftschiff
beleidige	beleidige
Fußbodens	Fußbodens
Schobern	Schobern
Gerichten	Gerichten
betrübten	betrübten
unterscheide	unterscheide
wachset	wachset
rangieret	rangieret
konsumiere	konsumiere
Mäusespeck	Mäusespeck
versagen	versagen
zerrissen	zerrissen
ausführte	ausführte
Karer	Karer
formulieren	formulieren
Stätten	Stätten
löge	löge
More	More
bündelest	bündelest
entwickelten	entwickelten
gedenke	gedenke
gleite	gleite
dechiffriere	dechiffriere
armen	armen
erkälteten	erkälteten
Quatsch	Quatsch
batet	batet
Komplexionen	Komplexionen
nötigte	nötigte
kürze	kürze
Astat	Astat
Brikette	Brikette
produzierest	produzierest
einst	einst
Locken	Locken
Erzherzogshüte	Erzherzogshüte
belohnte	belohnte
entkäme	entkäme
manövrierte	manövrierte
benachrichtiget	benachrichtiget
erriet	erriet
Pfarrerinnen	Pfarrerinnen
veranstaltest	veranstaltest
Herd	Herd
wären	wären
süsse	süsse
gefügt	gefügt
Käsereibe	Käsereibe
gehören	gehören
Theistinnen	Theistinnen
meißeltest	meißeltest
Ludwigsburger	Ludwigsburger
Planern	Planern
Leide	Leide
trügen	trügen
Trinkgefäßen	Trinkgefäßen
Notizen	Notizen
grüble	grüble
zürnst	zürnst
kramst	kramst
piesackest	piesackest
Welpen	Welpen
mopst	mopst
Schwächung	Schwächung
hieltest	hieltest
gedachte	gedachte
überreichst	überreichst
verwaiset	verwaiset
hicksest	hicksest
Träumers	Träumers
verbaselte	verbaselte
wechselwirkte	wechselwirkte
frottier	frottier
widerlegte	widerlegte
buddelten	buddelten
schämet	schämet
Möbiusbänder	Möbiusbänder
beide	beide
Brite	Brite
Unterseiten	Unterseiten
Polarisation	Polarisation
eggten	eggten
Liebchen	Liebchen
erwärmte	erwärmte
liebe	liebe
prahlte	prahlte
stickt	stickt
versuchten	versuchten
versuchest	versuchest
wogen	wogen
verstrahlet	verstrahlet
begehrtet	begehrtet
ärgere	ärgere
räucheret	räucheret
gestaltest	gestaltest
Kopfsalat	Kopfsalat
sitzet	sitzet
konsolidierest	konsolidierest
Sphäre	Sphäre
entdeckst	entdeckst
Polizeisprecher	Polizeisprecher
Collagen	Collagen
Acetaten	Acetaten
plagen	plagen
faschieren	faschieren
rebelliere	rebelliere
Regent	Regent
versucht	versucht
stellst	stellst
pulsiere	pulsiere
Bienenstock	Bienenstock
gewünscht	gewünscht
Testamente	Testamente
streute	streute
nagelest	nagelest
Bifurkationen	Bifurkationen
dividiere	dividiere
Lebenskraft	Lebenskraft
verbitterten	verbitterten
platzt	platzt
unehret	unehret
Gehör	Gehör
Tritt	Tritt
mikrominiaturisierten	mikrominiaturisierten
Sprödmetallen	Sprödmetallen
aller	aller
bekannte	bekannte
esset	esset
schwadronierten	schwadronierten
strömte	strömte
Schreibtischtätern	Schreibtischtätern
bebte	bebte
heilige	heilige
fistete	fistete
Wiedergutmachung	Wiedergutmachung
Marjellchens	Marjellchens
gravierst	gravierst
diese	diese
Membran	Membran
Geliebte	Geliebte
sinnst	sinnst
Zehnt	Zehnt
ahne	ahne
häufte	häufte
verwechseltet	verwechseltet
raubte	raubte
malträtierte	malträtierte
Reichweiten	Reichweiten
spekulieren	spekulieren
Dudelsäcken	Dudelsäcken
unterbewerte	unterbewerte
Störe	Störe
enträtselten	enträtselten
misstrauest	misstrauest
versteckten	versteckten
Heiratsgut	Heiratsgut
harmoniere	harmoniere
Werte	Werte
filzst	filzst
Affenbrotbaum	Affenbrotbaum
Banknoten	Banknoten
Knüppeln	Knüppeln
Anmeldern	Anmeldern
quietsche	quietsche
reif	reif
Päderast	Päderast
erlöst	erlöst
forschte	forschte
verziehst	verziehst
verdunsten	verdunsten
Lärche	Lärche
Stearat	Stearat
schweigen	schweigen
Drillinge	Drillinge
Kuttern	Kuttern
Numerus	Numerus
Herkünften	Herkünften
Meines	Meines
gewärtigt	gewärtigt
Sonnenfinsternis	Sonnenfinsternis
wispern	wispern
Kronsbeeren	Kronsbeeren
Borhydride	Borhydride
jedem	jedem
stillte	stillte
Weichlote	Weichlote
entdecket	entdecket
Stolz	Stolz
Düfte	Düfte
bis	bis
Abschirmungen	Abschirmungen
Heptamolybdat	Heptamolybdat
grün	grün
All	All
suchet	suchet
verbaselt	verbaselt
speise	speise
legt	legt
erzeigen	erzeigen
Landwirte	Landwirte
dein	dein
Kommoden	Kommoden
Halbzeit	Halbzeit
Tretlager	Tretlager
Narkotikum	Narkotikum
koexistierten	koexistierten
blast	blast
Dorsche	Dorsche
punkteten	punkteten
ungefälschter	ungefälschter
schläfst	schläfst
Abflug	Abflug
Portal	Portal
sagte	sagte
attackieret	attackieret
Ranzigkeit	Ranzigkeit
wart	wart
recycelten	recycelten
Jagdhunden	Jagdhunden
benützt	benützt
Trägergasen	Trägergasen
frische	frische
sündiget	sündiget
schwirret	schwirret
hintertriebe	hintertriebe
Zain	Zain
ermordetest	ermordetest
designiertet	designiertet
verdammtet	verdammtet
Crescendos	Crescendos
Rechenbrettern	Rechenbrettern
grausten	grausten
