missi	missi
reyndir	reyndir
ríkt	ríkt
eina	eina
skýrði	skýrði
nokkurs	nokkurs
ríktu	ríktu
sumu	sumu
Skyldum	Skyldum
notum	notum
væruð	væruð
guð	guð
kórónum	kórónum
lagður	lagður
síið	síið
þremur	þremur
Orðið	Orðið
inni	inni
meira	meira
þessar	þessar
salt	salt
engan	engan
raust	raust
Leita	Leita
langað	langað
veikir	veikir
gleðst	gleðst
nú	nú
öðlist	öðlist
áhuga	áhuga
útlisti	útlisti
dáið	dáið
gengið	gengið
fæðast	fæðast
hliðið	hliðið
berst	berst
Asía	Asía
tilreiknar	tilreiknar
fæddu	fæddu
hvort	hvort
minnstur	minnstur
mættum	mættum
sendur	sendur
oft	oft
sérhverja	sérhverja
kristinna	kristinna
hötuðum	hötuðum
skrifaði	skrifaði
kært	kært
styrktu	styrktu
fyrstum	fyrstum
lögðu	lögðu
lagt	lagt
hliðum	hliðum
kjörinn	kjörinn
líkið	líkið
dans	dans
ættu	ættu
tíðir	tíðir
mátt	mátt
hinum	hinum
tunglsjúka	tunglsjúka
fremstur	fremstur
hvern	hvern
grein	grein
þeirra	þeirra
hin	hin
horfið	horfið
ríkdóminn	ríkdóminn
hryggist	hryggist
hverjir	hverjir
múr	múr
munum	munum
sæti	sæti
hýstuð	hýstuð
leyfum	leyfum
heiður	heiður
framar	framar
boði	boði
auka	auka
hliðin	hliðin
hefðarsæti	hefðarsæti
nefnt	nefnt
birti	birti
vík	vík
hugsaði	hugsaði
mættuð	mættuð
seldu	seldu
skrifum	skrifum
síðast	síðast
lík	lík
skulu	skulu
blindum	blindum
Komu	Komu
of	of
mælir	mælir
fjórum	fjórum
líkist	líkist
jafnir	jafnir
misst	misst
lærast	lærast
neinn	neinn
dreif	dreif
skjóti	skjóti
hálsinn	hálsinn
kæru	kæru
nota	nota
skylduð	skylduð
æptu	æptu
hvílist	hvílist
lofi	lofi
getur	getur
mælið	mælið
mátti	mátti
met	met
foreldrum	foreldrum
var	var
reyndur	reyndur
sigur	sigur
veturinn	veturinn
standi	standi
gjöra	gjöra
koma	koma
Getum	Getum
verið	verið
hvað	hvað
fæddur	fæddur
starfa	starfa
tilreiknuð	tilreiknuð
andast	andast
kórónu	kórónu
net	net
leysir	leysir
krossfestan	krossfestan
breyttu	breyttu
stærum	stærum
byggð	byggð
huldu	huldu
næstur	næstur
skiptið	skiptið
valinn	valinn
lastmælir	lastmælir
sjötta	sjötta
Æðst	Æðst
sætum	sætum
þrengingu	þrengingu
þótti	þótti
dauðinn	dauðinn
ytra	ytra
slíka	slíka
séum	séum
skilin	skilin
hvaða	hvaða
hennar	hennar
eruð	eruð
mundir	mundir
þol	þol
fylltur	fylltur
borgum	borgum
sá	sá
gjörast	gjörast
glatast	glatast
lofaði	lofaði
hitt	hitt
báðar	báðar
mund	mund
eigur	eigur
safna	safna
talaði	talaði
náið	náið
aldir	aldir
umskornu	umskornu
Hvorn	Hvorn
hengdi	hengdi
settu	settu
hvílíkur	hvílíkur
skyldum	skyldum
skip	skip
hórkarla	hórkarla
víkur	víkur
virðist	virðist
hornum	hornum
haga	haga
skildir	skildir
skulum	skulum
fenguð	fenguð
minna	minna
hræða	hræða
komist	komist
Hvert	Hvert
krossinn	krossinn
berast	berast
hefur	hefur
kasti	kasti
postuladómi	postuladómi
allir	allir
sums	sums
bundna	bundna
Koma	Koma
skildum	skildum
séu	séu
spilltum	spilltum
Annað	Annað
æðsta	æðsta
drukkna	drukkna
bættu	bættu
vissum	vissum
kæra	kæra
fullreynd	fullreynd
valda	valda
ytri	ytri
græddir	græddir
Ert	Ert
þreytist	þreytist
óvirtir	óvirtir
hvorum	hvorum
ákæra	ákæra
fylli	fylli
Hafa	Hafa
byggðum	byggðum
Leitast	Leitast
mætti	mætti
loka	loka
lítið	lítið
Enginn	Enginn
leiðin	leiðin
sinna	sinna
gullið	gullið
þakkaði	þakkaði
neyddur	neyddur
leynda	leynda
hluti	hluti
vona	vona
hópum	hópum
fyllist	fyllist
styrkir	styrkir
heyrðu	heyrðu
laukst	laukst
nokkrir	nokkrir
spyrjist	spyrjist
selduð	selduð
samkundustjóri	samkundustjóri
slepptu	slepptu
spillist	spillist
saurga	saurga
Hvort	Hvort
aftra	aftra
engar	engar
komna	komna
hulda	hulda
mest	mest
Hvaða	Hvaða
vaxi	vaxi
trúðu	trúðu
fluttu	fluttu
Haf	Haf
vakir	vakir
staðinn	staðinn
heyrðir	heyrðir
hvílíka	hvílíka
kastaði	kastaði
heilla	heilla
postuladóm	postuladóm
rek	rek
mínu	mínu
felldur	felldur
skjótt	skjótt
vor	vor
hneigði	hneigði
senduð	senduð
slíkum	slíkum
sóttu	sóttu
þinn	þinn
málið	málið
gátum	gátum
hvaðan	hvaðan
einhver	einhver
flesta	flesta
byggir	byggir
svona	svona
hræddir	hræddir
leit	leit
þriðja	þriðja
spá	spá
flokka	flokka
fullreyndin	fullreyndin
uppvekja	uppvekja
missti	missti
náðu	náðu
breytist	breytist
Orð	Orð
sinn	sinn
skipa	skipa
bundið	bundið
skírist	skírist
fullnast	fullnast
fæst	fæst
dauði	dauði
felldir	felldir
hrekjast	hrekjast
eyrunum	eyrunum
leiða	leiða
hlýddu	hlýddu
skipt	skipt
norður	norður
fljótt	fljótt
yrði	yrði
stær	stær
valið	valið
ríkir	ríkir
greini	greini
þau	þau
Allan	Allan
fléttum	fléttum
mælum	mælum
Mannssonurinn	Mannssonurinn
komu	komu
komast	komast
einhvern	einhvern
át	át
skal	skal
þinni	þinni
brennur	brennur
þýðist	þýðist
þekktuð	þekktuð
ræddi	ræddi
talast	talast
eitur	eitur
leggst	leggst
klæða	klæða
vitrað	vitrað
minn	minn
yrðum	yrðum
Sjálfir	Sjálfir
tilreiknast	tilreiknast
finnst	finnst
þörfum	þörfum
ræðu	ræðu
Sendu	Sendu
Mannssoninn	Mannssoninn
munduð	munduð
verð	verð
samkundustjórunum	samkundustjórunum
gangast	gangast
þess	þess
hræðist	hræðist
sendu	sendu
völdu	völdu
velþóknanlegar	velþóknanlegar
skipast	skipast
verðum	verðum
færu	færu
báðum	báðum
þínar	þínar
langt	langt
mörkum	mörkum
skömmum	skömmum
þýðast	þýðast
lýsti	lýsti
ýmiss	ýmiss
eigist	eigist
nokkurt	nokkurt
skilaði	skilaði
heita	heita
nei	nei
sést	sést
sendum	sendum
syndgar	syndgar
fæddir	fæddir
lærði	lærði
umskorna	umskorna
alls	alls
höndli	höndli
vörum	vörum
minnast	minnast
reiðum	reiðum
kvæntur	kvæntur
Verði	Verði
öllu	öllu
burt	burt
leggur	leggur
lið	lið
eyddist	eyddist
gerðu	gerðu
hóp	hóp
sumum	sumum
rótfestu	rótfestu
drekkið	drekkið
sendi	sendi
virðast	virðast
slík	slík
Innan	Innan
slíkar	slíkar
vörunum	vörunum
skyldir	skyldir
blindir	blindir
Slíkar	Slíkar
tjá	tjá
fiska	fiska
þekktu	þekktu
fyrsta	fyrsta
skírði	skírði
skil	skil
mæli	mæli
máttu	máttu
líka	líka
segir	segir
spyrjast	spyrjast
kallaði	kallaði
sneri	sneri
höfðuð	höfðuð
heill	heill
þakkað	þakkað
ná	ná
gætir	gætir
hneigðu	hneigðu
sjúkdómur	sjúkdómur
óskum	óskum
settir	settir
muni	muni
heima	heima
leysa	leysa
fimmta	fimmta
þessu	þessu
greina	greina
hópur	hópur
láta	láta
gefinn	gefinn
þvo	þvo
fullnuð	fullnuð
eyðist	eyðist
Anna	Anna
Hafði	Hafði
deyðir	deyðir
ert	ert
horfðu	horfðu
aukið	aukið
aukist	aukist
ritum	ritum
brenna	brenna
djúp	djúp
skuluð	skuluð
uppi	uppi
haldast	haldast
finnast	finnast
leyndum	leyndum
gjörir	gjörir
Mælir	Mælir
ákveðin	ákveðin
ríki	ríki
giftist	giftist
kasta	kasta
þvost	þvost
víst	víst
fremur	fremur
seldir	seldir
þúsunda	þúsunda
stór	stór
Lík	Lík
ríkdóm	ríkdóm
styrkist	styrkist
stóra	stóra
gefast	gefast
flytjist	flytjist
þreytast	þreytast
værum	værum
mínar	mínar
hvílíkan	hvílíkan
mesta	mesta
Þess	Þess
tölu	tölu
vanheilagan	vanheilagan
fá	fá
krossfesti	krossfesti
Æðstu	Æðstu
það	það
læsir	læsir
skömm	skömm
felldu	felldu
gift	gift
dána	dána
þrengingunum	þrengingunum
þrumum	þrumum
foreldrunum	foreldrunum
haldið	haldið
hljómaði	hljómaði
segist	segist
ræddu	ræddu
fjarlægir	fjarlægir
bættist	bættist
Hverja	Hverja
orðið	orðið
postuladóms	postuladóms
vitrast	vitrast
verk	verk
tíð	tíð
best	best
ríkti	ríkti
rekið	rekið
skalt	skalt
vísa	vísa
skipta	skipta
lærður	lærður
hvílu	hvílu
höfum	höfum
sleppt	sleppt
borðum	borðum
fylltir	fylltir
Hvað	Hvað
munið	munið
skækjum	skækjum
engu	engu
Þau	Þau
hvor	hvor
Enga	Enga
lögð	lögð
hvorir	hvorir
metið	metið
áhugi	áhugi
skapi	skapi
drýgðu	drýgðu
lokum	lokum
Hef	Hef
háls	háls
ályktað	ályktað
gróðaveg	gróðaveg
þakkir	þakkir
mæla	mæla
gegnt	gegnt
skamma	skamma
skækjur	skækjur
sjálfir	sjálfir
reki	reki
kunna	kunna
keyptu	keyptu
fáist	fáist
Eru	Eru
helgi	helgi
birta	birta
þoli	þoli
glerhafið	glerhafið
byggða	byggða
turninn	turninn
öðlast	öðlast
hvílíkum	hvílíkum
auk	auk
allur	allur
yrðu	yrðu
kastað	kastað
hrekja	hrekja
haft	haft
þúsundum	þúsundum
settum	settum
hagi	hagi
völdum	völdum
þolið	þolið
gjalda	gjalda
Er	Er
hugi	hugi
Kom	Kom
spillti	spillti
er	er
elskum	elskum
leyst	leyst
múrinn	múrinn
jafnt	jafnt
Látið	Látið
aftrar	aftrar
fyrsti	fyrsti
fara	fara
fyrstur	fyrstur
leiddur	leiddur
einum	einum
hverju	hverju
Guði	Guði
úti	úti
hinir	hinir
Asíu	Asíu
mær	mær
hræðast	hræðast
bæta	bæta
málum	málum
misgjörðin	misgjörðin
gegnum	gegnum
gættu	gættu
ræða	ræða
þín	þín
fleygt	fleygt
útlistum	útlistum
lauk	lauk
safnaði	safnaði
minnst	minnst
æpti	æpti
tölum	tölum
þessum	þessum
dæma	dæma
kóróna	kóróna
akur	akur
treystu	treystu
leitaði	leitaði
hina	hina
munu	munu
breyta	breyta
kyssti	kyssti
lastmælin	lastmælin
breiddi	breiddi
birtur	birtur
mála	mála
heiðurinn	heiðurinn
safnað	safnað
þvoðu	þvoðu
haldist	haldist
óskir	óskir
djúpt	djúpt
nefnast	nefnast
dæmdum	dæmdum
leyfi	leyfi
eru	eru
sjálft	sjálft
sigurinn	sigurinn
líkir	líkir
safnast	safnast
leyfið	leyfið
undir	undir
hópinn	hópinn
hefðum	hefðum
allan	allan
dæmast	dæmast
brotið	brotið
rita	rita
fleygði	fleygði
ljúka	ljúka
gjörði	gjörði
hvíl	hvíl
gull	gull
vísu	vísu
gengist	gengist
engir	engir
hvílík	hvílík
munir	munir
óréttinn	óréttinn
sumir	sumir
Hinar	Hinar
ljúkast	ljúkast
fyrstir	fyrstir
fylltu	fylltu
sjálfu	sjálfu
skipaði	skipaði
starfi	starfi
vonum	vonum
flettu	flettu
stærið	stærið
rekur	rekur
flokki	flokki
hinar	hinar
verði	verði
Hefur	Hefur
hvílíkar	hvílíkar
blinda	blinda
Hinir	Hinir
rótfestir	rótfestir
þolað	þolað
kom	kom
klæddir	klæddir
giftast	giftast
fyllti	fyllti
útlista	útlista
foreldra	foreldra
glerhaf	glerhaf
nefndir	nefndir
andaði	andaði
búið	búið
gátuð	gátuð
drepa	drepa
vissir	vissir
ríkdóms	ríkdóms
enn	enn
skipti	skipti
tala	tala
hræddur	hræddur
boðið	boðið
vitrunum	vitrunum
skilið	skilið
jafna	jafna
svara	svara
lofgjörðin	lofgjörðin
þótt	þótt
þreytst	þreytst
skrifi	skrifi
hafið	hafið
Getur	Getur
kær	kær
kærðu	kærðu
hittum	hittum
lagðir	lagðir
leystu	leystu
yrðuð	yrðuð
guði	guði
stóð	stóð
reiðin	reiðin
Hin	Hin
syndgað	syndgað
skipunum	skipunum
gjaldið	gjaldið
sjöundi	sjöundi
skyldi	skyldi
skjótum	skjótum
sjötti	sjötti
deyða	deyða
söfnuðu	söfnuðu
eyrum	eyrum
virti	virti
greinunum	greinunum
Allir	Allir
síðasta	síðasta
mun	mun
þrenging	þrenging
þrengingum	þrengingum
látum	látum
þriðju	þriðju
fæðu	fæðu
samkundustjórinn	samkundustjórinn
umskornir	umskornir
boðin	boðin
undan	undan
Verið	Verið
myrti	myrti
anda	anda
huga	huga
varst	varst
smaragður	smaragður
Munum	Munum
þörf	þörf
drekki	drekki
alda	alda
opinber	opinber
Hvaðan	Hvaðan
lastmæla	lastmæla
nefnist	nefnist
breiddu	breiddu
leiddi	leiddi
saurgar	saurgar
klæddum	klæddum
líki	líki
gjörðu	gjörðu
græddi	græddi
lærðuð	lærðuð
Hvar	Hvar
Jasoni	Jasoni
gegn	gegn
sagt	sagt
mundum	mundum
leyfðu	leyfðu
hlýddi	hlýddi
gæti	gæti
líkt	líkt
míns	míns
flytjast	flytjast
þekkt	þekkt
einu	einu
fæða	fæða
kjörið	kjörið
lastmælt	lastmælt
munt	munt
samboðið	samboðið
glataði	glataði
Hvor	Hvor
síðastir	síðastir
hætt	hætt
megum	megum
stæra	stæra
tjáði	tjáði
annað	annað
þekktur	þekktur
fylla	fylla
alla	alla
dáðu	dáðu
styrkti	styrkti
setta	setta
verðið	verðið
ættfeðurna	ættfeðurna
lofgjörð	lofgjörð
höfðu	höfðu
Líkt	Líkt
þrem	þrem
leyndi	leyndi
byggður	byggður
sýnast	sýnast
boðaði	boðaði
sakargift	sakargift
fyrstu	fyrstu
réttur	réttur
boða	boða
mælist	mælist
ala	ala
mörk	mörk
eitt	eitt
skírast	skírast
hryggir	hryggir
enginn	enginn
aukast	aukast
klædd	klædd
skyldu	skyldu
Munu	Munu
undur	undur
týnda	týnda
heiman	heiman
borðið	borðið
leyfði	leyfði
hengdu	hengdu
Send	Send
sjálfur	sjálfur
hefðarsætin	hefðarsætin
týndur	týndur
fórnfært	fórnfært
fljótið	fljótið
Sumir	Sumir
klæðum	klæðum
stundir	stundir
hafna	hafna
neytt	neytt
flettir	flettir
fyllir	fyllir
dæmi	dæmi
höndla	höndla
fluttur	fluttur
hórkarl	hórkarl
dæmið	dæmið
slíkir	slíkir
sumt	sumt
raustum	raustum
sjöunda	sjöunda
rigni	rigni
treystir	treystir
komum	komum
þekkist	þekkist
vissu	vissu
komst	komst
haf	haf
varðveitast	varðveitast
máli	máli
fremst	fremst
búist	búist
sum	sum
leitt	leitt
valdi	valdi
ritaði	ritaði
kunni	kunni
þrumu	þrumu
Sjálfur	Sjálfur
sett	sett
ferð	ferð
flétta	flétta
félagi	félagi
fjórir	fjórir
lofið	lofið
heiti	heiti
færð	færð
fimmti	fimmti
krossfestur	krossfestur
hugsast	hugsast
hafi	hafi
hafa	hafa
þreytum	þreytum
vissa	vissa
ákveðið	ákveðið
öllum	öllum
en	en
meta	meta
Mannssonur	Mannssonur
gætti	gætti
öll	öll
gjörðuð	gjörðuð
klædda	klædda
slíku	slíku
engum	engum
Skyldi	Skyldi
skýrðu	skýrðu
neins	neins
verða	verða
grísku	grísku
hætta	hætta
varðveitist	varðveitist
allt	allt
leggið	leggið
ráði	ráði
móður	móður
bætti	bætti
Hvern	Hvern
virði	virði
áliti	áliti
kvæntist	kvæntist
slíkan	slíkan
dæmdu	dæmdu
öðrum	öðrum
gerist	gerist
hötuðu	hötuðu
lifnaði	lifnaði
óvirti	óvirti
sinnar	sinnar
jafnað	jafnað
sérhvert	sérhvert
kosta	kosta
mestu	mestu
kringum	kringum
vaka	vaka
spillast	spillast
rifi	rifi
stundu	stundu
heitir	heitir
Kristur	Kristur
Allur	Allur
væri	væri
gjöri	gjöri
ættfeðurnir	ættfeðurnir
vaxið	vaxið
minnstu	minnstu
lifnaður	lifnaður
Fyrst	Fyrst
inn	inn
skýrum	skýrum
út	út
breytt	breytt
veitist	veitist
þrengingar	þrengingar
hittu	hittu
byggist	byggist
vara	vara
hljómað	hljómað
hvílíkt	hvílíkt
þjást	þjást
ein	ein
hvert	hvert
gleði	gleði
vitrir	vitrir
vetur	vetur
borði	borði
kristinn	kristinn
berð	berð
birtir	birtir
byggði	byggði
hégómamáls	hégómamáls
eigið	eigið
denar	denar
merkti	merkti
alinn	alinn
ráðast	ráðast
glatt	glatt
borgir	borgir
ríkdómi	ríkdómi
ilmjurtunum	ilmjurtunum
biðjist	biðjist
valdið	valdið
Eruð	Eruð
gefin	gefin
annan	annan
sinni	sinni
værir	værir
fundinn	fundinn
þriðji	þriðji
síst	síst
neitaði	neitaði
horn	horn
heilsaði	heilsaði
Dauðinn	Dauðinn
fylgdum	fylgdum
horft	horft
deyðast	deyðast
skipi	skipi
hreinsaði	hreinsaði
spáði	spáði
óska	óska
Það	Það
kross	kross
brott	brott
klæðast	klæðast
neitað	neitað
gerast	gerast
lifðu	lifðu
Slíkt	Slíkt
heyrðum	heyrðum
Fyrsti	Fyrsti
settuð	settuð
brúðkaupsgestir	brúðkaupsgestir
ríkdómur	ríkdómur
búna	búna
Þessir	Þessir
vissuð	vissuð
sé	sé
næst	næst
Látum	Látum
þrýstir	þrýstir
eyddi	eyddi
fyllast	fyllast
fram	fram
gætum	gætum
skírlífar	skírlífar
tunglsjúkur	tunglsjúkur
líkur	líkur
boðum	boðum
freistað	freistað
suma	suma
sig	sig
skilinn	skilinn
skapa	skapa
heyrast	heyrast
kröftugi	kröftugi
Hafi	Hafi
dreifst	dreifst
færði	færði
skrifa	skrifa
misgjörða	misgjörða
snúið	snúið
hrærði	hrærði
mínir	mínir
syndga	syndga
reynist	reynist
átuð	átuð
ofar	ofar
liðinn	liðinn
undu	undu
hlið	hlið
liðið	liðið
þjáði	þjáði
ferst	ferst
snerist	snerist
sjúkdóm	sjúkdóm
heyrðuð	heyrðuð
þekkti	þekkti
Alls	Alls
heilsu	heilsu
hluta	hluta
ráðið	ráðið
næsta	næsta
stóru	stóru
síðu	síðu
heitt	heitt
ali	ali
stundum	stundum
gætt	gætt
vanheilagir	vanheilagir
saurgi	saurgi
denarinn	denarinn
þúsund	þúsund
keyptir	keyptir
þrýstu	þrýstu
æðst	æðst
nefndur	nefndur
hvílíks	hvílíks
senda	senda
hefðuð	hefðuð
leggi	leggi
eigin	eigin
sleppir	sleppir
auki	auki
sína	sína
norðan	norðan
fletta	fletta
drepum	drepum
lengi	lengi
jafnast	jafnast
seldur	seldur
saurgast	saurgast
Hafið	Hafið
hrærist	hrærist
kastið	kastið
færist	færist
tali	tali
ættum	ættum
krossfestir	krossfestir
veittuð	veittuð
allar	allar
missir	missir
áttundi	áttundi
talentu	talentu
sendir	sendir
slíkt	slíkt
lítt	lítt
leiðir	leiðir
ráða	ráða
byggðu	byggðu
ættuð	ættuð
elskaði	elskaði
kennir	kennir
minnsta	minnsta
boð	boð
Suma	Suma
upp	upp
elska	elska
halda	halda
síðastur	síðastur
hreinsast	hreinsast
nokkru	nokkru
kallast	kallast
mínum	mínum
eigna	eigna
hafir	hafir
skildist	skildist
móðu	móðu
hýst	hýst
vanheilagt	vanheilagt
helgast	helgast
höndlað	höndlað
Krist	Krist
samkundustjóra	samkundustjóra
Réttu	Réttu
Kristi	Kristi
birtum	birtum
horfum	horfum
horfði	horfði
gerði	gerði
stökk	stökk
velþóknanlegur	velþóknanlegur
sótt	sótt
getum	getum
hinu	hinu
leiddu	leiddu
varna	varna
órétt	órétt
svaraði	svaraði
leiddir	leiddir
elsku	elsku
stæri	stæri
verki	verki
dansaði	dansaði
myrtu	myrtu
skipið	skipið
gifta	gifta
hlýst	hlýst
standast	standast
opna	opna
Fyrir	Fyrir
kunnir	kunnir
fært	fært
gangi	gangi
leyfa	leyfa
veittu	veittu
tíðum	tíðum
langaði	langaði
áttunda	áttunda
fjarlægt	fjarlægt
Krists	Krists
eignarlýður	eignarlýður
álit	álit
þrengingin	þrengingin
neitt	neitt
saltast	saltast
syndgið	syndgið
fórnfæra	fórnfæra
réttu	réttu
þessi	þessi
græddur	græddur
farast	farast
turn	turn
hitti	hitti
styrki	styrki
metast	metast
eyða	eyða
dæmdir	dæmdir
drukkið	drukkið
flokkum	flokkum
Alla	Alla
lagði	lagði
höfðum	höfðum
þakka	þakka
dáð	dáð
ráð	ráð
gríska	gríska
raustin	raustin
helgum	helgum
borga	borga
mærin	mærin
báða	báða
metum	metum
gjörist	gjörist
veitast	veitast
einhverja	einhverja
sjálfan	sjálfan
breytum	breytum
freistaði	freistaði
veitti	veitti
þarfir	þarfir
stóðuð	stóðuð
dæmist	dæmist
ofan	ofan
hlýði	hlýði
loft	loft
heyrði	heyrði
fjóra	fjóra
skammt	skammt
Guð	Guð
krossfest	krossfest
öðru	öðru
gjörður	gjörður
kysstu	kysstu
bæru	bæru
skiptir	skiptir
fiskinn	fiskinn
syndgum	syndgum
henni	henni
hvar	hvar
þína	þína
langi	langi
dauða	dauða
heimtuð	heimtuð
hættu	hættu
heim	heim
neytti	neytti
eigi	eigi
Jason	Jason
hvílt	hvílt
sín	sín
nokkur	nokkur
vakti	vakti
fullyrtu	fullyrtu
lengur	lengur
rigna	rigna
sjúkdóma	sjúkdóma
þínu	þínu
heilli	heilli
tíða	tíða
Mun	Mun
fást	fást
hvílast	hvílast
vanheilagur	vanheilagur
rétt	rétt
þessa	þessa
aftrið	aftrið
þessir	þessir
spáð	spáð
færðuð	færðuð
gengi	gengi
færðir	færðir
hafði	hafði
skjótast	skjótast
fullyrti	fullyrti
hórkarlar	hórkarlar
núna	núna
fjórðu	fjórðu
kosti	kosti
greinum	greinum
höfði	höfði
styrk	styrk
denara	denara
fjórði	fjórði
brennu	brennu
báðir	báðir
hengduð	hengduð
flokk	flokk
spilltur	spilltur
minni	minni
hristi	hristi
kenndir	kenndir
fljótir	fljótir
veikt	veikt
kring	kring
aftraði	aftraði
fullreyndur	fullreyndur
Inn	Inn
erum	erum
byggt	byggt
mega	mega
raustar	raustar
hópa	hópa
voruð	voruð
fundin	fundin
eignarlýð	eignarlýð
leiði	leiði
kenni	kenni
dansa	dansa
fremsta	fremsta
gefið	gefið
trú	trú
leitast	leitast
hvílir	hvílir
meir	meir
staða	staða
vorum	vorum
leita	leita
krossfestuð	krossfestuð
svarið	svarið
fiski	fiski
samboðin	samboðin
varðveitti	varðveitti
æðstu	æðstu
sýnist	sýnist
klædduð	klædduð
megið	megið
aldur	aldur
hrygg	hrygg
reka	reka
mestur	mestur
lastmæltu	lastmæltu
þínir	þínir
nokkrum	nokkrum
birtast	birtast
hins	hins
Erum	Erum
Rétt	Rétt
biðjast	biðjast
leiðast	leiðast
geta	geta
neinir	neinir
reynast	reynast
spáðu	spáðu
þóttist	þóttist
bærum	bærum
þjáist	þjáist
svo	svo
saurgað	saurgað
Komum	Komum
flokkur	flokkur
Fyrstur	Fyrstur
stært	stært
tilreiknaði	tilreiknaði
drýgði	drýgði
Þessi	Þessi
breytti	breytti
send	send
skækjan	skækjan
reiði	reiði
Sum	Sum
Allt	Allt
félaga	félaga
háum	háum
fiskurinn	fiskurinn
óvirtuð	óvirtuð
slíkur	slíkur
opnaði	opnaði
þekktir	þekktir
Engum	Engum
þinna	þinna
rétta	rétta
neyttu	neyttu
talið	talið
leitum	leitum
ákæru	ákæru
reiðir	reiðir
þúsundunum	þúsundunum
framan	framan
sérhver	sérhver
órétti	órétti
þrengdi	þrengdi
heimta	heimta
fisk	fisk
klæði	klæði
skírlífu	skírlífu
sérhvern	sérhvern
opið	opið
háir	háir
breidd	breidd
hvílíkir	hvílíkir
drekk	drekk
ákærðu	ákærðu
hætti	hætti
fundum	fundum
dæmdur	dæmdur
hefði	hefði
síðar	síðar
óvirt	óvirt
lastmæli	lastmæli
talentur	talentur
skjóta	skjóta
þeirrar	þeirrar
heitið	heitið
setti	setti
þrengdist	þrengdist
hefðu	hefðu
keypti	keypti
minnist	minnist
stökktu	stökktu
gætu	gætu
hrista	hrista
Þessa	Þessa
stærir	stærir
snúast	snúast
sýndu	sýndu
samboðna	samboðna
raustu	raustu
hef	hef
neinu	neinu
sagna	sagna
þarft	þarft
flokkinn	flokkinn
lýst	lýst
sýnduð	sýnduð
neyddu	neyddu
látna	látna
ýmist	ýmist
þinnar	þinnar
mál	mál
krossfesta	krossfesta
brúðkaupsgestum	brúðkaupsgestum
Skyldu	Skyldu
ráðum	ráðum
birtist	birtist
nokkra	nokkra
nokkrar	nokkrar
kennd	kennd
flestir	flestir
annast	annast
hýstum	hýstum
reynd	reynd
helga	helga
fórnfærði	fórnfærði
krossfestu	krossfestu
Nakson	Nakson
voru	voru
borð	borð
gjaldi	gjaldi
burtu	burtu
merkir	merkir
fæðist	fæðist
opinberast	opinberast
ilmjurtir	ilmjurtir
stökkti	stökkti
virtuð	virtuð
trúa	trúa
skiptum	skiptum
rétti	rétti
söfnuð	söfnuð
stunda	stunda
opnast	opnast
fæddi	fæddi
vitru	vitru
skapaði	skapaði
segðu	segðu
fylgdist	fylgdist
Naksons	Naksons
fundið	fundið
hlutum	hlutum
enga	enga
settur	settur
hópi	hópi
tilreiknað	tilreiknað
felld	felld
smaragð	smaragð
akurinn	akurinn
hégómamál	hégómamál
Dauði	Dauði
nefnda	nefnda
ályktaði	ályktaði
sást	sást
lokið	lokið
fjarlægð	fjarlægð
snúi	snúi
fengin	fengin
virða	virða
rifið	rifið
skýrt	skýrt
hald	hald
samboðinn	samboðinn
færðu	færðu
deyðið	deyðið
leysast	leysast
heilsa	heilsa
mína	mína
standa	standa
Þessu	Þessu
lok	lok
læsti	læsti
hristu	hristu
leyndu	leyndu
hryggi	hryggi
krossfestið	krossfestið
væru	væru
færir	færir
höfða	höfða
gróðavegur	gróðavegur
treyst	treyst
sakargiftir	sakargiftir
kærir	kærir
kröftugt	kröftugt
dæmt	dæmt
þíns	þíns
leysti	leysti
síður	síður
ríkið	ríkið
bestu	bestu
velþóknanleg	velþóknanleg
læst	læst
uppvekur	uppvekur
Mæli	Mæli
þeirri	þeirri
þínum	þínum
lifði	lifði
látið	látið
mín	mín
orð	orð
byggðir	byggðir
ber	ber
liði	liði
hverja	hverja
