Städte	Städte
aufhört	aufhört
unsere	unsere
blasen	blasen
taufst	taufst
blitzt	blitzt
aufrichte	aufrichte
ausbreitete	ausbreitete
Funken	Funken
Altären	Altären
Aussätzigen	Aussätzigen
aufwachte	aufwachte
sehest	sehest
unserem	unserem
Kosten	Kosten
Haut	Haut
Dinge	Dinge
Anschläge	Anschläge
grüßt	grüßt
ringet	ringet
stärken	stärken
Reife	Reife
merken	merken
Ordnungen	Ordnungen
Herden	Herden
prüfet	prüfet
Wehr	Wehr
führest	führest
Setzt	Setzt
wild	wild
frisch	frisch
versteckst	versteckst
weinest	weinest
übte	übte
rauben	rauben
Hecken	Hecken
zählet	zählet
streite	streite
stellst	stellst
irgendeine	irgendeine
erschrecket	erschrecket
vereinigt	vereinigt
Gebirgen	Gebirgen
Raben	Raben
schauen	schauen
Grüße	Grüße
forschte	forschte
Freunden	Freunden
befehlt	befehlt
Blitzen	Blitzen
raubet	raubet
glaubte	glaubte
haderte	haderte
regieret	regieret
lernet	lernet
gedenkest	gedenkest
hängen	hängen
ermahnt	ermahnt
älteste	älteste
Sieben	Sieben
fasset	fasset
hinausgeht	hinausgeht
mangeln	mangeln
Merket	Merket
Leide	Leide
Sorgen	Sorgen
verlasset	verlasset
verkürzt	verkürzt
Staube	Staube
Meeren	Meeren
ihrem	ihrem
Tiefe	Tiefe
schreien	schreien
Staub	Staub
wachen	wachen
hilft	hilft
lieben	lieben
hurst	hurst
flucht	flucht
jaget	jaget
spalten	spalten
Knechte	Knechte
Eile	Eile
Weihe	Weihe
hauen	hauen
Fittiche	Fittiche
gedenkst	gedenkst
Schaffet	Schaffet
trinkest	trinkest
demütigst	demütigst
brause	brause
streute	streute
blaset	blaset
Weihen	Weihen
Händen	Händen
streckst	streckst
reife	reife
Gebeine	Gebeine
Tust	Tust
haut	haut
Erben	Erben
ziere	ziere
Suchet	Suchet
liebe	liebe
innere	innere
Helme	Helme
kriegte	kriegte
wogen	wogen
Seilen	Seilen
Pfunde	Pfunde
vermagst	vermagst
Hecke	Hecke
erweckest	erweckest
schlaf	schlaf
zürnest	zürnest
Binden	Binden
Rauben	Rauben
arm	arm
wehren	wehren
dürfest	dürfest
zerbricht	zerbricht
brachen	brachen
gehet	gehet
Christen	Christen
Kühen	Kühen
erfreut	erfreut
beschuldiget	beschuldiget
laben	laben
zierte	zierte
stahl	stahl
bewahrst	bewahrst
Wänden	Wänden
würdet	würdet
schätzen	schätzen
eile	eile
Sprüche	Sprüche
langte	langte
Töpfen	Töpfen
Decken	Decken
tobst	tobst
gehorchst	gehorchst
gewöhnt	gewöhnt
Kommet	Kommet
Auge	Auge
fahrest	fahrest
erhörest	erhörest
Reiche	Reiche
dein	dein
schaffest	schaffest
neige	neige
Aase	Aase
hoffet	hoffet
Jude	Jude
auflegt	auflegt
aufkommen	aufkommen
Schauen	Schauen
Pfeile	Pfeile
deinen	deinen
warnte	warnte
Gehorchet	Gehorchet
Neumonden	Neumonden
bewähret	bewähret
Lobgesänge	Lobgesänge
Satzung	Satzung
Ihren	Ihren
mahle	mahle
Könige	Könige
Werke	Werke
Laufet	Laufet
Gebeten	Gebeten
alles	alles
Schilden	Schilden
zerstörst	zerstörst
erwürget	erwürget
ausführte	ausführte
ernten	ernten
irre	irre
träumte	träumte
Wehklage	Wehklage
warst	warst
Entsetzt	Entsetzt
gehest	gehest
preiset	preiset
zeigte	zeigte
zeiget	zeiget
zerstreuest	zerstreuest
messe	messe
wilden	wilden
sterbet	sterbet
wechselte	wechselte
hebet	hebet
Essen	Essen
werde	werde
hilfst	hilfst
schweiget	schweiget
vertraget	vertraget
empörten	empörten
Feinde	Feinde
schicke	schicke
erweckt	erweckt
gehörst	gehörst
Ebene	Ebene
erfahrest	erfahrest
anrichten	anrichten
zweifel	zweifel
Stricken	Stricken
gefällt	gefällt
blitzte	blitzte
ruhest	ruhest
Sternen	Sternen
untergehst	untergehst
Decket	Decket
Befehlen	Befehlen
Fällen	Fällen
unsrer	unsrer
keine	keine
beides	beides
schöpfte	schöpfte
Unsere	Unsere
Spannt	Spannt
zerstreut	zerstreut
macht	macht
Edelsteine	Edelsteine
kaufte	kaufte
Diebe	Diebe
aufheben	aufheben
Herzen	Herzen
absagen	absagen
Schenken	Schenken
deines	deines
anzeigest	anzeigest
Majestäten	Majestäten
speise	speise
vergessest	vergessest
Juden	Juden
weinen	weinen
lobte	lobte
Stämme	Stämme
demütiget	demütiget
Regiert	Regiert
verfolgst	verfolgst
Reif	Reif
würze	würze
besorgt	besorgt
anrichte	anrichte
löst	löst
haltest	haltest
eines	eines
schmückte	schmückte
Maße	Maße
wirket	wirket
führet	führet
Älteste	Älteste
durchbohrt	durchbohrt
Gehilfe	Gehilfe
grüßet	grüßet
Märkte	Märkte
Königreiche	Königreiche
zuschließet	zuschließet
Füchse	Füchse
vergesset	vergesset
fallen	fallen
leget	leget
trotze	trotze
weiche	weiche
entsetzten	entsetzten
Trinken	Trinken
verwahrst	verwahrst
füllen	füllen
erlassen	erlassen
rechten	rechten
Ängste	Ängste
trägst	trägst
Schläge	Schläge
weinst	weinst
Propheten	Propheten
Meinen	Meinen
irgendein	irgendein
rufen	rufen
scheinen	scheinen
Eines	Eines
setzte	setzte
glänzte	glänzte
Heide	Heide
bestellt	bestellt
seinen	seinen
Suche	Suche
verstecken	verstecken
stillte	stillte
euren	euren
wahre	wahre
Herr	Herr
vier	vier
Merke	Merke
könnten	könnten
Woge	Woge
gehorchte	gehorchte
nimmt	nimmt
schlagt	schlagt
befehle	befehle
Klagen	Klagen
jagst	jagst
fliegen	fliegen
Ecken	Ecken
pflegte	pflegte
Kehre	Kehre
Edelsteinen	Edelsteinen
erfüllet	erfüllet
Fellen	Fellen
wünsche	wünsche
pflanzet	pflanzet
Wesen	Wesen
laden	laden
Herren	Herren
ehrte	ehrte
Eingeweiden	Eingeweiden
lest	lest
währet	währet
stürzt	stürzt
brecht	brecht
steckst	steckst
schwelle	schwelle
prüfest	prüfest
Kein	Kein
suche	suche
bedürft	bedürft
Gläubige	Gläubige
harrte	harrte
erniedrigt	erniedrigt
sorge	sorge
fragte	fragte
betrübte	betrübte
bestimmt	bestimmt
nehmt	nehmt
verbergt	verbergt
schnitt	schnitt
taufte	taufte
speisen	speisen
schämet	schämet
Pferde	Pferde
Habe	Habe
Säcke	Säcke
gebot	gebot
Zöpfe	Zöpfe
Zäumen	Zäumen
haltet	haltet
versagen	versagen
versagt	versagt
Werkzeugen	Werkzeugen
Gesell	Gesell
vergebt	vergebt
erntete	erntete
bedürfet	bedürfet
holst	holst
stehest	stehest
betrübt	betrübt
Früchte	Früchte
scheide	scheide
scheu	scheu
blase	blase
Fülle	Fülle
fällt	fällt
jammern	jammern
binde	binde
Bund	Bund
Schaffe	Schaffe
beißt	beißt
danke	danke
gehorcht	gehorcht
zerstreuten	zerstreuten
unser	unser
Arme	Arme
gleich	gleich
Gehör	Gehör
wohnet	wohnet
Setzet	Setzet
Jüngern	Jüngern
bestanden	bestanden
anderen	anderen
Werdet	Werdet
Gebärde	Gebärde
befestigte	befestigte
Buchstabe	Buchstabe
stellte	stellte
räumen	räumen
kaufest	kaufest
stoßest	stoßest
feiert	feiert
Meinst	Meinst
fliege	fliege
Seil	Seil
Gläubigen	Gläubigen
bewahrest	bewahrest
Brüsten	Brüsten
Köpfen	Köpfen
reichet	reichet
zerstreuet	zerstreuet
Flammen	Flammen
ansehet	ansehet
lang	lang
pflügen	pflügen
lachen	lachen
griechisch	griechisch
mehr	mehr
tragt	tragt
neigte	neigte
rächest	rächest
gewinnen	gewinnen
heulte	heulte
Tat	Tat
auflegst	auflegst
fehlet	fehlet
unsre	unsre
Trinkgefäßen	Trinkgefäßen
eine	eine
hinausgehst	hinausgehst
liebest	liebest
kommest	kommest
geratest	geratest
losen	losen
trinket	trinket
gehört	gehört
befehlen	befehlen
Tiefen	Tiefen
wünschen	wünschen
Zerstreuten	Zerstreuten
Leid	Leid
kommst	kommst
trauten	trauten
Schneide	Schneide
Gerichten	Gerichten
Gedanke	Gedanke
Dein	Dein
spannen	spannen
Füllet	Füllet
wärmte	wärmte
lieb	lieb
verziehe	verziehe
Paläste	Paläste
baust	baust
werdet	werdet
huren	huren
Boten	Boten
Anschlägen	Anschlägen
salzen	salzen
schießt	schießt
Fischen	Fischen
Tier	Tier
Anfechtung	Anfechtung
haben	haben
Zeugnisse	Zeugnisse
Biene	Biene
bezahlst	bezahlst
Mäusen	Mäusen
Plage	Plage
baute	baute
einnehmest	einnehmest
lehnen	lehnen
handhabest	handhabest
herrschte	herrschte
schenkte	schenkte
setzt	setzt
reizen	reizen
Lüste	Lüste
heiß	heiß
Heuschrecken	Heuschrecken
werfet	werfet
spielte	spielte
Krieg	Krieg
Geboten	Geboten
Lehnen	Lehnen
Steige	Steige
zeuge	zeuge
gelangte	gelangte
schnelle	schnelle
verführt	verführt
bricht	bricht
Enden	Enden
Söhnen	Söhnen
behalte	behalte
wehrte	wehrte
weisest	weisest
warnst	warnst
aufhörte	aufhörte
fällen	fällen
sitze	sitze
verständig	verständig
Elle	Elle
springst	springst
scheinet	scheinet
tretet	tretet
Hundert	Hundert
Gefäßen	Gefäßen
log	log
Keiner	Keiner
Weile	Weile
bedeckest	bedeckest
reif	reif
handhaben	handhaben
vierte	vierte
wach	wach
verklärest	verklärest
Sehnen	Sehnen
führen	führen
Unserer	Unserer
würdest	würdest
beweisen	beweisen
sprachen	sprachen
ausrufen	ausrufen
Höret	Höret
wiederkommt	wiederkommt
Märkten	Märkten
linken	linken
widerstanden	widerstanden
Heeren	Heeren
beseht	beseht
machest	machest
Schaden	Schaden
heiße	heiße
Fremden	Fremden
liebte	liebte
strafen	strafen
überführen	überführen
gebiete	gebiete
verkehrte	verkehrte
meinen	meinen
wirft	wirft
wallet	wallet
Sprüchen	Sprüchen
Bleibe	Bleibe
ausrufest	ausrufest
kaufet	kaufet
Räten	Räten
fange	fange
greife	greife
soll	soll
drängte	drängte
Wunden	Wunden
schlafet	schlafet
suchten	suchten
aufrichtest	aufrichtest
Gerichte	Gerichte
Alle	Alle
anrufen	anrufen
Flöten	Flöten
mache	mache
gewinne	gewinne
strafe	strafe
Sabbate	Sabbate
zuhört	zuhört
ausführen	ausführen
Teppiche	Teppiche
bewahret	bewahret
morde	morde
erforschest	erforschest
verderben	verderben
arbeiten	arbeiten
leset	leset
ihren	ihren
einem	einem
Habt	Habt
Ellen	Ellen
Tore	Tore
unschuldigen	unschuldigen
gießet	gießet
Kriegen	Kriegen
Willen	Willen
Wege	Wege
backen	backen
stiege	stiege
blast	blast
zieren	zieren
Unglauben	Unglauben
holte	holte
auflöste	auflöste
koste	koste
versuchen	versuchen
Grüßet	Grüßet
Scharen	Scharen
mal	mal
Söhne	Söhne
Dienet	Dienet
Rufet	Rufet
knüpfst	knüpfst
erschreckten	erschreckten
ausgeht	ausgeht
seht	seht
glaube	glaube
bleibe	bleibe
Spanne	Spanne
keines	keines
behaltet	behaltet
Tagen	Tagen
kämpfen	kämpfen
speisest	speisest
Dank	Dank
wahr	wahr
bekehrst	bekehrst
spannt	spannt
suchst	suchst
lügen	lügen
pflanzest	pflanzest
Schätze	Schätze
vergleichen	vergleichen
Berge	Berge
neigest	neigest
Bahnen	Bahnen
verstörte	verstörte
Solche	Solche
heißet	heißet
Prophet	Prophet
mehret	mehret
Toren	Toren
decken	decken
arbeit	arbeit
Last	Last
zeigst	zeigst
halben	halben
schaffen	schaffen
Röcken	Röcken
Stolz	Stolz
verkehrt	verkehrt
sage	sage
dürft	dürft
säst	säst
Drachen	Drachen
Stühlen	Stühlen
Keine	Keine
lange	lange
legst	legst
springen	springen
würde	würde
zanket	zanket
schneide	schneide
stehst	stehst
Christ	Christ
erhöht	erhöht
zürnet	zürnet
erhöhst	erhöhst
Beten	Beten
machet	machet
Grieche	Grieche
Wehklagen	Wehklagen
jeden	jeden
bestimmte	bestimmte
siegen	siegen
nötig	nötig
zählte	zählte
Winde	Winde
faul	faul
lassest	lassest
Quellen	Quellen
schaffte	schaffte
lernst	lernst
ehren	ehren
Bären	Bären
Weichet	Weichet
Schmieden	Schmieden
lauf	lauf
könne	könne
verhalten	verhalten
Eine	Eine
hüte	hüte
Gefäße	Gefäße
schon	schon
Zweigen	Zweigen
Tage	Tage
ehret	ehret
ladest	ladest
übet	übet
Rühmst	Rühmst
unseren	unseren
verstopften	verstopften
Riesen	Riesen
Plagen	Plagen
Namen	Namen
keiner	keiner
Male	Male
bauest	bauest
schmiert	schmiert
speiet	speiet
Friede	Friede
gehörten	gehörten
seufzte	seufzte
Schlägen	Schlägen
umkehret	umkehret
vergleiche	vergleiche
Basilisken	Basilisken
Ihre	Ihre
rechte	rechte
Gesetzen	Gesetzen
hebräische	hebräische
nähret	nähret
Rufe	Rufe
Meinet	Meinet
verdeckst	verdeckst
sollst	sollst
trotzest	trotzest
Forschet	Forschet
Heiden	Heiden
beweisest	beweisest
wunderte	wunderte
fangt	fangt
Monaten	Monaten
Worten	Worten
Meinem	Meinem
Flamme	Flamme
Augen	Augen
Herrn	Herrn
umkehrte	umkehrte
Höhen	Höhen
Stärke	Stärke
wollest	wollest
Kriegsknechte	Kriegsknechte
trage	trage
Gäste	Gäste
raubte	raubte
preise	preise
einführen	einführen
abziehen	abziehen
mangelte	mangelte
ruhe	ruhe
meine	meine
tiefe	tiefe
Briefen	Briefen
Helden	Helden
Erstlingen	Erstlingen
verbirgt	verbirgt
Same	Same
Vorstädte	Vorstädte
feierten	feierten
lernte	lernte
jedes	jedes
Pflanzungen	Pflanzungen
beschwören	beschwören
trieb	trieb
lade	lade
meinem	meinem
hörest	hörest
verzieh	verzieh
teilet	teilet
ernte	ernte
allem	allem
bekannt	bekannt
hausen	hausen
schauet	schauet
tuest	tuest
Mäuse	Mäuse
ihres	ihres
erbte	erbte
griechischen	griechischen
wirkst	wirkst
Westen	Westen
steckte	steckte
Riese	Riese
eilet	eilet
wehklagen	wehklagen
streckte	streckte
morden	morden
fluche	fluche
hörte	hörte
hasset	hasset
Zehe	Zehe
treibst	treibst
lesen	lesen
verlasse	verlasse
zerreißest	zerreißest
reizte	reizte
Unrechten	Unrechten
bereitet	bereitet
beschädigt	beschädigt
zankte	zankte
Perle	Perle
predigten	predigten
gelangt	gelangt
Glauben	Glauben
Gerät	Gerät
verwahrt	verwahrt
leere	leere
Festen	Festen
gebäret	gebäret
Klauen	Klauen
Taten	Taten
Beinen	Beinen
Ende	Ende
Elf	Elf
Einheimischen	Einheimischen
wachsen	wachsen
Fliege	Fliege
danket	danket
anrichtet	anrichtet
Leichname	Leichname
fehlen	fehlen
Vorhäuten	Vorhäuten
vor	vor
Hauen	Hauen
kriegen	kriegen
vermöget	vermöget
Ängsten	Ängsten
zerbrichst	zerbrichst
ermahnet	ermahnet
Gut	Gut
Feste	Feste
erlöse	erlöse
schenke	schenke
Strafe	Strafe
schreist	schreist
Rubinen	Rubinen
predigst	predigst
Erden	Erden
leihet	leihet
Fäusten	Fäusten
Stufen	Stufen
freiwilligen	freiwilligen
verbannt	verbannt
Gesellen	Gesellen
Strömen	Strömen
vertrieb	vertrieb
bedenken	bedenken
Felsen	Felsen
Werde	Werde
kämpfet	kämpfet
Türkis	Türkis
hineingehst	hineingehst
Schuhen	Schuhen
reckte	reckte
Eiche	Eiche
Spießen	Spießen
verstört	verstört
ausfuhr	ausfuhr
grüne	grüne
Waren	Waren
trügen	trügen
Trübsalen	Trübsalen
schauest	schauest
Broten	Broten
Tauben	Tauben
kehret	kehret
schreiben	schreiben
erbet	erbet
Ihr	Ihr
versöhnet	versöhnet
pflege	pflege
Wille	Wille
frage	frage
Lesen	Lesen
vermag	vermag
eingehet	eingehet
Fliegen	Fliegen
wachet	wachet
verboten	verboten
Türmen	Türmen
sitzt	sitzt
Laufen	Laufen
erlaubte	erlaubte
Fällt	Fällt
grabe	grabe
Bär	Bär
schmierte	schmierte
solle	solle
aufmacht	aufmacht
ehrest	ehrest
wälzte	wälzte
Röhre	Röhre
entsetzte	entsetzte
klagte	klagte
bekannten	bekannten
Testamente	Testamente
Kreisen	Kreisen
grüße	grüße
Anklage	Anklage
pflanze	pflanze
Teile	Teile
kehre	kehre
reizet	reizet
solche	solche
unschuldige	unschuldige
verunreinigt	verunreinigt
fluchte	fluchte
aufrichtet	aufrichtet
Grenzen	Grenzen
teil	teil
Sehe	Sehe
breche	breche
schrecke	schrecke
Röhren	Röhren
Leuchten	Leuchten
loben	loben
Schwänzen	Schwänzen
leer	leer
erhöhest	erhöhest
ruhte	ruhte
Fels	Fels
kämpfe	kämpfe
wälzt	wälzt
brennen	brennen
War	War
Monate	Monate
scheue	scheue
nützt	nützt
dankte	dankte
ringe	ringe
Kreise	Kreise
Gebet	Gebet
ob	ob
Buben	Buben
Säuen	Säuen
freute	freute
scheiden	scheiden
sorgen	sorgen
Ärgernisse	Ärgernisse
Monde	Monde
beharret	beharret
esset	esset
Füchsen	Füchsen
zürnst	zürnst
hebe	hebe
ziehest	ziehest
aufmachte	aufmachte
Pauken	Pauken
pflanzte	pflanzte
griffen	griffen
Stolze	Stolze
weichest	weichest
verderbet	verderbet
webte	webte
Höhlen	Höhlen
Heben	Heben
hingeht	hingeht
fällte	fällte
schließt	schließt
nehmest	nehmest
Felle	Felle
hause	hause
ausbreitet	ausbreitet
weisen	weisen
abtrünnigen	abtrünnigen
besucht	besucht
Sinne	Sinne
stärke	stärke
freiwillige	freiwillige
ringst	ringst
braust	braust
verkehrten	verkehrten
stoßet	stoßet
glänzt	glänzt
befragt	befragt
fülle	fülle
Wehen	Wehen
wende	wende
Räte	Räte
gedenket	gedenket
taufe	taufe
malen	malen
vertrage	vertrage
aufhebest	aufhebest
küsse	küsse
umbringt	umbringt
lehren	lehren
versöhnst	versöhnst
gehorchten	gehorchten
Lehre	Lehre
Frieden	Frieden
regieren	regieren
verzehrt	verzehrt
schaffet	schaffet
Sabbatjahre	Sabbatjahre
Töpfe	Töpfe
folgen	folgen
einnehmet	einnehmet
bange	bange
erlaubt	erlaubt
erwerbe	erwerbe
Ärgernissen	Ärgernissen
Morde	Morde
bitten	bitten
Laien	Laien
Leichnamen	Leichnamen
fraget	fraget
vergießest	vergießest
verbirgst	verbirgst
einführte	einführte
krähen	krähen
stirbst	stirbst
Maß	Maß
Erstlinge	Erstlinge
wehklage	wehklage
lehrest	lehrest
zerschlagt	zerschlagt
Solches	Solches
Zäunen	Zäunen
Grenze	Grenze
Gelobt	Gelobt
betrüge	betrüge
zerstreute	zerstreute
Bitten	Bitten
verbergest	verbergest
dürfte	dürfte
toten	toten
aufnahmt	aufnahmt
regierest	regierest
fasse	fasse
Schar	Schar
besehet	besehet
Hunderten	Hunderten
Sollst	Sollst
Tausenden	Tausenden
Schleifen	Schleifen
Spitzen	Spitzen
Basilisk	Basilisk
hebräischen	hebräischen
Trage	Trage
verdammt	verdammt
verstörten	verstörten
Schlange	Schlange
ältesten	ältesten
Kristallen	Kristallen
brauche	brauche
Bote	Bote
wollt	wollt
Kriege	Kriege
Neumonde	Neumonde
Deutung	Deutung
fallet	fallet
Lüsten	Lüsten
erhalte	erhalte
Fallt	Fallt
schenkest	schenkest
unseres	unseres
Füße	Füße
legte	legte
Tiere	Tiere
taten	taten
Ding	Ding
nehmet	nehmet
anrufe	anrufe
Linke	Linke
Junge	Junge
klagen	klagen
kühle	kühle
Kriegsknechten	Kriegsknechten
gehorchet	gehorchet
Solcher	Solcher
Schneiden	Schneiden
Anfechtungen	Anfechtungen
Mensch	Mensch
Jahre	Jahre
Weinberge	Weinberge
Ochsen	Ochsen
Ochse	Ochse
nähre	nähre
fragest	fragest
stelle	stelle
tust	tust
wechseln	wechseln
Kost	Kost
Gebote	Gebote
anzeigen	anzeigen
verfolgt	verfolgt
Aufsätzen	Aufsätzen
Gibt	Gibt
forschen	forschen
Höhe	Höhe
Aufsätze	Aufsätze
Schiffen	Schiffen
Folge	Folge
eurer	eurer
Gängen	Gängen
Steigen	Steigen
vergibst	vergibst
Streiten	Streiten
anruft	anruft
taufen	taufen
kennst	kennst
hingehst	hingehst
gesellt	gesellt
Fremde	Fremde
aufnahmen	aufnahmen
meinst	meinst
wachte	wachte
weise	weise
Fische	Fische
Schild	Schild
begehrten	begehrten
Aller	Aller
Speise	Speise
stürzen	stürzen
verkaufe	verkaufe
Feiertagen	Feiertagen
Ratet	Ratet
strecken	strecken
betrügen	betrügen
trinken	trinken
gefällst	gefällst
drängst	drängst
Sekte	Sekte
fragen	fragen
Bande	Bande
reden	reden
Freunde	Freunde
demütig	demütig
Sterne	Sterne
bleibet	bleibet
Linken	Linken
Geliebte	Geliebte
liebst	liebst
Wollte	Wollte
Stufe	Stufe
Hast	Hast
einsammelte	einsammelte
besitzet	besitzet
all	all
geraten	geraten
erbest	erbest
hassest	hassest
Armen	Armen
Skorpionen	Skorpionen
Jünglinge	Jünglinge
spiele	spiele
Kreuze	Kreuze
gibst	gibst
herrschet	herrschet
Wachet	Wachet
brauchst	brauchst
gebt	gebt
rufst	rufst
entsetzet	entsetzet
heulet	heulet
All	All
wissest	wissest
gebührt	gebührt
ziert	ziert
rufet	rufet
Knaben	Knaben
Sagte	Sagte
säumen	säumen
wisset	wisset
Joche	Joche
Röcke	Röcke
kehrte	kehrte
weiten	weiten
spanne	spanne
Bahn	Bahn
fällst	fällst
erlöst	erlöst
traut	traut
Narr	Narr
Pflanzung	Pflanzung
Gebt	Gebt
weiden	weiden
Hallen	Hallen
Rehen	Rehen
reizest	reizest
Entsetzen	Entsetzen
gelang	gelang
leuchtete	leuchtete
Loben	Loben
bringst	bringst
wallte	wallte
ungehorsame	ungehorsame
Reichen	Reichen
wünschte	wünschte
einführt	einführt
Urteil	Urteil
lobe	lobe
werden	werden
hebst	hebst
hebräisch	hebräisch
erhört	erhört
kaufst	kaufst
Füllen	Füllen
waren	waren
Lobet	Lobet
Weißt	Weißt
weichet	weichet
reizt	reizt
koche	koche
Wehret	Wehret
Zeuge	Zeuge
Stämmen	Stämmen
pflüget	pflüget
unsres	unsres
Jahren	Jahren
grün	grün
krieget	krieget
gründen	gründen
Folget	Folget
stimmte	stimmte
empörte	empörte
Tun	Tun
Graben	Graben
gut	gut
Sucht	Sucht
erfüllt	erfüllt
mögt	mögt
träumen	träumen
zerreißt	zerreißt
aufstehet	aufstehet
seine	seine
hieben	hieben
Gefilden	Gefilden
kühl	kühl
Tannen	Tannen
brichst	brichst
Sieb	Sieb
brauchte	brauchte
umkommt	umkommt
Tyrannen	Tyrannen
dürfe	dürfe
aufsteht	aufsteht
fließt	fließt
Trinkgefäße	Trinkgefäße
Gewürzen	Gewürzen
berührt	berührt
erschrickst	erschrickst
messen	messen
Schreien	Schreien
wälzet	wälzet
liegen	liegen
fetten	fetten
Gesetze	Gesetze
lösest	lösest
naht	naht
zuschließt	zuschließt
preisen	preisen
Tischen	Tischen
unterrichten	unterrichten
drückte	drückte
Schafen	Schafen
Falle	Falle
rühmte	rühmte
Laie	Laie
Geliebten	Geliebten
Seile	Seile
steinigte	steinigte
bezahlest	bezahlest
liege	liege
verbot	verbot
Fahret	Fahret
fassest	fassest
wolle	wolle
kehrst	kehrst
Leiste	Leiste
aufhebt	aufhebt
Decke	Decke
sollte	sollte
bestimmst	bestimmst
trüge	trüge
merkte	merkte
Weh	Weh
müßt	müßt
strafet	strafet
standet	standet
Bleche	Bleche
Grase	Grase
prediget	prediget
helfest	helfest
erhebet	erhebet
lehnte	lehnte
trägt	trägt
stiegen	stiegen
siehst	siehst
liebet	liebet
Morden	Morden
seufzest	seufzest
Lehne	Lehne
Stücken	Stücken
reich	reich
spricht	spricht
Äxten	Äxten
scheute	scheute
verdeckt	verdeckt
stellen	stellen
handhabt	handhabt
bedenket	bedenket
Ordnung	Ordnung
seufzt	seufzt
Empörung	Empörung
Satzungen	Satzungen
spannte	spannte
Klage	Klage
Heißt	Heißt
bekennet	bekennet
leid	leid
laufe	laufe
bestimmten	bestimmten
erlösest	erlösest
zählst	zählst
anbetet	anbetet
Bitte	Bitte
Deine	Deine
borgte	borgte
tobte	tobte
halt	halt
erlöset	erlöset
arme	arme
empört	empört
halbe	halbe
gebietet	gebietet
Hörst	Hörst
stoße	stoße
bekennt	bekennt
schöpfe	schöpfe
backe	backe
Beine	Beine
befestigten	befestigten
urteilen	urteilen
Sekten	Sekten
schmücket	schmücket
Zerstreut	Zerstreut
Worte	Worte
eingehst	eingehst
nahest	nahest
ritten	ritten
Pfunden	Pfunden
Kristalle	Kristalle
Ringen	Ringen
Würze	Würze
schaute	schaute
verführe	verführe
habest	habest
greifen	greifen
Geräte	Geräte
bauet	bauet
salz	salz
Spieße	Spieße
zerstreust	zerstreust
bestellte	bestellte
wollten	wollten
erkennest	erkennest
machst	machst
lügst	lügst
jedem	jedem
übest	übest
bessere	bessere
mühte	mühte
glaubet	glaubet
müsset	müsset
stand	stand
kostet	kostet
Herz	Herz
Weinet	Weinet
lache	lache
Binde	Binde
stürze	stürze
Taufe	Taufe
sagst	sagst
raubest	raubest
Sägen	Sägen
Säcken	Säcken
Kehret	Kehret
beschädigten	beschädigten
sorget	sorget
Sagen	Sagen
Wolle	Wolle
Ecke	Ecke
könnet	könnet
zweifeln	zweifeln
Lasten	Lasten
Narren	Narren
rühmst	rühmst
fertigte	fertigte
Obrigkeiten	Obrigkeiten
regte	regte
lebst	lebst
Ärzten	Ärzten
Zähnen	Zähnen
führe	führe
eilte	eilte
stiftete	stiftete
bebte	bebte
Sage	Sage
Führe	Führe
schlag	schlag
Tyrann	Tyrann
sitzest	sitzest
verkauft	verkauft
machte	machte
bekehrte	bekehrte
Türme	Türme
wehen	wehen
maß	maß
vertrauet	vertrauet
heißest	heißest
versuchet	versuchet
verderbest	verderbest
deinem	deinem
offenbare	offenbare
entsetzt	entsetzt
ringen	ringen
sehet	sehet
Ehre	Ehre
Wände	Wände
wohnst	wohnst
kommet	kommet
Buch	Buch
verzieht	verzieht
trieben	trieben
Zäune	Zäune
Mein	Mein
Götze	Götze
Empörungen	Empörungen
Spaltung	Spaltung
lobet	lobet
Herde	Herde
Heere	Heere
täuschte	täuschte
pflegst	pflegst
junge	junge
Schwänze	Schwänze
könnt	könnt
schickte	schickte
Gewürze	Gewürze
Einheimische	Einheimische
Gefangenen	Gefangenen
reichte	reichte
Abhängen	Abhängen
Sollte	Sollte
begrabet	begrabet
armen	armen
gebären	gebären
anzeigte	anzeigte
aufrichten	aufrichten
frische	frische
Trinket	Trinket
nahte	nahte
bedeckt	bedeckt
Zeugen	Zeugen
Steinen	Steinen
denkst	denkst
erwerben	erwerben
verständige	verständige
klaget	klaget
murmeln	murmeln
Gras	Gras
andere	andere
Sehne	Sehne
erzürnet	erzürnet
Schuld	Schuld
füllst	füllst
Hebet	Hebet
aufkommt	aufkommt
solchen	solchen
schwellen	schwellen
plagest	plagest
kein	kein
unserer	unserer
Dingen	Dingen
essest	essest
wacht	wacht
Hat	Hat
verkriechet	verkriechet
Werken	Werken
bereite	bereite
Ärzte	Ärzte
Schiffe	Schiffe
zeugte	zeugte
leiten	leiten
fresse	fresse
stirbt	stirbt
Leiche	Leiche
auszieht	auszieht
Dieben	Dieben
Garten	Garten
Tausend	Tausend
Spaltungen	Spaltungen
Rabe	Rabe
leuchten	leuchten
plagen	plagen
verlieren	verlieren
ziehet	ziehet
kranken	kranken
verstanden	verstanden
bemüht	bemüht
stürzest	stürzest
erwürgt	erwürgt
schwebe	schwebe
Glaubet	Glaubet
Einer	Einer
begehrte	begehrte
beweise	beweise
Schwelle	Schwelle
suchet	suchet
entsetzen	entsetzen
hure	hure
hauest	hauest
Schlangen	Schlangen
fressen	fressen
Ältesten	Ältesten
möge	möge
verdammten	verdammten
wenden	wenden
würzen	würzen
verdeckte	verdeckte
Geviert	Geviert
Büschen	Büschen
Spitze	Spitze
Pferden	Pferden
offenbart	offenbart
leide	leide
blenden	blenden
betrübst	betrübst
gelobet	gelobet
vierten	vierten
Königen	Königen
kühlen	kühlen
brach	brach
verwirfst	verwirfst
essen	essen
Alles	Alles
setzet	setzet
siegte	siegte
wärmet	wärmet
Nehmet	Nehmet
hängte	hängte
vertrieben	vertrieben
Feind	Feind
schlaget	schlaget
Wachen	Wachen
Frommen	Frommen
gereichte	gereichte
leiden	leiden
gewöhnte	gewöhnte
säet	säet
Entsetzet	Entsetzet
stille	stille
wehret	wehret
schau	schau
hüten	hüten
kennet	kennet
Regieren	Regieren
Sabbatjahr	Sabbatjahr
erfahrt	erfahrt
Klaue	Klaue
erhöhet	erhöhet
erbauet	erbauet
schreibst	schreibst
unterrichte	unterrichte
erhörst	erhörst
linke	linke
frommen	frommen
oben	oben
Arm	Arm
versöhnt	versöhnt
Helmen	Helmen
Schulden	Schulden
gelangen	gelangen
mögest	mögest
schläfst	schläfst
wache	wache
sagte	sagte
beißet	beißet
zweifelte	zweifelte
erfüllst	erfüllst
höhnest	höhnest
Pfeifen	Pfeifen
fehlte	fehlte
eng	eng
Bächen	Bächen
Leset	Leset
ander	ander
Maultier	Maultier
bemühst	bemühst
wundere	wundere
zerschlaget	zerschlaget
Gevierte	Gevierte
eure	eure
Hände	Hände
Tragt	Tragt
trotzt	trotzt
rufe	rufe
Fäuste	Fäuste
Steine	Steine
bestand	bestand
keinen	keinen
Macht	Macht
Sinnen	Sinnen
Schalen	Schalen
umkommst	umkommst
auflöst	auflöst
murmelte	murmelte
Fett	Fett
Befehle	Befehle
teile	teile
schenkst	schenkst
bekehrten	bekehrten
meinet	meinet
Machet	Machet
eins	eins
Gute	Gute
versuche	versuche
Schade	Schade
erweckst	erweckst
zudeckt	zudeckt
erniedrigst	erniedrigst
durchbohrte	durchbohrte
weinet	weinet
Werden	Werden
seinem	seinem
maßen	maßen
Unglaube	Unglaube
Zweige	Zweige
Brüste	Brüste
Heiße	Heiße
flehte	flehte
feierte	feierte
Trübsal	Trübsal
griffe	griffe
Klüfte	Klüfte
verkürzest	verkürzest
Gebot	Gebot
reichen	reichen
spracht	spracht
verliert	verliert
trotzet	trotzet
rührte	rührte
Pfeife	Pfeife
verwirft	verwirft
halten	halten
gießt	gießt
eurem	eurem
wachset	wachset
rate	rate
Nehmt	Nehmt
speiest	speiest
fromme	fromme
brechet	brechet
Träume	Träume
eures	eures
gehören	gehören
Weinstöcken	Weinstöcken
ausführe	ausführe
hieb	hieb
schenket	schenket
betrübten	betrübten
Stricke	Stricke
Weinen	Weinen
grüßte	grüßte
predigte	predigte
beider	beider
Stäben	Stäben
falle	falle
suchest	suchest
verliere	verliere
heben	heben
keinem	keinem
schätze	schätze
ausgehst	ausgehst
erschreckte	erschreckte
habt	habt
schläft	schläft
Reihe	Reihe
diente	diente
ratet	ratet
Verheißungen	Verheißungen
glaubst	glaubst
regiert	regiert
tragen	tragen
verkauften	verkauften
Band	Band
Monden	Monden
gebest	gebest
schlaft	schlaft
Gründe	Gründe
Solchen	Solchen
berühret	berühret
aufstand	aufstand
merke	merke
versteckt	versteckt
wohnest	wohnest
verwirren	verwirren
rede	rede
verbannet	verbannet
ausführt	ausführt
Raube	Raube
Schwellen	Schwellen
Rehe	Rehe
Reich	Reich
jede	jede
lehrte	lehrte
liegst	liegst
gebäre	gebäre
stärket	stärket
habe	habe
Lobe	Lobe
strecke	strecke
faule	faule
anzeige	anzeige
weh	weh
taufet	taufet
ein	ein
hineingeht	hineingeht
Gehilfen	Gehilfen
pflügte	pflügte
Ring	Ring
forschet	forschet
begehrt	begehrt
Tieren	Tieren
Kohlen	Kohlen
befragten	befragten
stürzte	stürzte
fertige	fertige
Forsche	Forsche
schlagest	schlagest
Gebärden	Gebärden
gebraucht	gebraucht
säte	säte
fluchten	fluchten
Bürde	Bürde
fallest	fallest
weine	weine
Elfen	Elfen
haust	haust
Gründen	Gründen
Seht	Seht
beschwert	beschwert
weide	weide
verschonet	verschonet
wart	wart
Predigt	Predigt
laufet	laufet
Meine	Meine
demütige	demütige
alle	alle
Reizt	Reizt
Wehre	Wehre
besitze	besitze
traget	traget
nütze	nütze
begehre	begehre
reifen	reifen
plagte	plagte
Hirsche	Hirsche
sterbt	sterbt
Würzen	Würzen
Zöpfen	Zöpfen
Aas	Aas
Werkzeuge	Werkzeuge
Haben	Haben
Wunde	Wunde
beweiset	beweiset
gelobten	gelobten
trüb	trüb
höhnte	höhnte
werdest	werdest
speist	speist
Kaufleuten	Kaufleuten
solcher	solcher
fremde	fremde
wollte	wollte
schweigen	schweigen
Kommst	Kommst
prüfst	prüfst
schreckt	schreckt
urteile	urteile
Fragen	Fragen
betrübet	betrübet
verwirrt	verwirrt
vermögen	vermögen
ihr	ihr
bleibest	bleibest
Gehörst	Gehörst
dienest	dienest
Höfe	Höfe
erzürnt	erzürnt
Abtrünnige	Abtrünnige
offenbar	offenbar
Bäumen	Bäumen
jammerte	jammerte
feiern	feiern
verkriechst	verkriechst
verstehst	verstehst
schließe	schließe
gleiche	gleiche
abtrünnige	abtrünnige
tragest	tragest
sitzet	sitzet
merket	merket
grünte	grünte
erfahret	erfahret
Aussätzige	Aussätzige
stoßt	stoßt
erben	erben
erlösen	erlösen
verziehen	verziehen
aufstehst	aufstehst
gibt	gibt
Strafen	Strafen
Skorpione	Skorpione
verführen	verführen
freuet	freuet
versucht	versucht
erhaltet	erhaltet
suchen	suchen
Kleinoden	Kleinoden
steigen	steigen
folget	folget
Name	Name
fragst	fragst
glauben	glauben
messet	messet
aufstanden	aufstanden
Brote	Brote
besorgte	besorgte
Bube	Bube
zerstört	zerstört
krähte	krähte
löset	löset
Hälse	Hälse
Ränke	Ränke
Wehe	Wehe
Knechten	Knechten
Buchstaben	Buchstaben
Hure	Hure
Zehen	Zehen
besitzest	besitzest
weichen	weichen
krank	krank
sollt	sollt
Quelle	Quelle
vorn	vorn
decket	decket
beschwöre	beschwöre
kaufe	kaufe
Gebirge	Gebirge
war	war
untergeht	untergeht
vereinigte	vereinigte
Sabbaten	Sabbaten
Eichen	Eichen
male	male
Kräften	Kräften
geselle	geselle
Klüften	Klüften
Buchen	Buchen
Füßen	Füßen
höret	höret
Gibst	Gibst
regiere	regiere
lebest	lebest
irren	irren
Jungen	Jungen
Ställen	Ställen
tut	tut
erlasset	erlasset
Huren	Huren
fette	fette
erkennet	erkennet
bekehrt	bekehrt
lieget	lieget
gute	gute
Euren	Euren
mahlen	mahlen
Palästen	Palästen
hell	hell
behaltest	behaltest
nötige	nötige
Tische	Tische
fahret	fahret
erkennst	erkennst
schöpfen	schöpfen
kosten	kosten
dienst	dienst
Danket	Danket
ausfuhren	ausfuhren
verkaufst	verkaufst
Verheißung	Verheißung
schrecken	schrecken
bewährt	bewährt
schonte	schonte
wünschet	wünschet
gebühren	gebühren
Weil	Weil
pflanzt	pflanzt
heilet	heilet
schenken	schenken
weite	weite
rächte	rächte
verklärt	verklärt
wog	wog
Hunden	Hunden
griff	griff
besuchen	besuchen
säumet	säumet
Glaubst	Glaubst
zuhöret	zuhöret
rühmet	rühmet
tretest	tretest
Feinden	Feinden
Seines	Seines
Wüste	Wüste
tatet	tatet
solches	solches
räumet	räumet
schmelzt	schmelzt
erschreckt	erschreckt
demütigte	demütigte
Ringe	Ringe
grüßen	grüßen
Ratsherren	Ratsherren
gewinnet	gewinnet
Stärket	Stärket
anrührte	anrührte
gehörte	gehörte
Samen	Samen
enge	enge
wiederkommst	wiederkommst
vermöge	vermöge
bekennst	bekennst
beide	beide
verlaßt	verlaßt
einsammelst	einsammelst
weist	weist
Löwen	Löwen
Früchten	Früchten
greifet	greifet
Wollt	Wollt
verwahret	verwahret
Malen	Malen
Griechen	Griechen
Weiß	Weiß
Kohle	Kohle
absagt	absagt
begrabest	begrabest
Höfen	Höfen
deine	deine
Wegen	Wegen
heil	heil
herrschest	herrschest
schämst	schämst
begehret	begehret
streiten	streiten
steiget	steiget
bekannte	bekannte
fremden	fremden
beweist	beweist
erforschet	erforschet
Tut	Tut
Gefängnissen	Gefängnissen
Ränken	Ränken
beugst	beugst
wärme	wärme
schweigst	schweigst
Träumen	Träumen
verhalte	verhalte
beharrt	beharrt
Mache	Mache
gelobt	gelobt
schnitten	schnitten
nährte	nährte
verdeckten	verdeckten
säume	säume
graben	graben
beschuldigt	beschuldigt
Tanne	Tanne
blende	blende
Werk	Werk
brausen	brausen
zeugst	zeugst
halte	halte
helft	helft
Kleinod	Kleinod
Blitze	Blitze
sorgte	sorgte
Pauke	Pauke
drängten	drängten
könnte	könnte
Seinen	Seinen
täuschet	täuschet
stahlen	stahlen
los	los
ritt	ritt
fließe	fließe
erbaut	erbaut
Keile	Keile
mühe	mühe
Weinbergen	Weinbergen
Licht	Licht
steig	steig
Lichte	Lichte
legest	legest
steige	steige
beschwerst	beschwerst
Hälsen	Hälsen
Kräfte	Kräfte
eingeht	eingeht
lehrst	lehrst
Seine	Seine
bauten	bauten
Gefangene	Gefangene
Speeren	Speeren
bestellten	bestellten
Steiget	Steiget
Gehorcht	Gehorcht
heilte	heilte
Fette	Fette
Führet	Führet
Köpfe	Köpfe
ansehen	ansehen
Gemeinden	Gemeinden
hänge	hänge
aufwacht	aufwacht
rauschte	rauschte
füllte	füllte
bekehret	bekehret
sagest	sagest
Kleinode	Kleinode
Meere	Meere
holet	holet
strafst	strafst
wilde	wilde
stehet	stehet
band	band
hingehet	hingehet
vertrauten	vertrauten
Frösche	Frösche
Zähne	Zähne
Weinstöcke	Weinstöcke
Deutungen	Deutungen
Bete	Bete
anzeigt	anzeigt
Rudern	Rudern
allen	allen
opferte	opferte
beschädigte	beschädigte
ehrst	ehrst
abzieht	abzieht
Städten	Städten
fallt	fallt
scheinest	scheinest
Reizen	Reizen
Königreichen	Königreichen
Esset	Esset
Schleife	Schleife
Wache	Wache
zürnte	zürnte
weg	weg
Reihen	Reihen
erhebest	erhebest
lose	lose
bringet	bringet
sprecht	sprecht
jungen	jungen
drücke	drücke
Weiche	Weiche
Eingeweide	Eingeweide
verstecke	verstecke
solchem	solchem
wehte	wehte
Zeug	Zeug
raten	raten
Säue	Säue
Lehren	Lehren
bleiben	bleiben
Meines	Meines
ärger	ärger
rauschen	rauschen
Keilen	Keilen
Hunde	Hunde
mein	mein
Banden	Banden
Kühe	Kühe
nimmst	nimmst
erfreuest	erfreuest
kochte	kochte
Türkise	Türkise
widerstand	widerstand
Gebete	Gebete
sagen	sagen
schaffe	schaffe
brauste	brauste
regen	regen
teilen	teilen
gründe	gründe
fahrt	fahrt
fließen	fließen
gießest	gießest
Saget	Saget
Gar	Gar
Zäume	Zäume
Ratsherr	Ratsherr
hoffte	hoffte
Erbe	Erbe
setzest	setzest
wehe	wehe
Leuchte	Leuchte
strafte	strafte
Wüsten	Wüsten
leite	leite
sucht	sucht
bedeckst	bedeckst
Abtrünnigen	Abtrünnigen
Teilen	Teilen
bracht	bracht
Stimmen	Stimmen
Jünger	Jünger
Schauet	Schauet
Winden	Winden
hörst	hörst
Äxte	Äxte
zeugest	zeugest
erforscht	erforscht
fälle	fälle
sitzen	sitzen
Leisten	Leisten
Ruder	Ruder
leihst	leihst
brenne	brenne
schlafest	schlafest
zerbrechest	zerbrechest
Rühmet	Rühmet
zeugen	zeugen
Fetten	Fetten
gelobte	gelobte
führte	führte
lehret	lehret
Kreuz	Kreuz
hinaufgehst	hinaufgehst
Speisen	Speisen
führst	führst
steigest	steigest
wehre	wehre
Kaufleute	Kaufleute
stärkte	stärkte
steinigest	steinigest
schwimmen	schwimmen
weich	weich
versuchst	versuchst
stellet	stellet
Fittichen	Fittichen
befragte	befragte
verdammst	verdammst
esse	esse
lasset	lasset
Hebe	Hebe
Vorhäute	Vorhäute
überführt	überführt
logen	logen
predigt	predigt
Ästen	Ästen
Maultiere	Maultiere
Sorget	Sorget
Anklagen	Anklagen
spielet	spielet
verstand	verstand
Gelobet	Gelobet
Gedanken	Gedanken
sprechet	sprechet
weichst	weichst
Schilde	Schilde
Leichen	Leichen
lachet	lachet
schließen	schließen
werft	werft
Bäche	Bäche
Teppichen	Teppichen
Schafe	Schafe
schlage	schlage
meinte	meinte
lauft	lauft
backt	backt
steinigst	steinigst
Ochs	Ochs
Geschäften	Geschäften
anbetest	anbetest
löste	löste
währte	währte
Sehet	Sehet
Gänge	Gänge
Vorstädten	Vorstädten
tote	tote
ungehorsam	ungehorsam
helfet	helfet
teilte	teilte
Fahrt	Fahrt
begrabt	begrabt
Schreiet	Schreiet
besitzt	besitzt
Frage	Frage
möget	möget
schaffst	schaffst
glaubest	glaubest
Schau	Schau
Maßen	Maßen
stiften	stiften
umbringet	umbringet
triebe	triebe
besser	besser
lüge	lüge
Speere	Speere
ausrottet	ausrottet
inneren	inneren
empfanget	empfanget
Gefängnisse	Gefängnisse
begehrst	begehrst
habet	habet
suchte	suchte
Erde	Erde
wachse	wachse
schreie	schreie
verlobt	verlobt
trinkst	trinkst
berufe	berufe
Geschäfte	Geschäfte
schätzt	schätzt
Deinen	Deinen
drängest	drängest
wirfst	wirfst
zerbrecht	zerbrecht
treffen	treffen
irrte	irrte
Altäre	Altäre
grünen	grünen
denket	denket
Höhle	Höhle
Ehren	Ehren
schätzte	schätzte
Lob	Lob
beugte	beugte
Gebeinen	Gebeinen
fehle	fehle
borgst	borgst
schnell	schnell
stolze	stolze
Bienen	Bienen
Raten	Raten
verkaufte	verkaufte
erbaust	erbaust
Teil	Teil
Taube	Taube
Hirschen	Hirschen
baue	baue
Fröschen	Fröschen
preist	preist
würden	würden
anrührt	anrührt
erzürnst	erzürnst
helle	helle
still	still
lehre	lehre
rührst	rührst
schöpfest	schöpfest
drücken	drücken
ziehst	ziehst
Säge	Säge
gebet	gebet
Stimme	Stimme
banden	banden
Einem	Einem
Urteile	Urteile
kehren	kehren
wisse	wisse
sieht	sieht
schießen	schießen
Perlen	Perlen
Jünglingen	Jünglingen
ärgere	ärgere
Einen	Einen
sprichst	sprichst
Lobgesängen	Lobgesängen
schmückst	schmückst
zudeckte	zudeckte
wohnte	wohnte
Ströme	Ströme
gehst	gehst
erhebst	erhebst
schneiden	schneiden
folgte	folgte
Buche	Buche
blitzen	blitzen
dienet	dienet
spielen	spielen
hänget	hänget
Leiden	Leiden
Rubine	Rubine
opfern	opfern
jeder	jeder
hinaufgeht	hinaufgeht
sterbest	sterbest
schwebte	schwebte
vergießt	vergießt
gereicht	gereicht
Drache	Drache
Fromme	Fromme
Pfeilen	Pfeilen
Gemeinde	Gemeinde
Äste	Äste
stimmen	stimmen
brechen	brechen
Abhänge	Abhänge
wirkte	wirkte
schreiet	schreiet
lebte	lebte
Weine	Weine
geboten	geboten
Stühle	Stühle
vergebet	vergebet
könnest	könnest
folge	folge
Unrecht	Unrecht
Schenke	Schenke
ausrichtest	ausrichtest
zeuget	zeuget
Götzen	Götzen
deckst	deckst
saget	saget
Schmiede	Schmiede
Feiertage	Feiertage
heißt	heißt
Deinem	Deinem
streuen	streuen
lachte	lachte
verzehrst	verzehrst
eingehest	eingehest
heile	heile
stillest	stillest
bang	bang
stolz	stolz
Grabe	Grabe
Weg	Weg
gebrauchte	gebrauchte
tat	tat
sollten	sollten
haue	haue
erschrickt	erschrickt
Fallen	Fallen
Löwe	Löwe
deckte	deckte
beiden	beiden
zuhörte	zuhörte
besuche	besuche
ehre	ehre
befestigt	befestigt
bitte	bitte
Jochen	Jochen
Grab	Grab
weinte	weinte
Stücke	Stücke
Schätzen	Schätzen
Bleibet	Bleibet
Knabe	Knabe
müssest	müssest
hadere	hadere
recke	recke
Blechen	Blechen
Sorge	Sorge
Zeugnissen	Zeugnissen
bringest	bringest
müsse	müsse
unterrichtet	unterrichtet
harret	harret
Mal	Mal
verschont	verschont
reiche	reiche
rufest	rufest
Held	Held
nötigte	nötigte
einen	einen
verkehre	verkehre
aller	aller
verstehet	verstehet
flehst	flehst
nahe	nahe
gehorchest	gehorchest
Heuschrecke	Heuschrecke
müßten	müßten
Könnet	Könnet
decke	decke
Obrigkeit	Obrigkeit
Jahr	Jahr
Menschen	Menschen
schlafe	schlafe
müßte	müßte
binden	binden
mehrte	mehrte
gebieten	gebieten
Streite	Streite
Rufen	Rufen
Halle	Halle
Wogen	Wogen
pflanzen	pflanzen
lebet	lebet
Soll	Soll
aufwachst	aufwachst
treibest	treibest
Gefilde	Gefilde
jagte	jagte
Dienst	Dienst
verunreinigst	verunreinigst
verzehre	verzehre
schwimmst	schwimmst
trübe	trübe
klage	klage
vergibt	vergibt
Bergen	Bergen
fertig	fertig
verziehst	verziehst
Sollten	Sollten
auflegte	auflegte
Briefe	Briefe
verlobte	verlobte
Ebenen	Ebenen
vertraut	vertraut
Haue	Haue
gelobst	gelobst
Stäbe	Stäbe
küssen	küssen
urteilte	urteilte
ausrichtet	ausrichtet
bezahlt	bezahlt
Eure	Eure
seines	seines
einer	einer
Büsche	Büsche
bewahrt	bewahrt
leben	leben
fluchet	fluchet
Flöte	Flöte
Bürden	Bürden
Trübsale	Trübsale
Eilet	Eilet
Bunde	Bunde
sondern	sondern
webet	webet
spaltete	spaltete
Fallet	Fallet
fresset	fresset
Schuhe	Schuhe
hasse	hasse
Taufen	Taufen
rühmest	rühmest
gehöre	gehöre
kämpfte	kämpfte
schämte	schämte
Bäume	Bäume
berufen	berufen
vertraute	vertraute
ihre	ihre
beben	beben
schmelzen	schmelzen
ausrottest	ausrottest
tief	tief
knüpfte	knüpfte
wegen	wegen
verstopft	verstopft
Majestät	Majestät
Gästen	Gästen
Testamenten	Testamenten
Maultieren	Maultieren
verlaß	verlaß
rittest	rittest
Funke	Funke
kennest	kennest
Ställe	Ställe
sonderte	sonderte
meines	meines
umkehrt	umkehrt
Könnt	Könnt
ausziehst	ausziehst
labe	labe
Predigten	Predigten
verdammte	verdammte
bleibst	bleibst
empfange	empfange
trefft	trefft
Schale	Schale
verstehest	verstehest
