breche	breche
jagte	jagte
Predigt	Predigt
Sekte	Sekte
reckte	reckte
warnte	warnte
beben	beben
schauet	schauet
werft	werft
beschwerst	beschwerst
Wunden	Wunden
Broten	Broten
lehrest	lehrest
baute	baute
salz	salz
hell	hell
dingten	dingten
drücke	drücke
widerstanden	widerstanden
Willst	Willst
Stärket	Stärket
preisen	preisen
bereitet	bereitet
Bäume	Bäume
Meere	Meere
Bären	Bären
Ihren	Ihren
Deutungen	Deutungen
verkauft	verkauft
anrufen	anrufen
umkehrt	umkehrt
ausziehst	ausziehst
aufwachst	aufwachst
legte	legte
Laie	Laie
sterbet	sterbet
pflügen	pflügen
Keile	Keile
Gewürzen	Gewürzen
schneide	schneide
reife	reife
Griechen	Griechen
eilet	eilet
Ihre	Ihre
erkennet	erkennet
unser	unser
Könnet	Könnet
weisest	weisest
Held	Held
besäest	besäest
drängte	drängte
am	am
Grüße	Grüße
ringen	ringen
dingt	dingt
ob	ob
Werkzeugen	Werkzeugen
Pauke	Pauke
frisch	frisch
kämpfte	kämpfte
vermahnten	vermahnten
weichen	weichen
Kreisen	Kreisen
reifen	reifen
trinken	trinken
verziehe	verziehe
setzt	setzt
Jude	Jude
abtrünnigen	abtrünnigen
Hände	Hände
seine	seine
erhöhet	erhöhet
Sprüchen	Sprüchen
Zehen	Zehen
verbannet	verbannet
wollte	wollte
Tagen	Tagen
ermahnt	ermahnt
Toren	Toren
jedes	jedes
wog	wog
nützt	nützt
seufzte	seufzte
demütigst	demütigst
plagest	plagest
Westen	Westen
kühl	kühl
leide	leide
ziehest	ziehest
jede	jede
Höhe	Höhe
erschrecket	erschrecket
seines	seines
wehklage	wehklage
rühmst	rühmst
soll	soll
Funken	Funken
Kannst	Kannst
neigest	neigest
verdeckten	verdeckten
erfahrest	erfahrest
bemüht	bemüht
Röcken	Röcken
leihet	leihet
anderen	anderen
nähret	nähret
Wehr	Wehr
stoßest	stoßest
Kommst	Kommst
nötig	nötig
streiten	streiten
Kleinode	Kleinode
Mäusen	Mäusen
Gäste	Gäste
lobet	lobet
Meinen	Meinen
streckst	streckst
Teppiche	Teppiche
begrabest	begrabest
Schenke	Schenke
schöpfe	schöpfe
Tausend	Tausend
Sabbate	Sabbate
erfahret	erfahret
rotten	rotten
Weinberge	Weinberge
eingehst	eingehst
kriegen	kriegen
Wüsten	Wüsten
säumen	säumen
pflanzest	pflanzest
blenden	blenden
fragst	fragst
vergesset	vergesset
Eilet	Eilet
verbergest	verbergest
backe	backe
weinst	weinst
Betten	Betten
ungeistlichen	ungeistlichen
wohnte	wohnte
kein	kein
ziehst	ziehst
führet	führet
Gästen	Gästen
saget	saget
meine	meine
hebräische	hebräische
teil	teil
Bürden	Bürden
Heiße	Heiße
siegte	siegte
Gibt	Gibt
ratschlaget	ratschlaget
Laufet	Laufet
Zöpfe	Zöpfe
sehest	sehest
Befehlen	Befehlen
übrigbleibe	übrigbleibe
stellen	stellen
sündigst	sündigst
Sorget	Sorget
behaltest	behaltest
erkennst	erkennst
heiliget	heiliget
sprecht	sprecht
erwürgt	erwürgt
bedeckest	bedeckest
teilen	teilen
verwirft	verwirft
Werde	Werde
nachwandelt	nachwandelt
Lobgesängen	Lobgesängen
irrte	irrte
umkommt	umkommt
Friede	Friede
Ruder	Ruder
erlöset	erlöset
zerstreuest	zerstreuest
Anfechtungen	Anfechtungen
ernte	ernte
Gebete	Gebete
reichte	reichte
verbergt	verbergt
liebet	liebet
hauen	hauen
Keine	Keine
Linke	Linke
steinigest	steinigest
schnitt	schnitt
Spannt	Spannt
steckst	steckst
wild	wild
inneren	inneren
vergebet	vergebet
Klage	Klage
warten	warten
verzehrst	verzehrst
stäupt	stäupt
Frage	Frage
versucht	versucht
Helmen	Helmen
rufest	rufest
Ringen	Ringen
hilft	hilft
ruhest	ruhest
Speise	Speise
Geschäften	Geschäften
Höfe	Höfe
vertraget	vertraget
mehret	mehret
zerbricht	zerbricht
sucht	sucht
geraten	geraten
Schwellen	Schwellen
hebräisch	hebräisch
Zäune	Zäune
Weinet	Weinet
Loben	Loben
siegen	siegen
Geviert	Geviert
morden	morden
Leichname	Leichname
brachen	brachen
Schneiden	Schneiden
lügst	lügst
achten	achten
Beinen	Beinen
Füllen	Füllen
stolz	stolz
reizte	reizte
Geschäfte	Geschäfte
plagte	plagte
verstehest	verstehest
gehörte	gehörte
Klagen	Klagen
Weine	Weine
tretet	tretet
bleibet	bleibet
verbannt	verbannt
Einem	Einem
Kühen	Kühen
lehre	lehre
suchen	suchen
Bleche	Bleche
schaffet	schaffet
wirfst	wirfst
Erbe	Erbe
Amen	Amen
Trage	Trage
Testamente	Testamente
Glauben	Glauben
erzeige	erzeige
überführen	überführen
Taten	Taten
Helme	Helme
trübe	trübe
Laufen	Laufen
amen	amen
weisen	weisen
zürnet	zürnet
Köpfen	Köpfen
wachet	wachet
braust	braust
tragt	tragt
Fellen	Fellen
Seines	Seines
Gefängnissen	Gefängnissen
Habt	Habt
wallte	wallte
wohnst	wohnst
besitze	besitze
heißet	heißet
bracht	bracht
hausen	hausen
anrichten	anrichten
Frösche	Frösche
rufe	rufe
decket	decket
nahe	nahe
gewinne	gewinne
sterbest	sterbest
bekannt	bekannt
Schuld	Schuld
älteste	älteste
ihr	ihr
erhöhest	erhöhest
zeugte	zeugte
besitzest	besitzest
schlagt	schlagt
schenke	schenke
murmeln	murmeln
Sekten	Sekten
erforschet	erforschet
Verheißung	Verheißung
decken	decken
mögt	mögt
maß	maß
leset	leset
verkündige	verkündige
Grab	Grab
Reif	Reif
müsse	müsse
betrüge	betrüge
leid	leid
wirkte	wirkte
Ebenen	Ebenen
Kreuz	Kreuz
All	All
grüne	grüne
bessere	bessere
Trinken	Trinken
Bahnen	Bahnen
schwimmen	schwimmen
Leuchte	Leuchte
lesen	lesen
absagen	absagen
schaffte	schaffte
Gründe	Gründe
Hunden	Hunden
zuteil	zuteil
Söhnen	Söhnen
Kräften	Kräften
stahlen	stahlen
bringet	bringet
stärkte	stärkte
Gefangenen	Gefangenen
Gründen	Gründen
bestimmte	bestimmte
erschrickst	erschrickst
eilte	eilte
Quelle	Quelle
trügen	trügen
bereite	bereite
erweckt	erweckt
zweifeln	zweifeln
erschreckten	erschreckten
beharrt	beharrt
still	still
morde	morde
ausrottest	ausrottest
Weinbergen	Weinbergen
gibt	gibt
Königen	Königen
Heuschrecken	Heuschrecken
unehret	unehret
Stolz	Stolz
versuchet	versuchet
Füße	Füße
Majestät	Majestät
fälle	fälle
handhaben	handhaben
Testamenten	Testamenten
bekehrte	bekehrte
Urteile	Urteile
Fett	Fett
schließen	schließen
greife	greife
merke	merke
gebietet	gebietet
borgte	borgte
begehrst	begehrst
Stricke	Stricke
Enden	Enden
Buche	Buche
wärmte	wärmte
Ehre	Ehre
höhnest	höhnest
Empörung	Empörung
verstecken	verstecken
helfet	helfet
weite	weite
Götzen	Götzen
trinkest	trinkest
Kleinod	Kleinod
geboten	geboten
reichet	reichet
Sehne	Sehne
begehrt	begehrt
Last	Last
Wunde	Wunde
demütige	demütige
grünen	grünen
fremden	fremden
fallt	fallt
Edelsteinen	Edelsteinen
begehrte	begehrte
Pauken	Pauken
begrabt	begrabt
Brüsten	Brüsten
Speisen	Speisen
sündigten	sündigten
abtrünnige	abtrünnige
spannte	spannte
warte	warte
anhanget	anhanget
küsse	küsse
verführt	verführt
verkriechet	verkriechet
Forsche	Forsche
griff	griff
bis	bis
stürzte	stürzte
bezahlest	bezahlest
eng	eng
zählet	zählet
schenkest	schenkest
Trinkgefäße	Trinkgefäße
webte	webte
Heben	Heben
Entsetzen	Entsetzen
ehre	ehre
gründen	gründen
bleibest	bleibest
tiefe	tiefe
zweifel	zweifel
Türkise	Türkise
bedeckt	bedeckt
Schafen	Schafen
wärme	wärme
weide	weide
Biene	Biene
vertraute	vertraute
Einer	Einer
Ochsen	Ochsen
Obrigkeit	Obrigkeit
verlähmte	verlähmte
Warte	Warte
vertilgte	vertilgte
fehle	fehle
gießet	gießet
empfange	empfange
dürfest	dürfest
tragest	tragest
esse	esse
Ängsten	Ängsten
Malen	Malen
verklärest	verklärest
holte	holte
bleibe	bleibe
lebst	lebst
Sage	Sage
gebäret	gebäret
schaffest	schaffest
Bist	Bist
lest	lest
Älteste	Älteste
glaubst	glaubst
leite	leite
wisse	wisse
gebieten	gebieten
malen	malen
ausfuhr	ausfuhr
nimmst	nimmst
Ei	Ei
einnehmest	einnehmest
weh	weh
werde	werde
gebühren	gebühren
zerstückte	zerstückte
schaffst	schaffst
Haut	Haut
wollest	wollest
regiere	regiere
leben	leben
Stolze	Stolze
Unglaube	Unglaube
vermagst	vermagst
haderte	haderte
Zäumen	Zäumen
Wehklage	Wehklage
Werkzeuge	Werkzeuge
Befehle	Befehle
befestigt	befestigt
merken	merken
kehren	kehren
Sinnen	Sinnen
freiwillige	freiwillige
predigst	predigst
Schiffe	Schiffe
umbringet	umbringet
handhabt	handhabt
koche	koche
gehst	gehst
Gefilden	Gefilden
vier	vier
Male	Male
gewinnen	gewinnen
Zöpfen	Zöpfen
Folge	Folge
Sternen	Sternen
schlafet	schlafet
zerreißest	zerreißest
schaffe	schaffe
haue	haue
blast	blast
Vorstädten	Vorstädten
Gerichten	Gerichten
könnest	könnest
Buchen	Buchen
Sieben	Sieben
verlaßt	verlaßt
lebest	lebest
kämpfen	kämpfen
empfanget	empfanget
glaubet	glaubet
Gebet	Gebet
Feinden	Feinden
weise	weise
aufnahmt	aufnahmt
stellte	stellte
Schaffet	Schaffet
Herr	Herr
kehrte	kehrte
lachen	lachen
Herde	Herde
Höhen	Höhen
beharret	beharret
bemühst	bemühst
stehest	stehest
Schlange	Schlange
Aussätzigen	Aussätzigen
hörest	hörest
solle	solle
Klüften	Klüften
Dingen	Dingen
nütze	nütze
Eile	Eile
Laien	Laien
Hirte	Hirte
nahte	nahte
täuschet	täuschet
vermag	vermag
Erde	Erde
stehet	stehet
beiden	beiden
Zerstreuten	Zerstreuten
Fröschen	Fröschen
Bette	Bette
Banden	Banden
gründe	gründe
Abtrünnigen	Abtrünnigen
Heißt	Heißt
rührst	rührst
Ärgernissen	Ärgernissen
Wehret	Wehret
Alles	Alles
verkündigt	verkündigt
trotze	trotze
schmelzen	schmelzen
sorge	sorge
Jahren	Jahren
ausbreitet	ausbreitet
entsündigte	entsündigte
Monde	Monde
gehest	gehest
betrübten	betrübten
anrufe	anrufe
Obrigkeiten	Obrigkeiten
pflügte	pflügte
log	log
Gebt	Gebt
setzest	setzest
wachse	wachse
weine	weine
trefft	trefft
flehst	flehst
schauest	schauest
Sucht	Sucht
feiern	feiern
Lobet	Lobet
zieren	zieren
Städte	Städte
bitte	bitte
trägst	trägst
Gesetze	Gesetze
denket	denket
Tausenden	Tausenden
beweist	beweist
befehlen	befehlen
Eingeweiden	Eingeweiden
heißt	heißt
Junge	Junge
speist	speist
nähre	nähre
Fallen	Fallen
kämpfe	kämpfe
eures	eures
blitzen	blitzen
tretest	tretest
verderbet	verderbet
Seil	Seil
begrabet	begrabet
Den	Den
begehre	begehre
Felle	Felle
betrübst	betrübst
Kohle	Kohle
Regieren	Regieren
Kehret	Kehret
heben	heben
Leichen	Leichen
wechselte	wechselte
keinem	keinem
Würze	Würze
unseres	unseres
krähte	krähte
Meine	Meine
Deine	Deine
sitzet	sitzet
wirkst	wirkst
trieben	trieben
zuhört	zuhört
hure	hure
erbest	erbest
kommest	kommest
Solchen	Solchen
Streiten	Streiten
harret	harret
Fäuste	Fäuste
zählte	zählte
fertigte	fertigte
Grenzen	Grenzen
Name	Name
zudeckte	zudeckte
berührt	berührt
hieb	hieb
knüpfte	knüpfte
verzehre	verzehre
Rauben	Rauben
erwerben	erwerben
Werte	Werte
Skorpione	Skorpione
übrigbleibt	übrigbleibt
Gehorcht	Gehorcht
speisen	speisen
Grenze	Grenze
helle	helle
Teil	Teil
hingeht	hingeht
Rehen	Rehen
Fels	Fels
Garten	Garten
Leide	Leide
höhnte	höhnte
Tiefen	Tiefen
Lüsten	Lüsten
frommen	frommen
traut	traut
predigte	predigte
pflanzte	pflanzte
erlöse	erlöse
Ärzten	Ärzten
Lichte	Lichte
verschonet	verschonet
taufte	taufte
führest	führest
Soll	Soll
nötige	nötige
Sehe	Sehe
schwelle	schwelle
fliege	fliege
suchst	suchst
brauste	brauste
raubte	raubte
beschädigt	beschädigt
Prophet	Prophet
schweigen	schweigen
schaute	schaute
ausführen	ausführen
führen	führen
verhalten	verhalten
zerbrechest	zerbrechest
beweisest	beweisest
wallet	wallet
Anschläge	Anschläge
stürze	stürze
kehret	kehret
Steiget	Steiget
beschädigten	beschädigten
Taufe	Taufe
trüge	trüge
spracht	spracht
neigte	neigte
helfest	helfest
messe	messe
Tat	Tat
vertilgest	vertilgest
solche	solche
Weinen	Weinen
verbirgt	verbirgt
vergleiche	vergleiche
absagt	absagt
eingeht	eingeht
speise	speise
webet	webet
fresset	fresset
ausbreitete	ausbreitete
anruft	anruft
Kräfte	Kräfte
Hallen	Hallen
gebot	gebot
Sehet	Sehet
faule	faule
bringst	bringst
berufe	berufe
begehrten	begehrten
sagst	sagst
Ebene	Ebene
Hirsche	Hirsche
gebraucht	gebraucht
flucht	flucht
Ha	Ha
Jünglinge	Jünglinge
Stimmen	Stimmen
kehrst	kehrst
Kriegsknechte	Kriegsknechte
er	er
heilet	heilet
fette	fette
verzehrt	verzehrt
forschen	forschen
Palästen	Palästen
reizen	reizen
habest	habest
spricht	spricht
lose	lose
Pfeile	Pfeile
Leisten	Leisten
heile	heile
Hecken	Hecken
aufhebest	aufhebest
bestellte	bestellte
Beine	Beine
hilfst	hilfst
Gehörst	Gehörst
Als	Als
meinte	meinte
betrübet	betrübet
Kriegsknechten	Kriegsknechten
bestimmst	bestimmst
verfolgst	verfolgst
rauben	rauben
befehlt	befehlt
Nehmet	Nehmet
Trübsale	Trübsale
zerstreut	zerstreut
schöpfte	schöpfte
erzürnt	erzürnt
besehet	besehet
solches	solches
beides	beides
dich	dich
spiele	spiele
Briefe	Briefe
eher	eher
Abhängen	Abhängen
erforschest	erforschest
Märkten	Märkten
Vorhäute	Vorhäute
Esset	Esset
Staube	Staube
Gefäßen	Gefäßen
scheiden	scheiden
Sieb	Sieb
besitzt	besitzt
Binden	Binden
Sterne	Sterne
regieret	regieret
kochte	kochte
glänzt	glänzt
lügen	lügen
frevles	frevles
Geboten	Geboten
bestimmt	bestimmt
verstanden	verstanden
essest	essest
Jungen	Jungen
berufen	berufen
drückte	drückte
trinkst	trinkst
schenkte	schenkte
irgendeine	irgendeine
grüßen	grüßen
ehret	ehret
Helden	Helden
verkündigten	verkündigten
bebte	bebte
einem	einem
preise	preise
schlage	schlage
Flamme	Flamme
wälzt	wälzt
beide	beide
liebe	liebe
austilgest	austilgest
Klauen	Klauen
verkaufe	verkaufe
gefällst	gefällst
löst	löst
nimmt	nimmt
wilden	wilden
hineingeht	hineingeht
Amt	Amt
warnst	warnst
Auge	Auge
schmierte	schmierte
feierte	feierte
angehört	angehört
Säcke	Säcke
verkriechst	verkriechst
Same	Same
hauest	hauest
verzieh	verzieh
dichten	dichten
Fällt	Fällt
könnte	könnte
Anklagen	Anklagen
Alten	Alten
Sagte	Sagte
Schmiede	Schmiede
Fischen	Fischen
verdeckte	verdeckte
Bär	Bär
tatet	tatet
beweisen	beweisen
Sinne	Sinne
regiert	regiert
reden	reden
brach	brach
betrübte	betrübte
Pferde	Pferde
naht	naht
Bis	Bis
liegen	liegen
schreckt	schreckt
solchen	solchen
Höret	Höret
wirst	wirst
scheinen	scheinen
Schiffen	Schiffen
vertilgst	vertilgst
zerstücken	zerstücken
Zäunen	Zäunen
verstopft	verstopft
bewahrt	bewahrt
waren	waren
kennest	kennest
Licht	Licht
gibst	gibst
Vorhäuten	Vorhäuten
gelobte	gelobte
Kehre	Kehre
verbirgst	verbirgst
Klaue	Klaue
stoßt	stoßt
heiligten	heiligten
Plagen	Plagen
Buchstabe	Buchstabe
Sabbatjahr	Sabbatjahr
Tannen	Tannen
vor	vor
ziert	ziert
hüte	hüte
Warten	Warten
Gedanke	Gedanke
erniedrigst	erniedrigst
Drachen	Drachen
Pflanzung	Pflanzung
Stäbe	Stäbe
Ställe	Ställe
vertilgen	vertilgen
vertrauten	vertrauten
schätzte	schätzte
erzeigest	erzeigest
Träume	Träume
lernet	lernet
Hauen	Hauen
kaufe	kaufe
hebet	hebet
scheue	scheue
sprechet	sprechet
lobe	lobe
spielen	spielen
gebiete	gebiete
bestellt	bestellt
Hebet	Hebet
Perle	Perle
verstehst	verstehst
Händen	Händen
Jochen	Jochen
kehre	kehre
liebst	liebst
stiften	stiften
tuest	tuest
prüfest	prüfest
keines	keines
aufwacht	aufwacht
innere	innere
Schläge	Schläge
weiche	weiche
verkündigst	verkündigst
Füllet	Füllet
Sorge	Sorge
seht	seht
reich	reich
grüßt	grüßt
gehöre	gehöre
Schreiet	Schreiet
bekannten	bekannten
Tischen	Tischen
stand	stand
Freunden	Freunden
beider	beider
sitzen	sitzen
sprachen	sprachen
Gehilfen	Gehilfen
entsetzt	entsetzt
preiset	preiset
schweiget	schweiget
Narren	Narren
durchbohrt	durchbohrt
backen	backen
seinen	seinen
Tun	Tun
erben	erben
Pfunde	Pfunde
ungehorsame	ungehorsame
zuteilte	zuteilte
beweise	beweise
arm	arm
machet	machet
Waren	Waren
schließe	schließe
seit	seit
Höfen	Höfen
gleich	gleich
ratschlagt	ratschlagt
sitzest	sitzest
Fette	Fette
fallest	fallest
Ein	Ein
Decket	Decket
Morden	Morden
Ränken	Ränken
aufwachte	aufwachte
los	los
leider	leider
sorget	sorget
stimmte	stimmte
Setzet	Setzet
wache	wache
Ängste	Ängste
Ihr	Ihr
Essen	Essen
Stufen	Stufen
Glaubet	Glaubet
Hecke	Hecke
Wachet	Wachet
säte	säte
werte	werte
aufrichte	aufrichte
jagst	jagst
entsetzte	entsetzte
erhalte	erhalte
verlasse	verlasse
Gar	Gar
jeder	jeder
Entsetzt	Entsetzt
Ratet	Ratet
Wegen	Wegen
Haben	Haben
stellst	stellst
Alte	Alte
erzeigten	erzeigten
Steine	Steine
suchet	suchet
Bahn	Bahn
Leiste	Leiste
demütiget	demütiget
lange	lange
untertretet	untertretet
strafe	strafe
Wirte	Wirte
Namen	Namen
Kein	Kein
euren	euren
Kriege	Kriege
Worte	Worte
müßten	müßten
bestellten	bestellten
vertilgt	vertilgt
zeuge	zeuge
Wer	Wer
Fülle	Fülle
Altären	Altären
versuche	versuche
spannt	spannt
sagest	sagest
Seine	Seine
kämpfet	kämpfet
frevler	frevler
fluchte	fluchte
glauben	glauben
grabe	grabe
fahret	fahret
versöhnt	versöhnt
vertilge	vertilge
Speere	Speere
Königreiche	Königreiche
beschwöre	beschwöre
einführt	einführt
fasset	fasset
fahrt	fahrt
lebet	lebet
messet	messet
wärmet	wärmet
Meinst	Meinst
räumet	räumet
erlösest	erlösest
Gerät	Gerät
verdammst	verdammst
erhöht	erhöht
keiner	keiner
Meinet	Meinet
Mein	Mein
Decken	Decken
fertig	fertig
setzet	setzet
tief	tief
Dich	Dich
gefällt	gefällt
zuhöret	zuhöret
brechen	brechen
gebt	gebt
erlaubte	erlaubte
sterbt	sterbt
angehören	angehören
erweckst	erweckst
mehrte	mehrte
Reichen	Reichen
forschte	forschte
dienst	dienst
Lesen	Lesen
unsere	unsere
Suche	Suche
diente	diente
achte	achte
wisset	wisset
unserer	unserer
Ding	Ding
gehorcht	gehorcht
Predigten	Predigten
Zeugen	Zeugen
den	den
Säcken	Säcken
deines	deines
jeden	jeden
müßt	müßt
unsrer	unsrer
bekennst	bekennst
haltest	haltest
zanket	zanket
Boten	Boten
andere	andere
rächest	rächest
Felsen	Felsen
Türmen	Türmen
umkehrte	umkehrte
Fremden	Fremden
klage	klage
sei	sei
bedenken	bedenken
haut	haut
betrügen	betrügen
ihres	ihres
hoffte	hoffte
unterrichten	unterrichten
Beten	Beten
sagen	sagen
meinen	meinen
rote	rote
aufrichtest	aufrichtest
kostet	kostet
Schwänzen	Schwänzen
hasset	hasset
ihre	ihre
meinem	meinem
leuchtete	leuchtete
halbe	halbe
aßest	aßest
heil	heil
halt	halt
Bote	Bote
kühlen	kühlen
Briefen	Briefen
anbetest	anbetest
blasen	blasen
erfüllt	erfüllt
Gebot	Gebot
erschreckte	erschreckte
schießen	schießen
schlaf	schlaf
mühte	mühte
lade	lade
Krieg	Krieg
Danket	Danket
schämst	schämst
danket	danket
glaubest	glaubest
kennet	kennet
willst	willst
weist	weist
eine	eine
jammern	jammern
Taube	Taube
Deinem	Deinem
Binde	Binde
versöhnst	versöhnst
verderbest	verderbest
ältesten	ältesten
War	War
Pfunden	Pfunden
Söhne	Söhne
aufhörte	aufhörte
grüßte	grüßte
könnet	könnet
Fahrt	Fahrt
könnt	könnt
hineingehst	hineingehst
Löwe	Löwe
umkehret	umkehret
Knabe	Knabe
verwahrst	verwahrst
Raben	Raben
zerbrichst	zerbrichst
Könnt	Könnt
Raten	Raten
schießt	schießt
kosten	kosten
anzeigt	anzeigt
Gemeinden	Gemeinden
zeugst	zeugst
liebte	liebte
Wände	Wände
Basilisk	Basilisk
verwahrt	verwahrt
verfolgt	verfolgt
nachwandelte	nachwandelte
fertige	fertige
besorgte	besorgte
gebührt	gebührt
opfern	opfern
armen	armen
Fittichen	Fittichen
verkündigest	verkündigest
Suchet	Suchet
unehrt	unehrt
machst	machst
aufrichten	aufrichten
Erstlinge	Erstlinge
Ring	Ring
spannen	spannen
Gewürze	Gewürze
fließen	fließen
gelang	gelang
aufstehet	aufstehet
schwimmst	schwimmst
anhangen	anhangen
Wir	Wir
Unserer	Unserer
Christ	Christ
fallet	fallet
Buben	Buben
urteile	urteile
erzürnst	erzürnst
rühmest	rühmest
Skorpionen	Skorpionen
Macht	Macht
Ordnungen	Ordnungen
vertrieb	vertrieb
Zeugnissen	Zeugnissen
bestand	bestand
Hundert	Hundert
Lüste	Lüste
demütigte	demütigte
Leuchten	Leuchten
glänzte	glänzte
Türme	Türme
Aas	Aas
schreie	schreie
gewinnet	gewinnet
mahlen	mahlen
vertraut	vertraut
erlassen	erlassen
Ärgernisse	Ärgernisse
ausführt	ausführt
vermögen	vermögen
siehst	siehst
Narr	Narr
Meeren	Meeren
Weiß	Weiß
steiget	steiget
kaufst	kaufst
Stücke	Stücke
decke	decke
Worten	Worten
urteilte	urteilte
Steinen	Steinen
Kleinoden	Kleinoden
zweifelte	zweifelte
Mal	Mal
wilde	wilde
Spießen	Spießen
taufst	taufst
beschwert	beschwert
Setzt	Setzt
Zähne	Zähne
schlagest	schlagest
Jahr	Jahr
legest	legest
Füchse	Füchse
schlaft	schlaft
Gelobt	Gelobt
wogen	wogen
bist	bist
Armen	Armen
weichest	weichest
unschuldige	unschuldige
Wesen	Wesen
pflanzet	pflanzet
rufen	rufen
erbauet	erbauet
rittest	rittest
lieb	lieb
meines	meines
zerstreuet	zerstreuet
sollte	sollte
folget	folget
schickte	schickte
zierte	zierte
Verheißungen	Verheißungen
schwellen	schwellen
Weg	Weg
vertilgten	vertilgten
schreiben	schreiben
Fische	Fische
Gefangene	Gefangene
Schade	Schade
sichten	sichten
ausrichtet	ausrichtet
wahr	wahr
verständig	verständig
Wachen	Wachen
streute	streute
Dienet	Dienet
wahre	wahre
Gebeine	Gebeine
Spanne	Spanne
schmücket	schmücket
abzieht	abzieht
einer	einer
Wehen	Wehen
lernte	lernte
Werk	Werk
Weil	Weil
verstecke	verstecke
meinet	meinet
feierten	feierten
Sprüche	Sprüche
standet	standet
deinem	deinem
Rudern	Rudern
erniedrigt	erniedrigt
steig	steig
folgen	folgen
verdammte	verdammte
Fällen	Fällen
liege	liege
weichet	weichet
sorgte	sorgte
Tragt	Tragt
treibest	treibest
zerschlagt	zerschlagt
säume	säume
bitten	bitten
werden	werden
sollt	sollt
aufsteht	aufsteht
bedeckst	bedeckst
mangeln	mangeln
zerschlaget	zerschlaget
Dinge	Dinge
willen	willen
erhebest	erhebest
gereichte	gereichte
verschont	verschont
auflöste	auflöste
Wüste	Wüste
erlaubt	erlaubt
Einheimischen	Einheimischen
Frommen	Frommen
hinaufgehst	hinaufgehst
spaltete	spaltete
Acht	Acht
eurer	eurer
Sollte	Sollte
nährte	nährte
Satzungen	Satzungen
Knechten	Knechten
Ellen	Ellen
ruhte	ruhte
gut	gut
Schar	Schar
pflanzt	pflanzt
solcher	solcher
kennst	kennst
schenken	schenken
stimmen	stimmen
freuet	freuet
Gerichte	Gerichte
wehret	wehret
Aufsätzen	Aufsätzen
Spitzen	Spitzen
Kreise	Kreise
fallen	fallen
Röcke	Röcke
Ströme	Ströme
Reizen	Reizen
irre	irre
fluchet	fluchet
Tische	Tische
plagen	plagen
stellet	stellet
Steigen	Steigen
hoffet	hoffet
Gras	Gras
ärger	ärger
Eichen	Eichen
auflegst	auflegst
fetten	fetten
selbst	selbst
übest	übest
sorgen	sorgen
Wolle	Wolle
müßte	müßte
Werken	Werken
suche	suche
zürnte	zürnte
bewahrest	bewahrest
kühle	kühle
schätze	schätze
Heuschrecke	Heuschrecke
ander	ander
Ochs	Ochs
mahle	mahle
erhörst	erhörst
tobte	tobte
träge	träge
stillest	stillest
Anschlägen	Anschlägen
Gefilde	Gefilde
schnelle	schnelle
gehorchest	gehorchest
beugst	beugst
alle	alle
erweckest	erweckest
verkehrt	verkehrt
liebest	liebest
Gibst	Gibst
krieget	krieget
streckte	streckte
Winde	Winde
erkennest	erkennest
lehnen	lehnen
Räte	Räte
Mensch	Mensch
dein	dein
Erben	Erben
weinen	weinen
gereicht	gereicht
taufet	taufet
aufheben	aufheben
Halle	Halle
wachte	wachte
Strafe	Strafe
erhörest	erhörest
keine	keine
krähen	krähen
Schlägst	Schlägst
vierten	vierten
untergeht	untergeht
schreist	schreist
Feiertagen	Feiertagen
verständige	verständige
nötigte	nötigte
Neumonden	Neumonden
übrigbleibet	übrigbleibet
Stricken	Stricken
behalte	behalte
lüge	lüge
Lehre	Lehre
kommst	kommst
wert	wert
Trübsalen	Trübsalen
brechet	brechet
fülle	fülle
wollten	wollten
solchem	solchem
Röhre	Röhre
arbeiten	arbeiten
Märkte	Märkte
Ställen	Ställen
sagte	sagte
Eiche	Eiche
auflöst	auflöst
Strömen	Strömen
speiet	speiet
spanne	spanne
Ärzte	Ärzte
erfüllet	erfüllet
Hunde	Hunde
ausgehst	ausgehst
bauten	bauten
könnten	könnten
teilte	teilte
rechten	rechten
aufstanden	aufstanden
halben	halben
Unsere	Unsere
Tauben	Tauben
deckst	deckst
mangelte	mangelte
hörst	hörst
Wille	Wille
Meines	Meines
frevle	frevle
feiert	feiert
versteckst	versteckst
sieht	sieht
Schneide	Schneide
glaube	glaube
schreiet	schreiet
selber	selber
Solcher	Solcher
steigest	steigest
regierest	regierest
kranken	kranken
Entsetzet	Entsetzet
erst	erst
Scharen	Scharen
seien	seien
Werke	Werke
ausrufen	ausrufen
Stühle	Stühle
suchest	suchest
vergibst	vergibst
Blitzen	Blitzen
dienest	dienest
langte	langte
Rubinen	Rubinen
traget	traget
suchte	suchte
schläfst	schläfst
Gedanken	Gedanken
brichst	brichst
Städten	Städten
Staub	Staub
versuchen	versuchen
säst	säst
Gesellen	Gesellen
Gebeten	Gebeten
pflege	pflege
Bergen	Bergen
Aussätzige	Aussätzige
Falle	Falle
gelobt	gelobt
erwürget	erwürget
Satzung	Satzung
blende	blende
Stufe	Stufe
Riesen	Riesen
austilge	austilge
wir	wir
losen	losen
lehrte	lehrte
Habe	Habe
schwebte	schwebte
ziehet	ziehet
hasse	hasse
Reich	Reich
Gut	Gut
vertrauet	vertrauet
vermahnen	vermahnen
verunreinigst	verunreinigst
Hin	Hin
Werdet	Werdet
wachen	wachen
Schulden	Schulden
bekannte	bekannte
schrecke	schrecke
Höhle	Höhle
steinigte	steinigte
Jüngern	Jüngern
Fetten	Fetten
aufhört	aufhört
Knechte	Knechte
wegen	wegen
verkaufte	verkaufte
behaltet	behaltet
Flammen	Flammen
prüfst	prüfst
fahrest	fahrest
gebet	gebet
Sabbatjahre	Sabbatjahre
banden	banden
Ach	Ach
schauen	schauen
wünschte	wünschte
rechte	rechte
bleibst	bleibst
Fallet	Fallet
Tiefe	Tiefe
Keilen	Keilen
verkaufst	verkaufst
schmiert	schmiert
trage	trage
beugte	beugte
Heiden	Heiden
opferte	opferte
unterrichte	unterrichte
lehnte	lehnte
stoßet	stoßet
Neumonde	Neumonde
rühmte	rühmte
befragten	befragten
verlieren	verlieren
Grüßet	Grüßet
wiederkommst	wiederkommst
stärken	stärken
ausfuhren	ausfuhren
gedenket	gedenket
Stimme	Stimme
wirket	wirket
beseht	beseht
schöpfen	schöpfen
Schätzen	Schätzen
leiden	leiden
pflüget	pflüget
fassest	fassest
bauest	bauest
frage	frage
besät	besät
untertreten	untertreten
eile	eile
erforscht	erforscht
reizet	reizet
binden	binden
Bitten	Bitten
Töpfen	Töpfen
gute	gute
verdammt	verdammt
Bäumen	Bäumen
Weichet	Weichet
toten	toten
unschuldigen	unschuldigen
Brüste	Brüste
schreibst	schreibst
trotzest	trotzest
ungefälschtem	ungefälschtem
Altäre	Altäre
werdet	werdet
versteckt	versteckt
würzen	würzen
Knaben	Knaben
fluchten	fluchten
führte	führte
heiligest	heiligest
Bärte	Bärte
freiwilligen	freiwilligen
werfet	werfet
urteilen	urteilen
grün	grün
haust	haust
leuchten	leuchten
gebären	gebären
ehe	ehe
Hunderten	Hunderten
vermahne	vermahne
vergießest	vergießest
aufstand	aufstand
befestigte	befestigte
Schenken	Schenken
Meinem	Meinem
Räten	Räten
verlasset	verlasset
dankte	dankte
ratschlagen	ratschlagen
saht	saht
Abhänge	Abhänge
alles	alles
schreien	schreien
Zäume	Zäume
Schleife	Schleife
Füßen	Füßen
Gänge	Gänge
gelangen	gelangen
Mache	Mache
seufzest	seufzest
stiftete	stiftete
eingehet	eingehet
gehören	gehören
Glaubst	Glaubst
binde	binde
zankte	zankte
Aase	Aase
strafen	strafen
schmelzt	schmelzt
Säuen	Säuen
schmückst	schmückst
all	all
Tyrannen	Tyrannen
Dans	Dans
blitzte	blitzte
Kreuze	Kreuze
weg	weg
müssest	müssest
greifet	greifet
Säge	Säge
grünte	grünte
wer	wer
Joche	Joche
zerstört	zerstört
gehorchet	gehorchet
reif	reif
Rehe	Rehe
verbot	verbot
Klüfte	Klüfte
lehret	lehret
würze	würze
gelobten	gelobten
reizest	reizest
rühmet	rühmet
verziehen	verziehen
hebst	hebst
stiegen	stiegen
taten	taten
Euren	Euren
Säue	Säue
Bienen	Bienen
spalten	spalten
Alle	Alle
Gesell	Gesell
verkehrten	verkehrten
Bäche	Bäche
strecken	strecken
Heeren	Heeren
backt	backt
weiten	weiten
taufe	taufe
deinen	deinen
Hat	Hat
bekehrst	bekehrst
einführen	einführen
hassest	hassest
Jünger	Jünger
Empörungen	Empörungen
ruhe	ruhe
anders	anders
wirft	wirft
Köpfe	Köpfe
ladest	ladest
fragen	fragen
Seiten	Seiten
predigten	predigten
Sei	Sei
zerstreute	zerstreute
aufhebt	aufhebt
Blechen	Blechen
zeugen	zeugen
merket	merket
herrschte	herrschte
entsündigt	entsündigt
pflanze	pflanze
Grieche	Grieche
erhebst	erhebst
stillte	stillte
Heide	Heide
schämet	schämet
schätzt	schätzt
zuschließt	zuschließt
Berge	Berge
zudeckt	zudeckt
denkst	denkst
leere	leere
Riese	Riese
trotzet	trotzet
seufzt	seufzt
Schau	Schau
bleiben	bleiben
Leichnamen	Leichnamen
Erden	Erden
maßen	maßen
ehrest	ehrest
gelangt	gelangt
Plage	Plage
erntete	erntete
Deinen	Deinen
bricht	bricht
halte	halte
schweigst	schweigst
wissest	wissest
wehte	wehte
bringest	bringest
nachwandeln	nachwandeln
irgendein	irgendein
folge	folge
salzen	salzen
weich	weich
brecht	brecht
baust	baust
Keiner	Keiner
ein	ein
frische	frische
regte	regte
wiederkommt	wiederkommt
recke	recke
weinte	weinte
erzeigte	erzeigte
ritt	ritt
füllte	füllte
Schuhe	Schuhe
Huren	Huren
fließt	fließt
Heere	Heere
Wänden	Wänden
lachte	lachte
Tiere	Tiere
Weinstöcke	Weinstöcke
Blitze	Blitze
unterrichtet	unterrichtet
verlobt	verlobt
unserem	unserem
Solche	Solche
empörten	empörten
brennen	brennen
Schilden	Schilden
steckte	steckte
ungefälschter	ungefälschter
Maßen	Maßen
verstehet	verstehet
strecke	strecke
baue	baue
Augen	Augen
Gebärden	Gebärden
verdammten	verdammten
griechisch	griechisch
habet	habet
verstörte	verstörte
heißest	heißest
erfreut	erfreut
gehorchte	gehorchte
Decke	Decke
Wollte	Wollte
vermöge	vermöge
vereinigt	vereinigt
Kriegen	Kriegen
Weinstöcken	Weinstöcken
begehret	begehret
Einen	Einen
helft	helft
verdeckt	verdeckt
blase	blase
einnehmet	einnehmet
löset	löset
Propheten	Propheten
habe	habe
versagen	versagen
hängen	hängen
Tage	Tage
Kost	Kost
trauten	trauten
Abtrünnige	Abtrünnige
durchläuterte	durchläuterte
fließe	fließe
weinest	weinest
würdest	würdest
ausrichtest	ausrichtest
Seit	Seit
denn	denn
Unrecht	Unrecht
dienet	dienet
Elfen	Elfen
Graben	Graben
laufe	laufe
setzte	setzte
dingte	dingte
wehklagen	wehklagen
Fallt	Fallt
Gläubigen	Gläubigen
bewähret	bewähret
gelobst	gelobst
würdet	würdet
Fäusten	Fäusten
stehst	stehst
drängst	drängst
besser	besser
Reizt	Reizt
gehet	gehet
Jahre	Jahre
ausgereckten	ausgereckten
Schlangen	Schlangen
Gefäße	Gefäße
Ratsherr	Ratsherr
Schalen	Schalen
Eine	Eine
befehle	befehle
griffen	griffen
schlag	schlag
lang	lang
wehen	wehen
werdest	werdest
Werden	Werden
koste	koste
entsündigen	entsündigen
stahl	stahl
scheute	scheute
Herrn	Herrn
sehet	sehet
verliere	verliere
Schauen	Schauen
wünschen	wünschen
linke	linke
Wehklagen	Wehklagen
deckte	deckte
erhaltet	erhaltet
Gebote	Gebote
Dienst	Dienst
preist	preist
glaubte	glaubte
lauf	lauf
Perlen	Perlen
Rabe	Rabe
rauschte	rauschte
stürzest	stürzest
Ränke	Ränke
trotzt	trotzt
messen	messen
verliert	verliert
verwirren	verwirren
Tieren	Tieren
einführte	einführte
auflegt	auflegt
Trinket	Trinket
bezahlst	bezahlst
fasse	fasse
schenket	schenket
tat	tat
anhangt	anhangt
freute	freute
liegst	liegst
Ecken	Ecken
verkauften	verkauften
anrührt	anrührt
Geliebten	Geliebten
esset	esset
Rufen	Rufen
vergibt	vergibt
versöhnet	versöhnet
heiß	heiß
Lehne	Lehne
gehörten	gehörten
rede	rede
Rufet	Rufet
holst	holst
verdeckst	verdeckst
Zweigen	Zweigen
Schilde	Schilde
grüße	grüße
Herz	Herz
Stücken	Stücken
Ringe	Ringe
fehlen	fehlen
kommet	kommet
eurem	eurem
Schleifen	Schleifen
Menschen	Menschen
gedenkst	gedenkst
Gebeinen	Gebeinen
ringst	ringst
Äxte	Äxte
Feinde	Feinde
herrschet	herrschet
Stämme	Stämme
erlasset	erlasset
rauschen	rauschen
lasset	lasset
bezahlt	bezahlt
tragen	tragen
auszieht	auszieht
Linken	Linken
Tier	Tier
Sägen	Sägen
danke	danke
sündiget	sündiget
hängte	hängte
eins	eins
erzeigen	erzeigen
Gebärde	Gebärde
wohnest	wohnest
Dein	Dein
Kohlen	Kohlen
fangt	fangt
beschwören	beschwören
Wehe	Wehe
Willen	Willen
taufen	taufen
aufkommen	aufkommen
wohnet	wohnet
leiten	leiten
betrübt	betrübt
Geräte	Geräte
haltet	haltet
Solch	Solch
Weile	Weile
ihren	ihren
anzeigen	anzeigen
gelobet	gelobet
fällt	fällt
Schwänze	Schwänze
Festen	Festen
scheu	scheu
Pferden	Pferden
Feste	Feste
borgst	borgst
sahet	sahet
suchten	suchten
ringet	ringet
Würzen	Würzen
bekehrten	bekehrten
Buch	Buch
zerstreuten	zerstreuten
prediget	prediget
kaufest	kaufest
Ästen	Ästen
besitzet	besitzet
Hirt	Hirt
trüb	trüb
erhört	erhört
bange	bange
bekennt	bekennt
Stäben	Stäben
reizt	reizt
Fürst	Fürst
Unglauben	Unglauben
zeigst	zeigst
wünsche	wünsche
fange	fange
fragte	fragte
Kühe	Kühe
hüten	hüten
ringe	ringe
schnitten	schnitten
außen	außen
teilet	teilet
ach	ach
lösest	lösest
trinket	trinket
beißt	beißt
rührte	rührte
stürzt	stürzt
leget	leget
Bitte	Bitte
gehört	gehört
Am	Am
Streite	Streite
folgte	folgte
verkehrte	verkehrte
würde	würde
machest	machest
solch	solch
flehte	flehte
sonderte	sonderte
warst	warst
stärket	stärket
Schreien	Schreien
lieget	lieget
stärke	stärke
Erstlingen	Erstlingen
Brote	Brote
verzieht	verzieht
Funke	Funke
huren	huren
erschreckt	erschreckt
Drache	Drache
anrichte	anrichte
ausgereckt	ausgereckt
regieren	regieren
drängest	drängest
brauchte	brauchte
Früchte	Früchte
befragte	befragte
Trinkgefäßen	Trinkgefäßen
spielte	spielte
Röhren	Röhren
ausgereckte	ausgereckte
Raube	Raube
arme	arme
murmelte	murmelte
Seile	Seile
Zeug	Zeug
vertrieben	vertrieben
wehe	wehe
reiche	reiche
Diebe	Diebe
erfreuest	erfreuest
Feind	Feind
befragt	befragt
Buchstaben	Buchstaben
außer	außer
zerstreust	zerstreust
lebte	lebte
rufst	rufst
säumet	säumet
einerntest	einerntest
Äxten	Äxten
Tyrann	Tyrann
pflanzen	pflanzen
Bunde	Bunde
aufrichtet	aufrichtet
auflegte	auflegte
machte	machte
band	band
Höhlen	Höhlen
greifen	greifen
Kristallen	Kristallen
Deutung	Deutung
reichen	reichen
gerne	gerne
Regiert	Regiert
gebäre	gebäre
Tust	Tust
enge	enge
Christen	Christen
lernst	lernst
sollst	sollst
erhebet	erhebet
ausrottet	ausrottet
vergessest	vergessest
empörte	empörte
Ecke	Ecke
Kommet	Kommet
Basilisken	Basilisken
labe	labe
wechseln	wechseln
ehren	ehren
Zweige	Zweige
fluche	fluche
Maße	Maße
lehren	lehren
räumen	räumen
unseren	unseren
Fragen	Fragen
Löwen	Löwen
Spieße	Spieße
gießest	gießest
Kaufleute	Kaufleute
Rühmst	Rühmst
wehre	wehre
Jünglingen	Jünglingen
Machet	Machet
sage	sage
prüfet	prüfet
Gefängnisse	Gefängnisse
haben	haben
erschrickt	erschrickt
besuchen	besuchen
hingehst	hingehst
logen	logen
Solches	Solches
Bube	Bube
sich	sich
austilgen	austilgen
besuche	besuche
durchbohrte	durchbohrte
Spaltung	Spaltung
fällen	fällen
hebräischen	hebräischen
angehöre	angehöre
Merket	Merket
Freunde	Freunde
gewöhnte	gewöhnte
allen	allen
anrührte	anrührte
Folget	Folget
Winden	Winden
Strafen	Strafen
meinst	meinst
pflegte	pflegte
schläft	schläft
seist	seist
nachwandelst	nachwandelst
arbeit	arbeit
verstand	verstand
raten	raten
Schmieden	Schmieden
Reihen	Reihen
versuchst	versuchst
zürnest	zürnest
Wollt	Wollt
Zähnen	Zähnen
Töpfe	Töpfe
schicke	schicke
heulet	heulet
deine	deine
seinem	seinem
vermahnte	vermahnte
neige	neige
entsetzet	entsetzet
übet	übet
Rubine	Rubine
sprichst	sprichst
Sehnen	Sehnen
abziehen	abziehen
besorgt	besorgt
bang	bang
einen	einen
Sabbaten	Sabbaten
stoße	stoße
laden	laden
Kaufleuten	Kaufleuten
Büschen	Büschen
erhöhst	erhöhst
vermöget	vermöget
Maultier	Maultier
Lehren	Lehren
Fremde	Fremde
Götze	Götze
verlobte	verlobte
grüßet	grüßet
Seilen	Seilen
offenbar	offenbar
Band	Band
gleiche	gleiche
Hure	Hure
lauft	lauft
ratet	ratet
gebest	gebest
währte	währte
würden	würden
tobst	tobst
Monaten	Monaten
schon	schon
bestimmten	bestimmten
Aufsätze	Aufsätze
hingehet	hingehet
wachset	wachset
verkehre	verkehre
überführt	überführt
fremde	fremde
berühret	berühret
bedürfet	bedürfet
Lob	Lob
gehörst	gehörst
Gehilfe	Gehilfe
Bete	Bete
bedenket	bedenket
einst	einst
Gehorchet	Gehorchet
träumte	träumte
sondern	sondern
wacht	wacht
fällst	fällst
Sagen	Sagen
Flöte	Flöte
Geliebte	Geliebte
Tut	Tut
einernten	einernten
Gebirge	Gebirge
fehlet	fehlet
Schwelle	Schwelle
wunderte	wunderte
Weh	Weh
anbetet	anbetet
aufnahmen	aufnahmen
klagte	klagte
raubet	raubet
Herren	Herren
rate	rate
hieben	hieben
Träumen	Träumen
Weiche	Weiche
Rufe	Rufe
handhabest	handhabest
Eingeweide	Eingeweide
vermahnet	vermahnet
nehmest	nehmest
treffen	treffen
füllen	füllen
verwahret	verwahret
irren	irren
zerreißt	zerreißt
Stämmen	Stämmen
Schaden	Schaden
verstörten	verstörten
erzeigt	erzeigt
jedem	jedem
Königreichen	Königreichen
Forschet	Forschet
hinausgehst	hinausgehst
stäupte	stäupte
schenkst	schenkst
schaffen	schaffen
Ordnung	Ordnung
predigt	predigt
vergießt	vergießt
Pfeifen	Pfeifen
Stühlen	Stühlen
möget	möget
säet	säet
Kannen	Kannen
sitze	sitze
unsres	unsres
aßet	aßet
Unrechten	Unrechten
stäupen	stäupen
demütig	demütig
schonte	schonte
Maß	Maß
stirbt	stirbt
Ehren	Ehren
Samen	Samen
zürnst	zürnst
Einheimische	Einheimische
kaufet	kaufet
spielet	spielet
Bächen	Bächen
ärgere	ärgere
Schild	Schild
zerstückt	zerstückt
Lobe	Lobe
Äste	Äste
Elle	Elle
vierte	vierte
heiligem	heiligem
fromme	fromme
mögest	mögest
Teile	Teile
wolle	wolle
verkündigte	verkündigte
halten	halten
Wogen	Wogen
hebe	hebe
leer	leer
Edelsteine	Edelsteine
dürft	dürft
Gelobet	Gelobet
währet	währet
scheinest	scheinest
Quellen	Quellen
rächte	rächte
essen	essen
Wert	Wert
Feiertage	Feiertage
Teppichen	Teppichen
Nehmt	Nehmt
Leset	Leset
gießt	gießt
aufmachte	aufmachte
Ende	Ende
Büsche	Büsche
treibst	treibst
Füchsen	Füchsen
Anklage	Anklage
müsset	müsset
Fromme	Fromme
strafte	strafte
jaget	jaget
unsre	unsre
linken	linken
Leiden	Leiden
forschet	forschet
fragest	fragest
Sollten	Sollten
Gehör	Gehör
schlafest	schlafest
hadere	hadere
lehrst	lehrst
offenbare	offenbare
schmückte	schmückte
Schauet	Schauet
beschuldigt	beschuldigt
zeugest	zeugest
Kosten	Kosten
vereinigte	vereinigte
träumen	träumen
bekehrt	bekehrt
sollten	sollten
Tanne	Tanne
Fliegen	Fliegen
stiege	stiege
ehrst	ehrst
durchläutert	durchläutert
mache	mache
Arm	Arm
allem	allem
klaget	klaget
Türkis	Türkis
Ratsherren	Ratsherren
eingehest	eingehest
wehren	wehren
Dieben	Dieben
hänge	hänge
leihst	leihst
Maultiere	Maultiere
Grabe	Grabe
Schale	Schale
erfüllst	erfüllst
Leiche	Leiche
erbte	erbte
mein	mein
untergehst	untergehst
gewöhnt	gewöhnt
heilte	heilte
merkte	merkte
Gebirgen	Gebirgen
stolze	stolze
blitzt	blitzt
Hörst	Hörst
Weihen	Weihen
erlöst	erlöst
verkürzt	verkürzt
laben	laben
ansehen	ansehen
Saget	Saget
bewahret	bewahret
pflegst	pflegst
oben	oben
Lasten	Lasten
schöpfest	schöpfest
fliegen	fliegen
griechischen	griechischen
tote	tote
streite	streite
umbringt	umbringt
einsammelte	einsammelte
tut	tut
Wege	Wege
wälzte	wälzte
drängten	drängten
Haue	Haue
steigen	steigen
übte	übte
Dichten	Dichten
aber	aber
gedenkest	gedenkest
regen	regen
blaset	blaset
scheide	scheide
ausgeht	ausgeht
war	war
verziehst	verziehst
Wache	Wache
knüpfst	knüpfst
sündigte	sündigte
schätzen	schätzen
Gesetzen	Gesetzen
verlähmt	verlähmt
keinen	keinen
nahest	nahest
Hirschen	Hirschen
trägt	trägt
verhalte	verhalte
male	male
Rühmet	Rühmet
Hast	Hast
gelangte	gelangte
bedürft	bedürft
führst	führst
ihrem	ihrem
Pfeife	Pfeife
Für	Für
stelle	stelle
verstört	verstört
hörte	hörte
Bund	Bund
hinaufgeht	hinaufgeht
Steige	Steige
kriegte	kriegte
habt	habt
vermahnt	vermahnt
Paläste	Paläste
Grase	Grase
mühe	mühe
Schuhen	Schuhen
vorn	vorn
springen	springen
Bleibe	Bleibe
speiest	speiest
scheinet	scheinet
faul	faul
ausführte	ausführte
brauche	brauche
schließt	schließt
Aller	Aller
ehrte	ehrte
weichst	weichst
aufkommt	aufkommt
Stärke	Stärke
küssen	küssen
füllst	füllst
bekennet	bekennet
holet	holet
falle	falle
Sorgen	Sorgen
Hebe	Hebe
erbet	erbet
verwirfst	verwirfst
höret	höret
gesellt	gesellt
graben	graben
aufmacht	aufmacht
Ältesten	Ältesten
bauet	bauet
besäet	besäet
beißet	beißet
ziere	ziere
zählst	zählst
Hälse	Hälse
Bürde	Bürde
Gemeinde	Gemeinde
verderben	verderben
heiligt	heiligt
raubest	raubest
weiden	weiden
dürfte	dürfte
Denn	Denn
Lobgesänge	Lobgesänge
Mäuse	Mäuse
hurst	hurst
weinet	weinet
hänget	hänget
widerstand	widerstand
zerstörst	zerstörst
wart	wart
geratest	geratest
sündigt	sündigt
schneiden	schneiden
ratschlagten	ratschlagten
erbaut	erbaut
Woge	Woge
lache	lache
angehöret	angehöret
umkommst	umkommst
erbaust	erbaust
bewahrst	bewahrst
Fliege	Fliege
Schafe	Schafe
Vorstädte	Vorstädte
Leid	Leid
Wirst	Wirst
Zeuge	Zeuge
besucht	besucht
Morde	Morde
Trübsal	Trübsal
fresse	fresse
Taufen	Taufen
heiße	heiße
Kristalle	Kristalle
Anfechtung	Anfechtung
täuschte	täuschte
heiligte	heiligte
Führe	Führe
strafet	strafet
macht	macht
schrecken	schrecken
Lehnen	Lehnen
dürfe	dürfe
Eure	Eure
verwirrt	verwirrt
anzeigest	anzeigest
anzeige	anzeige
brause	brause
Wehre	Wehre
schwebe	schwebe
jammerte	jammerte
steinigst	steinigst
erzürnet	erzürnet
ungehorsam	ungehorsam
mehr	mehr
Pfeilen	Pfeilen
verführe	verführe
eines	eines
erfahrt	erfahrt
drücken	drücken
links	links
springst	springst
anzeigte	anzeigte
Juden	Juden
eure	eure
schlafe	schlafe
ausführe	ausführe
Gläubige	Gläubige
Zeugnisse	Zeugnisse
Hie	Hie
gehorchten	gehorchten
ratschlagte	ratschlagte
Schlägen	Schlägen
Elf	Elf
strafst	strafst
bewährt	bewährt
Herden	Herden
Arme	Arme
Gute	Gute
verunreinigt	verunreinigt
besäen	besäen
befestigten	befestigten
könne	könne
Flöten	Flöten
Schaffe	Schaffe
Schätze	Schätze
führe	führe
ansehet	ansehet
Weißt	Weißt
anrichtet	anrichtet
gehorchst	gehorchst
zuhörte	zuhörte
nehmet	nehmet
löste	löste
wünschet	wünschet
lieben	lieben
möge	möge
verführen	verführen
verboten	verboten
Gevierte	Gevierte
aller	aller
Reife	Reife
ausgereckter	ausgereckter
heulte	heulte
ungeistlich	ungeistlich
heilige	heilige
teile	teile
loben	loben
gebrauchte	gebrauchte
stille	stille
verkündiget	verkündiget
Reihe	Reihe
Früchten	Früchten
wehrte	wehrte
schlaget	schlaget
legst	legst
Zehe	Zehe
stäupten	stäupten
sitzt	sitzt
laufet	laufet
vergleichen	vergleichen
aufstehst	aufstehst
wende	wende
schau	schau
Gängen	Gängen
zeuget	zeuget
Seht	Seht
harrte	harrte
junge	junge
erlösen	erlösen
herrschest	herrschest
fällte	fällte
empört	empört
beschädigte	beschädigte
Spitze	Spitze
zuschließet	zuschließet
entsündigten	entsündigten
hinausgeht	hinausgeht
schnell	schnell
Hälsen	Hälsen
brenne	brenne
übrigbleiben	übrigbleiben
wundere	wundere
krank	krank
Bande	Bande
ab	ab
Speeren	Speeren
trieb	trieb
Seinen	Seinen
Eins	Eins
lassest	lassest
fehlte	fehlte
Maultieren	Maultieren
tust	tust
zeigte	zeigte
ausgerecktem	ausgerecktem
stürzen	stürzen
versagt	versagt
entsetzten	entsetzten
Herzen	Herzen
Dank	Dank
einsammelst	einsammelst
Fahret	Fahret
Könige	Könige
bekehret	bekehret
Tore	Tore
mal	mal
hause	hause
verkürzest	verkürzest
griffe	griffe
Dann	Dann
zerbrecht	zerbrecht
beweiset	beweiset
Pflanzungen	Pflanzungen
steige	steige
ernten	ernten
Spaltungen	Spaltungen
Merke	Merke
brauchst	brauchst
verklärt	verklärt
vergebt	vergebt
geselle	geselle
zeiget	zeiget
Teilen	Teilen
werten	werten
wachsen	wachsen
ermahnet	ermahnet
beschuldiget	beschuldiget
triebe	triebe
Weihe	Weihe
erwerbe	erwerbe
wollt	wollt
vertrage	vertrage
bestanden	bestanden
Majestäten	Majestäten
Urteil	Urteil
speisest	speisest
stirbst	stirbst
kaufte	kaufte
streuen	streuen
Ochse	Ochse
ausrufest	ausrufest
Führet	Führet
Frieden	Frieden
Zerstreut	Zerstreut
Reiche	Reiche
jungen	jungen
klagen	klagen
fraget	fraget
fressen	fressen
lachet	lachet
Eines	Eines
offenbart	offenbart
wenden	wenden
entsetzen	entsetzen
rufet	rufet
Bleibet	Bleibet
Monden	Monden
wach	wach
wälzet	wälzet
verstopften	verstopften
schämte	schämte
bereits	bereits
lobte	lobte
Monate	Monate
nehmt	nehmt
Fittiche	Fittiche
gern	gern
ritten	ritten
Sollst	Sollst
verlaß	verlaß
brausen	brausen
