Talismanen	Talismanen
Sagen	Sagen
verwirkliche	verwirkliche
schnorrtet	schnorrtet
neigest	neigest
Schläge	Schläge
schenket	schenket
Deckenzapfen	Deckenzapfen
umhüllend	umhüllend
Weiß	Weiß
Anachronismen	Anachronismen
ratschlagen	ratschlagen
Alibis	Alibis
verwaisten	verwaisten
Gefangenen	Gefangenen
suchte	suchte
Tiefschutzen	Tiefschutzen
räumen	räumen
Theistin	Theistin
hebräische	hebräische
Leuchtkäfer	Leuchtkäfer
besicheret	besicheret
Bazzit	Bazzit
punktetest	punktetest
bekehrte	bekehrte
Europium	Europium
Unserer	Unserer
kram	kram
bewiese	bewiese
Nadelbäumen	Nadelbäumen
vertäte	vertäte
Krankenschein	Krankenschein
brecht	brecht
austilge	austilge
Metallspiegeln	Metallspiegeln
überreichen	überreichen
führest	führest
Blattgeweben	Blattgeweben
am	am
Futur	Futur
punkteten	punkteten
Dank	Dank
Substanz	Substanz
Leset	Leset
freiwilligen	freiwilligen
Maximierung	Maximierung
fällst	fällst
Exzentriker	Exzentriker
Einrädern	Einrädern
Radiergummi	Radiergummi
all	all
folg	folg
Pflichten	Pflichten
nahe	nahe
Rumänin	Rumänin
verachtet	verachtet
Türkenbünden	Türkenbünden
Abhänge	Abhänge
reichet	reichet
Durchbruches	Durchbruches
Germanist	Germanist
Stechpalmen	Stechpalmen
Gleitzeit	Gleitzeit
reiftet	reiftet
Stellen	Stellen
Ställe	Ställe
Hüllenelektronen	Hüllenelektronen
leiste	leiste
Herkünften	Herkünften
rüste	rüste
analysiere	analysiere
begehrte	begehrte
Konifere	Konifere
initiierten	initiierten
Rabe	Rabe
Laufringe	Laufringe
Tretlager	Tretlager
Decken	Decken
Abfertigungsschalters	Abfertigungsschalters
Dichten	Dichten
verspätest	verspätest
erzeigest	erzeigest
Zeile	Zeile
initiierst	initiierst
Schreibtischtätern	Schreibtischtätern
haben	haben
parkierten	parkierten
erfahrest	erfahrest
essest	essest
unserem	unserem
Crescendo	Crescendo
Schlange	Schlange
Ring	Ring
Metallothionein	Metallothionein
Gedanken	Gedanken
Zehnt	Zehnt
Name	Name
Farbstoffen	Farbstoffen
legten	legten
Elf	Elf
kühl	kühl
Kriegsknechten	Kriegsknechten
verschränkest	verschränkest
helft	helft
spekuliere	spekuliere
lachen	lachen
sterilisierte	sterilisierte
beschottre	beschottre
steig	steig
Fußmatten	Fußmatten
optimierte	optimierte
Toypudel	Toypudel
Mauten	Mauten
Habt	Habt
scheltet	scheltet
gedolmetscht	gedolmetscht
neigte	neigte
liebten	liebten
Zähnen	Zähnen
lösest	lösest
gestattest	gestattest
einen	einen
emaillieret	emaillieret
anrufen	anrufen
ärgertest	ärgertest
flambiert	flambiert
klemmt	klemmt
diversifiziere	diversifiziere
strafte	strafte
Geburtsnamen	Geburtsnamen
verbaselt	verbaselt
vertrieben	vertrieben
untertreten	untertreten
Knechte	Knechte
Schwärmereien	Schwärmereien
sondern	sondern
erntet	erntet
beanspruchet	beanspruchet
Schwermetallionen	Schwermetallionen
Glaubet	Glaubet
vergiftet	vergiftet
Thioacetalen	Thioacetalen
Ackerschachtelhalme	Ackerschachtelhalme
heiligt	heiligt
knistern	knistern
Lautwandeln	Lautwandeln
Abkürzungsverzeichnisse	Abkürzungsverzeichnisse
Polierstählen	Polierstählen
erbauet	erbauet
bestimmst	bestimmst
betrübst	betrübst
verlöteten	verlöteten
Rasterkraftmikroskop	Rasterkraftmikroskop
anhangt	anhangt
glänzten	glänzten
mißversteht	mißversteht
Mopps	Mopps
besetzest	besetzest
zuppe	zuppe
Außenministerium	Außenministerium
Bestechungsgelder	Bestechungsgelder
steinigte	steinigte
Geckos	Geckos
gewärtigt	gewärtigt
Abgaskatalysatoren	Abgaskatalysatoren
Armen	Armen
liebst	liebst
Besuch	Besuch
verderbet	verderbet
redetet	redetet
erwürgtest	erwürgtest
zagt	zagt
umarbeiten	umarbeiten
mogelten	mogelten
Fusselbärten	Fusselbärten
jaule	jaule
erlauben	erlauben
Indianern	Indianern
Katalanen	Katalanen
illustriertet	illustriertet
entsetzte	entsetzte
schnitten	schnitten
begebe	begebe
Zirkelbeweis	Zirkelbeweis
mogelest	mogelest
Wachet	Wachet
Pinguin	Pinguin
Wärt	Wärt
Rosinenkuchenmodell	Rosinenkuchenmodell
henket	henket
Fettes	Fettes
Aller	Aller
beäugst	beäugst
wischt	wischt
verkündigte	verkündigte
geleite	geleite
Schlägen	Schlägen
Sonderberichte	Sonderberichte
kletteret	kletteret
implodiere	implodiere
Schaffnerinnen	Schaffnerinnen
preise	preise
schlafe	schlafe
behütetest	behütetest
destabilisierst	destabilisierst
begehrtest	begehrtest
erzeigten	erzeigten
wisperten	wisperten
erriet	erriet
Stall	Stall
zersetzet	zersetzet
zerbrichst	zerbrichst
Menschenhandel	Menschenhandel
grüne	grüne
Metallspiegel	Metallspiegel
schwellen	schwellen
Türme	Türme
Judenräte	Judenräte
Augen	Augen
Uteri	Uteri
ach	ach
thematisierten	thematisierten
behalte	behalte
auszögen	auszögen
Kavalier	Kavalier
grausten	grausten
stammelest	stammelest
versteigernd	versteigernd
Hehlern	Hehlern
Gehirnwelle	Gehirnwelle
Wimpertierchen	Wimpertierchen
Californium	Californium
Sprichwörtern	Sprichwörtern
Merkel-Rauten	Merkel-Rauten
Elektrophil	Elektrophil
Kohle	Kohle
Satzung	Satzung
fünften	fünften
Erstlinge	Erstlinge
referenziere	referenziere
verewiget	verewiget
bereiteten	bereiteten
predigten	predigten
Senkungen	Senkungen
möchte	möchte
verwechselet	verwechselet
Schreien	Schreien
verderbest	verderbest
meines	meines
knautsche	knautsche
Heuhaufen	Heuhaufen
Ha	Ha
Reiseleitern	Reiseleitern
vertuest	vertuest
jammern	jammern
Kernspaltungen	Kernspaltungen
negierest	negierest
Rooibos	Rooibos
Blutgefäß	Blutgefäß
halten	halten
elfte	elfte
Amen	Amen
Hubschraubern	Hubschraubern
Firnisse	Firnisse
Reiterschwertern	Reiterschwertern
überdenkend	überdenkend
Seinen	Seinen
Huren	Huren
Feiertagen	Feiertagen
verdammten	verdammten
unsre	unsre
Deck	Deck
Flöte	Flöte
amputiere	amputiere
Einbrecher	Einbrecher
Reichweite	Reichweite
Zäume	Zäume
blamierte	blamierte
malten	malten
Schwan	Schwan
watet	watet
referenzierte	referenzierte
gehören	gehören
plaziert	plaziert
übrigbleibe	übrigbleibe
steckte	steckte
Gegenleistungen	Gegenleistungen
Füßen	Füßen
Verdachtes	Verdachtes
urteilte	urteilte
eiterten	eiterten
lispelt	lispelt
wegführen	wegführen
Rotgusses	Rotgusses
Reisebüros	Reisebüros
Türmen	Türmen
Flaschenhälsen	Flaschenhälsen
deute	deute
concessionieren	concessionieren
Gurten	Gurten
stillest	stillest
erweckst	erweckst
glühenden	glühenden
haust	haust
Bleigehalten	Bleigehalten
Gegebenheiten	Gegebenheiten
Weil	Weil
Ochs	Ochs
besprächen	besprächen
Wühltischen	Wühltischen
Grab	Grab
Puffersystem	Puffersystem
folterte	folterte
Hypochlorite	Hypochlorite
gebührt	gebührt
entwaffneten	entwaffneten
vermahne	vermahne
pflanzen	pflanzen
Kohlrübe	Kohlrübe
verstrahlten	verstrahlten
anderen	anderen
Eiszapfen	Eiszapfen
Stilllegungen	Stilllegungen
hauest	hauest
Kannen	Kannen
Peptid	Peptid
zerschlaget	zerschlaget
Spektralbereich	Spektralbereich
UND-Gattern	UND-Gattern
fabuliert	fabuliert
Krankenscheinen	Krankenscheinen
stellet	stellet
erwachend	erwachend
Ionen	Ionen
bemüht	bemüht
hievst	hievst
bemerken	bemerken
verwahrst	verwahrst
knüpfet	knüpfet
Kryostat	Kryostat
scherzt	scherzt
Signalen	Signalen
Mensch	Mensch
aufstand	aufstand
Substanzen	Substanzen
Älteste	Älteste
Pedanten	Pedanten
wehrend	wehrend
verabschiedeten	verabschiedeten
verstehet	verstehet
deaktivierst	deaktivierst
lieb	lieb
Hirnstämmen	Hirnstämmen
Siglen	Siglen
Tieren	Tieren
beschottert	beschottert
Bromidquelle	Bromidquelle
Heuschrecke	Heuschrecke
Funkfeuer	Funkfeuer
Ringeltaube	Ringeltaube
zerrüttet	zerrüttet
fragte	fragte
führe	führe
Noseanen	Noseanen
Schlöte	Schlöte
Ruße	Ruße
reanimiere	reanimiere
verkürzt	verkürzt
Achsel	Achsel
Bifurkationen	Bifurkationen
Körpergeruch	Körpergeruch
schauspielert	schauspielert
glawbte	glawbte
prangest	prangest
gelobtest	gelobtest
recycele	recycele
verdränge	verdränge
Geldautomaten	Geldautomaten
amenagiere	amenagiere
Messies	Messies
erkannten	erkannten
stäupt	stäupt
fritiert	fritiert
Kreise	Kreise
blitze	blitze
Kannst	Kannst
verpuffe	verpuffe
Saiblinge	Saiblinge
Rhabarbern	Rhabarbern
Temperaturanstiege	Temperaturanstiege
klappen	klappen
wachsen	wachsen
Ambiguitäten	Ambiguitäten
Wadenbeines	Wadenbeines
erliegen	erliegen
rodet	rodet
Benzol	Benzol
mampfen	mampfen
Aachener	Aachener
heiligte	heiligte
segelte	segelte
ausgereckter	ausgereckter
rolltet	rolltet
solches	solches
geratest	geratest
Adhäsionen	Adhäsionen
nächsten	nächsten
nehmt	nehmt
stellst	stellst
Tische	Tische
Innenschau	Innenschau
Beschleuniger	Beschleuniger
erstehen	erstehen
kremierten	kremierten
Pater	Pater
stapelten	stapelten
Zeithorizonten	Zeithorizonten
Hebet	Hebet
hastete	hastete
wallfahrest	wallfahrest
kürzt	kürzt
Schwänze	Schwänze
Massenarbeitslosigkeit	Massenarbeitslosigkeit
Moren	Moren
Zuschauer	Zuschauer
schubset	schubset
restaurierten	restaurierten
mästest	mästest
schlachten	schlachten
beteuerten	beteuerten
Einheimischen	Einheimischen
bessere	bessere
löse	löse
erkennest	erkennest
pflegst	pflegst
Reinstoffen	Reinstoffen
betrieben	betrieben
Selbstversuche	Selbstversuche
dehydrierte	dehydrierte
urteilen	urteilen
Silbergeschirr	Silbergeschirr
Felsboden	Felsboden
verlasse	verlasse
Generation	Generation
suche	suche
Pflaume	Pflaume
schreibst	schreibst
besetzen	besetzen
infizieret	infizieret
Klärungen	Klärungen
Welteninsel	Welteninsel
zeugst	zeugst
reich	reich
frohlockte	frohlockte
Kautschuken	Kautschuken
durchzuck	durchzuck
Märtyrer	Märtyrer
Tübingern	Tübingern
Zubrötchen	Zubrötchen
krähen	krähen
Ebenen	Ebenen
Teufeln	Teufeln
Sprachraum	Sprachraum
rauschte	rauschte
Borhydride	Borhydride
Gaschromatographie	Gaschromatographie
balkanisierten	balkanisierten
zerstreut	zerstreut
Unglauben	Unglauben
Briketten	Briketten
untertretet	untertretet
Erste	Erste
Autokraten	Autokraten
Laien	Laien
Steuerbord	Steuerbord
Ausländern	Ausländern
schleimte	schleimte
hickste	hickste
lockerst	lockerst
Dinge	Dinge
ringelten	ringelten
Extrems	Extrems
Schlaraffenlandes	Schlaraffenlandes
Armband	Armband
bitten	bitten
Chelatkomplex	Chelatkomplex
heischten	heischten
Biene	Biene
Toten	Toten
Schicksen	Schicksen
ferne	ferne
Verwundeten	Verwundeten
Schnittlauch	Schnittlauch
auszöge	auszöge
streue	streue
siehst	siehst
Senkung	Senkung
Fremdwort	Fremdwort
Scheißkerlen	Scheißkerlen
Reststoffen	Reststoffen
solchen	solchen
entsündigt	entsündigt
reifen	reifen
Keile	Keile
Liebchen	Liebchen
stigmatisierest	stigmatisierest
erntete	erntete
Jahr	Jahr
erwärmte	erwärmte
Fallturm	Fallturm
bereitete	bereitete
Ärzten	Ärzten
zelte	zelte
Gäste	Gäste
mögt	mögt
Pentaboraten	Pentaboraten
Patres	Patres
Eine	Eine
Aktienkurs	Aktienkurs
zürn	zürn
Anhang	Anhang
bewiesen	bewiesen
endlagern	endlagern
gelobten	gelobten
Reinigungsschritten	Reinigungsschritten
Fußboden	Fußboden
Tyrannen	Tyrannen
knutschest	knutschest
Glatteis	Glatteis
anrichte	anrichte
danke	danke
Greyerzer	Greyerzer
Dürre	Dürre
immunisiere	immunisiere
Adenosin	Adenosin
Dingen	Dingen
Füllet	Füllet
reinige	reinige
knistert	knistert
Diagnostik	Diagnostik
reimte	reimte
besprengen	besprengen
Fortsetzungen	Fortsetzungen
Kohlenstoffgehalt	Kohlenstoffgehalt
Eins	Eins
torpedieret	torpedieret
Referenz	Referenz
Paillette	Paillette
zirpen	zirpen
mopst	mopst
destabilisierte	destabilisierte
Berber	Berber
Wille	Wille
könnest	könnest
beschuldigt	beschuldigt
Leichen	Leichen
Aase	Aase
baggerte	baggerte
harmoniert	harmoniert
bezichtigten	bezichtigten
peiltest	peiltest
Arbeitsunfähigkeit	Arbeitsunfähigkeit
Chlorats	Chlorats
suchten	suchten
haschiert	haschiert
Wühltische	Wühltische
Drillinge	Drillinge
schlabbere	schlabbere
Jungen	Jungen
führte	führte
Brandbeschleuniger	Brandbeschleuniger
lögen	lögen
kategorisierst	kategorisierst
Altären	Altären
Tintenfisch	Tintenfisch
liebte	liebte
alarmieren	alarmieren
hebet	hebet
Anhängseln	Anhängseln
Beile	Beile
langweiltest	langweiltest
blamierest	blamierest
Gläubige	Gläubige
impfst	impfst
Arme	Arme
Steiget	Steiget
Jagdhund	Jagdhund
glaubst	glaubst
bekennt	bekennt
binden	binden
punktest	punktest
bestraft	bestraft
Landwirt	Landwirt
Wiedergutmachungen	Wiedergutmachungen
Schild	Schild
inneren	inneren
Türkenbund	Türkenbund
gern	gern
Cola	Cola
Auge	Auge
verwerten	verwerten
Organisation	Organisation
Beziehungen	Beziehungen
protokollieren	protokollieren
Schnipseln	Schnipseln
herrschten	herrschten
Autonomien	Autonomien
Lehrbücher	Lehrbücher
Zerfall	Zerfall
Städten	Städten
Ihr	Ihr
Weiblein	Weiblein
Fluorkohlenwasserstoff	Fluorkohlenwasserstoff
reparieret	reparieret
Sigle	Sigle
Zeitbomben	Zeitbomben
Zeilen	Zeilen
Steuerberatern	Steuerberatern
übersiehst	übersiehst
erstände	erstände
verblieben	verblieben
Ei	Ei
Erbsen	Erbsen
bekriegt	bekriegt
verklärt	verklärt
unterbewerte	unterbewerte
begräbt	begräbt
verwirrte	verwirrte
lösten	lösten
unschuldige	unschuldige
Shortcut	Shortcut
versuchet	versuchet
Gefängnisse	Gefängnisse
Überziehens	Überziehens
Tannen	Tannen
frohlocke	frohlocke
erstarrten	erstarrten
Feind	Feind
vereinigte	vereinigte
Gibst	Gibst
glänzen	glänzen
Flammen	Flammen
Dunkelkammern	Dunkelkammern
klumpe	klumpe
deutete	deutete
drosselt	drosselt
Anfänger	Anfänger
schnatternd	schnatternd
Hochzeitstorten	Hochzeitstorten
eingehest	eingehest
schmeicheln	schmeicheln
observierst	observierst
verbrauchet	verbrauchet
Stufen	Stufen
fließt	fließt
schlagest	schlagest
schwöret	schwöret
Kriegsschauplätze	Kriegsschauplätze
widerstand	widerstand
Assistentin	Assistentin
Zahnfleischentzündungen	Zahnfleischentzündungen
linstest	linstest
Brauhaus	Brauhaus
haarte	haarte
Spende	Spende
Buchhalterinnen	Buchhalterinnen
Keiner	Keiner
Maultieren	Maultieren
griffen	griffen
trompete	trompete
fasset	fasset
plagest	plagest
Zementen	Zementen
merkte	merkte
nehmest	nehmest
Sorget	Sorget
Linguistinnen	Linguistinnen
ertraget	ertraget
schaffe	schaffe
exmatrikulierte	exmatrikulierte
läutetet	läutetet
Rauten	Rauten
Oxalaten	Oxalaten
Äthern	Äthern
Kontraindikationen	Kontraindikationen
Tote	Tote
vertraget	vertraget
müsse	müsse
beförderet	beförderet
rekonstruieren	rekonstruieren
entsündigen	entsündigen
besinnen	besinnen
webet	webet
Tintenklecksen	Tintenklecksen
Unwahrheiten	Unwahrheiten
Teppichen	Teppichen
Tut	Tut
Atombomben	Atombomben
Eingeweiden	Eingeweiden
Zitronensäften	Zitronensäften
umgaben	umgaben
Aha-Erlebnis	Aha-Erlebnis
vertrauten	vertrauten
wegführe	wegführe
berufe	berufe
Ränke	Ränke
Milz	Milz
flirtete	flirtete
lüge	lüge
querte	querte
Fusseln	Fusseln
Trockendocks	Trockendocks
säte	säte
Politologen	Politologen
läutet	läutet
blondiert	blondiert
streite	streite
Telefonnummern	Telefonnummern
Managementsystem	Managementsystem
gähne	gähne
Stearat	Stearat
Chasaren	Chasaren
Abschirmungen	Abschirmungen
sabbre	sabbre
Halbgott	Halbgott
Lopariten	Lopariten
Libellen	Libellen
Strafräume	Strafräume
Freunden	Freunden
verstecktet	verstecktet
nähet	nähet
sponsert	sponsert
zeiget	zeiget
idealisierest	idealisierest
babbelten	babbelten
Rundbriefen	Rundbriefen
Stierkämpfen	Stierkämpfen
wärmet	wärmet
ersparet	ersparet
stäupen	stäupen
drängst	drängst
angehören	angehören
Achseln	Achseln
Anhängsel	Anhängsel
karikieret	karikieret
weinte	weinte
Inkarnationen	Inkarnationen
Hanse	Hanse
einführte	einführte
gedächte	gedächte
wünschen	wünschen
interagiert	interagiert
merket	merket
frappiere	frappiere
geselle	geselle
Langschwanzpinguinen	Langschwanzpinguinen
touchiere	touchiere
Störe	Störe
Handbuch	Handbuch
protestiere	protestiere
Aromastoffen	Aromastoffen
verbesserten	verbesserten
Trichtern	Trichtern
Augengläsern	Augengläsern
Pflanzung	Pflanzung
Bette	Bette
Meine	Meine
achten	achten
Meerschweinchen	Meerschweinchen
Werke	Werke
Röcke	Röcke
Genkinit	Genkinit
standet	standet
letzte	letzte
Nussknackern	Nussknackern
parfümierst	parfümierst
häufen	häufen
trübe	trübe
vibriere	vibriere
entwendet	entwendet
Beiblättern	Beiblättern
Polizeisprechern	Polizeisprechern
Kleptokratien	Kleptokratien
ölt	ölt
Schobern	Schobern
Zinkat	Zinkat
hebräischen	hebräischen
Magiern	Magiern
klumpt	klumpt
beschotterten	beschotterten
Drang	Drang
verletzt	verletzt
knusperten	knusperten
Herden	Herden
gabelst	gabelst
Äxten	Äxten
bewässern	bewässern
Dein	Dein
Ölspuren	Ölspuren
trinkst	trinkst
berücksichtigt	berücksichtigt
zerstückt	zerstückt
fresset	fresset
Asiatin	Asiatin
reden	reden
Schreiben	Schreiben
Zehe	Zehe
hantiert	hantiert
vermögen	vermögen
betrübest	betrübest
Solche	Solche
Fusselbart	Fusselbart
zieren	zieren
Stäbe	Stäbe
demütiget	demütiget
betrübe	betrübe
rufen	rufen
Zeugnissen	Zeugnissen
mischst	mischst
Inauguration	Inauguration
Schatten	Schatten
fromme	fromme
transportierte	transportierte
bewahrheitete	bewahrheitete
kramen	kramen
ernte	ernte
setzten	setzten
Automatikgetriebe	Automatikgetriebe
jappte	jappte
betrübtest	betrübtest
stärke	stärke
bürsten	bürsten
drücke	drücke
Operationssälen	Operationssälen
stickten	stickten
Besuchen	Besuchen
Nahrungsbestandteilen	Nahrungsbestandteilen
Minischwein	Minischwein
flitzen	flitzen
durchzuckest	durchzuckest
Schneepflug	Schneepflug
Trinkgefäße	Trinkgefäße
Halbmond	Halbmond
lostest	lostest
WebHooks	WebHooks
plissierten	plissierten
aller	aller
Kutter	Kutter
begrabt	begrabt
plazierest	plazierest
pharyngalisierst	pharyngalisierst
Sprecher	Sprecher
gedachte	gedachte
lange	lange
gewitterte	gewitterte
Fremden	Fremden
listeten	listeten
Panzerschreck	Panzerschreck
aufstanden	aufstanden
greinet	greinet
wurdet	wurdet
Nahrungsbestandteil	Nahrungsbestandteil
verunziere	verunziere
Pfunden	Pfunden
Antitranspirante	Antitranspirante
Atemgasen	Atemgasen
fetten	fetten
fließen	fließen
Leiche	Leiche
flehst	flehst
tut	tut
concessioniert	concessioniert
zuppte	zuppte
salzen	salzen
christianisiere	christianisiere
entkäme	entkäme
Monarchien	Monarchien
verzögerte	verzögerte
behauptete	behauptete
chloroformieret	chloroformieret
verwechseltet	verwechseltet
Diethylether	Diethylether
Kerzenfischen	Kerzenfischen
Hinterwäldlern	Hinterwäldlern
strömte	strömte
zentrifugieren	zentrifugieren
Ingredienzen	Ingredienzen
Sorgen	Sorgen
Herd	Herd
besucht	besucht
erhört	erhört
separieren	separieren
Fingerspitze	Fingerspitze
Erzherzogshüte	Erzherzogshüte
kramten	kramten
Baisers	Baisers
gefällst	gefällst
ausführte	ausführte
keinem	keinem
Gefängnissen	Gefängnissen
demütig	demütig
ansehen	ansehen
Renegaten	Renegaten
tat	tat
überwachten	überwachten
Kontrollboxen	Kontrollboxen
entzogen	entzogen
Fetten	Fetten
schütze	schütze
Heben	Heben
Säuen	Säuen
Besprechungen	Besprechungen
trinkest	trinkest
Jungfernflug	Jungfernflug
erlasset	erlasset
nachwandelte	nachwandelte
fastetet	fastetet
belauerten	belauerten
Pailletten	Pailletten
optimiert	optimiert
Kristalle	Kristalle
Kurkumen	Kurkumen
zupfte	zupfte
rebellieret	rebellieret
Ratet	Ratet
maximiere	maximiere
Euren	Euren
beherrscht	beherrscht
besehet	besehet
Aphasie	Aphasie
schäumt	schäumt
Jünger	Jünger
Trichter	Trichter
schnüren	schnüren
erniedrigt	erniedrigt
hure	hure
quatschen	quatschen
erst	erst
schreckt	schreckt
segmentierten	segmentierten
Teekesseln	Teekesseln
verbaselte	verbaselte
kämpfte	kämpfte
Sternen	Sternen
Steuerwagens	Steuerwagens
produzierten	produzierten
Einrad	Einrad
imitiertet	imitiertet
Planern	Planern
Samen	Samen
Anhänge	Anhänge
einer	einer
Kakao	Kakao
machest	machest
Dorsche	Dorsche
Rückwege	Rückwege
Schiffen	Schiffen
gute	gute
Domäne	Domäne
gereichte	gereichte
wechselte	wechselte
Weißflügelpinguin	Weißflügelpinguin
gedenkst	gedenkst
zeugte	zeugte
Drachen	Drachen
herrschen	herrschen
Retter	Retter
schwelle	schwelle
Willst	Willst
addieren	addieren
lostet	lostet
Oberbegriff	Oberbegriff
Anwendungsgebiet	Anwendungsgebiet
bollerte	bollerte
Gebirgen	Gebirgen
Zeitbombe	Zeitbombe
nähre	nähre
Alkine	Alkine
reanimierten	reanimierten
weise	weise
Spieße	Spieße
fremden	fremden
Vorstoß	Vorstoß
Brieftaubenzüchter	Brieftaubenzüchter
Gedicht	Gedicht
rollten	rollten
jedem	jedem
tatteret	tatteret
gründe	gründe
Taschenwörterbuch	Taschenwörterbuch
nötigte	nötigte
Tasten	Tasten
erratet	erratet
Orten	Orten
lehre	lehre
Anwendungsgebiete	Anwendungsgebiete
verzieh	verzieh
erkundigte	erkundigte
bekannt	bekannt
Blättchen	Blättchen
Dudelsack	Dudelsack
kooperierst	kooperierst
Halleluja	Halleluja
einerntest	einerntest
füllen	füllen
sucht	sucht
spritzt	spritzt
moppte	moppte
liebe	liebe
fotzte	fotzte
vergleichet	vergleichet
Festen	Festen
blitztet	blitztet
formirte	formirte
kürzten	kürzten
Halsabschneider	Halsabschneider
Halle	Halle
Otavit	Otavit
Euphemismus	Euphemismus
redete	redete
erdacht	erdacht
Hallen	Hallen
finanziere	finanziere
flambierten	flambierten
schwimmen	schwimmen
ersparten	ersparten
Ringe	Ringe
pflanzet	pflanzet
verkündigt	verkündigt
Kleinod	Kleinod
Urheimaten	Urheimaten
Würfen	Würfen
ausgehst	ausgehst
entmineralisierst	entmineralisierst
Fett	Fett
kritzelet	kritzelet
puddelst	puddelst
solle	solle
wiederholten	wiederholten
Äther	Äther
Beten	Beten
ritt	ritt
Hörspiel	Hörspiel
erwachte	erwachte
Assistentinnen	Assistentinnen
Katamaran	Katamaran
säet	säet
verunreinigst	verunreinigst
Blaumeise	Blaumeise
hinterzöge	hinterzöge
Leugnungen	Leugnungen
verzieret	verzieret
verjährte	verjährte
bedenken	bedenken
erziehst	erziehst
schätzen	schätzen
Ackerschachtelhalm	Ackerschachtelhalm
Laufen	Laufen
entflieht	entflieht
mache	mache
reglementiert	reglementiert
Gummibaumes	Gummibaumes
Dudelsäcken	Dudelsäcken
Transportweg	Transportweg
trefft	trefft
bleiben	bleiben
beten	beten
saht	saht
eingehet	eingehet
knutschst	knutschst
bewahrt	bewahrt
brillierest	brillierest
Grizzlybär	Grizzlybär
Pfeile	Pfeile
verklagst	verklagst
fresse	fresse
gedachtest	gedachtest
grause	grause
Badezimmer	Badezimmer
entkämen	entkämen
ummantle	ummantle
parliere	parliere
gabelt	gabelt
tränke	tränke
liebet	liebet
ersparen	ersparen
vor	vor
bedürft	bedürft
Seelöwen	Seelöwen
Staatsführungen	Staatsführungen
Chasar	Chasar
überstehst	überstehst
fragen	fragen
nippst	nippst
frikassierend	frikassierend
Galeere	Galeere
gezählt	gezählt
merke	merke
Herbstwinden	Herbstwinden
Petersfischen	Petersfischen
lade	lade
Bande	Bande
Taufe	Taufe
Knöllchens	Knöllchens
schließen	schließen
hintertrieben	hintertrieben
hydrogentartrate	hydrogentartrate
denaturiert	denaturiert
verdunsten	verdunsten
Tore	Tore
säst	säst
Testamenten	Testamenten
bekannte	bekannte
kranken	kranken
Kissenschlacht	Kissenschlacht
ringen	ringen
Hirnstämme	Hirnstämme
grüble	grüble
lang	lang
Eilande	Eilande
seufzt	seufzt
erhörest	erhörest
verhungert	verhungert
löstet	löstet
dritte	dritte
Ansichtskarte	Ansichtskarte
steigerten	steigerten
Provinzen	Provinzen
Futtermittel	Futtermittel
meinet	meinet
Harpunen	Harpunen
Dattel	Dattel
Wachen	Wachen
malochet	malochet
Mikrowellenfilter	Mikrowellenfilter
Fische	Fische
gewinnet	gewinnet
Seelöwe	Seelöwe
Konzentrat	Konzentrat
Gasflasche	Gasflasche
Halter	Halter
Ärztin	Ärztin
ausführe	ausführe
Bildpunkt	Bildpunkt
wollt	wollt
Arsenit	Arsenit
fotzt	fotzt
Anspielungen	Anspielungen
colorierten	colorierten
bang	bang
Pflicht	Pflicht
Herbstwinde	Herbstwinde
Gipfeltreffen	Gipfeltreffen
posiert	posiert
verkleinern	verkleinern
ermutigt	ermutigt
Buntspechten	Buntspechten
Sprödmetall	Sprödmetall
spaltete	spaltete
drillest	drillest
Piratensender	Piratensender
erstürmt	erstürmt
ob	ob
Abfahrtsliste	Abfahrtsliste
annektierst	annektierst
spricht	spricht
zerfetzt	zerfetzt
Schreibern	Schreibern
Händedruck	Händedruck
nächste	nächste
Ösophagospasmen	Ösophagospasmen
fragmentiert	fragmentiert
generiert	generiert
Remis	Remis
schwadronierten	schwadronierten
Lob	Lob
haschieret	haschieret
sterbet	sterbet
verlaßt	verlaßt
Abschiedsbrief	Abschiedsbrief
Brotkästen	Brotkästen
Zain	Zain
massierend	massierend
angehöre	angehöre
assimilierte	assimilierte
misstrauest	misstrauest
liegst	liegst
klemmen	klemmen
Helden	Helden
boß	boß
wachen	wachen
Schanktisch	Schanktisch
dirigiert	dirigiert
liebest	liebest
Stiefvätern	Stiefvätern
Waren	Waren
Gesetzen	Gesetzen
blondierten	blondierten
Eiland	Eiland
Abhängen	Abhängen
watete	watete
Sollst	Sollst
beanspruchte	beanspruchte
Polyphosphat	Polyphosphat
argumentierten	argumentierten
Lammfellhandschuhen	Lammfellhandschuhen
Kaffeelöffel	Kaffeelöffel
nehmet	nehmet
Afrikaner	Afrikaner
Brieföffners	Brieföffners
nippend	nippend
Radsatzes	Radsatzes
Schnarchralle	Schnarchralle
quietschest	quietschest
Ambiguität	Ambiguität
verurteilen	verurteilen
straften	straften
schwächend	schwächend
elften	elften
überweisend	überweisend
Physikerin	Physikerin
Langschwanzpinguin	Langschwanzpinguin
austilgest	austilgest
befehle	befehle
zuppt	zuppt
Letzte	Letzte
er	er
Fluoratomen	Fluoratomen
streifte	streifte
erhörst	erhörst
Werken	Werken
lose	lose
stärkte	stärkte
Abschußring	Abschußring
Tatsachenbeschönigern	Tatsachenbeschönigern
Schlangen	Schlangen
Kälber	Kälber
ihnen	ihnen
präsentiere	präsentiere
Eisenkräutern	Eisenkräutern
unsres	unsres
bestellt	bestellt
Flussbett	Flussbett
Pferde	Pferde
liebtet	liebtet
fällte	fällte
Galeeren	Galeeren
gedenket	gedenket
hegst	hegst
Ältesten	Ältesten
Gesetze	Gesetze
gebündelt	gebündelt
lehrest	lehrest
Dachdecker	Dachdecker
vergrubt	vergrubt
Tiefe	Tiefe
verbleibet	verbleibet
Radfahrer	Radfahrer
sedimentiert	sedimentiert
Preisen	Preisen
setzest	setzest
bewahrest	bewahrest
versuchst	versuchst
Zeitschlitzen	Zeitschlitzen
kaufe	kaufe
binde	binde
Testamente	Testamente
versuchest	versuchest
Lotterien	Lotterien
vergaset	vergaset
alarmiere	alarmiere
Ionenaustauscher	Ionenaustauscher
wehen	wehen
Mobilfunknetzen	Mobilfunknetzen
assimiliertest	assimiliertest
ausgereckt	ausgereckt
Bluffs	Bluffs
restaurieret	restaurieret
Bleiglanz	Bleiglanz
Sitzfleisch	Sitzfleisch
Leide	Leide
werdet	werdet
Montagmittag	Montagmittag
rebelliertet	rebelliertet
gebot	gebot
Gruftis	Gruftis
einem	einem
schlaget	schlaget
aufkommt	aufkommt
entmineralisieret	entmineralisieret
Messiassen	Messiassen
verkriechst	verkriechst
täuschet	täuschet
Banknoten	Banknoten
Wäre	Wäre
verkriechet	verkriechet
Paralipse	Paralipse
Ausbeutern	Ausbeutern
Normdatum	Normdatum
Hornung	Hornung
tage	tage
verseuchen	verseuchen
reagierte	reagierte
könnet	könnet
Nagellackentferner	Nagellackentferner
halltet	halltet
enträtselten	enträtselten
zeichnet	zeichnet
vertrieb	vertrieb
wehe	wehe
Silberdrahts	Silberdrahts
wolle	wolle
eines	eines
Malaysier	Malaysier
kaufte	kaufte
deklarierten	deklarierten
Äste	Äste
Taschenwörterbuches	Taschenwörterbuches
Alkalien	Alkalien
solch	solch
Kakadu	Kakadu
Unternehmung	Unternehmung
zerstreuten	zerstreuten
Thioacetal	Thioacetal
erste	erste
fasse	fasse
Fette	Fette
Unwahrheit	Unwahrheit
kreierten	kreierten
Fellachinnen	Fellachinnen
Ärztinnen	Ärztinnen
verstecken	verstecken
straftet	straftet
tränkten	tränkten
Emmer	Emmer
Geflecktheit	Geflecktheit
Kindergeldern	Kindergeldern
rangieret	rangieret
hättet	hättet
fallest	fallest
bröckelten	bröckelten
fladerten	fladerten
Fellen	Fellen
quietsche	quietsche
Verbindungsdrähten	Verbindungsdrähten
Finanzministerien	Finanzministerien
Hunde	Hunde
sollt	sollt
blast	blast
Stärkungsmittel	Stärkungsmittel
steige	steige
klettert	klettert
besitzet	besitzet
überweiset	überweiset
Macht	Macht
sonderte	sonderte
Verbrechen	Verbrechen
seht	seht
vergibt	vergibt
Höhle	Höhle
Verselbstständigung	Verselbstständigung
dienet	dienet
ratschlagt	ratschlagt
Nullpunktes	Nullpunktes
Lehrkörpern	Lehrkörpern
aufstehet	aufstehet
Samarskit	Samarskit
hadertet	hadertet
missversteht	missversteht
panaschieret	panaschieret
verblutete	verblutete
Mikrometern	Mikrometern
querest	querest
verdammen	verdammen
verantwortetest	verantwortetest
stirbst	stirbst
fritierten	fritierten
Spiralen	Spiralen
plissieren	plissieren
kriegte	kriegte
wachet	wachet
Bleigehalt	Bleigehalt
aufrichte	aufrichte
verstört	verstört
Verbindungsdraht	Verbindungsdraht
Ding	Ding
evakuierte	evakuierte
Vergrößerungen	Vergrößerungen
Literaturen	Literaturen
Warte	Warte
Döner	Döner
dunkelt	dunkelt
gestikuliere	gestikuliere
zählet	zählet
Halbzeit	Halbzeit
kehret	kehret
mangelte	mangelte
leide	leide
desensibilisierten	desensibilisierten
kickend	kickend
tendierst	tendierst
appellierst	appellierst
betrüben	betrüben
Bedenken	Bedenken
Volkslehren	Volkslehren
attackieren	attackieren
Brettspielen	Brettspielen
verhungerte	verhungerte
Vordenker	Vordenker
allen	allen
Laken	Laken
aufwachte	aufwachte
Ellen	Ellen
Hirschen	Hirschen
Galopps	Galopps
Bauwerke	Bauwerke
Gewinnungen	Gewinnungen
Kernladungszahl	Kernladungszahl
absolviertet	absolviertet
Ecke	Ecke
konnotierst	konnotierst
mehrte	mehrte
Fetzen	Fetzen
Trioxid	Trioxid
Nehmt	Nehmt
vertrage	vertrage
raubte	raubte
hingehet	hingehet
verfolgst	verfolgst
verschreibt	verschreibt
Fadenlauf	Fadenlauf
Reizt	Reizt
Arbeitsbereich	Arbeitsbereich
Entmachtungen	Entmachtungen
Elementarzelle	Elementarzelle
surre	surre
fegte	fegte
Selbstsicherheit	Selbstsicherheit
abtrünnige	abtrünnige
Effekt	Effekt
schwadroniert	schwadroniert
süsst	süsst
Acht	Acht
arbeiten	arbeiten
Festons	Festons
emendieret	emendieret
Büsche	Büsche
Kassettenrekorder	Kassettenrekorder
Vogelscheuchen	Vogelscheuchen
wehrte	wehrte
begehrt	begehrt
speisen	speisen
besprenget	besprenget
googelest	googelest
kabbelnd	kabbelnd
kurz	kurz
Gefilde	Gefilde
harmonierte	harmonierte
brillieret	brillieret
verunzierte	verunzierte
sündigt	sündigt
siegte	siegte
Verkehrsflugzeug	Verkehrsflugzeug
moppen	moppen
beeinflusste	beeinflusste
Kanzlei	Kanzlei
zerstücken	zerstücken
Trockendock	Trockendock
Fluoratome	Fluoratome
glaubest	glaubest
Minimierungen	Minimierungen
Lehnen	Lehnen
Fluorgehalt	Fluorgehalt
Wände	Wände
verfinstert	verfinstert
Genie	Genie
Tukanen	Tukanen
hüpfest	hüpfest
Götzen	Götzen
bewässerest	bewässerest
Verwaltungsakte	Verwaltungsakte
Kompassen	Kompassen
betrübt	betrübt
genieret	genieret
Besteck	Besteck
übte	übte
gönnest	gönnest
Hochsommern	Hochsommern
Bertrandit	Bertrandit
lanciertet	lanciertet
eggte	eggte
Negermusik	Negermusik
verifizierten	verifizierten
Toypudeln	Toypudeln
wachte	wachte
beeindrucket	beeindrucket
Locken	Locken
Schneepflüge	Schneepflüge
besorgten	besorgten
Schlägst	Schlägst
globalisieret	globalisieret
Feinde	Feinde
Säcke	Säcke
planschtest	planschtest
Holzquirl	Holzquirl
hüten	hüten
lodert	lodert
Tausch	Tausch
Knaben	Knaben
sehest	sehest
schaffst	schaffst
Weste	Weste
wach	wach
generalisiere	generalisiere
Buchhalterin	Buchhalterin
besuche	besuche
jauchzte	jauchzte
Ablösung	Ablösung
Hallelujas	Hallelujas
vermöge	vermöge
Fischer	Fischer
gleitest	gleitest
bedeckst	bedeckst
besänftigtest	besänftigtest
repräsentierten	repräsentierten
Halsabschneidern	Halsabschneidern
lösend	lösend
mein	mein
Gigapascal	Gigapascal
Bromidquellen	Bromidquellen
Wehr	Wehr
mikrominiaturisierten	mikrominiaturisierten
Plüschtiere	Plüschtiere
kappten	kappten
übet	übet
Berichterstattungen	Berichterstattungen
predig	predig
formirend	formirend
wässerten	wässerten
More	More
Datentypen	Datentypen
Kost	Kost
Halogenatom	Halogenatom
merken	merken
Töpfen	Töpfen
stapele	stapele
junge	junge
Dezernaten	Dezernaten
bandagierte	bandagierte
verseucht	verseucht
verlautete	verlautete
Palisade	Palisade
demütigte	demütigte
forschen	forschen
anzeigt	anzeigt
verallgemeinerest	verallgemeinerest
zerrisset	zerrisset
Lärche	Lärche
rekonstruieret	rekonstruieret
verselbstständigest	verselbstständigest
Kopfsalat	Kopfsalat
Spektralbereichen	Spektralbereichen
überweis	überweis
dingten	dingten
vandalieren	vandalieren
Omnibus	Omnibus
Knabe	Knabe
lüftetet	lüftetet
gründen	gründen
Leisten	Leisten
manövrierte	manövrierte
Hirte	Hirte
Proton	Proton
schälte	schälte
Schönrednern	Schönrednern
Gewichten	Gewichten
löstest	löstest
zentriert	zentriert
pressierten	pressierten
Bote	Bote
Zeug	Zeug
Kohlen	Kohlen
Löwen	Löwen
erlösest	erlösest
Kalifeldspat	Kalifeldspat
murmeln	murmeln
Flenser	Flenser
reicht	reicht
sahet	sahet
unehrt	unehrt
Acetaten	Acetaten
zerbrechen	zerbrechen
Werkzeuge	Werkzeuge
parametrisierte	parametrisierte
Wirte	Wirte
verschicket	verschicket
Talisman	Talisman
dehydrierten	dehydrierten
Großstädter	Großstädter
analysierest	analysierest
Epidemien	Epidemien
Wolfesgrube	Wolfesgrube
armen	armen
unterwerfest	unterwerfest
Puffersystemen	Puffersystemen
heile	heile
lauten	lauten
Buntwaschmittel	Buntwaschmittel
erstürmet	erstürmet
Tiefschutz	Tiefschutz
oben	oben
besät	besät
Wer	Wer
Schale	Schale
kauten	kauten
Teufel	Teufel
ortete	ortete
Bauwerken	Bauwerken
motivierte	motivierte
zähltet	zähltet
besser	besser
Rechtsruck	Rechtsruck
Strahlentierchens	Strahlentierchens
besichtigt	besichtigt
besorgest	besorgest
Suchet	Suchet
neiden	neiden
Weh	Weh
fistete	fistete
eggten	eggten
Atemgas	Atemgas
frappierte	frappierte
Zitronensaft	Zitronensaft
designiertet	designiertet
Einsätzen	Einsätzen
Ångström	Ångström
leiten	leiten
verschmelzen	verschmelzen
karikierten	karikierten
versuchte	versuchte
feierst	feierst
springst	springst
gewärtigten	gewärtigten
assimilierten	assimilierten
Minimierung	Minimierung
Gicht	Gicht
exmatrikuliertet	exmatrikuliertet
würde	würde
grüßest	grüßest
trüb	trüb
zweifelte	zweifelte
Kacke	Kacke
ungehorsam	ungehorsam
Leitkegel	Leitkegel
Präservativs	Präservativs
spracht	spracht
Stolz	Stolz
zerrütteten	zerrütteten
Ringen	Ringen
Rutheniumkomplex	Rutheniumkomplex
erobern	erobern
Thioester	Thioester
Orte	Orte
planschest	planschest
öle	öle
Abschiedsbriefe	Abschiedsbriefe
Banketten	Banketten
batet	batet
fahret	fahret
Qualifikationen	Qualifikationen
Höhe	Höhe
Fahlflanken-Ameisenwürger	Fahlflanken-Ameisenwürger
gelegt	gelegt
Streich	Streich
hätte	hätte
schluchze	schluchze
sprachen	sprachen
scheitertet	scheitertet
begehrten	begehrten
Wir	Wir
Anmeldern	Anmeldern
entgehst	entgehst
schlaf	schlaf
Stärke	Stärke
zählten	zählten
seinen	seinen
entschädigte	entschädigte
mehret	mehret
Tanne	Tanne
plumpse	plumpse
Busen	Busen
bist	bist
Welche	Welche
verkürztet	verkürztet
massakrierte	massakrierte
erstarre	erstarre
gelangen	gelangen
Werden	Werden
Tyrann	Tyrann
wahre	wahre
falteten	falteten
Rehe	Rehe
blitz	blitz
Marjellchen	Marjellchen
Füchsin	Füchsin
Paragraphenreiter	Paragraphenreiter
Frommen	Frommen
dich	dich
beschlügen	beschlügen
Kettenraucher	Kettenraucher
Geringschätzung	Geringschätzung
kehren	kehren
schießt	schießt
Polizeisprecher	Polizeisprecher
Telefonnummer	Telefonnummer
verkauften	verkauften
anhanget	anhanget
streckte	streckte
solche	solche
Brikette	Brikette
kickst	kickst
transportierst	transportierst
möchten	möchten
regierte	regierte
hoben	hoben
Solcher	Solcher
Küchenmaschine	Küchenmaschine
Hahnenkämmen	Hahnenkämmen
Höschens	Höschens
Tiere	Tiere
parametrisierst	parametrisierst
Butzemänner	Butzemänner
umarmet	umarmet
Brüdern	Brüdern
Vanadaten	Vanadaten
Karern	Karern
Hertz	Hertz
verzeigt	verzeigt
Zwetschgen	Zwetschgen
Technetaten	Technetaten
auflegst	auflegst
vertonten	vertonten
ehrest	ehrest
Gewürze	Gewürze
strömt	strömt
Zunge	Zunge
Wiederbelebung	Wiederbelebung
Arbeitsleistung	Arbeitsleistung
liebt	liebt
verdinglichest	verdinglichest
Neuigkeit	Neuigkeit
wiederkamt	wiederkamt
kristallisierest	kristallisierest
Tumulten	Tumulten
beiden	beiden
Playlist	Playlist
soll	soll
Haltepunkten	Haltepunkten
erwärmst	erwärmst
nötige	nötige
Efeu	Efeu
veranstaltest	veranstaltest
Auguren	Auguren
sterbest	sterbest
allem	allem
ermächtigest	ermächtigest
heparinisierten	heparinisierten
entfachten	entfachten
Trübsalen	Trübsalen
Schickse	Schickse
sprecht	sprecht
lohnten	lohnten
umarbeitest	umarbeitest
Frage	Frage
lösen	lösen
Ersten	Ersten
Schaden	Schaden
Isolatoren	Isolatoren
Unterschlagung	Unterschlagung
urbanisiert	urbanisiert
Gebeten	Gebeten
wurden	wurden
möge	möge
stolz	stolz
strecken	strecken
Gespenstern	Gespenstern
verbündet	verbündet
segeln	segeln
Schuldner	Schuldner
Würfelspiel	Würfelspiel
begründest	begründest
decke	decke
vertagest	vertagest
fluppen	fluppen
Denkmünze	Denkmünze
speisend	speisend
erlabet	erlabet
pflücktet	pflücktet
prangte	prangte
dotiere	dotiere
Steuerborden	Steuerborden
vernehmen	vernehmen
repräsentieret	repräsentieret
Schlössern	Schlössern
Schulleiterin	Schulleiterin
befürchtet	befürchtet
regierest	regierest
verwahrt	verwahrt
Suchanfragen	Suchanfragen
Tust	Tust
verzehrst	verzehrst
Mönche	Mönche
stirbt	stirbt
protokollierst	protokollierst
Fetzens	Fetzens
Gigapascaln	Gigapascaln
Tritt	Tritt
Chemikerinnen	Chemikerinnen
Flosse	Flosse
Teile	Teile
verschärfst	verschärfst
Beine	Beine
respektierten	respektierten
Herabsetzungen	Herabsetzungen
gehorchet	gehorchet
glaubten	glaubten
Waldbränden	Waldbränden
Forschung	Forschung
Wespen	Wespen
speiest	speiest
geniertest	geniertest
empörte	empörte
Denunziationen	Denunziationen
Türklingel	Türklingel
dürfe	dürfe
entkörperlichten	entkörperlichten
Knechten	Knechten
ab	ab
stand	stand
warntest	warntest
Fettsäcken	Fettsäcken
Elfen	Elfen
Einsatz	Einsatz
Nanotesla	Nanotesla
tanzen	tanzen
müssest	müssest
schauend	schauend
sündigten	sündigten
balkanisierte	balkanisierte
Argyroditen	Argyroditen
tabuisierten	tabuisierten
gestikulierst	gestikulierst
betätigest	betätigest
lobe	lobe
Indianer	Indianer
übrigbleiben	übrigbleiben
Eingaben	Eingaben
lochten	lochten
Autonomie	Autonomie
verunreinigt	verunreinigt
Physikerinnen	Physikerinnen
narren	narren
Stadtbezirken	Stadtbezirken
reformieren	reformieren
verständig	verständig
charakterisiert	charakterisiert
Fittichen	Fittichen
zensiere	zensiere
verlassen	verlassen
verpufftest	verpufftest
Provinz	Provinz
pfände	pfände
einigte	einigte
gestatte	gestatte
besorg	besorg
evakuieret	evakuieret
interpretiert	interpretiert
Nanokondensatoren	Nanokondensatoren
zappten	zappten
lauschte	lauschte
Wucher	Wucher
entzögen	entzögen
WebHook	WebHook
halte	halte
Schlot	Schlot
scheue	scheue
verletzte	verletzte
verzeichne	verzeichne
härtet	härtet
Kriegsenden	Kriegsenden
erliegst	erliegst
Städte	Städte
Kunstgeschichte	Kunstgeschichte
Kompass	Kompass
Arsenite	Arsenite
verwertete	verwertete
Aussätzigen	Aussätzigen
piesacken	piesacken
blaset	blaset
Zwergschwanes	Zwergschwanes
erbest	erbest
All	All
ältesten	ältesten
anrichtet	anrichtet
zuhört	zuhört
Brechnüssen	Brechnüssen
anders	anders
verfängt	verfängt
kommest	kommest
zerbräche	zerbräche
keine	keine
Metallothioneinen	Metallothioneinen
Stiefvater	Stiefvater
schämet	schämet
Volltreffer	Volltreffer
malträtierte	malträtierte
deinen	deinen
Theologien	Theologien
Spirale	Spirale
Bajonette	Bajonette
Asylrechten	Asylrechten
Staatsanleihe	Staatsanleihe
höhnest	höhnest
Betainen	Betainen
zürnet	zürnet
greifen	greifen
brenne	brenne
vermeßest	vermeßest
überfallen	überfallen
Arsch	Arsch
zanket	zanket
Adamsapfel	Adamsapfel
Rückumlauten	Rückumlauten
verspäteten	verspäteten
prostituieret	prostituieret
Fallet	Fallet
ziert	ziert
massierst	massierst
Vogelscheuche	Vogelscheuche
Alten	Alten
Primatologen	Primatologen
Fremdwörter	Fremdwörter
inspirierten	inspirierten
hinterfragten	hinterfragten
Massenanteilen	Massenanteilen
möpperst	möpperst
gelobst	gelobst
Lärchen	Lärchen
hetzte	hetzte
tiefe	tiefe
Martyrologium	Martyrologium
bemühet	bemühet
jungen	jungen
geraten	geraten
Nussknacker	Nussknacker
hurst	hurst
ehre	ehre
addierte	addierte
warnet	warnet
Berufen	Berufen
Pferden	Pferden
aufhebest	aufhebest
frevler	frevler
Male	Male
aufsteht	aufsteht
Playlists	Playlists
wacht	wacht
Fettsack	Fettsack
Massage	Massage
Konfitüre	Konfitüre
gähnten	gähnten
verdamme	verdamme
Nukleinsäuren	Nukleinsäuren
Otaviten	Otaviten
billigen	billigen
stimmet	stimmet
Donor	Donor
fingieret	fingieret
Mähnenwolfes	Mähnenwolfes
Angaben	Angaben
Melanteriten	Melanteriten
Neumonden	Neumonden
Zipfelmützen	Zipfelmützen
hilfst	hilfst
verglühest	verglühest
Wehret	Wehret
verifizieret	verifizieret
begrub	begrub
Agoraphobie	Agoraphobie
dankte	dankte
Silbererze	Silbererze
Kardinal	Kardinal
verfanget	verfanget
Seetauchers	Seetauchers
leertet	leertet
Bär	Bär
Laubbläsern	Laubbläsern
verschlimmerte	verschlimmerte
Rechten	Rechten
bejubelte	bejubelte
Dieben	Dieben
Abflug	Abflug
Beinen	Beinen
Fülle	Fülle
zerbricht	zerbricht
spezialisiere	spezialisiere
grienest	grienest
Decks	Decks
Meinst	Meinst
unseres	unseres
fluchte	fluchte
schickte	schickte
Taschendieb	Taschendieb
Agoraphobien	Agoraphobien
brauchst	brauchst
verlieren	verlieren
fraget	fraget
Entmachtung	Entmachtung
tappst	tappst
Kanzlerinnen	Kanzlerinnen
beleuchteten	beleuchteten
reizen	reizen
Aggressor	Aggressor
Signal	Signal
klage	klage
Geflecktheiten	Geflecktheiten
Apfelbäume	Apfelbäume
Aderhäuten	Aderhäuten
erkannte	erkannte
strandend	strandend
verkleidete	verkleidete
Entsetzet	Entsetzet
stutzt	stutzt
Pardelkatze	Pardelkatze
verstecke	verstecke
steckst	steckst
Buchfinken	Buchfinken
verjährest	verjährest
trägt	trägt
Klüften	Klüften
grüßt	grüßt
Briefköpfen	Briefköpfen
Kommet	Kommet
Meeren	Meeren
durchwachen	durchwachen
Fiasko	Fiasko
Kirgisinnen	Kirgisinnen
Weihe	Weihe
zentrifugierst	zentrifugierst
Früchten	Früchten
motivieren	motivieren
Setzt	Setzt
Rechnungen	Rechnungen
Premieren	Premieren
Lümmeltüten	Lümmeltüten
deinem	deinem
aasend	aasend
Pfründe	Pfründe
parlieren	parlieren
verbasele	verbasele
gesellt	gesellt
Geigerzähler	Geigerzähler
Brechnuss	Brechnuss
neige	neige
Stufe	Stufe
schmuggelte	schmuggelte
Sterne	Sterne
Teilnehmerin	Teilnehmerin
erbte	erbte
kehrte	kehrte
Briten	Briten
interagierte	interagierte
erklinge	erklinge
Myriade	Myriade
Bete	Bete
Eingeweide	Eingeweide
faschierst	faschierst
triebe	triebe
kommet	kommet
Dans	Dans
Raten	Raten
strafest	strafest
fallet	fallet
Übelkeit	Übelkeit
Perle	Perle
bitte	bitte
Däumlingen	Däumlingen
Gleitzeiten	Gleitzeiten
Fußballweltmeisterschaftsqualifikationsspielen	Fußballweltmeisterschaftsqualifikationsspielen
Höhlen	Höhlen
holst	holst
verdammst	verdammst
Bächen	Bächen
Haltepunkt	Haltepunkt
grünend	grünend
strecke	strecke
Hackern	Hackern
führen	führen
begnadigte	begnadigte
hörest	hörest
predigt	predigt
Abszisse	Abszisse
Sagte	Sagte
erbaust	erbaust
ermahnt	ermahnt
Königreiche	Königreiche
hieltet	hieltet
Abbindebeschleunigern	Abbindebeschleunigern
häufte	häufte
Fällt	Fällt
geboten	geboten
Weile	Weile
Karikaturistinnen	Karikaturistinnen
Abtrünnige	Abtrünnige
grübelten	grübelten
Adventskalender	Adventskalender
Monarchie	Monarchie
durchläutert	durchläutert
konstatiertest	konstatiertest
Rückweg	Rückweg
versucht	versucht
lebte	lebte
begehre	begehre
amen	amen
Zeugen	Zeugen
bricht	bricht
Sabbate	Sabbate
Philerast	Philerast
ruhe	ruhe
schauen	schauen
dirigieret	dirigieret
Kürasse	Kürasse
greifet	greifet
Carbiden	Carbiden
Langeweile	Langeweile
euren	euren
Basiliken	Basiliken
verseift	verseift
Galoppen	Galoppen
schneidend	schneidend
Silbersulfidbelag	Silbersulfidbelag
diskutierst	diskutierst
Telefonverkäufer	Telefonverkäufer
Buche	Buche
malochte	malochte
faschieren	faschieren
besichtiget	besichtiget
Paragraphenreitern	Paragraphenreitern
verstehst	verstehst
Trübsale	Trübsale
koexistierte	koexistierte
langte	langte
sedimentieret	sedimentieret
reizte	reizte
Bagger	Bagger
changieren	changieren
Silberdrähten	Silberdrähten
schämte	schämte
interpretierten	interpretierten
Totgeburten	Totgeburten
Sprichwort	Sprichwort
Suffixen	Suffixen
Laib	Laib
Autoklaven	Autoklaven
Anfängern	Anfängern
durften	durften
weh	weh
klöne	klöne
beanspruchest	beanspruchest
Krokus	Krokus
Gerichte	Gerichte
Eiszapfens	Eiszapfens
rühmte	rühmte
Gehirnwellen	Gehirnwellen
tobet	tobet
wünschst	wünschst
gelobte	gelobte
beseht	beseht
Buch	Buch
wehr	wehr
lavierte	lavierte
manchen	manchen
billige	billige
Grießen	Grießen
illustriere	illustriere
Bademantel	Bademantel
teile	teile
verzweigst	verzweigst
Last	Last
Brettspiele	Brettspiele
Pumpellyiten	Pumpellyiten
hebst	hebst
gelobtet	gelobtet
erhöhet	erhöhet
Kairiner	Kairiner
Heiratsgütern	Heiratsgütern
betreibet	betreibet
Anzeichens	Anzeichens
Kein	Kein
diskutiere	diskutiere
Fehlen	Fehlen
bequemen	bequemen
innere	innere
Pfählen	Pfählen
Pinguinen	Pinguinen
weichst	weichst
Anfechtung	Anfechtung
Gepäckträgern	Gepäckträgern
ziehet	ziehet
hintertriebe	hintertriebe
mikrominiaturisiere	mikrominiaturisiere
überquerst	überquerst
labe	labe
türmen	türmen
Füllen	Füllen
Halbzeiten	Halbzeiten
Nanoteslan	Nanoteslan
Citrat	Citrat
meißeltest	meißeltest
Darlehen	Darlehen
entsündigten	entsündigten
verwirrt	verwirrt
lancierst	lancierst
Zäumen	Zäumen
dingte	dingte
versteigerest	versteigerest
vertraute	vertraute
Möbelstoff	Möbelstoff
Schilde	Schilde
verklärest	verklärest
Aufsätze	Aufsätze
eng	eng
sortierte	sortierte
anfinge	anfinge
beider	beider
schenke	schenke
Bildpunkten	Bildpunkten
türmt	türmt
ihren	ihren
Rufet	Rufet
überdenkest	überdenkest
Abschreckungen	Abschreckungen
markiere	markiere
Gedächtnisse	Gedächtnisse
ihrem	ihrem
Deuteriums	Deuteriums
Eutektikum	Eutektikum
Dezernat	Dezernat
pensionierest	pensionierest
befestigten	befestigten
sezierte	sezierte
verachtend	verachtend
Stühlen	Stühlen
Bube	Bube
Altäre	Altäre
Grenzen	Grenzen
Sanatoriums	Sanatoriums
beziehen	beziehen
zeugt	zeugt
Industrienation	Industrienation
trinken	trinken
vermahnte	vermahnte
Gallanen	Gallanen
überfischt	überfischt
Tübinger	Tübinger
assimilieret	assimilieret
Wehklage	Wehklage
Einem	Einem
Version	Version
erforscht	erforscht
wachse	wachse
Weichseln	Weichseln
Sitz	Sitz
fällt	fällt
heißt	heißt
Westen	Westen
gepuddelt	gepuddelt
Dann	Dann
Gebot	Gebot
plärrtest	plärrtest
grabble	grabble
Sinnen	Sinnen
verspielte	verspielte
folgen	folgen
offenbar	offenbar
Blässe	Blässe
Maßen	Maßen
harmoniere	harmoniere
demütigst	demütigst
Sphäre	Sphäre
Strohhälmchen	Strohhälmchen
beleidige	beleidige
dümpelt	dümpelt
Prügelstrafen	Prügelstrafen
sponseret	sponseret
unsere	unsere
wallfahrten	wallfahrten
Hure	Hure
Männlein	Männlein
kühle	kühle
außen	außen
wünscht	wünscht
Essigsäurechlorid	Essigsäurechlorid
Argentit	Argentit
beschwöre	beschwöre
gewurstelt	gewurstelt
Mutagen	Mutagen
wer	wer
bestellte	bestellte
murmelte	murmelte
Kehret	Kehret
bräunen	bräunen
Träumer	Träumer
bestand	bestand
Meinen	Meinen
reinstitutionalisierten	reinstitutionalisierten
gebieten	gebieten
Handbüchern	Handbüchern
labert	labert
warte	warte
sündiget	sündiget
verantwortet	verantwortet
freute	freute
Kornnattern	Kornnattern
malträtiert	malträtiert
sedimentierte	sedimentierte
Trägergas	Trägergas
Höfen	Höfen
rodete	rodete
offenbartest	offenbartest
Artischocken	Artischocken
Kakaos	Kakaos
Flussbetten	Flussbetten
Hirten	Hirten
finanziert	finanziert
Gepäckträger	Gepäckträger
abweichet	abweichet
pflanzest	pflanzest
Abfertigungsgebäuden	Abfertigungsgebäuden
Denn	Denn
stellte	stellte
bummeltet	bummeltet
verkehrte	verkehrte
beschert	beschert
Uranerz	Uranerz
ärgerst	ärgerst
Glauben	Glauben
funkeln	funkeln
brausen	brausen
Cyanat	Cyanat
Fellachin	Fellachin
werft	werft
Trägergasen	Trägergasen
hadere	hadere
Entsetzen	Entsetzen
koordinieret	koordinieret
verhörest	verhörest
Streife	Streife
verbluteten	verbluteten
eingehst	eingehst
Excimerlaser	Excimerlaser
betonierte	betonierte
Eselsohren	Eselsohren
rote	rote
belohnte	belohnte
partitionierten	partitionierten
andere	andere
pharyngalisierten	pharyngalisierten
Montagmittagen	Montagmittagen
Notizen	Notizen
beäugen	beäugen
Linguisten	Linguisten
gelangt	gelangt
kategorisierte	kategorisierte
laufe	laufe
losest	losest
Vergeltungen	Vergeltungen
willst	willst
welche	welche
beschlaget	beschlaget
Coventrisierung	Coventrisierung
Falzen	Falzen
laben	laben
Reliquiare	Reliquiare
Dachdeckerinnen	Dachdeckerinnen
sannen	sannen
Regent	Regent
konntest	konntest
extemporieret	extemporieret
Schauet	Schauet
lest	lest
Flitzer	Flitzer
schmiert	schmiert
Haben	Haben
imprägniere	imprägniere
Baiser	Baiser
stimmen	stimmen
leihe	leihe
Kindergeld	Kindergeld
bejubelst	bejubelst
Euter	Euter
haare	haare
Felle	Felle
Theistinnen	Theistinnen
belüftet	belüftet
schau	schau
spannen	spannen
fabulierest	fabulierest
liegen	liegen
Schober	Schober
Bist	Bist
Erstlingen	Erstlingen
hicksest	hicksest
Ausgangssperren	Ausgangssperren
Elle	Elle
piesackest	piesackest
radiertest	radiertest
Trioxiden	Trioxiden
Fotosynthese	Fotosynthese
seufzest	seufzest
könnten	könnten
Zwangsarbeiterin	Zwangsarbeiterin
replizieret	replizieret
schmeichelest	schmeichelest
bombardiert	bombardiert
war	war
glänzt	glänzt
verlaß	verlaß
hänge	hänge
Dewargefäß	Dewargefäß
Überfamilie	Überfamilie
Kurkuma	Kurkuma
schlachtet	schlachtet
Fussel	Fussel
gelobe	gelobe
Schneepflügen	Schneepflügen
Taschendiebe	Taschendiebe
Ausnahme	Ausnahme
heftete	heftete
Asylrechte	Asylrechte
bleibst	bleibst
Monate	Monate
füllte	füllte
Götze	Götze
entsündigte	entsündigte
legte	legte
jeder	jeder
Weinbergen	Weinbergen
weg	weg
entheiligten	entheiligten
läuten	läuten
Feuerteufel	Feuerteufel
stillte	stillte
Wüsten	Wüsten
vollendete	vollendete
Gasflaschen	Gasflaschen
Welteninseln	Welteninseln
verführten	verführten
machte	machte
nimmst	nimmst
hebe	hebe
Rutheniumisotopen	Rutheniumisotopen
schon	schon
ringst	ringst
legend	legend
verteidigte	verteidigte
Muster	Muster
sündigte	sündigte
Backpflaumen	Backpflaumen
ein	ein
Raben	Raben
Hurriter	Hurriter
Pfeilen	Pfeilen
bestimmten	bestimmten
baust	baust
Drache	Drache
brach	brach
Fiebermittel	Fiebermittel
Katamarane	Katamarane
Buchfink	Buchfink
lackiere	lackiere
Karer	Karer
Gemüseläden	Gemüseläden
ernten	ernten
Begünstigung	Begünstigung
Feste	Feste
klappst	klappst
obfuskierten	obfuskierten
Wert	Wert
kühlen	kühlen
reichst	reichst
setzen	setzen
Mischelement	Mischelement
begnadigst	begnadigst
gefällt	gefällt
bewahrheitetet	bewahrheitetet
Tatsachenbeschöniger	Tatsachenbeschöniger
ritze	ritze
pulsiere	pulsiere
reizet	reizet
Komplexionen	Komplexionen
Domänen	Domänen
Genkinits	Genkinits
Meter	Meter
wurdest	wurdest
Arsenolithen	Arsenolithen
streutet	streutet
Klappertopf	Klappertopf
fluppt	fluppt
Korrosionsschutz	Korrosionsschutz
schnell	schnell
vergast	vergast
steiget	steiget
Edelsteine	Edelsteine
verdammte	verdammte
drescht	drescht
Lüsten	Lüsten
setzt	setzt
Propheten	Propheten
Beobachtung	Beobachtung
säumet	säumet
wärme	wärme
erschrickt	erschrickt
wäre	wäre
gewährtest	gewährtest
fluppst	fluppst
Feiertage	Feiertage
gewarnt	gewarnt
schreist	schreist
lös	lös
Füllfederhalter	Füllfederhalter
seist	seist
Körpergeruches	Körpergeruches
zweifeln	zweifeln
gewähret	gewähret
pressiert	pressiert
verkündigten	verkündigten
verunglimpfen	verunglimpfen
strafet	strafet
Würze	Würze
vermischten	vermischten
lohnt	lohnt
Sündern	Sündern
Enthärtungen	Enthärtungen
Adlerbussard	Adlerbussard
gehörst	gehörst
Treibhausgase	Treibhausgase
Beryll	Beryll
Knüppels	Knüppels
Grüße	Grüße
Extremen	Extremen
funzen	funzen
wünschest	wünschest
messet	messet
beklage	beklage
setztest	setztest
Ypecaharalle	Ypecaharalle
Weinstöcke	Weinstöcke
entdeckst	entdeckst
Feuerteufels	Feuerteufels
schwenkt	schwenkt
frohlockest	frohlockest
Kirgisin	Kirgisin
Backenbärten	Backenbärten
umbrächte	umbrächte
Apotheose	Apotheose
beliefen	beliefen
Held	Held
grüßen	grüßen
pflanzt	pflanzt
Hunden	Hunden
Coventrisierungen	Coventrisierungen
Wahnen	Wahnen
schwebe	schwebe
zerstreuest	zerstreuest
trieb	trieb
vertilge	vertilge
Kompromissen	Kompromissen
Wunde	Wunde
Arbeitsgruppen	Arbeitsgruppen
flieh	flieh
fehle	fehle
Mein	Mein
verlobt	verlobt
Gewicht	Gewicht
Schnittlauche	Schnittlauche
gebet	gebet
gedenkt	gedenkt
taufen	taufen
Hehler	Hehler
rotten	rotten
gehöre	gehöre
Erbse	Erbse
Abnahmen	Abnahmen
Aufträgen	Aufträgen
Hadithe	Hadithe
Gehilfen	Gehilfen
Halogenatomen	Halogenatomen
jemanden	jemanden
Dewargefäße	Dewargefäße
formulieren	formulieren
Sage	Sage
Geldautomat	Geldautomat
anrührte	anrührte
bündelest	bündelest
Stimme	Stimme
verdammend	verdammend
sich	sich
verdamm	verdamm
bemerket	bemerket
geherrscht	geherrscht
klingt	klingt
höret	höret
leere	leere
zerbrechest	zerbrechest
wiederkamen	wiederkamen
Ruß	Ruß
Klotzes	Klotzes
grien	grien
sprüht	sprüht
taufte	taufte
läute	läute
Schlüchte	Schlüchte
Brote	Brote
ärger	ärger
wurstelten	wurstelten
Gymnasien	Gymnasien
downloadet	downloadet
verreisest	verreisest
Numerus	Numerus
schlafet	schlafet
Smaragdkehlkolibris	Smaragdkehlkolibris
Radsätzen	Radsätzen
verbitterten	verbitterten
Anfechtungen	Anfechtungen
parfümierte	parfümierte
regeln	regeln
Erzeugung	Erzeugung
Sekten	Sekten
Grabbeltischen	Grabbeltischen
beschotteret	beschotteret
Mittelaltermarktes	Mittelaltermarktes
verforme	verforme
Verwaltungsakten	Verwaltungsakten
bollerest	bollerest
losten	losten
bekannten	bekannten
Vorhäute	Vorhäute
vierten	vierten
implodier	implodier
kabeln	kabeln
Epoxide	Epoxide
Diäresen	Diäresen
Weihen	Weihen
schneide	schneide
betreten	betreten
begebet	begebet
konntet	konntet
entgegenkamen	entgegenkamen
flense	flense
verbitterest	verbitterest
grüßten	grüßten
Möbiusbändern	Möbiusbändern
applizirte	applizirte
Abfertigungsgebäude	Abfertigungsgebäude
Hat	Hat
streiten	streiten
drängest	drängest
dekoriere	dekoriere
Abschirmung	Abschirmung
gönnst	gönnst
pendelt	pendelt
spannt	spannt
hilft	hilft
Hochhäuser	Hochhäuser
missverstände	missverstände
widerstanden	widerstanden
amenagier	amenagier
trinket	trinket
verbündete	verbündete
schweigst	schweigst
Dilettanten	Dilettanten
lärmte	lärmte
sterbt	sterbt
Bonzen	Bonzen
Schwänzen	Schwänzen
Planer	Planer
berühret	berühret
Mops	Mops
Alltag	Alltag
backen	backen
Ektoplasmen	Ektoplasmen
Trümmersprache	Trümmersprache
Uterus	Uterus
bespracht	bespracht
Räten	Räten
Mischung	Mischung
kostet	kostet
kommst	kommst
Abbindebeschleuniger	Abbindebeschleuniger
kein	kein
beweisest	beweisest
Reinelemente	Reinelemente
Monde	Monde
dechiffriere	dechiffriere
ziere	ziere
teilet	teilet
sterilisiert	sterilisiert
Braunralle	Braunralle
unterschieden	unterschieden
erwähnten	erwähnten
sitzen	sitzen
denn	denn
Altbau	Altbau
ruckelst	ruckelst
Mache	Mache
Rekursion	Rekursion
Fahret	Fahret
gleich	gleich
pflüget	pflüget
Rechte	Rechte
Lehrkörpers	Lehrkörpers
benütztest	benütztest
überbewerte	überbewerte
kitzeln	kitzeln
Früchte	Früchte
feierten	feierten
betätigtet	betätigtet
filzst	filzst
würden	würden
Massenanteil	Massenanteil
Rheumatismus	Rheumatismus
Büchereien	Büchereien
trotzt	trotzt
gedächtet	gedächtet
fladerst	fladerst
misstrauet	misstrauet
Grüßet	Grüßet
benehme	benehme
verkapselten	verkapselten
Atommodelle	Atommodelle
Leichtmetalle	Leichtmetalle
dirigieren	dirigieren
Deutung	Deutung
Loparite	Loparite
Gebeinen	Gebeinen
flötete	flötete
Alteritäten	Alteritäten
mischt	mischt
Geliebte	Geliebte
mühe	mühe
bücktest	bücktest
speichertest	speichertest
Adlerbussarden	Adlerbussarden
Taufen	Taufen
transportiere	transportiere
puste	puste
häufe	häufe
Kupferkiesen	Kupferkiesen
verlautet	verlautet
Strafraum	Strafraum
Kompromiss	Kompromiss
sichere	sichere
nähret	nähret
Stolze	Stolze
begehren	begehren
gravierten	gravierten
Hummel	Hummel
verkaufte	verkaufte
verlobte	verlobte
eure	eure
Rufen	Rufen
gehst	gehst
installiert	installiert
grauten	grauten
messen	messen
naschten	naschten
Atommasse	Atommasse
lehret	lehret
Freunde	Freunde
flupptest	flupptest
Knüppeln	Knüppeln
sorge	sorge
Spitze	Spitze
Barschaften	Barschaften
Flöten	Flöten
Pudern	Pudern
reichen	reichen
Diese	Diese
Atomphysikern	Atomphysikern
versteckte	versteckte
Steinen	Steinen
kasernierte	kasernierte
Geschrei	Geschrei
Trübsal	Trübsal
Molybdite	Molybdite
entmineralisierten	entmineralisierten
Irrtümern	Irrtümern
heben	heben
Ringeltauben	Ringeltauben
stammeln	stammeln
drosselten	drosselten
Zwingburgen	Zwingburgen
schmelzen	schmelzen
reim	reim
diente	diente
Einwirkungen	Einwirkungen
Verkehrsflugzeuge	Verkehrsflugzeuge
gedachten	gedachten
willen	willen
halbierte	halbierte
Technikerinnen	Technikerinnen
Kreisen	Kreisen
fokussieret	fokussieret
glaubt	glaubt
wogen	wogen
erwache	erwache
belohnten	belohnten
erzürnet	erzürnet
Krieg	Krieg
erkanntet	erkanntet
wärt	wärt
rüstete	rüstete
solcher	solcher
schleim	schleim
bereiten	bereiten
ermächtige	ermächtige
anrichten	anrichten
weinet	weinet
Pflanzenstoff	Pflanzenstoff
meinte	meinte
plissiere	plissiere
Hahnenkämme	Hahnenkämme
Riese	Riese
Narkotikum	Narkotikum
Bajonetten	Bajonetten
kräusle	kräusle
bewieset	bewieset
Klaue	Klaue
verständige	verständige
Dorsch	Dorsch
dein	dein
greinen	greinen
klone	klone
Lasten	Lasten
nähert	nähert
verkürzest	verkürzest
erkennet	erkennet
räumet	räumet
funkelet	funkelet
sagt	sagt
Nadel	Nadel
schöpfte	schöpfte
habest	habest
Garben	Garben
tyrannisiertest	tyrannisiertest
Türklingeln	Türklingeln
plärrt	plärrt
Löwe	Löwe
Kleptokratie	Kleptokratie
heiligest	heiligest
gewöhnte	gewöhnte
schaust	schaust
Puder	Puder
entschleiert	entschleiert
Zwergschwan	Zwergschwan
Brieftaubenzüchters	Brieftaubenzüchters
überlebest	überlebest
Gaunern	Gaunern
hebräisch	hebräisch
Omnibusse	Omnibusse
Lobe	Lobe
föhnten	föhnten
verkröchet	verkröchet
berührt	berührt
verfehlten	verfehlten
Wurzelwachstum	Wurzelwachstum
wähnet	wähnet
Blitzableiter	Blitzableiter
unterstützet	unterstützet
klicket	klicket
Grufti	Grufti
bange	bange
offenbare	offenbare
Kronsbeere	Kronsbeere
vertiefe	vertiefe
defragmentierest	defragmentierest
dramatisieren	dramatisieren
Lüste	Lüste
bildest	bildest
anzöge	anzöge
strullerte	strullerte
begliche	begliche
Nehmet	Nehmet
verstehest	verstehest
erlösen	erlösen
rühmst	rühmst
blitzte	blitzte
krähte	krähte
zeigst	zeigst
borgte	borgte
Pest	Pest
einigst	einigst
verdrehet	verdrehet
Vaginen	Vaginen
Schläfchens	Schläfchens
Stämme	Stämme
mögest	mögest
stolze	stolze
gehorchten	gehorchten
Homodimere	Homodimere
Rücktritt	Rücktritt
heulte	heulte
brandet	brandet
Lebenskraft	Lebenskraft
kurze	kurze
bedingst	bedingst
bedenket	bedenket
Meldezettel	Meldezettel
unsrer	unsrer
heilige	heilige
transportierten	transportierten
Kautschuke	Kautschuke
wichste	wichste
scheiterst	scheiterst
Steigen	Steigen
revoltierte	revoltierte
taufet	taufet
Kohlenstoffgehalten	Kohlenstoffgehalten
Desserts	Desserts
verleumdete	verleumdete
anrührt	anrührt
Dorngesträuch	Dorngesträuch
bete	bete
Marjellchens	Marjellchens
enttäuschtest	enttäuschtest
abzieht	abzieht
hineinbrächten	hineinbrächten
Chlorat	Chlorat
Bunde	Bunde
pflanzte	pflanzte
Animation	Animation
blättertet	blättertet
stimme	stimme
zerstückte	zerstückte
schöben	schöben
entfolgte	entfolgte
regen	regen
kennet	kennet
verschärftet	verschärftet
Unterseiten	Unterseiten
Seile	Seile
knurrt	knurrt
verschaffte	verschaffte
Binde	Binde
verwahret	verwahret
verladet	verladet
prostituierte	prostituierte
gewünscht	gewünscht
Regierung	Regierung
eine	eine
Diebe	Diebe
beweisen	beweisen
Banden	Banden
grünen	grünen
entwickelten	entwickelten
Schwächungen	Schwächungen
enge	enge
geleitet	geleitet
wachset	wachset
härte	härte
Primärenergien	Primärenergien
kollidierte	kollidierte
ehren	ehren
Bundesgebieten	Bundesgebieten
Schwirrvögel	Schwirrvögel
Kopfverletzungen	Kopfverletzungen
erlagst	erlagst
abalieniertest	abalieniertest
höbe	höbe
verwirren	verwirren
behauptest	behauptest
Anzeichen	Anzeichen
kurbelte	kurbelte
Gallan	Gallan
Kassettenrekordern	Kassettenrekordern
lebest	lebest
ziehest	ziehest
kollidierten	kollidierten
mopsend	mopsend
sagte	sagte
aase	aase
verprügelte	verprügelte
Ahnen	Ahnen
Stilllegung	Stilllegung
lackieren	lackieren
predigtest	predigtest
irre	irre
Scherzes	Scherzes
entstände	entstände
Landesverräterinnen	Landesverräterinnen
Zeitungsenten	Zeitungsenten
möchtest	möchtest
dividiere	dividiere
tasteten	tasteten
buddelten	buddelten
Chlorwasserstoffmoleküls	Chlorwasserstoffmoleküls
fritieret	fritieret
Paradiesäpfeln	Paradiesäpfeln
Mischelementen	Mischelementen
angehört	angehört
verstörten	verstörten
erhöhest	erhöhest
Händedrücken	Händedrücken
zürnst	zürnst
Schwester	Schwester
Donoren	Donoren
gehorchte	gehorchte
erntest	erntest
regte	regte
diesen	diesen
Leugnung	Leugnung
Werkzeugen	Werkzeugen
verscheißert	verscheißert
Münzsammlungen	Münzsammlungen
verteidigt	verteidigt
Fromme	Fromme
Geräte	Geräte
Großfürsten	Großfürsten
bleibest	bleibest
Adamsäpfeln	Adamsäpfeln
sehet	sehet
verzierten	verzierten
schaute	schaute
Schwebfliegen	Schwebfliegen
negierte	negierte
Erzherzogshüten	Erzherzogshüten
Dachdeckerin	Dachdeckerin
Überziehen	Überziehen
posiertet	posiertet
Flamingo	Flamingo
Stämmen	Stämmen
Kontrollkästchen	Kontrollkästchen
weich	weich
Schaffet	Schaffet
weissagten	weissagten
lieben	lieben
reizest	reizest
vereinigt	vereinigt
Gebirge	Gebirge
leben	leben
Seilen	Seilen
Pläsier	Pläsier
Nachteilen	Nachteilen
versteckten	versteckten
Notstand	Notstand
kriegen	kriegen
Laufet	Laufet
Recitativen	Recitativen
Klüfte	Klüfte
Wechselstuben	Wechselstuben
Lümmeltüte	Lümmeltüte
liehe	liehe
Alkali	Alkali
Almanachen	Almanachen
Leid	Leid
quatschest	quatschest
Schuhe	Schuhe
tust	tust
zeuget	zeuget
kritzele	kritzele
heiß	heiß
Regieren	Regieren
Bademäntel	Bademäntel
gehörten	gehörten
Markise	Markise
Bürzel	Bürzel
knackt	knackt
Serverzugriffe	Serverzugriffe
habt	habt
Gesamtmenge	Gesamtmenge
sortiert	sortiert
unschuldigen	unschuldigen
rüstetest	rüstetest
schaben	schaben
gewährte	gewährte
Rechenbrett	Rechenbrett
Pis	Pis
fastete	fastete
funzt	funzt
Videoaufzeichnung	Videoaufzeichnung
Gefäße	Gefäße
suchet	suchet
deckst	deckst
Ich	Ich
Saiblingen	Saiblingen
annektierten	annektierten
Trinkgefäßen	Trinkgefäßen
Wolle	Wolle
konsumieren	konsumieren
murmelst	murmelst
malträtiere	malträtiere
Sportlerinnen	Sportlerinnen
sinterte	sinterte
Quellfluss	Quellfluss
hingeht	hingeht
erlabe	erlabe
Deinen	Deinen
bedingten	bedingten
Portale	Portale
bombardiertet	bombardiertet
rundet	rundet
erfreuen	erfreuen
Hacker	Hacker
Kriegen	Kriegen
pilgert	pilgert
Großfürst	Großfürst
durchläuterte	durchläuterte
finanzieret	finanzieret
ausfuhren	ausfuhren
eigene	eigene
charakterisierend	charakterisierend
instanziier	instanziier
filteret	filteret
frische	frische
erfüllst	erfüllst
Insulaner	Insulaner
Dreieinigkeit	Dreieinigkeit
zweiten	zweiten
Fanmeilen	Fanmeilen
maß	maß
batest	batest
konvertiere	konvertiere
entheilige	entheilige
begrabest	begrabest
Anarchisten	Anarchisten
babbeltet	babbeltet
haderte	haderte
Arsenbergwerken	Arsenbergwerken
dritten	dritten
Schwächung	Schwächung
Aas	Aas
heißet	heißet
Gefügen	Gefügen
Solchen	Solchen
predigte	predigte
Argentits	Argentits
Raucherinnen	Raucherinnen
Zehen	Zehen
Unterschlagungen	Unterschlagungen
Reinigungsschrittes	Reinigungsschrittes
befördert	befördert
laut	laut
Abbild	Abbild
Klassenzimmern	Klassenzimmern
macht	macht
täuschte	täuschte
fastetest	fastetest
Kraftfahrzeugen	Kraftfahrzeugen
Zähne	Zähne
bauten	bauten
spukte	spukte
Bausch	Bausch
Helme	Helme
Sonderbericht	Sonderbericht
weisen	weisen
scheuchen	scheuchen
verwechsele	verwechsele
schneidet	schneidet
dürft	dürft
Sprödmetallen	Sprödmetallen
Ärzteblättern	Ärzteblättern
Serverzugriffen	Serverzugriffen
Gewinnung	Gewinnung
trägst	trägst
gleiche	gleiche
Eutern	Eutern
kontaktiere	kontaktiere
werden	werden
verstrahlet	verstrahlet
bescherten	bescherten
steuerst	steuerst
Abartigkeit	Abartigkeit
Abartigkeiten	Abartigkeiten
meine	meine
lögest	lögest
wallet	wallet
Neumonde	Neumonde
verkürzten	verkürzten
Ansteckern	Ansteckern
verdeckte	verdeckte
verkapselt	verkapselt
überschatteten	überschatteten
anzeigen	anzeigen
Zur-Schau-Stellen	Zur-Schau-Stellen
scheute	scheute
verglichest	verglichest
Peptids	Peptids
Schenken	Schenken
umbrächten	umbrächten
Golfplätzen	Golfplätzen
verringeret	verringeret
injiziert	injiziert
Entree	Entree
ladest	ladest
beteuerest	beteuerest
Nachteile	Nachteile
konjugiere	konjugiere
wünsche	wünsche
Pfandgeld	Pfandgeld
Möbelstoffen	Möbelstoffen
pflügen	pflügen
hell	hell
verklagt	verklagt
Lobet	Lobet
lehrte	lehrte
Laubbläser	Laubbläser
Pflaumen	Pflaumen
laute	laute
dichten	dichten
schlabberten	schlabberten
stürzen	stürzen
anzeigte	anzeigte
Rotgüssen	Rotgüssen
kehre	kehre
fressen	fressen
Leiste	Leiste
Kosten	Kosten
speiste	speiste
beneidest	beneidest
überschattete	überschattete
diversifiziert	diversifiziert
Rücktrittbremsen	Rücktrittbremsen
füsilierten	füsilierten
bewahret	bewahret
prostet	prostet
Büstenhalters	Büstenhalters
beichten	beichten
Charakteristikan	Charakteristikan
erfüllt	erfüllt
Zeitplanes	Zeitplanes
Begünstigungen	Begünstigungen
überschnitten	überschnitten
Kaufhäuser	Kaufhäuser
Noseans	Noseans
ander	ander
Äxte	Äxte
blende	blende
Rhabarber	Rhabarber
Böreks	Böreks
Händen	Händen
bürsteten	bürsteten
verderben	verderben
nagelest	nagelest
Wandergewerbe	Wandergewerbe
kreieren	kreieren
Chlorid	Chlorid
gelobet	gelobet
Regenten	Regenten
Hochsommer	Hochsommer
rächest	rächest
verknüpft	verknüpft
verringert	verringert
langweilst	langweilst
werde	werde
hingehst	hingehst
Weinet	Weinet
Gästen	Gästen
bereitet	bereitet
reifte	reifte
fabuliere	fabuliere
unterdrückte	unterdrückte
schluchzte	schluchzte
aktualisiere	aktualisiere
nachwandelt	nachwandelt
Freitagnachmittagen	Freitagnachmittagen
spalten	spalten
Empörung	Empörung
schmuste	schmuste
zürntet	zürntet
Gram	Gram
Ecken	Ecken
Bärenfelle	Bärenfelle
Bergen	Bergen
besänne	besänne
schäme	schäme
vertreibt	vertreibt
keulst	keulst
attestierten	attestierten
dürfest	dürfest
Somiten	Somiten
Gefäßen	Gefäßen
Jude	Jude
gräbst	gräbst
begruben	begruben
ermordetest	ermordetest
Randbemerkung	Randbemerkung
idealisieret	idealisieret
Feierabende	Feierabende
Führe	Führe
ritzten	ritzten
Den	Den
Kriege	Kriege
gafften	gafften
Bevölkerungsdichten	Bevölkerungsdichten
streiften	streiften
Stücken	Stücken
Mönchen	Mönchen
Schnute	Schnute
klagte	klagte
zankte	zankte
Kaufkraft	Kaufkraft
platzt	platzt
bracht	bracht
Lautschrift	Lautschrift
leite	leite
Werde	Werde
sei	sei
zersetzte	zersetzte
Blockflöte	Blockflöte
heilte	heilte
Friede	Friede
begehrtet	begehrtet
kritzelst	kritzelst
Wegen	Wegen
schaffen	schaffen
Amt	Amt
scheitern	scheitern
wohnst	wohnst
zürntest	zürntest
löset	löset
bekriegtet	bekriegtet
entzweiest	entzweiest
Kaktusfeige	Kaktusfeige
raubest	raubest
Schauen	Schauen
schließt	schließt
Brüder	Brüder
fladern	fladern
Kalifeldspate	Kalifeldspate
schimmerst	schimmerst
Pflanzungen	Pflanzungen
Azubi	Azubi
mobilisieret	mobilisieret
gequasselt	gequasselt
dekompilierten	dekompilierten
Nährmedien	Nährmedien
schonte	schonte
idealisierten	idealisierten
wälzt	wälzt
sicherst	sicherst
verschlungen	verschlungen
verziehen	verziehen
zürnest	zürnest
entwickele	entwickele
Donnerstagabenden	Donnerstagabenden
freuet	freuet
Band	Band
hieltest	hieltest
Maultier	Maultier
erhöht	erhöht
wässerst	wässerst
Trinken	Trinken
Taube	Taube
rundest	rundest
irrte	irrte
Epoxiden	Epoxiden
Speere	Speere
Kleinoden	Kleinoden
bereitend	bereitend
hydrogentartrat	hydrogentartrat
Pausbacken	Pausbacken
erwischten	erwischten
erscheinest	erscheinest
umhüllst	umhüllst
jaulst	jaulst
überfällst	überfällst
fahrest	fahrest
Robe	Robe
Muhme	Muhme
baute	baute
klappten	klappten
Almanache	Almanache
reglementierte	reglementierte
lausche	lausche
velarisiert	velarisiert
Hektaren	Hektaren
Bruchstrich	Bruchstrich
anzögen	anzögen
steinigst	steinigst
filtern	filtern
ehrte	ehrte
duzen	duzen
Lötzinn	Lötzinn
vergliche	vergliche
dresche	dresche
Bund	Bund
wehrt	wehrt
zeugtest	zeugtest
sage	sage
prophezeiet	prophezeiet
Freeganer	Freeganer
pilgerte	pilgerte
hinterzögen	hinterzögen
Zement	Zement
Füchse	Füchse
tobte	tobte
Ärgernissen	Ärgernissen
Badezimmers	Badezimmers
nahte	nahte
erstaunte	erstaunte
gratuliere	gratuliere
bedrücktest	bedrücktest
verzweigt	verzweigt
schimmerest	schimmerest
Gebäck	Gebäck
schätzt	schätzt
verschlingt	verschlingt
benützt	benützt
prostete	prostete
kichern	kichern
Massagen	Massagen
Bombardierung	Bombardierung
auflöste	auflöste
Boten	Boten
bezahlst	bezahlst
auflegt	auflegt
generalisiert	generalisiert
Crescendos	Crescendos
Maultiere	Maultiere
Kommoden	Kommoden
regieret	regieret
Druckfehler	Druckfehler
Wadenbein	Wadenbein
Kerls	Kerls
Reiterschwert	Reiterschwert
grau	grau
thematisierte	thematisierte
lehren	lehren
Sizilianer	Sizilianer
Augenglases	Augenglases
Rekursionen	Rekursionen
Sportlerin	Sportlerin
hegt	hegt
Konfitüren	Konfitüren
Hochhäusern	Hochhäusern
Rotzinkerzen	Rotzinkerzen
begnügt	begnügt
Solches	Solches
Buntspechte	Buntspechte
weichest	weichest
schlag	schlag
Küchenmaschinen	Küchenmaschinen
Krume	Krume
zürnten	zürnten
Schlaraffenländern	Schlaraffenländern
ungefälschter	ungefälschter
verkündigest	verkündigest
hinterlege	hinterlege
überdenkst	überdenkst
dürfen	dürfen
Grabe	Grabe
Bestecken	Bestecken
substituierten	substituierten
dürftet	dürftet
holet	holet
Effekten	Effekten
fahrt	fahrt
rechte	rechte
Bäusche	Bäusche
Premierministerinnen	Premierministerinnen
foppten	foppten
krösest	krösest
Entsetzt	Entsetzt
Herr	Herr
lauft	lauft
Sanatorien	Sanatorien
verlötest	verlötest
sprühend	sprühend
Solch	Solch
Farbstoffe	Farbstoffe
eggt	eggt
Autoklav	Autoklav
legen	legen
glaubend	glaubend
Buchstabe	Buchstabe
schließe	schließe
flirre	flirre
Treibhausgasen	Treibhausgasen
appellierte	appellierte
stoßt	stoßt
Rutheniumisotop	Rutheniumisotop
addierest	addierest
führet	führet
meinst	meinst
gelost	gelost
bewährt	bewährt
tastet	tastet
scheinen	scheinen
Bäche	Bäche
kristallisiertest	kristallisiertest
Sprüchen	Sprüchen
Für	Für
Beziehung	Beziehung
harrest	harrest
Fußmatte	Fußmatte
pendele	pendele
Kardinäle	Kardinäle
austilgen	austilgen
Gemüt	Gemüt
deren	deren
Gute	Gute
ärgere	ärgere
Frösche	Frösche
gebären	gebären
Trickbetrügern	Trickbetrügern
denen	denen
stelle	stelle
Bedeutung	Bedeutung
hattet	hattet
stellen	stellen
Schalen	Schalen
jammerte	jammerte
Urbaren	Urbaren
Europameisters	Europameisters
Achatschnecken	Achatschnecken
erhebst	erhebst
lobet	lobet
fehlte	fehlte
umgäben	umgäben
Kräften	Kräften
bündelten	bündelten
Floß	Floß
unterscheide	unterscheide
heilet	heilet
opferte	opferte
durfte	durfte
Abfertigungsschalter	Abfertigungsschalter
Seit	Seit
Gemeinden	Gemeinden
Füchsen	Füchsen
reizt	reizt
dissentierte	dissentierte
Sei	Sei
Geschichtsbücher	Geschichtsbücher
käbbelte	käbbelte
verkaufe	verkaufe
erforschest	erforschest
eins	eins
warnt	warnt
Namen	Namen
begründetest	begründetest
dringen	dringen
schautet	schautet
Kleinode	Kleinode
bereue	bereue
besuchen	besuchen
Bleche	Bleche
Landstreicher	Landstreicher
verringertet	verringertet
Paläste	Paläste
beherrschest	beherrschest
pipettierten	pipettierten
Ansteckers	Ansteckers
Dampfschiffen	Dampfschiffen
Affenbrotbäumen	Affenbrotbäumen
Reinelementen	Reinelementen
behaltest	behaltest
Kerzenfische	Kerzenfische
stapften	stapften
Riesen	Riesen
zerstreute	zerstreute
Rückumschlägen	Rückumschlägen
niemand	niemand
fallt	fallt
begrubt	begrubt
verallgemeinerst	verallgemeinerst
erhebet	erhebet
Schwirrvogel	Schwirrvogel
UND-Gatter	UND-Gatter
prophezeie	prophezeie
bezahlt	bezahlt
Laufring	Laufring
Erzeugungen	Erzeugungen
Bazziten	Bazziten
bestimmt	bestimmt
beschrifteten	beschrifteten
quantisiere	quantisiere
warntet	warntet
stoßest	stoßest
Malaysierin	Malaysierin
Wunden	Wunden
gesagt	gesagt
Urologe	Urologe
meuterest	meuterest
Bevölkerungsdichte	Bevölkerungsdichte
Käsereibe	Käsereibe
Keine	Keine
Nanosatellit	Nanosatellit
Stoffwechselweg	Stoffwechselweg
reif	reif
vorn	vorn
koste	koste
Arbeitskreis	Arbeitskreis
stürzest	stürzest
Attentäter	Attentäter
griechisch	griechisch
Bleiglanzes	Bleiglanzes
ungeistlich	ungeistlich
heulet	heulet
verflog	verflog
reagiert	reagiert
Sauberfrau	Sauberfrau
diese	diese
ahne	ahne
beeinflusst	beeinflusst
verringerten	verringerten
regierten	regierten
Flossen	Flossen
knitterte	knitterte
weinest	weinest
vernichtete	vernichtete
Hörst	Hörst
lodertet	lodertet
föchte	föchte
stoßet	stoßet
blitzen	blitzen
seinem	seinem
süsse	süsse
parametrisierten	parametrisierten
bölkte	bölkte
Helmen	Helmen
filzen	filzen
erschrickst	erschrickst
Hälsen	Hälsen
Fanatiker	Fanatiker
malet	malet
tappten	tappten
Sprüche	Sprüche
Blattgewebe	Blattgewebe
siegen	siegen
speicherten	speicherten
leistest	leistest
lügen	lügen
Sippe	Sippe
driftete	driftete
lauf	lauf
mißverstehet	mißverstehet
Spurensicherung	Spurensicherung
leuchten	leuchten
überschattet	überschattet
helfest	helfest
sinke	sinke
verbaseln	verbaseln
krieget	krieget
aufkommen	aufkommen
Fledermaus	Fledermaus
verließen	verließen
Scheck	Scheck
beben	beben
Bombardierungen	Bombardierungen
Exilanten	Exilanten
Fluorgehalte	Fluorgehalte
Katz-und-Maus-Spiele	Katz-und-Maus-Spiele
Arm	Arm
Anker	Anker
Letzten	Letzten
widerlegte	widerlegte
grabe	grabe
betrübtet	betrübtet
sagten	sagten
versuchtet	versuchtet
Rubine	Rubine
schmuggle	schmuggle
Klotz	Klotz
erlöse	erlöse
regelet	regelet
inhalierest	inhalierest
fertige	fertige
bekehret	bekehret
Seil	Seil
erkalten	erkalten
wähnt	wähnt
Fragen	Fragen
ausführt	ausführt
lüftet	lüftet
verführen	verführen
Membranen	Membranen
vertilgt	vertilgt
Alle	Alle
Generationen	Generationen
kaserniert	kaserniert
Deine	Deine
meinen	meinen
Aphasien	Aphasien
Fehden	Fehden
Anlass	Anlass
Weichloten	Weichloten
zensierten	zensierten
preist	preist
Klappertöpfen	Klappertöpfen
henken	henken
verdinglichtest	verdinglichtest
Amtsträger	Amtsträger
bezichtigt	bezichtigt
Kaufleuten	Kaufleuten
Jünglingen	Jünglingen
ruckeln	ruckeln
Irrtumes	Irrtumes
frevle	frevle
zierte	zierte
folgend	folgend
respektiere	respektiere
beantragt	beantragt
eskaliert	eskaliert
substituierend	substituierend
Republikflucht	Republikflucht
Ranzigkeit	Ranzigkeit
Antimusters	Antimusters
hintertreibt	hintertreibt
Betten	Betten
tragen	tragen
Füllfeder	Füllfeder
Fischotters	Fischotters
ducktest	ducktest
Herkunft	Herkunft
grabbelten	grabbelten
versuchen	versuchen
Atemlüfte	Atemlüfte
Gespenst	Gespenst
speisest	speisest
zählte	zählte
zuhörte	zuhörte
Briefen	Briefen
scheuchtest	scheuchtest
nachwandeln	nachwandeln
Schau	Schau
klagen	klagen
Amokläuferinnen	Amokläuferinnen
zappen	zappen
kappet	kappet
scheuchten	scheuchten
webte	webte
lautete	lautete
Reizen	Reizen
konstatiere	konstatiere
kooperierte	kooperierte
Kernladungszahlen	Kernladungszahlen
Friedensforscherinnen	Friedensforscherinnen
Safran	Safran
Aromastoffe	Aromastoffe
sprichst	sprichst
ringet	ringet
knurrtet	knurrtet
unser	unser
Überschüssen	Überschüssen
kautest	kautest
Öfchen	Öfchen
faltest	faltest
Gemütes	Gemütes
Riegel	Riegel
Fröschen	Fröschen
kugele	kugele
reparierten	reparierten
stiftete	stiftete
punkten	punkten
infiziertet	infiziertet
zertifizierst	zertifizierst
speist	speist
dümpelest	dümpelest
still	still
hydrolysierend	hydrolysierend
Ypecaharallen	Ypecaharallen
verunglimpfest	verunglimpfest
letzten	letzten
liebtest	liebtest
Roben	Roben
bemühten	bemühten
eiterte	eiterte
erstehst	erstehst
Ausbeuterei	Ausbeuterei
beweiset	beweiset
fingiere	fingiere
nähernd	nähernd
begrübe	begrübe
konvergierest	konvergierest
werfet	werfet
klappest	klappest
heil	heil
verberge	verberge
Höfe	Höfe
verdammet	verdammet
colorierend	colorierend
koche	koche
überwiese	überwiese
Dochte	Dochte
protestieret	protestieret
Dithiolane	Dithiolane
Privatsachen	Privatsachen
Anführer	Anführer
dechiffrierend	dechiffrierend
blasen	blasen
Stiefmütterchen	Stiefmütterchen
Streichen	Streichen
knusperst	knusperst
Iberer	Iberer
tragt	tragt
extemporiere	extemporiere
vandaliere	vandaliere
verfange	verfange
Wirtschaftswissenschaft	Wirtschaftswissenschaft
Sehnen	Sehnen
beunruhigte	beunruhigte
tattert	tattert
sorgen	sorgen
sagst	sagst
loste	loste
erkältete	erkältete
demütige	demütige
laden	laden
schubse	schubse
verzeichnete	verzeichnete
Ästen	Ästen
Rücktrittbremse	Rücktrittbremse
Gläubigern	Gläubigern
Dünungen	Dünungen
Shortcuts	Shortcuts
wünschet	wünschet
vergiften	vergiften
pressiere	pressiere
Stierkämpfe	Stierkämpfe
verscheißerte	verscheißerte
schlagt	schlagt
deine	deine
begehrest	begehrest
Plumpsen	Plumpsen
ertragen	ertragen
glaube	glaube
Scheißkerl	Scheißkerl
schiesst	schiesst
Pedant	Pedant
Pentaborat	Pentaborat
Höret	Höret
Führet	Führet
erfahrt	erfahrt
Drehtüren	Drehtüren
Arreste	Arreste
ermutigte	ermutigte
trauerten	trauerten
Jahren	Jahren
schwirrt	schwirrt
sedimentiere	sedimentiere
Scherzen	Scherzen
bestrafe	bestrafe
entflöhen	entflöhen
Gangster	Gangster
Atombombe	Atombombe
alle	alle
Normdaten	Normdaten
Indern	Indern
Schiffe	Schiffe
Ausländer	Ausländer
stiftest	stiftest
Ächselchen	Ächselchen
schreie	schreie
stehest	stehest
Idolatrien	Idolatrien
antworte	antworte
auszogst	auszogst
analysieret	analysieret
Schreiber	Schreiber
Fallen	Fallen
Sorge	Sorge
inszenierst	inszenierst
absagt	absagt
schaffet	schaffet
schöpfe	schöpfe
Würfelspiele	Würfelspiele
zweite	zweite
fünfte	fünfte
lehnte	lehnte
Schamentzündung	Schamentzündung
Fällen	Fällen
Finanzminister	Finanzminister
rännen	rännen
versteckend	versteckend
dingt	dingt
ärgerte	ärgerte
zerfetzte	zerfetzte
glauben	glauben
lügt	lügt
geloben	geloben
lügst	lügst
unehret	unehret
substituierest	substituierest
Seine	Seine
suchst	suchst
Beobachtungen	Beobachtungen
seien	seien
ernteten	ernteten
Einfältigkeit	Einfältigkeit
aufhoben	aufhoben
Türkinnen	Türkinnen
Gesamtmengen	Gesamtmengen
tun	tun
erstaunst	erstaunst
winkt	winkt
gewöhnt	gewöhnt
Skorpionen	Skorpionen
Weichlote	Weichlote
Marokkaners	Marokkaners
Ende	Ende
weiche	weiche
erhebest	erhebest
Wüste	Wüste
kapiertet	kapiertet
bemühst	bemühst
verrosteten	verrosteten
sponsertest	sponsertest
entrümpelst	entrümpelst
braust	braust
Schotten	Schotten
War	War
kritzeln	kritzeln
grünten	grünten
verdunstet	verdunstet
verschränken	verschränken
reichtet	reichtet
Berge	Berge
lege	lege
vertreiben	vertreiben
regierst	regierst
Lobgesänge	Lobgesänge
Edelsteinen	Edelsteinen
verarbeite	verarbeite
meldeten	meldeten
träge	träge
Machet	Machet
Harpune	Harpune
wende	wende
begehrst	begehrst
verschafft	verschafft
eures	eures
verwiesen	verwiesen
Mittelaltermarkt	Mittelaltermarkt
wenden	wenden
blockierten	blockierten
verfolgt	verfolgt
sticke	sticke
Woge	Woge
stärken	stärken
laufet	laufet
nötig	nötig
überlieferten	überlieferten
konnten	konnten
Heuschrecken	Heuschrecken
erzeigen	erzeigen
brauste	brauste
Asthenosphäre	Asthenosphäre
belauere	belauere
gehet	gehet
Reflexionen	Reflexionen
jemand	jemand
Grieße	Grieße
achte	achte
beleuchte	beleuchte
Pfahl	Pfahl
Graben	Graben
Aspartamen	Aspartamen
grünest	grünest
Nervenzellen	Nervenzellen
Reiseleiter	Reiseleiter
bis	bis
schenkst	schenkst
vermahnt	vermahnt
Unternehmensanwendungsintegrationen	Unternehmensanwendungsintegrationen
freiwillige	freiwillige
linke	linke
Bienenstöcke	Bienenstöcke
Ausnahmen	Ausnahmen
Blumensträußen	Blumensträußen
Hardwareentwicklerin	Hardwareentwicklerin
Eines	Eines
Saget	Saget
glühten	glühten
spanne	spanne
Gebote	Gebote
Feldzug	Feldzug
enttäuschet	enttäuschet
Fußballweltmeisterschaftsqualifikationsspiel	Fußballweltmeisterschaftsqualifikationsspiel
erschüttere	erschüttere
verkleide	verkleide
beschwindele	beschwindele
ärgernd	ärgernd
Schote	Schote
Mageninhalten	Mageninhalten
finanzierest	finanzierest
mobilisierten	mobilisierten
erfreu	erfreu
entkörperlichte	entkörperlichte
versagt	versagt
verurteile	verurteile
Sprechers	Sprechers
sezierst	sezierst
Stücke	Stücke
schäumtest	schäumtest
rauben	rauben
schautest	schautest
fokussierten	fokussierten
Ärzte	Ärzte
Verdacht	Verdacht
bedrückest	bedrückest
betrügen	betrügen
kaufest	kaufest
verbündest	verbündest
Meinet	Meinet
plagte	plagte
Heteroatom	Heteroatom
ausgeht	ausgeht
Apfelbäumen	Apfelbäumen
gehorcht	gehorcht
Andrologie	Andrologie
begrabet	begrabet
spielen	spielen
verkürzte	verkürzte
taufe	taufe
Steige	Steige
präsentier	präsentier
lebet	lebet
Malaysiers	Malaysiers
Treppe	Treppe
Tier	Tier
betrüge	betrüge
vermutest	vermutest
kennst	kennst
setztet	setztet
Gründungsprivilegien	Gründungsprivilegien
haltet	haltet
torpediert	torpediert
erwähnet	erwähnet
erbringen	erbringen
feiertest	feiertest
Jagdbomber	Jagdbomber
überprüfte	überprüfte
gereicht	gereicht
unterfordern	unterfordern
Breiten	Breiten
schweiget	schweiget
imkernd	imkernd
sehnet	sehnet
reichte	reichte
schiebest	schiebest
Esset	Esset
Kapitalverkehr	Kapitalverkehr
strullerst	strullerst
Nullpunkt	Nullpunkt
Am	Am
Seetaucher	Seetaucher
jagst	jagst
verführtest	verführtest
Rechenbrettern	Rechenbrettern
Präservativen	Präservativen
könne	könne
Girls	Girls
stiften	stiften
Elektronenschale	Elektronenschale
schleißt	schleißt
Dochten	Dochten
rangierst	rangierst
rufst	rufst
steigest	steigest
Lunisolarkalender	Lunisolarkalender
Teekessel	Teekessel
bereite	bereite
weissagst	weissagst
kämmtet	kämmtet
kämmt	kämmt
Fieberanfall	Fieberanfall
wilde	wilde
wog	wog
Buchstaben	Buchstaben
Safrane	Safrane
Bushaltestellen	Bushaltestellen
zerstreuet	zerstreuet
substituieren	substituieren
Säue	Säue
verwirklicht	verwirklicht
Unrechten	Unrechten
Heteroatome	Heteroatome
Abnahme	Abnahme
verbitterte	verbitterte
spurtest	spurtest
zwölften	zwölften
formulierst	formulierst
viele	viele
Tollkirschen	Tollkirschen
Tintenklecks	Tintenklecks
Meinem	Meinem
Kerfe	Kerfe
bescheißt	bescheißt
Metallquirlen	Metallquirlen
Alterität	Alterität
Streiten	Streiten
Als	Als
Anführern	Anführern
Licht	Licht
Wisset	Wisset
Anschläge	Anschläge
posierten	posierten
zeug	zeug
Langzeichen	Langzeichen
sagtest	sagtest
verschonet	verschonet
stärket	stärket
Malaysierinnen	Malaysierinnen
jene	jene
sollst	sollst
Stimmen	Stimmen
schnitt	schnitt
pflügest	pflügest
Schwarzseherin	Schwarzseherin
Trotzkisten	Trotzkisten
vertilgest	vertilgest
wünschte	wünschte
Dich	Dich
besäest	besäest
Freizeitzentrum	Freizeitzentrum
duschte	duschte
tabuisiert	tabuisiert
verewigt	verewigt
Bundesgebiet	Bundesgebiet
wollte	wollte
schrecken	schrecken
Zerfällen	Zerfällen
sprechet	sprechet
konnotieret	konnotieret
Spitzen	Spitzen
Alkin	Alkin
Zäune	Zäune
Junge	Junge
gelobt	gelobt
frottierten	frottierten
weisest	weisest
jede	jede
stürze	stürze
Antitranspiranten	Antitranspiranten
Böse	Böse
unterbrächest	unterbrächest
Europameistern	Europameistern
Weißt	Weißt
Heringen	Heringen
Setzet	Setzet
pflücke	pflücke
Untier	Untier
Gebete	Gebete
Ente	Ente
ehe	ehe
referenzierst	referenzierst
rufe	rufe
Übertretung	Übertretung
predigen	predigen
Gammastrahlen	Gammastrahlen
Mäusespeck	Mäusespeck
Borhydrid	Borhydrid
schwimmst	schwimmst
leid	leid
Türkis	Türkis
Außenministerien	Außenministerien
Komponisten	Komponisten
Linien	Linien
flehte	flehte
wert	wert
vertiefet	vertiefet
unserer	unserer
Ichs	Ichs
sehnte	sehnte
Krusten	Krusten
zerrissen	zerrissen
Jüngern	Jüngern
porträtiere	porträtiere
schlage	schlage
Honigbär	Honigbär
wirst	wirst
fritierst	fritierst
hüpfen	hüpfen
sehn	sehn
Falltürme	Falltürme
Unterwerfungen	Unterwerfungen
Werte	Werte
heftetest	heftetest
Beteiligte	Beteiligte
verknüpfet	verknüpfet
Mageninhalt	Mageninhalt
verliert	verliert
erschütterte	erschütterte
Türkin	Türkin
desertierst	desertierst
Einstufung	Einstufung
darfst	darfst
Wasserquelle	Wasserquelle
Trickbetrüger	Trickbetrüger
Mutagenen	Mutagenen
fällen	fällen
Gebeine	Gebeine
Schreiet	Schreiet
scheinet	scheinet
umarmen	umarmen
Zirkelschluss	Zirkelschluss
verkürztest	verkürztest
Halte	Halte
fluktuiert	fluktuiert
wehre	wehre
gewähr	gewähr
bölket	bölket
wir	wir
habe	habe
Innenministerien	Innenministerien
kauerten	kauerten
wälzet	wälzet
Fahrt	Fahrt
reformierten	reformierten
setzet	setzet
knüpfte	knüpfte
obfuskieren	obfuskieren
Blitze	Blitze
Libelle	Libelle
Arbeitsbereichen	Arbeitsbereichen
applizirst	applizirst
Ochsen	Ochsen
Membran	Membran
Epiker	Epiker
denaturieret	denaturieret
loben	loben
verlähmt	verlähmt
privilegiere	privilegiere
dümpelst	dümpelst
Technetiumatom	Technetiumatom
rekrutiere	rekrutiere
grüßend	grüßend
warst	warst
verdeckten	verdeckten
Amnestie	Amnestie
hegten	hegten
plumpsten	plumpsten
Apportierhund	Apportierhund
Ankern	Ankern
Schaffe	Schaffe
rinnt	rinnt
Zäunen	Zäunen
äussern	äussern
vibrierend	vibrierend
Werk	Werk
unterwerft	unterwerft
Vesper	Vesper
zertifiziertest	zertifiziertest
Quelle	Quelle
Zapfhähnen	Zapfhähnen
brichst	brichst
huren	huren
Worte	Worte
urbanisier	urbanisier
gebäret	gebäret
beißt	beißt
verspätete	verspätete
tief	tief
ringele	ringele
fehlen	fehlen
Paradiesapfel	Paradiesapfel
funktionierte	funktionierte
brauche	brauche
boßte	boßte
Reinstoff	Reinstoff
weinen	weinen
schmetterst	schmetterst
esset	esset
Linguist	Linguist
schwöllen	schwöllen
Versorgungen	Versorgungen
lachet	lachet
leiden	leiden
privilegierst	privilegierst
respektiert	respektiert
linsten	linsten
Frieden	Frieden
Spannt	Spannt
Hubschrauber	Hubschrauber
enttäusche	enttäusche
fertig	fertig
Kommst	Kommst
fistet	fistet
Jochen	Jochen
Schanktischen	Schanktischen
Hände	Hände
gestaltest	gestaltest
ermahnet	ermahnet
Huflattich	Huflattich
Stempeluhren	Stempeluhren
rauschen	rauschen
Eingabe	Eingabe
verbüßest	verbüßest
hämmerst	hämmerst
harmonierest	harmonierest
versagen	versagen
Schaffnerin	Schaffnerin
Androiden	Androiden
zuppst	zuppst
Kassiterits	Kassiterits
gratuliert	gratuliert
Wollt	Wollt
Orgeln	Orgeln
Quellflüssen	Quellflüssen
Hobby	Hobby
Bilderstürmer	Bilderstürmer
empört	empört
unterbrächen	unterbrächen
Wiedergutmachung	Wiedergutmachung
Prüfberichten	Prüfberichten
Hobbys	Hobbys
egalisierten	egalisierten
überreicht	überreicht
schweigen	schweigen
Juden	Juden
bestellten	bestellten
verprügelet	verprügelet
bimmelten	bimmelten
entschleieret	entschleieret
Grenze	Grenze
faschieret	faschieret
beweist	beweist
fabulierte	fabulierte
Biokraftstoff	Biokraftstoff
strafen	strafen
Warten	Warten
Dolde	Dolde
werten	werten
setzte	setzte
säusele	säusele
dotierst	dotierst
welchen	welchen
Elstern	Elstern
schnappet	schnappet
duckmäusere	duckmäusere
Komponistin	Komponistin
Adeliepinguins	Adeliepinguins
Töpfe	Töpfe
producieret	producieret
vernehmest	vernehmest
vertagt	vertagt
regieren	regieren
Milchflaschen	Milchflaschen
säuselest	säuselest
deklarierte	deklarierte
respektieren	respektieren
Darlegung	Darlegung
Meines	Meines
hattest	hattest
widerlegest	widerlegest
Ölfässern	Ölfässern
versüßtet	versüßtet
spielet	spielet
erlöst	erlöst
Raute	Raute
vermag	vermag
schlabberte	schlabberte
mästet	mästet
posierst	posierst
Klauen	Klauen
Metallquirle	Metallquirle
Kriegsschauplatz	Kriegsschauplatz
Skorpione	Skorpione
Elementarzellen	Elementarzellen
Bildschirmfoto	Bildschirmfoto
Atommodellen	Atommodellen
Introjektion	Introjektion
heißest	heißest
vermeße	vermeße
wild	wild
pflügten	pflügten
manövrieret	manövrieret
Färsen	Färsen
raffiniere	raffiniere
schnattert	schnattert
zerschlagt	zerschlagt
Geschäften	Geschäften
Kraftfahrzeuges	Kraftfahrzeuges
Blaumeisen	Blaumeisen
schnorrest	schnorrest
erzeige	erzeige
klonet	klonet
Heeren	Heeren
frottier	frottier
vielen	vielen
schummelten	schummelten
Abfahrtslisten	Abfahrtslisten
grüße	grüße
Wasserbädern	Wasserbädern
tote	tote
Unter	Unter
auszogen	auszogen
schreien	schreien
versüße	versüße
tatet	tatet
teilen	teilen
Lammfellhandschuhs	Lammfellhandschuhs
stigmatisierst	stigmatisierst
fehlet	fehlet
filzten	filzten
taten	taten
lavierend	lavierend
prahlet	prahlet
Heide	Heide
Leiden	Leiden
Portal	Portal
egalisiertet	egalisiertet
seit	seit
Kontaktierungen	Kontaktierungen
Psi	Psi
Begrenzung	Begrenzung
Remisen	Remisen
ertönst	ertönst
scheucht	scheucht
Organistin	Organistin
Basilisk	Basilisk
Mop	Mop
manche	manche
Hektare	Hektare
ankern	ankern
verabschiedetet	verabschiedetet
analysiert	analysiert
Asteroide	Asteroide
Teilen	Teilen
zeichnest	zeichnest
blitzet	blitzet
schlängelest	schlängelest
sedimentiertet	sedimentiertet
bandagiert	bandagiert
brechen	brechen
Lautschriften	Lautschriften
brennen	brennen
legt	legt
warten	warten
fegst	fegst
Nanosatelliten	Nanosatelliten
vermahnen	vermahnen
Treppen	Treppen
zürnte	zürnte
überprüftest	überprüftest
Monaten	Monaten
Hinkelstein	Hinkelstein
errötest	errötest
Einöde	Einöde
vermutet	vermutet
duschten	duschten
stäupten	stäupten
wehte	wehte
konsolidierend	konsolidierend
Ratsherr	Ratsherr
Pforte	Pforte
Eure	Eure
wehrten	wehrten
Wege	Wege
bewässertet	bewässertet
Gemurmel	Gemurmel
Dürren	Dürren
verkündiget	verkündiget
Markisen	Markisen
Essigsäurechloriden	Essigsäurechloriden
wirfst	wirfst
Carbid	Carbid
entwendete	entwendete
Kaliumdichromat	Kaliumdichromat
verwechselst	verwechselst
Anrufbeantworter	Anrufbeantworter
benähmen	benähmen
schenken	schenken
Heiratsgut	Heiratsgut
Ärzteblatt	Ärzteblatt
Sollten	Sollten
aufrichtest	aufrichtest
geliebt	geliebt
Amputierte	Amputierte
orgelt	orgelt
hinterfragst	hinterfragst
musizieret	musizieret
hüte	hüte
zwölfte	zwölfte
vermöget	vermöget
Kronsbeeren	Kronsbeeren
Regenwald	Regenwald
betrübte	betrübte
wärst	wärst
Hummern	Hummern
Kirchhof	Kirchhof
Ludwigsburger	Ludwigsburger
sorgte	sorgte
ruhest	ruhest
panaschieren	panaschieren
Arresten	Arresten
Linken	Linken
verselbständigt	verselbständigt
Freibrief	Freibrief
Trinket	Trinket
Geschwindigkeitsmessern	Geschwindigkeitsmessern
vergaste	vergaste
Ölfasses	Ölfasses
gehorchest	gehorchest
pustet	pustet
Einfältigkeiten	Einfältigkeiten
Mammut	Mammut
amenagieren	amenagieren
bequemest	bequemest
Gebäcken	Gebäcken
Somite	Somite
Maße	Maße
Sachen	Sachen
begäben	begäben
Pianos	Pianos
Recitativ	Recitativ
Füllfederhalters	Füllfederhalters
Menschen	Menschen
schauest	schauest
erweckt	erweckt
jappten	jappten
Rückumschlages	Rückumschlages
Urbare	Urbare
handhabt	handhabt
Toren	Toren
Marokkanern	Marokkanern
beantrage	beantrage
Asteroid	Asteroid
zweifel	zweifel
Ängsten	Ängsten
motivierten	motivierten
Düfte	Düfte
anfingst	anfingst
Druckfehlern	Druckfehlern
seines	seines
Bis	Bis
führst	führst
blitzt	blitzt
Apostel	Apostel
demoralisiere	demoralisiere
bewiest	bewiest
Zeithorizonte	Zeithorizonte
Krumen	Krumen
nähte	nähte
gelang	gelang
faul	faul
misstrauen	misstrauen
Sonnenfinsternis	Sonnenfinsternis
Zeugnisse	Zeugnisse
wollest	wollest
beide	beide
ziehst	ziehst
Koniferen	Koniferen
häuftet	häuftet
außer	außer
gebühren	gebühren
erbrüte	erbrüte
Molybdit	Molybdit
kramst	kramst
glaubtet	glaubtet
bediene	bediene
Adelungen	Adelungen
Würzen	Würzen
verbluten	verbluten
klickte	klickte
Milzen	Milzen
besprichst	besprichst
aufhobt	aufhobt
bedeckest	bedeckest
koordinierte	koordinierte
Transportwegen	Transportwegen
kaufst	kaufst
späht	späht
Tetraiodiden	Tetraiodiden
boykottierten	boykottierten
treibest	treibest
Zehnten	Zehnten
rede	rede
eroberte	eroberte
wahr	wahr
abtrünnigen	abtrünnigen
ersparte	ersparte
knüpfen	knüpfen
haltest	haltest
Gaschromatographien	Gaschromatographien
bequemtet	bequemtet
Gammastrahl	Gammastrahl
Schreibtischtäter	Schreibtischtäter
lachte	lachte
beides	beides
boykottierst	boykottierst
hievten	hievten
verzieht	verzieht
Videoaufzeichnungen	Videoaufzeichnungen
teil	teil
Inder	Inder
Bertrandite	Bertrandite
Prophet	Prophet
preisen	preisen
hantierte	hantierte
preiset	preiset
verstanden	verstanden
begnügte	begnügte
Kupferkiese	Kupferkiese
Mikrometer	Mikrometer
halbe	halbe
gravierst	gravierst
schätzte	schätzte
dringest	dringest
prediget	prediget
Herzchen	Herzchen
machst	machst
bekennst	bekennst
backt	backt
duzet	duzet
ausgereckten	ausgereckten
Samstagnachmittagen	Samstagnachmittagen
Dominicanerin	Dominicanerin
harren	harren
trödele	trödele
sinkest	sinkest
sterilisierten	sterilisierten
bilden	bilden
verstörte	verstörte
gedenke	gedenke
angehöret	angehöret
Fermium	Fermium
Samstagnachmittag	Samstagnachmittag
filzte	filzte
folgte	folgte
Aktivist	Aktivist
verbrauchte	verbrauchte
Grabbeltisch	Grabbeltisch
Panamaer	Panamaer
Kühe	Kühe
ausfuhr	ausfuhr
arrivierst	arrivierst
verkaufst	verkaufst
Gefangene	Gefangene
Ausstiegstüren	Ausstiegstüren
sagtet	sagtet
verschont	verschont
hätten	hätten
dividiert	dividiert
geschlummert	geschlummert
unterbewertete	unterbewertete
Palme	Palme
Ebene	Ebene
Programmiererinnen	Programmiererinnen
Broten	Broten
knufften	knufften
fluche	fluche
Kürass	Kürass
ihr	ihr
kämpfet	kämpfet
verirrt	verirrt
Campingplätzen	Campingplätzen
Finanzministern	Finanzministern
Rinde	Rinde
Überweisung	Überweisung
aufhebt	aufhebt
bat	bat
flöteten	flöteten
Märchenbüchern	Märchenbüchern
flenstet	flenstet
ruhte	ruhte
Rückumlaute	Rückumlaute
erlöset	erlöset
baue	baue
Fischotter	Fischotter
Feierabend	Feierabend
Totenglocke	Totenglocke
meldet	meldet
Kaufleute	Kaufleute
Butzemann	Butzemann
Aluminaten	Aluminaten
verziehe	verziehe
tattre	tattre
Rehböcken	Rehböcken
ihn	ihn
Kerzenlichter	Kerzenlichter
stützet	stützet
schummelst	schummelst
jenen	jenen
Wachteln	Wachteln
Untern	Untern
Ochse	Ochse
schützt	schützt
gewinne	gewinne
Hainbuche	Hainbuche
Abkürzungsverzeichnis	Abkürzungsverzeichnis
hassest	hassest
Beiblätter	Beiblätter
Zeitschlitze	Zeitschlitze
fluppten	fluppten
Griechen	Griechen
dringt	dringt
Malen	Malen
rekrutierest	rekrutierest
erwürgten	erwürgten
Fürst	Fürst
fremde	fremde
schaut	schaut
verbündeten	verbündeten
Schwestern	Schwestern
entdecket	entdecket
versklavte	versklavte
Gewalttätern	Gewalttätern
beschrifte	beschrifte
Aderhaut	Aderhaut
Durchbruch	Durchbruch
oxidierte	oxidierte
Wanderfalken	Wanderfalken
Adelung	Adelung
kräuselten	kräuselten
verdammtet	verdammtet
grübelt	grübelt
Germanisten	Germanisten
Eissteinen	Eissteinen
Thioestere	Thioestere
bekennet	bekennet
Abschußringe	Abschußringe
betrübet	betrübet
Oberlandesgericht	Oberlandesgericht
trotze	trotze
verzweifelten	verzweifelten
verkehrten	verkehrten
Steuerwagen	Steuerwagen
berücksichtiget	berücksichtiget
Haarshampoos	Haarshampoos
Wasserquellen	Wasserquellen
grabest	grabest
kehrst	kehrst
Decket	Decket
Diesen	Diesen
Trotzkist	Trotzkist
stürzte	stürzte
Prostyloi	Prostyloi
drillte	drillte
Höhen	Höhen
Flamme	Flamme
verselbständigst	verselbständigst
älteste	älteste
lispelten	lispelten
prahlte	prahlte
Dienstgrad	Dienstgrad
Bällchen	Bällchen
Teppiche	Teppiche
legst	legst
Pi	Pi
deponiere	deponiere
erinnre	erinnre
erwürgest	erwürgest
wären	wären
hintertreiben	hintertreiben
Kruste	Kruste
emittierte	emittierte
rechten	rechten
bewerbet	bewerbet
unterdrücke	unterdrücke
Regiert	Regiert
verboten	verboten
geleitest	geleitest
überfischte	überfischte
wollten	wollten
Schätze	Schätze
beschuldiget	beschuldiget
Schläfchen	Schläfchen
schläft	schläft
injizierest	injizierest
Däumlings	Däumlings
malt	malt
dampfte	dampfte
Geboten	Geboten
dekorieren	dekorieren
Tollkirsche	Tollkirsche
bescheiße	bescheiße
Briefwechsel	Briefwechsel
schauspieleren	schauspieleren
Kuckucken	Kuckucken
mühte	mühte
fälle	fälle
sagest	sagest
umkämen	umkämen
schmuggelest	schmuggelest
eher	eher
gare	gare
Kerl	Kerl
impfte	impfte
Sprachräumen	Sprachräumen
rittest	rittest
trügen	trügen
wispern	wispern
Schilden	Schilden
gewitterest	gewitterest
Dobermännern	Dobermännern
Beschuldigung	Beschuldigung
Sabbatjahr	Sabbatjahr
vergrabest	vergrabest
springen	springen
Energiespeicher	Energiespeicher
sollten	sollten
erniedrigst	erniedrigst
Bilderstürmers	Bilderstürmers
entgehe	entgehe
niemanden	niemanden
Flame	Flame
Maut	Maut
gestalten	gestalten
Füchsinnen	Füchsinnen
verdammt	verdammt
befehlt	befehlt
Überschüsse	Überschüsse
Rhodochrosite	Rhodochrosite
suchen	suchen
Korrosionsschutzen	Korrosionsschutzen
Brite	Brite
Haarverlust	Haarverlust
würdest	würdest
Fiebermitteln	Fiebermitteln
Pflanzenwachstum	Pflanzenwachstum
grübelte	grübelte
stürzt	stürzt
zerstreust	zerstreust
frisch	frisch
halle	halle
lehnen	lehnen
Ausbeuter	Ausbeuter
Temperaturanstieg	Temperaturanstieg
Rhodochrositen	Rhodochrositen
Untiefe	Untiefe
Bilderstürmereien	Bilderstürmereien
überqueren	überqueren
heparinisiere	heparinisiere
verliere	verliere
Bären	Bären
Zwetschge	Zwetschge
beschwören	beschwören
Tischen	Tischen
löge	löge
bedeckt	bedeckt
auflegte	auflegte
entsetzt	entsetzt
kennest	kennest
Hornunges	Hornunges
Schwermetallion	Schwermetallion
steuerte	steuerte
kapiert	kapiert
herrschet	herrschet
Linie	Linie
überreichend	überreichend
Eistaucher	Eistaucher
Fokusse	Fokusse
toten	toten
entfachet	entfachet
Bienenstock	Bienenstock
spekulieren	spekulieren
Schal	Schal
halbierest	halbierest
formiret	formiret
träumen	träumen
Steuerberater	Steuerberater
dümpelte	dümpelte
explodierten	explodierten
Bettlers	Bettlers
Acetat	Acetat
chloroformiere	chloroformiere
helfet	helfet
schichtet	schichtet
Butike	Butike
halben	halben
Jungfernflüge	Jungfernflüge
stehet	stehet
besorgend	besorgend
Oheim	Oheim
wehret	wehret
Gefilden	Gefilden
Notärztinnen	Notärztinnen
naschst	naschst
verfliegest	verfliegest
Schafe	Schafe
erwärmet	erwärmet
föhnest	föhnest
winke	winke
bebte	bebte
Wollte	Wollte
Pfarrerinnen	Pfarrerinnen
leer	leer
betrübten	betrübten
redetest	redetest
Rücktrittes	Rücktrittes
Generatoren	Generatoren
gehorchst	gehorchst
zeugten	zeugten
enterten	enterten
Berufe	Berufe
schätze	schätze
Quellen	Quellen
geknautscht	geknautscht
log	log
kupieren	kupieren
gebietet	gebietet
drückte	drückte
Hinkelsteine	Hinkelsteine
forschet	forschet
Brieföffner	Brieföffner
Grizzlybären	Grizzlybären
brauchte	brauchte
Minischweine	Minischweine
schabst	schabst
Hälse	Hälse
Diamantringen	Diamantringen
Oxonium	Oxonium
erzürnst	erzürnst
schämst	schämst
Golfplatz	Golfplatz
Ängste	Ängste
Wehre	Wehre
koexistierten	koexistierten
gewinnen	gewinnen
Lautwandel	Lautwandel
besorgt	besorgt
googelten	googelten
folterst	folterst
begleicht	begleicht
strafend	strafend
wurde	wurde
Funktionalität	Funktionalität
bedient	bedient
Pläsieren	Pläsieren
Halt	Halt
aufnahmt	aufnahmt
drifte	drifte
simuliertet	simuliertet
Zapfhahn	Zapfhahn
wilden	wilden
erfreute	erfreute
Chinakohl	Chinakohl
gaffest	gaffest
neidest	neidest
feiere	feiere
beichteten	beichteten
stoppten	stoppten
schaffest	schaffest
Operationssaal	Operationssaal
Märtyrern	Märtyrern
besprachen	besprachen
abalienierest	abalienierest
drängte	drängte
Renegat	Renegat
Abschreckung	Abschreckung
Höschen	Höschen
harrtest	harrtest
Vorstädte	Vorstädte
flitzte	flitzte
Schade	Schade
Ölspur	Ölspur
gespeist	gespeist
platz	platz
glühende	glühende
verhalte	verhalte
Blütenachse	Blütenachse
emittiert	emittiert
anzeige	anzeige
faule	faule
zerreißt	zerreißt
Bettler	Bettler
herrschst	herrschst
hatten	hatten
verkürze	verkürze
überbewertet	überbewertet
imkeret	imkeret
Ion	Ion
Recht	Recht
regelten	regelten
kabbelet	kabbelet
kupiert	kupiert
dramatisiert	dramatisiert
Oberlippe	Oberlippe
Wirst	Wirst
griechischen	griechischen
Wänden	Wänden
bewürben	bewürben
Hummer	Hummer
reifst	reifst
strandeten	strandeten
Anschlägen	Anschlägen
helle	helle
bemächtigest	bemächtigest
Fischzucht	Fischzucht
unterstützten	unterstützten
Iberers	Iberers
Nukleinsäure	Nukleinsäure
weichen	weichen
versklavt	versklavt
lobte	lobte
gehetzt	gehetzt
verschickte	verschickte
käbbelnd	käbbelnd
Zankapfel	Zankapfel
scheiterest	scheiterest
Prostylos	Prostylos
unterforderten	unterforderten
griff	griff
befehlen	befehlen
raffinier	raffinier
verdreht	verdreht
separieret	separieret
äusserst	äusserst
Wache	Wache
Anlässe	Anlässe
glaubet	glaubet
ratet	ratet
evaluierten	evaluierten
trüge	trüge
klönen	klönen
ansehet	ansehet
ausrufest	ausrufest
prosteten	prosteten
nahest	nahest
maximierten	maximierten
Abarten	Abarten
verblute	verblute
borgst	borgst
Hode	Hode
gibst	gibst
Hüftgelenken	Hüftgelenken
wechselwirkt	wechselwirkt
verkündige	verkündige
feire	feire
fluktuierte	fluktuierte
buddeln	buddeln
geräuchert	geräuchert
rebelliere	rebelliere
Apportierhunde	Apportierhunde
versteckt	versteckt
Meere	Meere
verunglimpfte	verunglimpfte
widerrufe	widerrufe
wisperest	wisperest
Wiederauferstehung	Wiederauferstehung
pflügte	pflügte
regiert	regiert
Gedränge	Gedränge
entwischten	entwischten
Freizeitzentren	Freizeitzentren
Bürzeln	Bürzeln
Grieche	Grieche
Weinen	Weinen
ummantelten	ummantelten
auflöst	auflöst
Kehre	Kehre
fluppe	fluppe
feierte	feierte
Tauben	Tauben
waren	waren
konsumiere	konsumiere
erfahret	erfahret
schichteten	schichteten
Bushaltestelle	Bushaltestelle
Reichweiten	Reichweiten
Päderast	Päderast
Gut	Gut
umkäme	umkäme
gehört	gehört
zagest	zagest
predige	predige
ersten	ersten
Rehen	Rehen
Vorhäuten	Vorhäuten
verfehle	verfehle
ehret	ehret
Hüfte	Hüfte
löst	löst
trödeltest	trödeltest
verformen	verformen
Klassenzimmer	Klassenzimmer
stützen	stützen
selbst	selbst
Platte	Platte
Keilen	Keilen
blockiert	blockiert
Zahnfleischentzündung	Zahnfleischentzündung
Welpen	Welpen
kitzele	kitzele
NAND-Gatter	NAND-Gatter
argumentierest	argumentierest
Heere	Heere
Herde	Herde
Augur	Augur
Isobar	Isobar
haste	haste
Laubholz	Laubholz
wallfahrteten	wallfahrteten
glänzte	glänzte
schlafest	schlafest
dürften	dürften
beschlug	beschlug
Schuhen	Schuhen
Gewalttäter	Gewalttäter
Same	Same
eurer	eurer
Funkfeuern	Funkfeuern
schenkte	schenkte
vertilgst	vertilgst
vereinbaren	vereinbaren
verludet	verludet
Gasen	Gasen
arbeit	arbeit
strafst	strafst
fallen	fallen
Unterseite	Unterseite
produziert	produziert
Soge	Soge
Seiten	Seiten
Bittersüß	Bittersüß
nachwandelst	nachwandelst
vermahnet	vermahnet
Preis	Preis
schießen	schießen
gedurft	gedurft
offenbart	offenbart
jedes	jedes
betrete	betrete
Tritte	Tritte
beunruhige	beunruhige
maßen	maßen
Deuterium	Deuterium
Aggressoren	Aggressoren
begehr	begehr
Königen	Königen
Pimmel	Pimmel
Gitarrenspieler	Gitarrenspieler
Sekretärinnen	Sekretärinnen
Gedanke	Gedanke
verzehrt	verzehrt
Ställen	Ställen
erkälteten	erkälteten
verwaiset	verwaiset
Biokraftstoffes	Biokraftstoffes
brause	brause
erkaltest	erkaltest
folge	folge
quasselten	quasselten
Büstenhaltern	Büstenhaltern
beneidete	beneidete
denaturierten	denaturierten
aufkäme	aufkäme
Rutheniumkomplexen	Rutheniumkomplexen
gestatteten	gestatteten
notlande	notlande
näht	näht
Geber	Geber
herrschest	herrschest
entwischtet	entwischtet
erwachet	erwachet
arrivieren	arrivieren
Radfahrern	Radfahrern
Aufsätzen	Aufsätzen
essen	essen
Käsereiben	Käsereiben
bereuest	bereuest
Möbiusbänder	Möbiusbänder
überdächte	überdächte
verbot	verbot
Ein	Ein
scheu	scheu
emigriert	emigriert
folgt	folgt
wegen	wegen
lieget	lieget
amputierten	amputierten
Hälmchen	Hälmchen
pflegte	pflegte
Lazarette	Lazarette
erben	erben
deines	deines
Erdkruste	Erdkruste
schämest	schämest
Sabotagen	Sabotagen
Gauner	Gauner
Atemluft	Atemluft
Seines	Seines
Tun	Tun
gelobend	gelobend
Vollkornbrot	Vollkornbrot
frommen	frommen
einst	einst
Ratsherren	Ratsherren
segmentiere	segmentiere
Panzerschrecke	Panzerschrecke
zwingst	zwingst
aßest	aßest
rammte	rammte
durchwacht	durchwacht
desensibilisierte	desensibilisierte
Seehechten	Seehechten
wehrtest	wehrtest
zerfielest	zerfielest
hinterlegt	hinterlegt
downloadete	downloadete
anruft	anruft
überliefere	überliefere
Prozedur	Prozedur
graben	graben
verführt	verführt
spezialisierst	spezialisierst
tanze	tanze
dolmetschst	dolmetschst
reichtest	reichtest
regiertest	regiertest
verfügten	verfügten
Berylle	Berylle
tagen	tagen
vertilgten	vertilgten
verwirft	verwirft
Strahlentierchen	Strahlentierchen
verunglimpftet	verunglimpftet
Gedächtnissen	Gedächtnissen
Dominicanerinnen	Dominicanerinnen
Charakteristika	Charakteristika
verwirfst	verwirfst
Leitungswegs	Leitungswegs
Beilen	Beilen
Sabbaten	Sabbaten
putzt	putzt
Weinberge	Weinberge
Steine	Steine
blenden	blenden
gleite	gleite
Zebrahaies	Zebrahaies
Erstarren	Erstarren
dressierten	dressierten
Zebrahai	Zebrahai
stiege	stiege
fülle	fülle
entert	entert
moppet	moppet
emigrieret	emigrieret
lochtest	lochtest
Kandidaturen	Kandidaturen
Denkmünzen	Denkmünzen
fladerest	fladerest
Lehrbüchern	Lehrbüchern
dunkelten	dunkelten
Rubinen	Rubinen
fette	fette
Judenrat	Judenrat
Kleinodien	Kleinodien
Sinne	Sinne
Vordenkern	Vordenkern
Kortholt	Kortholt
Gänge	Gänge
verkauft	verkauft
sieht	sieht
Alles	Alles
zeugest	zeugest
Abkömmlingen	Abkömmlingen
Gegebenheit	Gegebenheit
Räte	Räte
verdrängen	verdrängen
Trinker	Trinker
Vetter	Vetter
heiße	heiße
wünschtest	wünschtest
Rußen	Rußen
Zankapfels	Zankapfels
sabbere	sabbere
baten	baten
Sünders	Sünders
unterschiede	unterschiede
entsetzet	entsetzet
mußten	mußten
Sphären	Sphären
Welchen	Welchen
Nachruf	Nachruf
Carbids	Carbids
Türkise	Türkise
Aktenkoffer	Aktenkoffer
verbündend	verbündend
Gibt	Gibt
Suffix	Suffix
schmettern	schmettern
Ihre	Ihre
bedurftest	bedurftest
imitiert	imitiert
Wachtel	Wachtel
Erlösungen	Erlösungen
Atomphysiker	Atomphysiker
kauern	kauern
Vorstädten	Vorstädten
blase	blase
Sauberfrauen	Sauberfrauen
übrigbleibet	übrigbleibet
Märkten	Märkten
Metonymie	Metonymie
Stör	Stör
hineinbrächte	hineinbrächte
Wandergesellen	Wandergesellen
tagten	tagten
erzwinget	erzwinget
desertiertet	desertiertet
Anmelder	Anmelder
liebend	liebend
Abkömmling	Abkömmling
Zipfelmütze	Zipfelmütze
stationierten	stationierten
Protonen	Protonen
vernichtest	vernichtest
breche	breche
keiner	keiner
Leitkegeln	Leitkegeln
rüstetet	rüstetet
Pforten	Pforten
rebellieren	rebellieren
Subspezies	Subspezies
haarten	haarten
hängte	hängte
vierte	vierte
beißet	beißet
bombardiere	bombardiere
entgegenkamst	entgegenkamst
brillieren	brillieren
grünet	grünet
erforschet	erforschet
wohnest	wohnest
verziehst	verziehst
Schleppern	Schleppern
Schlagzeugern	Schlagzeugern
Impedanz	Impedanz
dampfst	dampfst
schnelle	schnelle
bräunst	bräunst
gehörte	gehörte
Gerät	Gerät
Hinterwäldler	Hinterwäldler
denaturierte	denaturierte
Leuchtstoff	Leuchtstoff
steigeret	steigeret
Drillingen	Drillingen
Rotzinkerz	Rotzinkerz
produzierte	produzierte
sortierest	sortierest
vernickele	vernickele
bringet	bringet
sitzt	sitzt
stiegen	stiegen
dringst	dringst
salz	salz
Notständen	Notständen
Münzsammlung	Münzsammlung
hängen	hängen
beklagte	beklagte
untersagest	untersagest
raten	raten
treibst	treibst
fügt	fügt
Strontiumamalgams	Strontiumamalgams
inszeniere	inszeniere
Gehorcht	Gehorcht
sehnst	sehnst
schleiß	schleiß
Säcken	Säcken
explodierst	explodierst
Hadith	Hadith
schmelzt	schmelzt
reinstitutionalisiert	reinstitutionalisiert
verdrängt	verdrängt
Dorngesträuchen	Dorngesträuchen
Bezeugungen	Bezeugungen
Penis	Penis
Chlorwasserstoffmolekül	Chlorwasserstoffmolekül
Gasgemischen	Gasgemischen
verführest	verführest
schläfst	schläfst
verführte	verführte
falle	falle
übrigbleibt	übrigbleibt
pfänden	pfänden
tätowiertet	tätowiertet
kaufet	kaufet
spielte	spielte
Freibergits	Freibergits
Beschuldigungen	Beschuldigungen
bimmelte	bimmelte
keinen	keinen
ackerst	ackerst
mehr	mehr
Lazarett	Lazarett
sollte	sollte
Essen	Essen
Assimilationen	Assimilationen
Automatikgetrieben	Automatikgetrieben
Volkslehre	Volkslehre
bleibet	bleibet
Erdbirnen	Erdbirnen
Antimustern	Antimustern
Glühwürmchen	Glühwürmchen
velarisierend	velarisierend
stickt	stickt
Maxima	Maxima
malen	malen
Zeitüberschreitung	Zeitüberschreitung
Joche	Joche
feiern	feiern
suchest	suchest
Hirt	Hirt
Lusitaner	Lusitaner
Entrées	Entrées
nagelte	nagelte
Stühle	Stühle
gerne	gerne
Geschreis	Geschreis
leistete	leistete
Angabe	Angabe
Eisstein	Eisstein
irgendeine	irgendeine
Wissen	Wissen
revoltiert	revoltiert
Fäuste	Fäuste
besitzest	besitzest
Organisationen	Organisationen
Adeliepinguin	Adeliepinguin
Anachronismus	Anachronismus
kürze	kürze
erlassen	erlassen
verseifet	verseifet
schaue	schaue
Wembley-Tore	Wembley-Tore
Drohkulissen	Drohkulissen
aufheben	aufheben
ihres	ihres
Campingplatzes	Campingplatzes
gebt	gebt
Geliebten	Geliebten
lehrst	lehrst
vertreibe	vertreibe
geschämt	geschämt
Mitschuld	Mitschuld
inhalier	inhalier
schmusen	schmusen
Buben	Buben
bauet	bauet
Elastomer	Elastomer
Botokuden	Botokuden
erbet	erbet
Trägerwellen	Trägerwellen
Samarskite	Samarskite
Ihren	Ihren
leset	leset
Willen	Willen
Wasserbades	Wasserbades
Wahn	Wahn
Homodimeren	Homodimeren
Haarverlusten	Haarverlusten
Monden	Monden
Mitwisserschaft	Mitwisserschaft
Gässchen	Gässchen
Aktivisten	Aktivisten
erdachten	erdachten
bestanden	bestanden
sitzet	sitzet
Atmosphäre	Atmosphäre
Mopp	Mopp
unterrichtet	unterrichtet
initiieret	initiieret
Tetraiodide	Tetraiodide
rufest	rufest
jauchzt	jauchzt
Rast	Rast
entschädiget	entschädiget
Maß	Maß
Werdet	Werdet
lesen	lesen
folget	folget
scherze	scherze
murmelten	murmelten
Unglaube	Unglaube
Fingerhüte	Fingerhüte
hupet	hupet
Traggasen	Traggasen
folgtet	folgtet
frevles	frevles
entmineralisieren	entmineralisieren
verglühte	verglühte
keines	keines
Lenkstange	Lenkstange
schicke	schicke
Begrenzungen	Begrenzungen
wohnet	wohnet
porträtiert	porträtiert
Schenke	Schenke
taufst	taufst
blondieren	blondieren
Bebauungsplänen	Bebauungsplänen
tunet	tunet
foppst	foppst
Leitungsweg	Leitungsweg
Amputierten	Amputierten
Feldbett	Feldbett
Magier	Magier
Gar	Gar
blamierten	blamierten
skypst	skypst
Basilisken	Basilisken
Auszüge	Auszüge
Empfängnisverhütungen	Empfängnisverhütungen
fragst	fragst
Ach	Ach
Bienen	Bienen
weine	weine
Suche	Suche
meißelt	meißelt
überführen	überführen
globalisier	globalisier
Preisanstiegen	Preisanstiegen
Kerf	Kerf
hobt	hobt
Märchenbuches	Märchenbuches
ausführen	ausführen
schöpfen	schöpfen
Katz-und-Maus-Spielen	Katz-und-Maus-Spielen
fern	fern
Prozeduren	Prozeduren
veranstalten	veranstalten
verstand	verstand
instanziiere	instanziiere
abweichest	abweichest
mußt	mußt
Aerosole	Aerosole
Tumult	Tumult
Freitagnachmittage	Freitagnachmittage
bündelet	bündelet
handhaben	handhaben
Küstenwache	Küstenwache
bewähret	bewähret
brachen	brachen
Stärket	Stärket
replizierten	replizierten
leuchtete	leuchtete
verhalten	verhalten
Gerichten	Gerichten
polymerisierte	polymerisierte
schaffte	schaffte
decket	decket
fluchten	fluchten
Laubbaum	Laubbaum
Wären	Wären
tendiertet	tendiertet
fluchet	fluchet
glawbten	glawbten
designierst	designierst
zentrierest	zentrierest
trompetete	trompetete
ermordeten	ermordeten
überweise	überweise
beleidigst	beleidigst
zähle	zähle
Elementen	Elementen
bekehrt	bekehrt
widerriefe	widerriefe
schwangt	schwangt
Wogen	Wogen
sinnst	sinnst
Luftschiff	Luftschiff
Schlepper	Schlepper
sabbelt	sabbelt
Küsserei	Küsserei
erlaube	erlaube
amenagierst	amenagierst
bummelet	bummelet
narret	narret
weinst	weinst
schlaft	schlaft
rächte	rächte
frohlockten	frohlockten
vertilgte	vertilgte
plagen	plagen
Weinstöcken	Weinstöcken
wart	wart
Darlegungen	Darlegungen
bekehrst	bekehrst
Neuigkeiten	Neuigkeiten
konvergiere	konvergiere
schnappt	schnappt
moppst	moppst
Blicksilber	Blicksilber
verwirrest	verwirrest
den	den
heiligten	heiligten
Braunrallen	Braunrallen
verbraucht	verbraucht
überweist	überweist
blondieret	blondieret
unterwerfe	unterwerfe
Anliegen	Anliegen
unterrichten	unterrichten
Blechen	Blechen
kosten	kosten
weichet	weichet
emailliert	emailliert
füllst	füllst
Lobgesängen	Lobgesängen
erzürnt	erzürnt
hatte	hatte
vollendest	vollendest
pulsiert	pulsiert
Aussätzige	Aussätzige
überreichst	überreichst
verbirgst	verbirgst
Falz	Falz
Spanne	Spanne
strafe	strafe
möchtet	möchtet
stäupte	stäupte
Android	Android
Gläubigen	Gläubigen
flucht	flucht
Hypochlorit	Hypochlorit
spaltest	spaltest
Gängen	Gängen
duckt	duckt
wallte	wallte
Sehne	Sehne
leget	leget
teilte	teilte
Zwingburg	Zwingburg
skypet	skypet
stoppte	stoppte
Sexten	Sexten
gekröst	gekröst
Alte	Alte
Jünglinge	Jünglinge
Schlager	Schlager
möppertet	möppertet
Reststoff	Reststoff
drangen	drangen
ballaste	ballaste
kontaktieret	kontaktieret
Blockflöten	Blockflöten
vier	vier
Reliquiar	Reliquiar
streckst	streckst
jaget	jaget
Krustentier	Krustentier
bromiert	bromiert
verführe	verführe
polymerisier	polymerisier
klaget	klaget
versuche	versuche
tagest	tagest
Unrecht	Unrecht
Blumenstrauß	Blumenstrauß
ausgerecktem	ausgerecktem
speiset	speiset
stimmte	stimmte
Verehrer	Verehrer
Adler	Adler
treffen	treffen
Drohkulisse	Drohkulisse
Herrn	Herrn
Quatsch	Quatsch
begrübest	begrübest
Sekte	Sekte
schenkest	schenkest
foppte	foppte
Großstädtern	Großstädtern
traget	traget
wetzte	wetzte
Nährmediums	Nährmediums
Silbererzen	Silbererzen
erklingt	erklingt
Heiden	Heiden
Lichte	Lichte
sitzest	sitzest
kabelst	kabelst
Perlen	Perlen
griffe	griffe
Hirsche	Hirsche
Rechnung	Rechnung
Ehren	Ehren
Märkte	Märkte
krank	krank
Optimisten	Optimisten
Bärenfellen	Bärenfellen
erzeigte	erzeigte
funktionalisiertest	funktionalisiertest
babbelt	babbelt
ausziehst	ausziehst
aber	aber
werte	werte
Kuttern	Kuttern
tätowierest	tätowierest
Obszönität	Obszönität
zeuge	zeuge
seine	seine
unterwirft	unterwirft
bebten	bebten
überschneidet	überschneidet
Gummibäumen	Gummibäumen
Grenzwert	Grenzwert
ankerst	ankerst
Leichnamen	Leichnamen
weist	weist
bebet	bebet
Füße	Füße
speise	speise
hauen	hauen
Seehechte	Seehechte
folgst	folgst
Schönredner	Schönredner
anhangen	anhangen
ahnten	ahnten
Rotscheitelreiher	Rotscheitelreiher
schwöre	schwöre
Geschichtsbüchern	Geschichtsbüchern
Früchtchen	Früchtchen
linken	linken
konsolidierest	konsolidierest
Gebern	Gebern
verlähmte	verlähmte
Mähnenwölfen	Mähnenwölfen
Gelobt	Gelobt
Hansen	Hansen
eskalieret	eskalieret
Fluoratom	Fluoratom
entsetzten	entsetzten
gebäre	gebäre
spähet	spähet
Eisenkraut	Eisenkraut
erzwangt	erzwangt
Büschen	Büschen
spiele	spiele
hupen	hupen
dürfte	dürfte
quantisierte	quantisierte
bauest	bauest
scheinest	scheinest
Habe	Habe
Spektroskopie	Spektroskopie
vermischen	vermischen
changiere	changiere
Ösophagospasmus	Ösophagospasmus
rufet	rufet
verzweifelt	verzweifelt
lockerte	lockerte
zerfielen	zerfielen
sintertest	sintertest
privatisiert	privatisiert
Kalb	Kalb
Nadelbäume	Nadelbäume
gefügt	gefügt
Gedrängen	Gedrängen
Kochfeldern	Kochfeldern
beauftragt	beauftragt
bromiertet	bromiertet
betrübend	betrübend
grünst	grünst
parkierst	parkierst
Greyerzern	Greyerzern
beeindruckt	beeindruckt
heiligem	heiligem
Laiben	Laiben
begraben	begraben
losen	losen
begehret	begehret
reiche	reiche
Polierstahl	Polierstahl
verschmelze	verschmelze
Raucherin	Raucherin
bezieht	bezieht
widmest	widmest
radierte	radierte
einführen	einführen
verweise	verweise
zwänget	zwänget
konvertieren	konvertieren
absolviere	absolviere
Gehorsam	Gehorsam
Cyclodextrinen	Cyclodextrinen
versteckst	versteckst
Stoffwechselwegen	Stoffwechselwegen
verhören	verhören
Schlagzeuger	Schlagzeuger
Rehbock	Rehbock
streuen	streuen
entrümpelest	entrümpelest
Hast	Hast
verbirgt	verbirgt
deaktiviere	deaktiviere
Schafen	Schafen
bekotete	bekotete
Zirkelschlüssen	Zirkelschlüssen
Bluff	Bluff
Zeitplan	Zeitplan
Deutungen	Deutungen
massakrierten	massakrierten
Plüschtier	Plüschtier
produzierest	produzierest
behütet	behütet
Genies	Genies
zwängtet	zwängtet
duckmäuseret	duckmäuseret
Gewürzen	Gewürzen
Zeitungsente	Zeitungsente
instrumentalisierest	instrumentalisierest
besäen	besäen
Pfleglinge	Pfleglinge
simulierst	simulierst
Forschungen	Forschungen
evaluiert	evaluiert
stille	stille
Gehorsams	Gehorsams
Collagen	Collagen
höbest	höbest
rühmet	rühmet
verdeckt	verdeckt
Fiesling	Fiesling
Laufringen	Laufringen
trage	trage
aufwacht	aufwacht
halt	halt
Gehilfe	Gehilfe
sorget	sorget
Trümmersprachen	Trümmersprachen
generiertet	generiertet
pflanze	pflanze
liste	liste
Kriegsknechte	Kriegsknechte
Öfchens	Öfchens
gibt	gibt
protestierst	protestierst
Schätzen	Schätzen
dekompiliertest	dekompiliertest
ermordet	ermordet
verkleinerest	verkleinerest
abziehen	abziehen
wichsten	wichsten
Affenbrotbaum	Affenbrotbaum
warne	warne
erliegest	erliegest
drücken	drücken
kabelten	kabelten
Aufprall	Aufprall
Filzläusen	Filzläusen
benachrichtige	benachrichtige
Apostels	Apostels
Linke	Linke
berufen	berufen
steigen	steigen
Gichten	Gichten
Orgel	Orgel
Deinem	Deinem
zittere	zittere
bequemte	bequemte
eingeht	eingeht
ausrufen	ausrufen
selber	selber
fragmentierst	fragmentierst
Tukans	Tukans
Technetate	Technetate
Freibergit	Freibergit
Fellhandschuh	Fellhandschuh
könnte	könnte
Düften	Düften
Haue	Haue
einführt	einführt
trieben	trieben
Erdboden	Erdboden
Jagdhunden	Jagdhunden
Kanzleien	Kanzleien
schlängelt	schlängelt
höbet	höbet
Wechselstube	Wechselstube
Pausbacke	Pausbacke
spukest	spukest
reinigst	reinigst
Kristallen	Kristallen
Glaubst	Glaubst
aufrichtet	aufrichtet
Ränken	Ränken
Kräfte	Kräfte
ehrst	ehrst
Borkenkäfer	Borkenkäfer
Fahrzeugkatalysatoren	Fahrzeugkatalysatoren
enträtselst	enträtselst
Stätte	Stätte
Fanmeile	Fanmeile
raubet	raubet
Briefe	Briefe
Einheimische	Einheimische
hämmerte	hämmerte
Mäppchen	Mäppchen
Schneidern	Schneidern
feiert	feiert
Bienenzüchter	Bienenzüchter
Excimerlasern	Excimerlasern
privatisierest	privatisierest
dienest	dienest
entfolgst	entfolgst
zeugen	zeugen
ermordetet	ermordetet
Konzentrate	Konzentrate
attackieret	attackieret
spannte	spannte
wohnte	wohnte
flambierest	flambierest
möget	möget
Danket	Danket
erscheine	erscheine
könnt	könnt
Komponistinnen	Komponistinnen
gedenk	gedenk
verachte	verachte
fragest	fragest
werdest	werdest
gut	gut
besitze	besitze
Leichenschauhäusern	Leichenschauhäusern
greife	greife
observiertest	observiertest
Weg	Weg
Einzelgänger	Einzelgänger
zittertest	zittertest
Unsere	Unsere
gedenkest	gedenkest
widmeten	widmeten
brechet	brechet
deckte	deckte
hasset	hasset
zuppen	zuppen
Sucht	Sucht
Empörungen	Empörungen
billigte	billigte
Soll	Soll
Klärung	Klärung
höhnte	höhnte
Aufpralle	Aufpralle
spaltetest	spaltetest
harrten	harrten
Schlüchten	Schlüchten
Knöllchen	Knöllchen
Kerzenlichtern	Kerzenlichtern
verzehre	verzehre
aufrichten	aufrichten
Gemeinde	Gemeinde
meinem	meinem
verkündigst	verkündigst
Äquatoren	Äquatoren
Petersfisch	Petersfisch
herrschte	herrschte
vermagst	vermagst
pensionierten	pensionierten
geleiteten	geleiteten
Leichname	Leichname
ringe	ringe
verdränget	verdränget
Ärgernisse	Ärgernisse
attestiertet	attestiertet
Milchflasche	Milchflasche
Abbildern	Abbildern
schämten	schämten
Sexte	Sexte
hasse	hasse
erlaubest	erlaubest
Astats	Astats
erstehet	erstehet
babbelst	babbelst
stoße	stoße
grünte	grünte
Mähnenwolf	Mähnenwolf
installierten	installierten
einernten	einernten
Notärztin	Notärztin
eigenen	eigenen
opfern	opfern
drängten	drängten
entwaffnest	entwaffnest
übersteht	übersteht
schwebte	schwebte
reife	reife
notlandet	notlandet
Flamen	Flamen
Lehne	Lehne
Theologie	Theologie
tragest	tragest
Tiegel	Tiegel
zügelten	zügelten
kugelten	kugelten
Fluorkohlenwasserstoffe	Fluorkohlenwasserstoffe
bringst	bringst
Firnis	Firnis
Barbareien	Barbareien
Preisanstieg	Preisanstieg
erbringst	erbringst
blätteret	blätteret
Euphemismen	Euphemismen
schmierte	schmierte
klingest	klingest
Lesen	Lesen
surrst	surrst
baggerst	baggerst
fertigte	fertigte
defragmentierten	defragmentierten
schlummerte	schlummerte
kremieren	kremieren
Metaphern	Metaphern
tobend	tobend
vergibst	vergibst
zerrüttete	zerrüttete
benachrichtiget	benachrichtiget
köderte	köderte
Grönländer	Grönländer
jappen	jappen
Päckchen	Päckchen
Gnaden	Gnaden
entzweit	entzweit
begeben	begeben
erziehen	erziehen
beweise	beweise
arme	arme
Polarisation	Polarisation
frikassiert	frikassiert
revoltieren	revoltieren
ackerest	ackerest
grüßet	grüßet
kämpfen	kämpfen
Halbmonden	Halbmonden
irren	irren
Wiederauferstehungen	Wiederauferstehungen
Enden	Enden
entsetzen	entsetzen
Stätten	Stätten
knacktest	knacktest
entständen	entständen
befestigte	befestigte
Tintenfische	Tintenfische
Sonnenfinsternissen	Sonnenfinsternissen
egge	egge
bemächtigte	bemächtigte
Lebenskräften	Lebenskräften
Aspartame	Aspartame
bekehrten	bekehrten
Futtermitteln	Futtermitteln
Päckchens	Päckchens
Radiergummis	Radiergummis
Palästen	Palästen
Flensern	Flensern
Chronisten	Chronisten
trotzest	trotzest
arm	arm
aufkämen	aufkämen
Putschisten	Putschisten
Fischen	Fischen
Kernspaltung	Kernspaltung
Stäben	Stäben
bückest	bückest
Naturen	Naturen
Geschwindigkeitsmesser	Geschwindigkeitsmesser
erinnerest	erinnerest
Denen	Denen
verspäte	verspäte
Selbstversuch	Selbstversuch
Wehe	Wehe
Reißnagel	Reißnagel
Fahrzeugkatalysator	Fahrzeugkatalysator
verlasset	verlasset
Traubenlese	Traubenlese
Landstreichereien	Landstreichereien
Aerosolen	Aerosolen
Genetikerin	Genetikerin
leerst	leerst
Worten	Worten
mußte	mußte
auszieht	auszieht
Selbstversuchen	Selbstversuchen
Bankettes	Bankettes
inspirierest	inspirierest
verleumdetest	verleumdetest
Bergsteiger	Bergsteiger
vereinbarten	vereinbarten
schwirret	schwirret
bezahlest	bezahlest
löste	löste
Küstenwachen	Küstenwachen
Zinkionen	Zinkionen
Ärschen	Ärschen
überstehend	überstehend
Schnallen	Schnallen
Garten	Garten
tyrannisierte	tyrannisierte
Atommassen	Atommassen
Mobilfunknetze	Mobilfunknetze
solchem	solchem
Finanzministerium	Finanzministerium
Verwundete	Verwundete
wirft	wirft
Königreichen	Königreichen
Schwänzchen	Schwänzchen
knuffend	knuffend
verzögerten	verzögerten
kochte	kochte
glaubte	glaubte
Fußbodens	Fußbodens
verbrauchten	verbrauchten
Spielen	Spielen
vernickelte	vernickelte
meuternd	meuternd
jeden	jeden
kabelte	kabelte
untersagtest	untersagtest
Heptamolybdat	Heptamolybdat
köderet	köderet
Zöpfen	Zöpfen
Gegenleistung	Gegenleistung
eurem	eurem
Martyrologien	Martyrologien
höben	höben
Träumers	Träumers
schmuggele	schmuggele
Kuckucke	Kuckucke
Metapher	Metapher
hättest	hättest
Oxalate	Oxalate
spritzet	spritzet
handhabest	handhabest
fliehe	fliehe
Schnipsel	Schnipsel
kürzest	kürzest
Landwirte	Landwirte
Sabbatjahre	Sabbatjahre
Gläubiger	Gläubiger
Einen	Einen
keulte	keulte
Nigger	Nigger
ungefälschtem	ungefälschtem
Satzungen	Satzungen
vermahnten	vermahnten
Gründungsprivileg	Gründungsprivileg
schreiet	schreiet
Stadtbezirke	Stadtbezirke
Rundbriefe	Rundbriefe
umhüllt	umhüllt
Schnitzeljagd	Schnitzeljagd
stapfst	stapfst
Bruchstriches	Bruchstriches
Binden	Binden
wiederholte	wiederholte
ratschlaget	ratschlaget
Fingerhüten	Fingerhüten
geahnt	geahnt
Geschäfte	Geschäfte
erpresst	erpresst
absagen	absagen
Fremde	Fremde
Bildschirmfotos	Bildschirmfotos
schwängen	schwängen
Abtrünnigen	Abtrünnigen
Gehorchet	Gehorchet
übersehest	übersehest
mangeln	mangeln
Laie	Laie
Leuchtstoffen	Leuchtstoffen
beläufst	beläufst
Dessous	Dessous
versuchten	versuchten
bewahrst	bewahrst
genehmigt	genehmigt
überführt	überführt
Nachweisreagenzien	Nachweisreagenzien
wechselwirkte	wechselwirkte
verrostet	verrostet
besäet	besäet
flirtest	flirtest
Könige	Könige
überwachest	überwachest
Isobars	Isobars
machet	machet
Loben	Loben
lüg	lüg
Ehre	Ehre
Fahlflanken-Ameisenwürgern	Fahlflanken-Ameisenwürgern
dissentierten	dissentierten
Sogen	Sogen
Schlagern	Schlagern
Aha-Erlebnisse	Aha-Erlebnisse
Dienstgrade	Dienstgrade
ungeistlichen	ungeistlichen
fassest	fassest
recycelten	recycelten
grüßte	grüßte
Leichenschauhäuser	Leichenschauhäuser
Friesen	Friesen
sabbelten	sabbelten
Flöße	Flöße
musizierte	musizierte
nähe	nähe
danket	danket
deponierte	deponierte
Aacheners	Aacheners
Mäuse	Mäuse
Fallt	Fallt
zählend	zählend
verkündet	verkündet
Herabsetzung	Herabsetzung
holte	holte
sündigst	sündigst
föchten	föchten
wechseln	wechseln
Sollte	Sollte
verließet	verließet
Dödeln	Dödeln
Speeren	Speeren
Basilikum	Basilikum
verfinstere	verfinstere
nütze	nütze
Musters	Musters
belüftete	belüftete
räucheret	räucheret
bröckeln	bröckeln
irgendein	irgendein
Gelobet	Gelobet
stifte	stifte
Besprechung	Besprechung
dressieret	dressieret
vertilgen	vertilgen
Honigbären	Honigbären
brandeten	brandeten
aßet	aßet
Spießen	Spießen
würdet	würdet
Gehör	Gehör
hänget	hänget
Kassiteriten	Kassiteriten
umhüll	umhüll
Kadavergehorsam	Kadavergehorsam
Fäusten	Fäusten
schöpfest	schöpfest
ratschlagten	ratschlagten
Zensus	Zensus
Wembley-Toren	Wembley-Toren
Sitzfleisches	Sitzfleisches
Zainen	Zainen
verschlimmere	verschlimmere
links	links
Falle	Falle
Aktienkursen	Aktienkursen
Bärte	Bärte
wache	wache
protestierest	protestierest
schwächst	schwächst
peilst	peilst
Deckenfarbe	Deckenfarbe
ungehorsame	ungehorsame
verspielest	verspielest
zupftet	zupftet
zeltest	zeltest
zirpe	zirpe
bewies	bewies
setze	setze
Prüfbericht	Prüfbericht
Vipernatter	Vipernatter
erpress	erpress
Beteiligten	Beteiligten
Arsenbergwerk	Arsenbergwerk
Zapfen	Zapfen
Pfleglingen	Pfleglingen
gedächten	gedächten
Kontraindikation	Kontraindikation
besichert	besichert
schauet	schauet
ihre	ihre
gelangte	gelangte
heiliget	heiliget
nützt	nützt
verbarg	verbarg
gedenken	gedenken
Argyrodite	Argyrodite
erzeigt	erzeigt
Streite	Streite
Schrei	Schrei
begehrend	begehrend
Reisebüro	Reisebüro
Einöden	Einöden
Erfahrung	Erfahrung
verselbstständige	verselbstständige
offenbarten	offenbarten
gezügelt	gezügelt
putzte	putzte
Kaufhäusern	Kaufhäusern
Leuchtkäfern	Leuchtkäfern
ratschlagte	ratschlagte
alles	alles
schnürest	schnürest
füsilierte	füsilierte
nimmt	nimmt
bedürftet	bedürftet
Mäusen	Mäusen
Politologe	Politologe
befestigt	befestigt
grüntet	grüntet
Dithiolan	Dithiolan
Frettchen	Frettchen
Gasgemisch	Gasgemisch
Akkadierinnen	Akkadierinnen
Piratensendern	Piratensendern
Gerücht	Gerücht
Plumpse	Plumpse
Cholesterin	Cholesterin
besänftiget	besänftiget
Gurt	Gurt
habet	habet
Kopfsalaten	Kopfsalaten
Fellhandschuhen	Fellhandschuhen
Uranerzen	Uranerzen
Blitzen	Blitzen
erfüllet	erfüllet
Brötchen	Brötchen
legest	legest
grünt	grünt
emendierte	emendierte
mampfte	mampfte
predigend	predigend
Röcken	Röcken
ritten	ritten
beansprucht	beansprucht
Drachenblut	Drachenblut
sagen	sagen
säumen	säumen
anzeigest	anzeigest
oxidierst	oxidierst
wehren	wehren
Wehklagen	Wehklagen
Erfahrungen	Erfahrungen
Sichelzellenanämien	Sichelzellenanämien
imprägnieret	imprägnieret
Katamaranen	Katamaranen
Geheimdienst	Geheimdienst
leider	leider
Tiefen	Tiefen
Schamentzündungen	Schamentzündungen
Zöpfe	Zöpfe
gelobest	gelobest
Einer	Einer
Suchanfrage	Suchanfrage
Leichtmetallen	Leichtmetallen
funktioniertest	funktioniertest
verbärgen	verbärgen
saget	saget
Heringe	Heringe
Fittiche	Fittiche
gedacht	gedacht
Primärenergie	Primärenergie
Imperialismen	Imperialismen
endlagerten	endlagerten
erwärmten	erwärmten
hydrolysierest	hydrolysierest
Alibi	Alibi
offenbarest	offenbarest
der	der
widmend	widmend
Tausche	Tausche
härten	härten
Astat	Astat
begrabe	begrabe
Referenzen	Referenzen
Traubenlesen	Traubenlesen
zürne	zürne
regiere	regiere
Dödel	Dödel
Managementsystemen	Managementsystemen
funktionalisierte	funktionalisierte
bewässerst	bewässerst
schreiben	schreiben
schauten	schauten
zwang	zwang
aufnahmen	aufnahmen
touchierte	touchierte
sichten	sichten
Auszügen	Auszügen
streute	streute
Aprikose	Aprikose
Epidemie	Epidemie
erweckest	erweckest
lebst	lebst
Pfunde	Pfunde
Kühen	Kühen
träumte	träumte
Lusitaners	Lusitaners
ramme	ramme
liehen	liehen
decken	decken
säume	säume
Ass	Ass
ausgereckte	ausgereckte
erbrütet	erbrütet
addieret	addieret
Aprikosen	Aprikosen
Jahre	Jahre
Gase	Gase
widmet	widmet
unseren	unseren
liege	liege
grün	grün
forschte	forschte
kichert	kichert
Schneider	Schneider
Gehörst	Gehörst
verdeckst	verdeckst
Strontiumamalgamen	Strontiumamalgamen
Graphem	Graphem
Füllfedern	Füllfedern
mineralisierten	mineralisierten
konnte	konnte
traueret	traueret
Fokus	Fokus
vertonet	vertonet
