höfðum	höfðum
flokkum	flokkum
bifreiðirnar	bifreiðirnar
Sumir	Sumir
skiptir	skiptir
sum	sum
fisksins	fisksins
flæmskunni	flæmskunni
karakterinn	karakterinn
abbadís	abbadís
fletti	fletti
sæbjúgað	sæbjúgað
felldu	felldu
ljúka	ljúka
undirfylkingu	undirfylkingu
staðlana	staðlana
sparðs	sparðs
undirættbálkur	undirættbálkur
drolls	drolls
Fyrst	Fyrst
verðsins	verðsins
kjörfurstann	kjörfurstann
varna	varna
hvor	hvor
hornum	hornum
köstum	köstum
drýgi	drýgi
krossfesti	krossfesti
ályktaði	ályktaði
leynið	leynið
gærum	gærum
köstuðuð	köstuðuð
færð	færð
klæindi	klæindi
vissa	vissa
brúðkaupsgestum	brúðkaupsgestum
skildist	skildist
totta	totta
hersveitirnar	hersveitirnar
jötunuxa	jötunuxa
kýklópa	kýklópa
Æðst	Æðst
báðum	báðum
flokks	flokks
ályktað	ályktað
stoppana	stoppana
brauðin	brauðin
þvargaði	þvargaði
yfirheitið	yfirheitið
forsíðurnar	forsíðurnar
lítt	lítt
þolið	þolið
ofan	ofan
þrýstir	þrýstir
boði	boði
flokkarnir	flokkarnir
varaliðið	varaliðið
sin	sin
flestir	flestir
dissar	dissar
ergir	ergir
þínir	þínir
spörfuglar	spörfuglar
lýsir	lýsir
plóg	plóg
kosti	kosti
bundna	bundna
prúttuðuð	prúttuðuð
leyfðu	leyfðu
læsir	læsir
kökukeflið	kökukeflið
öskra	öskra
skyldir	skyldir
Allan	Allan
rétti	rétti
reiðhjólunum	reiðhjólunum
diskur	diskur
frjókornanna	frjókornanna
fetinu	fetinu
kjaltan	kjaltan
leyni	leyni
viskí	viskí
líkamana	líkamana
Hinir	Hinir
Hvorn	Hvorn
hlutirnir	hlutirnir
glatast	glatast
talaði	talaði
æðikollur	æðikollur
grunnla	grunnla
vonirnar	vonirnar
leglinum	leglinum
göfga	göfga
lastmælir	lastmælir
gyldu	gyldu
klæða	klæða
pípuhatta	pípuhatta
skyti	skyti
Mælir	Mælir
þvörguðuð	þvörguðuð
mestu	mestu
ryðönd	ryðönd
fá	fá
ráða	ráða
súrefnisskortinum	súrefnisskortinum
aðvöruðu	aðvöruðu
þakkirnar	þakkirnar
fleygi	fleygi
skytuð	skytuð
nöðru	nöðru
þurrísi	þurrísi
hryggdýrin	hryggdýrin
hitamælunum	hitamælunum
gjóstarnir	gjóstarnir
vettlingum	vettlingum
markmanninn	markmanninn
drottnara	drottnara
væskill	væskill
brennu	brennu
keyptu	keyptu
flokkurinn	flokkurinn
iðnað	iðnað
hnéskel	hnéskel
skjóta	skjóta
þrengingar	þrengingar
kúrdískan	kúrdískan
fjórðu	fjórðu
safnað	safnað
makar	makar
flokkunum	flokkunum
æðahnútarnir	æðahnútarnir
skelfisk	skelfisk
drottnaðir	drottnaðir
annir	annir
verðin	verðin
hvað	hvað
hneigðu	hneigðu
mynstur	mynstur
arga	arga
leiðin	leiðin
siðaði	siðaði
hreyfingum	hreyfingum
hengduð	hengduð
strákar	strákar
söfnum	söfnum
leyfi	leyfi
matana	matana
hafði	hafði
lofaðir	lofaðir
teið	teið
eru	eru
hræddum	hræddum
skipi	skipi
liðum	liðum
leitaði	leitaði
fermingu	fermingu
talsmaðurinn	talsmaðurinn
sparkið	sparkið
úthlutum	úthlutum
fyrstum	fyrstum
reyndur	reyndur
leysa	leysa
neytti	neytti
jafna	jafna
tunglsjúkur	tunglsjúkur
hvílist	hvílist
kyssti	kyssti
notið	notið
áfrýjuninni	áfrýjuninni
saltkjöt	saltkjöt
betrir	betrir
brögðin	brögðin
Þessu	Þessu
sekt	sekt
Naksons	Naksons
Allir	Allir
dæmdir	dæmdir
gagntakið	gagntakið
kantöturnar	kantöturnar
steikinni	steikinni
skilin	skilin
skrifir	skrifir
breyting	breyting
tilreiknar	tilreiknar
keyptir	keyptir
grísku	grísku
formönnunum	formönnunum
fé	fé
valinn	valinn
félagsins	félagsins
gómunum	gómunum
krælandi	krælandi
rigni	rigni
þekkti	þekkti
skýrðuð	skýrðuð
flokkur	flokkur
karsi	karsi
útisundlaugar	útisundlaugar
beila	beila
enga	enga
allt	allt
deyðast	deyðast
tómlætinu	tómlætinu
svæfði	svæfði
skörð	skörð
tröllkonu	tröllkonu
saknir	saknir
sjússa	sjússa
gætti	gætti
værum	værum
hópi	hópi
húsbóndanum	húsbóndanum
ræddi	ræddi
anda	anda
mengaði	mengaði
sérhverja	sérhverja
missum	missum
malbikið	malbikið
tíða	tíða
viðskiptavinunum	viðskiptavinunum
húsfrúna	húsfrúna
sett	sett
vörina	vörina
Kristur	Kristur
svertuð	svertuð
hnéskelin	hnéskelin
testósteróns	testósteróns
þjálfunin	þjálfunin
bagli	bagli
klæðinu	klæðinu
eldpipar	eldpipar
hristi	hristi
kennd	kennd
freistið	freistið
fjörðunum	fjörðunum
þol	þol
skækjan	skækjan
smaragður	smaragður
sérhvern	sérhvern
skjótandi	skjótandi
fimbulvetrunum	fimbulvetrunum
Hvert	Hvert
félag	félag
samfundi	samfundi
granatepli	granatepli
ættuð	ættuð
hórkarla	hórkarla
senda	senda
minna	minna
haltra	haltra
sleiksins	sleiksins
páskaeggja	páskaeggja
kinnaliturinn	kinnaliturinn
körtunnar	körtunnar
þolinu	þolinu
svikarar	svikarar
mögnum	mögnum
fæla	fæla
þérum	þérum
opinberast	opinberast
veldu	veldu
voruð	voruð
logni	logni
vanadínið	vanadínið
lokum	lokum
sjálfsmyndina	sjálfsmyndina
lauguðum	lauguðum
æðsta	æðsta
læra	læra
trompið	trompið
engir	engir
kalkspati	kalkspati
fjölgyðistrúm	fjölgyðistrúm
tilreiknuð	tilreiknuð
hópa	hópa
kefði	kefði
höfðuð	höfðuð
frjókorn	frjókorn
skip	skip
Réttu	Réttu
kunna	kunna
lénið	lénið
iðnum	iðnum
þinn	þinn
spurningarnar	spurningarnar
sætti	sætti
stjórna	stjórna
sættir	sættir
skyttuna	skyttuna
skíri	skíri
vændinu	vændinu
kastið	kastið
ruslinu	ruslinu
umskorna	umskorna
tignaðir	tignaðir
folunum	folunum
síðar	síðar
endaþarmsmökin	endaþarmsmökin
raðið	raðið
bandstrik	bandstrik
kom	kom
verslaði	verslaði
hálsum	hálsum
fjöldann	fjöldann
þægindi	þægindi
móðunum	móðunum
plógs	plógs
risa	risa
mæðraveldis	mæðraveldis
báðar	báðar
berð	berð
hópur	hópur
meltingar	meltingar
mína	mína
hvítvíni	hvítvíni
réttur	réttur
lærandi	lærandi
morgnunum	morgnunum
Lík	Lík
ákærðu	ákærðu
vínguðinum	vínguðinum
dauði	dauði
flesta	flesta
hagnaðurinn	hagnaðurinn
gólfið	gólfið
Svía	Svía
hvort	hvort
sjálft	sjálft
greinanna	greinanna
lærir	lærir
eigi	eigi
kantinn	kantinn
Hvor	Hvor
mala	mala
jöfnuninni	jöfnuninni
sjálfstraust	sjálfstraust
styrkjandi	styrkjandi
sleppt	sleppt
fyllir	fyllir
saurgar	saurgar
rek	rek
svikanna	svikanna
laukst	laukst
mynstrið	mynstrið
segðu	segðu
garðyrkjufræðin	garðyrkjufræðin
forsíðu	forsíðu
hlýddi	hlýddi
geddanna	geddanna
þessi	þessi
hjúkrar	hjúkrar
nokkurt	nokkurt
Hvern	Hvern
grasafræðin	grasafræðin
endarnir	endarnir
tréblásturshljóðfærið	tréblásturshljóðfærið
tilreiknaði	tilreiknaði
vegasalt	vegasalt
aukaspyrnunum	aukaspyrnunum
fóðrunum	fóðrunum
etýðunnar	etýðunnar
er	er
geymdi	geymdi
nasismanum	nasismanum
skipin	skipin
þandi	þandi
engan	engan
misstum	misstum
æxlanirnar	æxlanirnar
búna	búna
postuladóm	postuladóm
leitast	leitast
verðið	verðið
skjóla	skjóla
hvílíkan	hvílíkan
gátuð	gátuð
fremur	fremur
nú	nú
þvo	þvo
spila	spila
þessir	þessir
rífst	rífst
fiska	fiska
stjórnuðu	stjórnuðu
bílstjórar	bílstjórar
skírir	skírir
bíóið	bíóið
hugsaði	hugsaði
þrýstu	þrýstu
græddur	græddur
portum	portum
svæfið	svæfið
grundarinnar	grundarinnar
krossfestið	krossfestið
velþóknanlegur	velþóknanlegur
áfrýjunar	áfrýjunar
lýsti	lýsti
hefðuð	hefðuð
brekkusóley	brekkusóley
reyni	reyni
skjallið	skjallið
köngulónum	köngulónum
rekið	rekið
jörðuðum	jörðuðum
flokkanna	flokkanna
breidd	breidd
rithöfund	rithöfund
höfnunum	höfnunum
verði	verði
reynd	reynd
aborra	aborra
laugaði	laugaði
fósturs	fósturs
fjölgyðistrúarinnar	fjölgyðistrúarinnar
fylla	fylla
stoppunar	stoppunar
sendu	sendu
skyldu	skyldu
fundunum	fundunum
bumbubúum	bumbubúum
drunið	drunið
minnsta	minnsta
uppi	uppi
ættfeðurnir	ættfeðurnir
denara	denara
trúðu	trúðu
sjúg	sjúg
ferming	ferming
flotaforingja	flotaforingja
vökina	vökina
nefndur	nefndur
reiðin	reiðin
skildir	skildir
grískuna	grískuna
árósa	árósa
geisladiskurinn	geisladiskurinn
æðahnúta	æðahnúta
djúpt	djúpt
orð	orð
hryggja	hryggja
kennir	kennir
bifaði	bifaði
sleppir	sleppir
Hinar	Hinar
glatt	glatt
porti	porti
líkinu	líkinu
kölluðu	kölluðu
vorum	vorum
dygðarinnar	dygðarinnar
svæfi	svæfi
bullinu	bullinu
heróíninu	heróíninu
Send	Send
slíkar	slíkar
gjörðu	gjörðu
fjóra	fjóra
sóunin	sóunin
vitrunum	vitrunum
segir	segir
haft	haft
hross	hross
saurgað	saurgað
Mæli	Mæli
hringaðir	hringaðir
dúksins	dúksins
sjöunda	sjöunda
gramúlfarnir	gramúlfarnir
flettuð	flettuð
fundin	fundin
skipt	skipt
okkarínurnar	okkarínurnar
kryfði	kryfði
hreppa	hreppa
vissir	vissir
mátt	mátt
syndum	syndum
hillu	hillu
dansa	dansa
krossfest	krossfest
fleygt	fleygt
hvorum	hvorum
dæmið	dæmið
trú	trú
mær	mær
sýndu	sýndu
gráðu	gráðu
als	als
kostum	kostum
suma	suma
skýrið	skýrið
herpir	herpir
horfum	horfum
búninganna	búninganna
birtast	birtast
lakka	lakka
hugi	hugi
senduð	senduð
spá	spá
Belgann	Belgann
samfundinn	samfundinn
raust	raust
lénin	lénin
nokkrir	nokkrir
sæbjúgu	sæbjúgu
kúfi	kúfi
girninu	girninu
bólstraskýs	bólstraskýs
hug	hug
fylli	fylli
fisks	fisks
tíðir	tíðir
vögguvísa	vögguvísa
gjöri	gjöri
báða	báða
settuð	settuð
þjöl	þjöl
árós	árós
svengdin	svengdin
leiða	leiða
hefjir	hefjir
æfingu	æfingu
hnerri	hnerri
klappandi	klappandi
ræðu	ræðu
fyllt	fyllt
nekt	nekt
deyðir	deyðir
skaflinn	skaflinn
vinátta	vinátta
nýtir	nýtir
búningana	búningana
Skyldi	Skyldi
flokka	flokka
tómstundagamni	tómstundagamni
leikara	leikara
klúðrir	klúðrir
teiknuðuð	teiknuðuð
fegrað	fegrað
svindlurum	svindlurum
hjakka	hjakka
æðarblikans	æðarblikans
hvern	hvern
mengar	mengar
bæru	bæru
breiddu	breiddu
sektir	sektir
bjarkar	bjarkar
vísindamanni	vísindamanni
hugsunum	hugsunum
sokk	sokk
ærumeiðingum	ærumeiðingum
meðalið	meðalið
fiskum	fiskum
fyrstir	fyrstir
fæðu	fæðu
minnið	minnið
hætt	hætt
hænsna	hænsna
leiðsla	leiðsla
líks	líks
uppfærum	uppfærum
göfguðuð	göfguðuð
lærður	lærður
hryggðu	hryggðu
fenguð	fenguð
sent	sent
flokkar	flokkar
gallín	gallín
ógleði	ógleði
náðu	náðu
lúkks	lúkks
færðir	færðir
Þessa	Þessa
eðju	eðju
póker	póker
stundir	stundir
goldið	goldið
iðnanna	iðnanna
hátíða	hátíða
félaga	félaga
Anna	Anna
skamma	skamma
vallarmiðju	vallarmiðju
umfjöllunin	umfjöllunin
neyddu	neyddu
salt	salt
hryggðuð	hryggðuð
gullið	gullið
þarfaþing	þarfaþing
græddir	græddir
móðunni	móðunni
komast	komast
væruð	væruð
spjarir	spjarir
minnt	minnt
öfunduðuð	öfunduðuð
gagntaka	gagntaka
prentuðuð	prentuðuð
færeysku	færeysku
látna	látna
rifrildi	rifrildi
missir	missir
komist	komist
liðanna	liðanna
málaði	málaði
peningi	peningi
einstaklingurinn	einstaklingurinn
skjólanna	skjólanna
Hef	Hef
skírnir	skírnir
dána	dána
skýrt	skýrt
þekktu	þekktu
mættuð	mættuð
gyldir	gyldir
vakar	vakar
eruð	eruð
leynduð	leynduð
sátunni	sátunni
ráðið	ráðið
hvílir	hvílir
ölum	ölum
vanheilagan	vanheilagan
hjúkruðum	hjúkruðum
hálsinum	hálsinum
blóðfrumunum	blóðfrumunum
auka	auka
klippti	klippti
þátíðina	þátíðina
heddinu	heddinu
hugsast	hugsast
iðnina	iðnina
tíin	tíin
stýrið	stýrið
hluti	hluti
ráðanna	ráðanna
kristinn	kristinn
höndla	höndla
geimar	geimar
hávellunum	hávellunum
gætið	gætið
svörður	svörður
koki	koki
sproki	sproki
stundina	stundina
aftra	aftra
tefldir	tefldir
lifnaður	lifnaður
vitru	vitru
kyrki	kyrki
bíóinu	bíóinu
hnefann	hnefann
vakir	vakir
missti	missti
setti	setti
erfðafræðina	erfðafræðina
líksins	líksins
bumbubúa	bumbubúa
hefli	hefli
veitti	veitti
sumt	sumt
treystuð	treystuð
fjörður	fjörður
raðað	raðað
vara	vara
róður	róður
hóp	hóp
undantekið	undantekið
postuladóms	postuladóms
furunni	furunni
hafanna	hafanna
áfrýjandi	áfrýjandi
heimtuð	heimtuð
stunda	stunda
þéruðu	þéruðu
Asíu	Asíu
miðgildið	miðgildið
skán	skán
endurnýjuðu	endurnýjuðu
væri	væri
ættum	ættum
brottfararinnar	brottfararinnar
elskaði	elskaði
yrðuð	yrðuð
lessum	lessum
tröllkonurnar	tröllkonurnar
Hverja	Hverja
leitum	leitum
geddu	geddu
hólanna	hólanna
samfund	samfund
greina	greina
melting	melting
hýstum	hýstum
pats	pats
snúi	snúi
kalkúnum	kalkúnum
vísindamönnunum	vísindamönnunum
viskíi	viskíi
minningin	minningin
komst	komst
maur	maur
hljóðfæri	hljóðfæri
heróínið	heróínið
markspyrnu	markspyrnu
horfið	horfið
flugvellirnir	flugvellirnir
teikna	teikna
naðranna	naðranna
þinnar	þinnar
fiskana	fiskana
fórintum	fórintum
sviti	sviti
jaka	jaka
fimmta	fimmta
hins	hins
byggðin	byggðin
hýdrat	hýdrat
heiman	heiman
tárum	tárum
kjaftar	kjaftar
dryn	dryn
raustu	raustu
sinnar	sinnar
þöggum	þöggum
vælið	vælið
heilsaði	heilsaði
Enginn	Enginn
stikana	stikana
kjörinn	kjörinn
perlanna	perlanna
hliðin	hliðin
sleðum	sleðum
fæddu	fæddu
Leita	Leita
æðst	æðst
sérhljóð	sérhljóð
jarðarberjum	jarðarberjum
gorm	gorm
hliðum	hliðum
vind	vind
Munum	Munum
gætir	gætir
hafs	hafs
kjarnakorn	kjarnakorn
gjömmum	gjömmum
hirðana	hirðana
minnkaðir	minnkaðir
tignað	tignað
hverju	hverju
fremstur	fremstur
kalksteininum	kalksteininum
grípur	grípur
félagi	félagi
kostandi	kostandi
hnerruðu	hnerruðu
gjaldir	gjaldir
strika	strika
skrifið	skrifið
kvænti	kvænti
villimönnunum	villimönnunum
gjöra	gjöra
gæja	gæja
saurgi	saurgi
gætum	gætum
spjótkast	spjótkast
sérhver	sérhver
hópum	hópum
samvistarfallinu	samvistarfallinu
afrit	afrit
sést	sést
samkomulag	samkomulag
sérhvert	sérhvert
testósterónið	testósterónið
nokkur	nokkur
hvílíks	hvílíks
faldi	faldi
útlisti	útlisti
prómetínið	prómetínið
metið	metið
erum	erum
farsíma	farsíma
brjóstbeins	brjóstbeins
tengisagnirnar	tengisagnirnar
látið	látið
þrælkaði	þrælkaði
skepnu	skepnu
þögguðu	þögguðu
væla	væla
Verði	Verði
framar	framar
meiðsli	meiðsli
ríkdóminn	ríkdóminn
beltum	beltum
þrælkuðu	þrælkuðu
skipast	skipast
markgreifa	markgreifa
ljóðlista	ljóðlista
erfir	erfir
leynir	leynir
ranns	ranns
aliönd	aliönd
bliku	bliku
vísum	vísum
kalli	kalli
leyfanna	leyfanna
óskum	óskum
smókinn	smókinn
mæðraveldi	mæðraveldi
múslimarnir	múslimarnir
vörum	vörum
brögðum	brögðum
skírandi	skírandi
Slíkar	Slíkar
skips	skips
uppfærið	uppfærið
óvirt	óvirt
dæma	dæma
hvar	hvar
reyndi	reyndi
lakki	lakki
múkka	múkka
viðræða	viðræða
hirða	hirða
ýmist	ýmist
lykkjuna	lykkjuna
samtengingin	samtengingin
sjötta	sjötta
dauðinn	dauðinn
trúarjátningin	trúarjátningin
plastanna	plastanna
inni	inni
dagurinn	dagurinn
græddum	græddum
eyrað	eyrað
svikurunum	svikurunum
reyrinn	reyrinn
verðinu	verðinu
eitt	eitt
frumbyggja	frumbyggja
þínu	þínu
andast	andast
settu	settu
sona	sona
standi	standi
hrákann	hrákann
furunum	furunum
skipti	skipti
hlið	hlið
þína	þína
hefði	hefði
slepptu	slepptu
sagt	sagt
tindurinn	tindurinn
mistrið	mistrið
Sjálfir	Sjálfir
dýralækni	dýralækni
dæmi	dæmi
málir	málir
langaði	langaði
æðikolls	æðikolls
slíkir	slíkir
krossfestuð	krossfestuð
nefnda	nefnda
sérhljóða	sérhljóða
mistilteinum	mistilteinum
högum	högum
hryggt	hryggt
stundanna	stundanna
lífvörðurinn	lífvörðurinn
guðinn	guðinn
skipta	skipta
burtu	burtu
þriðju	þriðju
vakirnar	vakirnar
kveikinn	kveikinn
kantötum	kantötum
snúast	snúast
gjörist	gjörist
smalahundur	smalahundur
nokkurs	nokkurs
alda	alda
síðastir	síðastir
sléttsöng	sléttsöng
óhamingjunni	óhamingjunni
gerast	gerast
lík	lík
dauða	dauða
ergið	ergið
tréblásturshljóðfæris	tréblásturshljóðfæris
unglingsins	unglingsins
láta	láta
öslir	öslir
krydda	krydda
brekkusóleyjunum	brekkusóleyjunum
týndur	týndur
gjörði	gjörði
þín	þín
minntir	minntir
handrits	handrits
enginn	enginn
fremst	fremst
umkringdi	umkringdi
lok	lok
byggir	byggir
hvíldina	hvíldina
heitir	heitir
úti	úti
öfunda	öfunda
minnast	minnast
Sjálfur	Sjálfur
staðurinn	staðurinn
fram	fram
birti	birti
stundum	stundum
denar	denar
ríktu	ríktu
hvorir	hvorir
minnanna	minnanna
fjarlægir	fjarlægir
endaþarmsmökum	endaþarmsmökum
Annað	Annað
spöðum	spöðum
æðarblika	æðarblika
gorminn	gorminn
Komum	Komum
órétti	órétti
geirfuglsins	geirfuglsins
þrasið	þrasið
frumvörpum	frumvörpum
klæðandi	klæðandi
úkraínsku	úkraínsku
kossinn	kossinn
færum	færum
helgi	helgi
skammir	skammir
bifa	bifa
eignarlýð	eignarlýð
árósinn	árósinn
aldir	aldir
dæmt	dæmt
leystu	leystu
bóndi	bóndi
græði	græði
hneykjandi	hneykjandi
hraða	hraða
skiptum	skiptum
tjörnum	tjörnum
hvíl	hvíl
skjalla	skjalla
hefjið	hefjið
hagi	hagi
prenta	prenta
dans	dans
Mannssonurinn	Mannssonurinn
skytir	skytir
jóna	jóna
elska	elska
skírt	skírt
skjóti	skjóti
frystiskápum	frystiskápum
fiskur	fiskur
talsmannsins	talsmannsins
net	net
hjartar	hjartar
hvítvín	hvítvín
söfnuðu	söfnuðu
tennisboltann	tennisboltann
lífvarðarins	lífvarðarins
hina	hina
aðdáandann	aðdáandann
ofar	ofar
skil	skil
kysstu	kysstu
færanna	færanna
settir	settir
vafa	vafa
sparði	sparði
Jótlandið	Jótlandið
jarða	jarða
skýrum	skýrum
mærin	mærin
hefðarsætin	hefðarsætin
Hafið	Hafið
hráka	hráka
leysir	leysir
mínum	mínum
þrengdist	þrengdist
hlutarins	hlutarins
eignina	eignina
greinisins	greinisins
laggaðir	laggaðir
krossgátuna	krossgátuna
afklæðum	afklæðum
ríkt	ríkt
prómetín	prómetín
bestu	bestu
heilsu	heilsu
ytra	ytra
vísur	vísur
forsælu	forsælu
spurninga	spurninga
akursins	akursins
selleríið	selleríið
boð	boð
leyndi	leyndi
skyldum	skyldum
safnaðir	safnaðir
hitti	hitti
malbiki	malbiki
einræktað	einræktað
vindum	vindum
fagurfræðina	fagurfræðina
blóðflögur	blóðflögur
afritunum	afritunum
rasskinna	rasskinna
unga	unga
hrekjast	hrekjast
bændurnir	bændurnir
gafflana	gafflana
eflduð	eflduð
heflaði	heflaði
treystir	treystir
ráðsins	ráðsins
krossgáturnar	krossgáturnar
minnstu	minnstu
Fyrir	Fyrir
þótt	þótt
sektuðu	sektuðu
endurnýja	endurnýja
kjörið	kjörið
heyrðuð	heyrðuð
hænsnunum	hænsnunum
étið	étið
hnúts	hnúts
skíðaði	skíðaði
garðyrkjufræði	garðyrkjufræði
hæðir	hæðir
minntuð	minntuð
freista	freista
eðjan	eðjan
sakna	sakna
aukafalls	aukafalls
hryggðir	hryggðir
bólstraskýjum	bólstraskýjum
eiturlyfjanotendurnir	eiturlyfjanotendurnir
hjartarsalt	hjartarsalt
þjáði	þjáði
lofaði	lofaði
fjallgarð	fjallgarð
muni	muni
skrifi	skrifi
vökunum	vökunum
fýri	fýri
tígrisdýrs	tígrisdýrs
styrki	styrki
breytist	breytist
handbolta	handbolta
hverja	hverja
geimur	geimur
frökkum	frökkum
múgæsingu	múgæsingu
hneykið	hneykið
græðum	græðum
þerrar	þerrar
neitt	neitt
kysstuð	kysstuð
gættum	gættum
fiskinn	fiskinn
hætti	hætti
eitur	eitur
líkir	líkir
drekki	drekki
kontrabassann	kontrabassann
gaffallinn	gaffallinn
sinni	sinni
undu	undu
myrti	myrti
klædduð	klædduð
hreinsunareld	hreinsunareld
skírðuð	skírðuð
drýgði	drýgði
veikir	veikir
vináttuna	vináttuna
auki	auki
stigbreytingu	stigbreytingu
kúfinn	kúfinn
tískurnar	tískurnar
treystu	treystu
lærði	lærði
mynstrum	mynstrum
hæsinnar	hæsinnar
kirsuber	kirsuber
Mun	Mun
ríkir	ríkir
djúp	djúp
hagnýta	hagnýta
heltir	heltir
róðra	róðra
þanka	þanka
hengið	hengið
glerhaf	glerhaf
burt	burt
hötuðu	hötuðu
safnast	safnast
lofgjörðin	lofgjörðin
mörkin	mörkin
alla	alla
næst	næst
settum	settum
sæbjúga	sæbjúga
neins	neins
spjara	spjara
fimbulvetur	fimbulvetur
frumvörpunum	frumvörpunum
stigbreytinguna	stigbreytinguna
munduð	munduð
tár	tár
gjörast	gjörast
fjarlægð	fjarlægð
plokki	plokki
eiginmanninn	eiginmanninn
æptir	æptir
umkringja	umkringja
étum	étum
sendum	sendum
vitrast	vitrast
bruna	bruna
kallað	kallað
lítið	lítið
sérhljóðum	sérhljóðum
stærum	stærum
fást	fást
skapi	skapi
spils	spils
lifðu	lifðu
felldur	felldur
spáði	spáði
rósemi	rósemi
dæmdu	dæmdu
sónatína	sónatína
blóðboga	blóðboga
glasi	glasi
belgi	belgi
kastar	kastar
safna	safna
smalahundurinn	smalahundurinn
aftraði	aftraði
herstígvél	herstígvél
belgir	belgir
súrefnisskorturinn	súrefnisskorturinn
skutum	skutum
efaði	efaði
lausnarinnar	lausnarinnar
glataði	glataði
spáð	spáð
óskuðu	óskuðu
eyjar	eyjar
heiðagæs	heiðagæs
hryggi	hryggi
pókersins	pókersins
syndgað	syndgað
endar	endar
séum	séum
skitur	skitur
tyrkneskan	tyrkneskan
gull	gull
skaut	skaut
lastmælt	lastmælt
fært	fært
voru	voru
köntunum	köntunum
lifandann	lifandann
berklar	berklar
slíkum	slíkum
Hvað	Hvað
togi	togi
ráðast	ráðast
mætti	mætti
fyrstu	fyrstu
kastir	kastir
ert	ert
efldi	efldi
bögum	bögum
japönskunni	japönskunni
reiðum	reiðum
rymur	rymur
kökukeflis	kökukeflis
höf	höf
ónáðuðuð	ónáðuðuð
hýdratið	hýdratið
haginn	haginn
páskaeggsins	páskaeggsins
véið	véið
söfnuðuð	söfnuðuð
lengur	lengur
Hvaða	Hvaða
gólfa	gólfa
stór	stór
hitamælinn	hitamælinn
reka	reka
vor	vor
horft	horft
egnir	egnir
argaðir	argaðir
skyldufræðinni	skyldufræðinni
metin	metin
Ert	Ert
dáið	dáið
spítalarnir	spítalarnir
hneigði	hneigði
mistilteins	mistilteins
körtum	körtum
æxlununum	æxlununum
Æðstu	Æðstu
undur	undur
fullyrtu	fullyrtu
vömbin	vömbin
granateplunum	granateplunum
stæri	stæri
fræðimennirnir	fræðimennirnir
Komu	Komu
einum	einum
jarðir	jarðir
brekkusniglunum	brekkusniglunum
talentu	talentu
birtir	birtir
ýsu	ýsu
kinn	kinn
skírlífar	skírlífar
byggi	byggi
síðast	síðast
rithöfundum	rithöfundum
burst	burst
blikum	blikum
skilaði	skilaði
öðluðumst	öðluðumst
meta	meta
stökkum	stökkum
styrkti	styrkti
fuglafræðin	fuglafræðin
hvæstuð	hvæstuð
legkaka	legkaka
gefið	gefið
jafnað	jafnað
trompin	trompin
minn	minn
virti	virti
munu	munu
kvarsinu	kvarsinu
hræddur	hræddur
kvæntir	kvæntir
góla	góla
óskar	óskar
hryggði	hryggði
fórnir	fórnir
blessuðuð	blessuðuð
hlutunum	hlutunum
þau	þau
vitrir	vitrir
hlátur	hlátur
skarði	skarði
máluðuð	máluðuð
handboltaþjálfara	handboltaþjálfara
akra	akra
staði	staði
eyddist	eyddist
einu	einu
lessan	lessan
kylfurnar	kylfurnar
strandlengjum	strandlengjum
fældu	fældu
synið	synið
staða	staða
lungnaberklarnir	lungnaberklarnir
vökin	vökin
félaganum	félaganum
hneigðuð	hneigðuð
postuladómi	postuladómi
hitt	hitt
plokka	plokka
skammar	skammar
meira	meira
engu	engu
vestranum	vestranum
brenna	brenna
þerra	þerra
líkist	líkist
ógleðina	ógleðina
hryggdýrið	hryggdýrið
sérhljóðs	sérhljóðs
brunann	brunann
höfðu	höfðu
líkið	líkið
sokka	sokka
kjarnakorni	kjarnakorni
tálvon	tálvon
sneri	sneri
Fyrsti	Fyrsti
skýt	skýt
stórhertoga	stórhertoga
skilinn	skilinn
fluttu	fluttu
sigur	sigur
alur	alur
gættir	gættir
lastmælin	lastmælin
seldir	seldir
kalkspatið	kalkspatið
klæddu	klæddu
kúturinn	kúturinn
gyltuna	gyltuna
ríbónúkleösunum	ríbónúkleösunum
skírðu	skírðu
vekti	vekti
munið	munið
leyndum	leyndum
órétt	órétt
gjaldi	gjaldi
íveru	íveru
guðir	guðir
þrengdi	þrengdi
drollinu	drollinu
slúttir	slúttir
dæmdur	dæmdur
þekktur	þekktur
slúttað	slúttað
kameljóns	kameljóns
ges	ges
glóbrystingurinn	glóbrystingurinn
hlýddu	hlýddu
hersveitina	hersveitina
þerruðum	þerruðum
leiddu	leiddu
skipa	skipa
alinn	alinn
valdið	valdið
vanadíni	vanadíni
fræðimönnunum	fræðimönnunum
krossfesta	krossfesta
færði	færði
skutuð	skutuð
fórnið	fórnið
ytri	ytri
löstum	löstum
þekkingar	þekkingar
hljóma	hljóma
þakkir	þakkir
gjörður	gjörður
byggjum	byggjum
fleygði	fleygði
loka	loka
deyðið	deyðið
þekktuð	þekktuð
nefnt	nefnt
hrifsaðir	hrifsaðir
öðrum	öðrum
fyllið	fyllið
tíðum	tíðum
félaganna	félaganna
pipars	pipars
sparka	sparka
flett	flett
breiddi	breiddi
átu	átu
bifreið	bifreið
klæddum	klæddum
heyrðir	heyrðir
múslima	múslima
geymduð	geymduð
feðgin	feðgin
flokkana	flokkana
leikmannanna	leikmannanna
Hvar	Hvar
greinum	greinum
brjálæðið	brjálæðið
eigendur	eigendur
fullnuð	fullnuð
grafíts	grafíts
efuðuð	efuðuð
færðuð	færðuð
færu	færu
lofa	lofa
kommúnistinn	kommúnistinn
umkringdum	umkringdum
drottnarans	drottnarans
brennur	brennur
elsku	elsku
tengisagna	tengisagna
skottulækni	skottulækni
Rétt	Rétt
siðuðum	siðuðum
tind	tind
orðið	orðið
skrifum	skrifum
misskilnings	misskilnings
maurs	maurs
horn	horn
ríbónúkleasann	ríbónúkleasann
hirðin	hirðin
minnisspili	minnisspili
rasskinn	rasskinn
yrðum	yrðum
kvænir	kvænir
almætti	almætti
handrit	handrit
sig	sig
verslið	verslið
markspyrnum	markspyrnum
æpa	æpa
reki	reki
æxlunum	æxlunum
knýði	knýði
samfundurinn	samfundurinn
hylli	hylli
stöðunum	stöðunum
dýralæknar	dýralæknar
labba	labba
lögð	lögð
hliðið	hliðið
ritum	ritum
lýsið	lýsið
kristni	kristni
Jason	Jason
stund	stund
snæri	snæri
oft	oft
böðullinn	böðullinn
sums	sums
sprokunum	sprokunum
blóðflögum	blóðflögum
okkarínu	okkarínu
styrktum	styrktum
lessa	lessa
gervitunglinu	gervitunglinu
káeta	káeta
skýrðir	skýrðir
ræða	ræða
gátum	gátum
kanti	kanti
skylduð	skylduð
legköku	legköku
heitt	heitt
hætta	hætta
bols	bols
hin	hin
skeifa	skeifa
ættkvíslinni	ættkvíslinni
korkum	korkum
birtur	birtur
fær	fær
hræddir	hræddir
Haf	Haf
upp	upp
opinber	opinber
fljótt	fljótt
heiðurinn	heiðurinn
jafnt	jafnt
ungmennis	ungmennis
gengi	gengi
sygjum	sygjum
hryggið	hryggið
lögðu	lögðu
tyrkneskunnar	tyrkneskunnar
notum	notum
krakkið	krakkið
neitað	neitað
vambirnar	vambirnar
hreyfinganna	hreyfinganna
dramb	dramb
þeirri	þeirri
málað	málað
flaga	flaga
sífrar	sífrar
byggði	byggði
ungmenni	ungmenni
vola	vola
gjósta	gjósta
reyndu	reyndu
dansinn	dansinn
leyndin	leyndin
mínu	mínu
safni	safni
valdi	valdi
símaskrána	símaskrána
skituna	skituna
undirættbálkunum	undirættbálkunum
rita	rita
loga	loga
styrktir	styrktir
sakargiftir	sakargiftir
aðgreindu	aðgreindu
langað	langað
undirfylkinganna	undirfylkinganna
stundinni	stundinni
allan	allan
boðið	boðið
getur	getur
efla	efla
dæmanna	dæmanna
ákæru	ákæru
væru	væru
sjálfstraustsins	sjálfstraustsins
rótfestu	rótfestu
öllu	öllu
jötunuxann	jötunuxann
knýir	knýir
söndunum	söndunum
höfum	höfum
kostuðu	kostuðu
kokið	kokið
kæra	kæra
ofurstinn	ofurstinn
uppfærðuð	uppfærðuð
Innan	Innan
breyttu	breyttu
byggðir	byggðir
komna	komna
prúttandi	prúttandi
styrktu	styrktu
fýrum	fýrum
eigandann	eigandann
krókusi	krókusi
sátu	sátu
siða	siða
hreyfir	hreyfir
góm	góm
greininum	greininum
anganna	anganna
önnunum	önnunum
týnda	týnda
rigna	rigna
fjallgarðs	fjallgarðs
maka	maka
best	best
glansi	glansi
mín	mín
enda	enda
gyldi	gyldi
spáðu	spáðu
væli	væli
körfuboltar	körfuboltar
leiðast	leiðast
færist	færist
arfur	arfur
hnefanum	hnefanum
byggið	byggið
skýrði	skýrði
jarðarberin	jarðarberin
fundinn	fundinn
gjammar	gjammar
skækjum	skækjum
minnist	minnist
þriðji	þriðji
kökukefli	kökukefli
almættið	almættið
styrkja	styrkja
öðlast	öðlast
engi	engi
hyllið	hyllið
Fyrstur	Fyrstur
öll	öll
fáist	fáist
hvílu	hvílu
aðfaranæturnar	aðfaranæturnar
borð	borð
styrkt	styrkt
einstaklinginn	einstaklinginn
Allur	Allur
morgnanna	morgnanna
aukafallsliðina	aukafallsliðina
verðs	verðs
gerðu	gerðu
vísurnar	vísurnar
setta	setta
Hin	Hin
mættum	mættum
sparkar	sparkar
krossfestu	krossfestu
norrænu	norrænu
lofandi	lofandi
þerraði	þerraði
kastað	kastað
viki	viki
felldir	felldir
akurinn	akurinn
kröftugi	kröftugi
skrifaði	skrifaði
Sum	Sum
kontrabassinn	kontrabassinn
kok	kok
breyta	breyta
fullreyndur	fullreyndur
allir	allir
skipaði	skipaði
neyðið	neyðið
blindir	blindir
þreytast	þreytast
laxins	laxins
trunta	trunta
peninginn	peninginn
eign	eign
læsti	læsti
hálfleikur	hálfleikur
skjótum	skjótum
jörðina	jörðina
Leitast	Leitast
Jasoni	Jasoni
sumum	sumum
úthlutaði	úthlutaði
höttum	höttum
framan	framan
ax	ax
pókers	pókers
virtuð	virtuð
skírið	skírið
liðinn	liðinn
stoðunum	stoðunum
slíku	slíku
sjúgi	sjúgi
prúttar	prúttar
raustum	raustum
færeyskuna	færeyskuna
trunturnar	trunturnar
brekkusnigla	brekkusnigla
tjöldunum	tjöldunum
treysta	treysta
kristinna	kristinna
tálvonin	tálvonin
afleiðingar	afleiðingar
fylltum	fylltum
Enga	Enga
efldu	efldu
sjálfsmynd	sjálfsmynd
pokir	pokir
brjóstbeinið	brjóstbeinið
minntu	minntu
umskornir	umskornir
hégómamál	hégómamál
uppvekja	uppvekja
hljómaði	hljómaði
vendir	vendir
hatti	hatti
rannana	rannana
hrekja	hrekja
kring	kring
skjótt	skjótt
sættið	sættið
frísparkið	frísparkið
rekur	rekur
drekktum	drekktum
Dauði	Dauði
deyða	deyða
brytinn	brytinn
markgreifanna	markgreifanna
drukkna	drukkna
neyðir	neyðir
vestrinn	vestrinn
lagður	lagður
nokkrum	nokkrum
túrista	túrista
tölvupóstföngum	tölvupóstföngum
beði	beði
liðsins	liðsins
göfguðu	göfguðu
leiðslu	leiðslu
þrjósku	þrjósku
vífið	vífið
Það	Það
varaliði	varaliði
þéraði	þéraði
framlengdu	framlengdu
denarinn	denarinn
hluta	hluta
nokkra	nokkra
nokkru	nokkru
hröðlum	hröðlum
þakkað	þakkað
aukaföllin	aukaföllin
rigningarnar	rigningarnar
dæmin	dæmin
gegnum	gegnum
saurga	saurga
líkin	líkin
gormsins	gormsins
tiggja	tiggja
skyttur	skyttur
dreifst	dreifst
þarfir	þarfir
skýrir	skýrir
leikmönnum	leikmönnum
strák	strák
flettið	flettið
fórnfært	fórnfært
klæðum	klæðum
dráps	dráps
saumurinn	saumurinn
hrista	hrista
elskum	elskum
velji	velji
skír	skír
gjóði	gjóði
þekktir	þekktir
vissum	vissum
hjakkið	hjakkið
kefja	kefja
metanna	metanna
samkundustjóri	samkundustjóri
lesandann	lesandann
málandi	málandi
vitrað	vitrað
flæmskuna	flæmskuna
magn	magn
notuðum	notuðum
gildið	gildið
flæmingja	flæmingja
skelfisksins	skelfisksins
vegasalta	vegasalta
boða	boða
múgæsingum	múgæsingum
æðikollsins	æðikollsins
fána	fána
lifnaði	lifnaði
þessar	þessar
eyddi	eyddi
gefast	gefast
samtengingum	samtengingum
endi	endi
blikunum	blikunum
haf	haf
leiðir	leiðir
hef	hef
húsfrúrnar	húsfrúrnar
tónfræði	tónfræði
værir	værir
heilsa	heilsa
lofi	lofi
hengjum	hengjum
gaurs	gaurs
útibúið	útibúið
greinis	greinis
áttundi	áttundi
afklæddir	afklæddir
svona	svona
gættu	gættu
musterið	musterið
kjöltu	kjöltu
drepa	drepa
hötuðum	hötuðum
tölvupóstfanga	tölvupóstfanga
hefjum	hefjum
aftrar	aftrar
afklæða	afklæða
veski	veski
drottnið	drottnið
patinu	patinu
hávellunnar	hávellunnar
ríkdómur	ríkdómur
flettum	flettum
undantókum	undantókum
fjalir	fjalir
myrtu	myrtu
heyrði	heyrði
þótti	þótti
óvirti	óvirti
meir	meir
verið	verið
tennisboltarnir	tennisboltarnir
óvirtir	óvirtir
gjörir	gjörir
krældi	krældi
plokkaði	plokkaði
stýrðu	stýrðu
slútta	slútta
fundum	fundum
krossanna	krossanna
aukafalla	aukafalla
kætin	kætin
nasisma	nasisma
öxin	öxin
sekta	sekta
hjartarins	hjartarins
skreyta	skreyta
varst	varst
tökuorð	tökuorð
smjatti	smjatti
sjötti	sjötti
áhugamálið	áhugamálið
rífist	rífist
minnstur	minnstur
öðlist	öðlist
fyllandi	fyllandi
stæra	stæra
tjull	tjull
skapinu	skapinu
leynum	leynum
þjást	þjást
rændi	rændi
hittum	hittum
birtum	birtum
angann	angann
kyrkti	kyrkti
félagshyggju	félagshyggju
logann	logann
reglu	reglu
leyndu	leyndu
hvæstu	hvæstu
spítalinn	spítalinn
flugvalla	flugvalla
Hvort	Hvort
sósubletturinn	sósubletturinn
skjöllum	skjöllum
reynir	reynir
betri	betri
henni	henni
hýst	hýst
fylltir	fylltir
áhuga	áhuga
káetunum	káetunum
gróðavegur	gróðavegur
endurnýjum	endurnýjum
munir	munir
munum	munum
settaug	settaug
máttu	máttu
stært	stært
aukaspyrnu	aukaspyrnu
baginn	baginn
eignarlýður	eignarlýður
stjórnandi	stjórnandi
sjálfsmorðs	sjálfsmorðs
hennar	hennar
kviðunum	kviðunum
dáðu	dáðu
sendi	sendi
óperuhúsa	óperuhúsa
byggjandi	byggjandi
kapellu	kapellu
raustar	raustar
óvirtuð	óvirtuð
kvakið	kvakið
hinir	hinir
kært	kært
hafi	hafi
iðnar	iðnar
iðnaður	iðnaður
hvílík	hvílík
spillti	spillti
ríkdómi	ríkdómi
þeirrar	þeirrar
byggðuð	byggðuð
misskilningi	misskilningi
gengið	gengið
lokið	lokið
skilið	skilið
vonin	vonin
glönsum	glönsum
næstur	næstur
sveikst	sveikst
háls	háls
munt	munt
tindur	tindur
krossfestir	krossfestir
handboltanum	handboltanum
hjökkuðuð	hjökkuðuð
vönduðuð	vönduðuð
vekjum	vekjum
vík	vík
ljúkast	ljúkast
strandlengju	strandlengju
gess	gess
indefinite	indefinite
ræni	ræni
Alla	Alla
guðspjallamenn	guðspjallamenn
geisladiskur	geisladiskur
töntu	töntu
galt	galt
guðspjallamaðurinn	guðspjallamaðurinn
kaupi	kaupi
leikfangs	leikfangs
sjálfu	sjálfu
þriðja	þriðja
lúkka	lúkka
hatursins	hatursins
vinkonan	vinkonan
vald	vald
sagna	sagna
viðbjóðirnir	viðbjóðirnir
lagðir	lagðir
kommúnistum	kommúnistum
annast	annast
leit	leit
akademíu	akademíu
býsn	býsn
skapa	skapa
spörkum	spörkum
sinn	sinn
fylltur	fylltur
færir	færir
fylltu	fylltu
guðum	guðum
beilum	beilum
aukafallsliðinn	aukafallsliðinn
slyppu	slyppu
grundina	grundina
styrkið	styrkið
gagntekur	gagntekur
skrifuðu	skrifuðu
efi	efi
drepur	drepur
safnar	safnar
líkt	líkt
klæðin	klæðin
smaragð	smaragð
varalitanna	varalitanna
samkundustjórinn	samkundustjórinn
borðar	borðar
ríkti	ríkti
þrengingin	þrengingin
bruninn	bruninn
ökuleyfið	ökuleyfið
aliandarinnar	aliandarinnar
tíð	tíð
sonunum	sonunum
kalkspats	kalkspats
klæinda	klæinda
fiskar	fiskar
efa	efa
flettu	flettu
valmynda	valmynda
kirsuberi	kirsuberi
bæjasvöluna	bæjasvöluna
fylgdist	fylgdist
notar	notar
blessi	blessi
ökrunum	ökrunum
skalt	skalt
aldinin	aldinin
miðnætta	miðnætta
saurgast	saurgast
sendir	sendir
þrengingu	þrengingu
skírin	skírin
safnandi	safnandi
hvílast	hvílast
kenni	kenni
þess	þess
flotaforingjann	flotaforingjann
samkomulagið	samkomulagið
leitt	leitt
óskir	óskir
fagga	fagga
langi	langi
málar	málar
það	það
drýgðu	drýgðu
meiðslunum	meiðslunum
búning	búning
kærðu	kærðu
borði	borði
ættfeðurna	ættfeðurna
rifið	rifið
borðaðir	borðaðir
lausnin	lausnin
réttu	réttu
neinir	neinir
byggja	byggja
klæðið	klæðið
leita	leita
treysti	treysti
guð	guð
hrösuðum	hrösuðum
sendur	sendur
kvíði	kvíði
þolað	þolað
minnum	minnum
sendið	sendið
bætti	bætti
heiti	heiti
hlutanna	hlutanna
efli	efli
norðan	norðan
mund	mund
keypti	keypti
seldur	seldur
aðgreindir	aðgreindir
hégómamáls	hégómamáls
frostið	frostið
tárið	tárið
eina	eina
spjótkastinu	spjótkastinu
hvaðan	hvaðan
tregi	tregi
skriðsundi	skriðsundi
belti	belti
misst	misst
uppvekur	uppvekur
umskornu	umskornu
áhrifi	áhrifi
borðið	borðið
mestur	mestur
slöngur	slöngur
flokknum	flokknum
prútta	prútta
báðir	báðir
hengdir	hengdir
fylgdum	fylgdum
séu	séu
tilreiknast	tilreiknast
Hvaðan	Hvaðan
haltri	haltri
boðaði	boðaði
blekbyttu	blekbyttu
heddunum	heddunum
öfgi	öfgi
kontrafagott	kontrafagott
neinn	neinn
máluðum	máluðum
stóðuð	stóðuð
þrassins	þrassins
hatur	hatur
herpti	herpti
gramúlfinn	gramúlfinn
helgum	helgum
leynda	leynda
vonunum	vonunum
endurræstu	endurræstu
míns	míns
undantekningum	undantekningum
gæta	gæta
ris	ris
hvílíkir	hvílíkir
vestrar	vestrar
sinna	sinna
flokkinn	flokkinn
kenndina	kenndina
notað	notað
sóða	sóða
skírðir	skírðir
mesta	mesta
gramúlfunum	gramúlfunum
legils	legils
drifta	drifta
drápum	drápum
prentaði	prentaði
nota	nota
óska	óska
leyst	leyst
ógleðin	ógleðin
egnduð	egnduð
þessum	þessum
svik	svik
sjálfan	sjálfan
hrap	hrap
spörfugl	spörfugl
skottulæknirinn	skottulæknirinn
einhver	einhver
drekkið	drekkið
breytti	breytti
gríska	gríska
sléttsöngur	sléttsöngur
vanda	vanda
flettir	flettir
veskjunum	veskjunum
lax	lax
treyst	treyst
Eru	Eru
tárin	tárin
villimanninn	villimanninn
blindum	blindum
kringum	kringum
yfirheitunum	yfirheitunum
fyllti	fyllti
neyddur	neyddur
blik	blik
selduð	selduð
Dauðinn	Dauðinn
agúrku	agúrku
gylturnar	gylturnar
dreif	dreif
sjálfstraustið	sjálfstraustið
skerið	skerið
þrenging	þrenging
úkraínskan	úkraínskan
sellerí	sellerí
leyfis	leyfis
fremsta	fremsta
þægindum	þægindum
fljótir	fljótir
snúið	snúið
lærðuð	lærðuð
tala	tala
sjálfsmorðið	sjálfsmorðið
kjafta	kjafta
þessu	þessu
herstígvéla	herstígvéla
freigátunum	freigátunum
knattspyrnu	knattspyrnu
útisundlaug	útisundlaug
hrogns	hrogns
tappatogarana	tappatogarana
kryddi	kryddi
eigna	eigna
sjúkdómur	sjúkdómur
byggða	byggða
sápur	sápur
síst	síst
út	út
slík	slík
kaupunum	kaupunum
lastmæltu	lastmæltu
fjórir	fjórir
ýfðuð	ýfðuð
freistað	freistað
síður	síður
æxlun	æxlun
ræddu	ræddu
hjartarsaltið	hjartarsaltið
hefðarsæti	hefðarsæti
símaskrá	símaskrá
kýklóparnir	kýklóparnir
meðulunum	meðulunum
krókus	krókus
hörmum	hörmum
fagurfræðin	fagurfræðin
dæmist	dæmist
greinarnir	greinarnir
jafnir	jafnir
byggðu	byggðu
skafls	skafls
engjum	engjum
þinni	þinni
kyssi	kyssi
reyrar	reyrar
gagntak	gagntak
hneigið	hneigið
leiði	leiði
kenndin	kenndin
of	of
færðu	færðu
horna	horna
langt	langt
missirinn	missirinn
ákveðið	ákveðið
hæsi	hæsi
spilin	spilin
kvaks	kvaks
menga	menga
þeirra	þeirra
fullnast	fullnast
hljómlist	hljómlist
fjarlægt	fjarlægt
leyfði	leyfði
klædda	klædda
þátíð	þátíð
tjarnar	tjarnar
lífstykkið	lífstykkið
flöguna	flöguna
vínguðunum	vínguðunum
óhamingju	óhamingju
þols	þols
agúrkuna	agúrkuna
þjónustuna	þjónustuna
framlengt	framlengt
akademíanna	akademíanna
fjár	fjár
sælunum	sælunum
Skyldum	Skyldum
mest	mest
fæddir	fæddir
íþyngi	íþyngi
hræddi	hræddi
japanskan	japanskan
gripið	gripið
Skyldu	Skyldu
heimta	heimta
ráðin	ráðin
opið	opið
ferð	ferð
rökuðuð	rökuðuð
bæjasvölur	bæjasvölur
yfirheitin	yfirheitin
hvína	hvína
fryst	fryst
freistaði	freistaði
bikkju	bikkju
ein	ein
köfðu	köfðu
styrkir	styrkir
gefinn	gefinn
ríkdóm	ríkdóm
köstuðum	köstuðum
guðina	guðina
neytt	neytt
hjólhýsi	hjólhýsi
sídd	sídd
spilltum	spilltum
gæti	gæti
hefðu	hefðu
veturinn	veturinn
leyn	leyn
kvikmyndanna	kvikmyndanna
þinna	þinna
skýri	skýri
snæris	snæris
svíki	svíki
skipinu	skipinu
bismúts	bismúts
fimmti	fimmti
hugsun	hugsun
stækjunnar	stækjunnar
hneyktuð	hneyktuð
upplestrar	upplestrar
vænt	vænt
eyru	eyru
reyknum	reyknum
kúts	kúts
stoð	stoð
stóð	stóð
Orð	Orð
efldir	efldir
hlýst	hlýst
bullið	bullið
kontrafagottið	kontrafagottið
borgir	borgir
hvílíkar	hvílíkar
öndun	öndun
gleði	gleði
varirnar	varirnar
eigist	eigist
gegn	gegn
svara	svara
kröftugt	kröftugt
skírn	skírn
pípuhöttunum	pípuhöttunum
svæfðuð	svæfðuð
hreima	hreima
tómlæti	tómlæti
metinu	metinu
rétt	rétt
hylja	hylja
hóll	hóll
slíkt	slíkt
gildi	gildi
geirfuglinn	geirfuglinn
æðarkónginn	æðarkónginn
svertir	svertir
hraktir	hraktir
minntum	minntum
þurríssins	þurríssins
trúleysi	trúleysi
fundi	fundi
slúttum	slúttum
fengin	fengin
orðskviða	orðskviða
hafa	hafa
lið	lið
sást	sást
misstuð	misstuð
hýstuð	hýstuð
pennavinurinn	pennavinurinn
rakað	rakað
engar	engar
eyranu	eyranu
útlista	útlista
vanheilagir	vanheilagir
lýsingarorða	lýsingarorða
raula	raula
skal	skal
þóttist	þóttist
sýnduð	sýnduð
leysti	leysti
skerma	skerma
nei	nei
nefnast	nefnast
eigur	eigur
velþóknanlegar	velþóknanlegar
pílu	pílu
arfi	arfi
miðnættin	miðnættin
þrem	þrem
Allt	Allt
hræðum	hræðum
rakaði	rakaði
gerði	gerði
syndgar	syndgar
fóður	fóður
köngla	köngla
etýðu	etýðu
klæði	klæði
sala	sala
höfnun	höfnun
björkum	björkum
búninginn	búninginn
hræðið	hræðið
leysast	leysast
svindlara	svindlara
missi	missi
öðlaðist	öðlaðist
samvistarfalli	samvistarfalli
þurrís	þurrís
iðn	iðn
eindar	eindar
mistur	mistur
hafna	hafna
áhrifið	áhrifið
gilt	gilt
þekkist	þekkist
definite	definite
flokk	flokk
rithöfundurinn	rithöfundurinn
kvelds	kvelds
gætt	gætt
fældir	fældir
ríkið	ríkið
annan	annan
breytt	breytt
sverði	sverði
éti	éti
sóla	sóla
skjótir	skjótir
svíkjum	svíkjum
klæddir	klæddir
hugtak	hugtak
fjólu	fjólu
sóttu	sóttu
hreim	hreim
haga	haga
ráði	ráði
gegnt	gegnt
spikinu	spikinu
erfðafræði	erfðafræði
leyndir	leyndir
nýtti	nýtti
eiturlyfjanotendum	eiturlyfjanotendum
valmyndarinnar	valmyndarinnar
rétta	rétta
væskla	væskla
skulum	skulum
kæru	kæru
kunnir	kunnir
skipunum	skipunum
vögguvísunum	vögguvísunum
fjöl	fjöl
stóru	stóru
Inn	Inn
klippi	klippi
tes	tes
glásum	glásum
borðaði	borðaði
menguðu	menguðu
lagt	lagt
rottuna	rottuna
liðið	liðið
fjöldanum	fjöldanum
yfirheita	yfirheita
vanrækja	vanrækja
fórnuðuð	fórnuðuð
skyldufræði	skyldufræði
endurræsti	endurræsti
fullreynd	fullreynd
ærumeiðinganna	ærumeiðinganna
metum	metum
uppfært	uppfært
fjarðanna	fjarðanna
skermurinn	skermurinn
skipsins	skipsins
teiknið	teiknið
kalkúnana	kalkúnana
aldin	aldin
leiddur	leiddur
drekkir	drekkir
minnkið	minnkið
hólminn	hólminn
undantekningu	undantekningu
verð	verð
opna	opna
brauð	brauð
akur	akur
feðginin	feðginin
hugunum	hugunum
glas	glas
straumarnir	straumarnir
hristu	hristu
ríkdóms	ríkdóms
engin	engin
tæfu	tæfu
kvars	kvars
trúa	trúa
suguð	suguð
áfrýjuðu	áfrýjuðu
þurrísum	þurrísum
boðin	boðin
minnir	minnir
læst	læst
samkundustjóra	samkundustjóra
skrifuðum	skrifuðum
Getur	Getur
fylltuð	fylltuð
kvæntur	kvæntur
borga	borga
farsímar	farsímar
slangan	slangan
staðalinn	staðalinn
dauðadóms	dauðadóms
dæmast	dæmast
skírðum	skírðum
störf	störf
Jótlandinu	Jótlandinu
fluttur	fluttur
hulda	hulda
vetur	vetur
kveikina	kveikina
kastandi	kastandi
minninganna	minninganna
meti	meti
yrði	yrði
hrasar	hrasar
bifar	bifar
koka	koka
ungum	ungum
mál	mál
samboðin	samboðin
núna	núna
stýri	stýri
skipið	skipið
straumurinn	straumurinn
uxa	uxa
vælir	vælir
sinarnar	sinarnar
lastmæli	lastmæli
skytum	skytum
skýrandi	skýrandi
bærum	bærum
klæð	klæð
hryggir	hryggir
vinkill	vinkill
ættu	ættu
freigátunnar	freigátunnar
fríspark	fríspark
hengdum	hengdum
sífra	sífra
vanræk	vanræk
lýst	lýst
raulið	raulið
þessa	þessa
ber	ber
gengist	gengist
þvoðu	þvoðu
laggir	laggir
grískunni	grískunni
byggð	byggð
kúbein	kúbein
byggist	byggist
þökkum	þökkum
valið	valið
Þessi	Þessi
afgreiddi	afgreiddi
rymdi	rymdi
styrktuð	styrktuð
helt	helt
þreytist	þreytist
áttunda	áttunda
farsími	farsími
bundið	bundið
fórinta	fórinta
búist	búist
vifta	vifta
afgreiðum	afgreiðum
inn	inn
huldu	huldu
skrifað	skrifað
aðvöruðuð	aðvöruðuð
rifi	rifi
reglurnar	reglurnar
gróðaveg	gróðaveg
Mannssonur	Mannssonur
einhverja	einhverja
drekktu	drekktu
snuði	snuði
dygðina	dygðina
talast	talast
notuðuð	notuðuð
þoli	þoli
köngull	köngull
leikaranna	leikaranna
diski	diski
sandinn	sandinn
drambið	drambið
teiknaði	teiknaði
korkunum	korkunum
hljómað	hljómað
firði	firði
þvost	þvost
birtist	birtist
síðasta	síðasta
minnti	minnti
líka	líka
ilmjurtir	ilmjurtir
borða	borða
kallir	kallir
máluðu	máluðu
Sendu	Sendu
ryðöndin	ryðöndin
þönkum	þönkum
skeifum	skeifum
stundarinnar	stundarinnar
hengdi	hengdi
klæddi	klæddi
stærið	stærið
tómstundagamanið	tómstundagamanið
notaði	notaði
kveldum	kveldum
lungnaberkla	lungnaberkla
smalahundana	smalahundana
góluðu	góluðu
þekkt	þekkt
minnisspilið	minnisspilið
síið	síið
styrkjum	styrkjum
Engum	Engum
skapanna	skapanna
Mannssoninn	Mannssoninn
brytar	brytar
krossfara	krossfara
drekkja	drekkja
smóka	smóka
lofið	lofið
musteranna	musteranna
engum	engum
piparinn	piparinn
át	át
trjóna	trjóna
brottfara	brottfara
helga	helga
fórintu	fórintu
vissu	vissu
tóninum	tóninum
leyfa	leyfa
gervitungls	gervitungls
hræætu	hræætu
tunglsjúka	tunglsjúka
steikunum	steikunum
útibúa	útibúa
leyfunum	leyfunum
Þau	Þau
stundu	stundu
loft	loft
útlistum	útlistum
heiður	heiður
zetu	zetu
öxla	öxla
kasti	kasti
Alls	Alls
veikt	veikt
Verið	Verið
æðstu	æðstu
grafítið	grafítið
breytingar	breytingar
bagall	bagall
poka	poka
þínum	þínum
skildum	skildum
æðardúninn	æðardúninn
göfgar	göfgar
sölurnar	sölurnar
ráðunum	ráðunum
fisk	fisk
völdunum	völdunum
mets	mets
kynkvísla	kynkvísla
tappatogara	tappatogara
kasta	kasta
var	var
köstuðu	köstuðu
skírlífu	skírlífu
fórnfærði	fórnfærði
hafir	hafir
leiddi	leiddi
félagum	félagum
skýrðum	skýrðum
hóllinn	hóllinn
ráðum	ráðum
húsbóndi	húsbóndi
slepp	slepp
hefðum	hefðum
skýr	skýr
Nakson	Nakson
iðnunum	iðnunum
minni	minni
hrifsuðuð	hrifsuðuð
kross	kross
rakið	rakið
mellum	mellum
skýrðu	skýrðu
gramúlf	gramúlf
gaggið	gaggið
tökuorðin	tökuorðin
spaðarnir	spaðarnir
hrek	hrek
klædd	klædd
hlátri	hlátri
þínar	þínar
vinkils	vinkils
lagði	lagði
ala	ala
hinum	hinum
Orðið	Orðið
sápa	sápa
gjörðuð	gjörðuð
Er	Er
fljótið	fljótið
hellirinn	hellirinn
fæddi	fæddi
boðum	boðum
beini	beini
vés	vés
drepum	drepum
dáð	dáð
organistum	organistum
kvikmyndin	kvikmyndin
fjórum	fjórum
burstirnar	burstirnar
ali	ali
lofgjörð	lofgjörð
standa	standa
klúðraðir	klúðraðir
Hafa	Hafa
heitið	heitið
kunni	kunni
minnunum	minnunum
heyrast	heyrast
hvein	hvein
hýdrötum	hýdrötum
skrifuðuð	skrifuðuð
hálfendum	hálfendum
settur	settur
undan	undan
hagnaðarins	hagnaðarins
skírum	skírum
kúbeinunum	kúbeinunum
misgjörða	misgjörða
leyfum	leyfum
tísku	tísku
bættist	bættist
skytu	skytu
öslaði	öslaði
þrengingunum	þrengingunum
sakargift	sakargift
búnings	búnings
byggt	byggt
dæmdum	dæmdum
Hefur	Hefur
huldir	huldir
skjótast	skjótast
brjálæði	brjálæði
færa	færa
næsta	næsta
reykjunum	reykjunum
Þess	Þess
lessunum	lessunum
samboðna	samboðna
nefnist	nefnist
leyfinu	leyfinu
labbið	labbið
synir	synir
Slíkt	Slíkt
klæðir	klæðir
kvæntist	kvæntist
uggum	uggum
drekk	drekk
orðskviður	orðskviður
pyntuðu	pyntuðu
syndgið	syndgið
hvílíkt	hvílíkt
metast	metast
fegrið	fegrið
getum	getum
miða	miða
strætisvagna	strætisvagna
fyrsti	fyrsti
fullyrti	fullyrti
yrðu	yrðu
neinu	neinu
kæti	kæti
sjússunum	sjússunum
spil	spil
liði	liði
tíi	tíi
allur	allur
trúleysið	trúleysið
ákæra	ákæra
fjölmiðlasögu	fjölmiðlasögu
stoppanirnar	stoppanirnar
móðu	móðu
hittu	hittu
reiði	reiði
helgast	helgast
ýmiss	ýmiss
þakka	þakka
trúna	trúna
koma	koma
eðla	eðla
Belga	Belga
lögum	lögum
málið	málið
vettling	vettling
horfði	horfði
slíkur	slíkur
Hafði	Hafði
skreytti	skreytti
nokkrar	nokkrar
öðru	öðru
rótfestir	rótfestir
vanadíns	vanadíns
frakka	frakka
ilmjurtunum	ilmjurtunum
gaurarnir	gaurarnir
fyrstur	fyrstur
káetan	káetan
heiðagæsum	heiðagæsum
hagann	hagann
búið	búið
kvæn	kvæn
spektu	spektu
akademíurnar	akademíurnar
fæst	fæst
lífstykkjanna	lífstykkjanna
vífa	vífa
völdum	völdum
hringar	hringar
ættkvíslum	ættkvíslum
tottaði	tottaði
dauðadómar	dauðadómar
bygg	bygg
vanheilagt	vanheilagt
eyjarnar	eyjarnar
lastmæla	lastmæla
hlutum	hlutum
líkaminn	líkaminn
skækjur	skækjur
dögunum	dögunum
æðardúni	æðardúni
safnið	safnið
víka	víka
jafnast	jafnast
farsímanna	farsímanna
vindill	vindill
Krists	Krists
sumir	sumir
skyldi	skyldi
færi	færi
jónirnar	jónirnar
hrapsins	hrapsins
ugga	ugga
skíða	skíða
sé	sé
heyrðum	heyrðum
sjúkdóm	sjúkdóm
kylfu	kylfu
stikann	stikann
sjúkdóma	sjúkdóma
kílói	kílói
girni	girni
myndaði	myndaði
synda	synda
segist	segist
þakkaði	þakkaði
stökkið	stökkið
helvíti	helvíti
umfjöllun	umfjöllun
ljóðlistin	ljóðlistin
áhugamáli	áhugamáli
bolir	bolir
flassið	flassið
settaugin	settaugin
Koma	Koma
spektan	spektan
standast	standast
nefndir	nefndir
hórkarl	hórkarl
kvíða	kvíða
brott	brott
mátti	mátti
aldur	aldur
sæbjúgna	sæbjúgna
kostaði	kostaði
óskaði	óskaði
akademíunum	akademíunum
fiskanna	fiskanna
horfðu	horfðu
gerist	gerist
maura	maura
græðið	græðið
seldu	seldu
teiknaðir	teiknaðir
nærmynda	nærmynda
bílstjóra	bílstjóra
perlunum	perlunum
toga	toga
smjattið	smjattið
drukkið	drukkið
sá	sá
neyttu	neyttu
jötunuxi	jötunuxi
sess	sess
hafið	hafið
kyssið	kyssið
fórnfæra	fórnfæra
fundanna	fundanna
varir	varir
andaði	andaði
mun	mun
löppunum	löppunum
minnst	minnst
raulaði	raulaði
æðarkóngarnir	æðarkóngarnir
brekkusnigli	brekkusnigli
hálfendarnir	hálfendarnir
sjöundi	sjöundi
greini	greini
lakkað	lakkað
Krist	Krist
káetu	káetu
síðu	síðu
albönsku	albönsku
brekkusnigill	brekkusnigill
þjálfun	þjálfun
huga	huga
fjórði	fjórði
fundið	fundið
sónatínan	sónatínan
smíða	smíða
ráð	ráð
stækju	stækju
vinkonurnar	vinkonurnar
hryggjum	hryggjum
höfði	höfði
langöfum	langöfum
klekkti	klekkti
höfða	höfða
sárasóttina	sárasóttina
varalit	varalit
byggður	byggður
reyndir	reyndir
áhugi	áhugi
lýsingarorð	lýsingarorð
stær	stær
kossarnir	kossarnir
eigin	eigin
grunnlinn	grunnlinn
leikfangi	leikfangi
gröftum	gröftum
lofuðum	lofuðum
sjálfir	sjálfir
greinirinn	greinirinn
sleða	sleða
svaraði	svaraði
frystiskápar	frystiskápar
markið	markið
stýrði	stýrði
vindlunum	vindlunum
hafsins	hafsins
jakanna	jakanna
hugtaks	hugtaks
kastaði	kastaði
fyrsta	fyrsta
folann	folann
gæra	gæra
lauk	lauk
berast	berast
andlang	andlang
kosta	kosta
markmaðurinn	markmaðurinn
furu	furu
unglingur	unglingur
stjórnið	stjórnið
látum	látum
vanheilagur	vanheilagur
skepnan	skepnan
vel	vel
kær	kær
sótt	sótt
samboðið	samboðið
hvaða	hvaða
umkringið	umkringið
langöfunum	langöfunum
miðgilda	miðgilda
korpöndunum	korpöndunum
sína	sína
hornið	hornið
tvennuna	tvennuna
sköpum	sköpum
allar	allar
gjalda	gjalda
kílóin	kílóin
hornsins	hornsins
skulu	skulu
Eruð	Eruð
hálfleikurinn	hálfleikurinn
sögn	sögn
böðla	böðla
bismútið	bismútið
albönskunnar	albönskunnar
teflir	teflir
mála	mála
kapellunni	kapellunni
fórnum	fórnum
málaðir	málaðir
norður	norður
vátryggja	vátryggja
volað	volað
heima	heima
tígrisdýrið	tígrisdýrið
hjólhýsunum	hjólhýsunum
vestra	vestra
Munu	Munu
veittuð	veittuð
hneigir	hneigir
þremur	þremur
tindana	tindana
síddum	síddum
kryfjið	kryfjið
tali	tali
Kom	Kom
vátryggðum	vátryggðum
gallínið	gallínið
lifði	lifði
ást	ást
öxli	öxli
móður	móður
blinda	blinda
flokki	flokki
hátíðina	hátíðina
misstir	misstir
æxlanir	æxlanir
köngulóm	köngulóm
geta	geta
myndið	myndið
kerti	kerti
gætu	gætu
afætuna	afætuna
neitaði	neitaði
æxlunina	æxlunina
berst	berst
þrengingum	þrengingum
tilreiknað	tilreiknað
reið	reið
ökuleyfi	ökuleyfi
hlýði	hlýði
strætisvagninn	strætisvagninn
skýtur	skýtur
korpönd	korpönd
þreytum	þreytum
klappað	klappað
sleik	sleik
missið	missið
engjanna	engjanna
lesanda	lesanda
plasta	plasta
hreyfi	hreyfi
ofursta	ofursta
síðastur	síðastur
víkur	víkur
víddunum	víddunum
mundum	mundum
stórhertoginn	stórhertoginn
þerrir	þerrir
saltast	saltast
alls	alls
klæðast	klæðast
aðfaranóttin	aðfaranóttin
líkunum	líkunum
skýra	skýra
lappa	lappa
fjóla	fjóla
strikin	strikin
ritaði	ritaði
ýfið	ýfið
syndgum	syndgum
eigið	eigið
missis	missis
kviðunni	kviðunni
þjónustu	þjónustu
svengd	svengd
lifanda	lifanda
nafla	nafla
rigninga	rigninga
hreinsunareldurinn	hreinsunareldurinn
þökkunum	þökkunum
hólmi	hólmi
hverjir	hverjir
Erum	Erum
trega	trega
æfingunum	æfingunum
bjórvömbunum	bjórvömbunum
þarfaþingið	þarfaþingið
sólunum	sólunum
leyndarinnar	leyndarinnar
Asía	Asía
tónninn	tónninn
mínar	mínar
faldanna	faldanna
breytum	breytum
kvöldunum	kvöldunum
sonur	sonur
viðbjóðs	viðbjóðs
hrætt	hrætt
óréttinn	óréttinn
organista	organista
brotið	brotið
dúkur	dúkur
þenjum	þenjum
kafði	kafði
Líkt	Líkt
send	send
saumi	saumi
slíka	slíka
þjáist	þjáist
höfunum	höfunum
komum	komum
drift	drift
syndga	syndga
hýdrötunum	hýdrötunum
hópinn	hópinn
kinnaliti	kinnaliti
höndlað	höndlað
náið	náið
kærir	kærir
aftrið	aftrið
drepir	drepir
höndli	höndli
fyllum	fyllum
grasafræði	grasafræði
talentur	talentur
skrifa	skrifa
hinar	hinar
málum	málum
helvítið	helvítið
hvílíka	hvílíka
nærmyndin	nærmyndin
hættu	hættu
mella	mella
kjörfurstar	kjörfurstar
eðlum	eðlum
met	met
sálma	sálma
hvert	hvert
viðskiptavinarins	viðskiptavinarins
beinana	beinana
hvílíkum	hvílíkum
gleðst	gleðst
bikkjurnar	bikkjurnar
sendandi	sendandi
annað	annað
ríki	ríki
hvílt	hvílt
heita	heita
skinum	skinum
hórkarlar	hórkarlar
spilltur	spilltur
krossfestur	krossfestur
glóbrystinginn	glóbrystinginn
meðal	meðal
sálmur	sálmur
færis	færis
hreyfðum	hreyfðum
undir	undir
flokksins	flokksins
píla	píla
fullreyndin	fullreyndin
Kristi	Kristi
synjaði	synjaði
dissið	dissið
stærir	stærir
formaðurinn	formaðurinn
aborranna	aborranna
skini	skini
borgum	borgum
reipið	reipið
skrifar	skrifar
hlátrinum	hlátrinum
fæddur	fæddur
einhvern	einhvern
verða	verða
mínir	mínir
leyfið	leyfið
upplestra	upplestra
svo	svo
hagnýtti	hagnýtti
hljóðfærið	hljóðfærið
afætunum	afætunum
starf	starf
felld	felld
blóðfrumu	blóðfrumu
flass	flass
byggðum	byggðum
líkur	líkur
pyntið	pyntið
fuglafræðina	fuglafræðina
velur	velur
rusls	rusls
átuð	átuð
endurnýjuðuð	endurnýjuðuð
sjálfur	sjálfur
kysstir	kysstir
sælur	sælur
íþyngir	íþyngir
skuluð	skuluð
hnútinn	hnútinn
mundir	mundir
möluðuð	möluðuð
konu	konu
reynið	reynið
raustin	raustin
jörð	jörð
fórnuðu	fórnuðu
rifrildisins	rifrildisins
velþóknanleg	velþóknanleg
starfið	starfið
pennavinunum	pennavinunum
vafann	vafann
eyra	eyra
völd	völd
vök	vök
krossfestan	krossfestan
sigurinn	sigurinn
slíkan	slíkan
Hafi	Hafi
mörkunum	mörkunum
náttúru	náttúru
fæl	fæl
tæfunum	tæfunum
ákveðin	ákveðin
feta	feta
misgjörðin	misgjörðin
klekkir	klekkir
ferst	ferst
hefur	hefur
karsinn	karsinn
leiddir	leiddir
frystinn	frystinn
sumu	sumu
klætt	klætt
harmurinn	harmurinn
drekkti	drekkti
fjölmiðlasögur	fjölmiðlasögur
frumbyggjann	frumbyggjann
geðshræringu	geðshræringu
hinu	hinu
kalksteinn	kalksteinn
guði	guði
fjarveru	fjarveru
staðinn	staðinn
sósublettanna	sósublettanna
gjaldið	gjaldið
öllum	öllum
sín	sín
heyrðu	heyrðu
samboðinn	samboðinn
gítar	gítar
skapaði	skapaði
jöfnunin	jöfnunin
eyrunum	eyrunum
glásirnar	glásirnar
lengi	lengi
þíns	þíns
gaggaði	gaggaði
beð	beð
þarft	þarft
konuna	konuna
hellum	hellum
snerist	snerist
safnaði	safnaði
dansaði	dansaði
gráða	gráða
körfubolta	körfubolta
glerhafið	glerhafið
máli	máli
líki	líki
gefin	gefin
spikum	spikum
líkum	líkum
birta	birta
trúarjátningunni	trúarjátningunni
brúðkaupsgestir	brúðkaupsgestir
völdu	völdu
vændis	vændis
stóra	stóra
eiginmönnum	eiginmönnum
reiðir	reiðir
félögin	félögin
samkundustjórunum	samkundustjórunum
mynstra	mynstra
berklanna	berklanna
gormarnir	gormarnir
hengdu	hengdu
græddi	græddi
ónáðaði	ónáðaði
minnkaði	minnkaði
skírði	skírði
tvennur	tvennur
aðdáendurna	aðdáendurna
svita	svita
þérað	þérað
fóstrunum	fóstrunum
óperuhúsið	óperuhúsið
Suma	Suma
bjórvömb	bjórvömb
Getum	Getum
vissuð	vissuð
fyll	fyll
kjólföt	kjólföt
krikkets	krikkets
framlengdi	framlengdi
söfnuð	söfnuð
geðshræringin	geðshræringin
hrææta	hrææta
hvílíkur	hvílíkur
vígvelli	vígvelli
kúrdísku	kúrdísku
rauluðuð	rauluðuð
herpi	herpi
ná	ná
heim	heim
minnandi	minnandi
sölum	sölum
erfði	erfði
Þessir	Þessir
smalahundum	smalahundum
notaðir	notaðir
kastaðir	kastaðir
hvíldunum	hvíldunum
komu	komu
afleiðingunum	afleiðingunum
þreytst	þreytst
