verbündend	verbündend
balkanisierten	balkanisierten
erwärmte	erwärmte
Weinberge	Weinberge
Töpfe	Töpfe
Diese	Diese
beläufst	beläufst
Vesper	Vesper
Bist	Bist
sabbelten	sabbelten
replizieret	replizieret
Zeitbombe	Zeitbombe
Scheißkerl	Scheißkerl
schließen	schließen
Trinkgefäße	Trinkgefäße
Farbstoffen	Farbstoffen
buddeln	buddeln
repräsentierten	repräsentierten
Frage	Frage
Samstagnachmittagen	Samstagnachmittagen
Lehne	Lehne
Notärztin	Notärztin
Tritte	Tritte
Gibt	Gibt
Euphemismus	Euphemismus
Taschendieb	Taschendieb
speist	speist
Crescendos	Crescendos
kichert	kichert
Renegat	Renegat
Politologen	Politologen
Sprödmetallen	Sprödmetallen
Wahnen	Wahnen
Hornung	Hornung
enttäuschtest	enttäuschtest
verklärt	verklärt
Paillette	Paillette
Braunralle	Braunralle
Carbids	Carbids
Landwirt	Landwirt
Fluorkohlenwasserstoff	Fluorkohlenwasserstoff
bündelet	bündelet
Bademantel	Bademantel
grabest	grabest
grausten	grausten
Radsatzes	Radsatzes
Zankapfels	Zankapfels
verunglimpfest	verunglimpfest
fritierten	fritierten
sahet	sahet
Tausch	Tausch
begehrtest	begehrtest
Tretlager	Tretlager
recycele	recycele
Preisanstiegen	Preisanstiegen
Leid	Leid
wallfahrten	wallfahrten
wurdest	wurdest
Zwergschwanes	Zwergschwanes
Gewürzen	Gewürzen
Negermusik	Negermusik
protokollieren	protokollieren
Rückumschlages	Rückumschlages
stäupen	stäupen
scheuchten	scheuchten
Fußboden	Fußboden
Tintenfisch	Tintenfisch
glaubt	glaubt
deutete	deutete
halben	halben
blitzte	blitzte
gewährtest	gewährtest
versucht	versucht
verbärgen	verbärgen
Flammen	Flammen
schweiget	schweiget
Lotterien	Lotterien
Unserer	Unserer
verreisest	verreisest
Suchanfrage	Suchanfrage
Nadelbäumen	Nadelbäumen
Mäusen	Mäusen
vertreibe	vertreibe
hilft	hilft
Weiß	Weiß
spannte	spannte
wünschen	wünschen
stäupten	stäupten
Maxima	Maxima
zeuget	zeuget
Elfen	Elfen
Zähne	Zähne
fließen	fließen
Strohhälmchen	Strohhälmchen
Heteroatom	Heteroatom
schnattert	schnattert
besorgt	besorgt
diente	diente
Ehre	Ehre
Zöpfen	Zöpfen
zensierten	zensierten
Wege	Wege
gehörten	gehörten
mogelest	mogelest
Tanne	Tanne
balkanisierte	balkanisierte
verwahrst	verwahrst
zählten	zählten
bessere	bessere
Leichtmetallen	Leichtmetallen
könnten	könnten
Laubholz	Laubholz
zerfielest	zerfielest
Schauet	Schauet
Grieße	Grieße
solchen	solchen
aufhoben	aufhoben
wärme	wärme
entwickele	entwickele
Meinem	Meinem
Schilde	Schilde
wog	wog
Seiten	Seiten
puddelst	puddelst
Fallen	Fallen
Spirale	Spirale
Psi	Psi
alarmieren	alarmieren
rote	rote
schickte	schickte
begeben	begeben
behaltest	behaltest
Male	Male
verwirfst	verwirfst
elfte	elfte
applizirst	applizirst
leihe	leihe
Maultiere	Maultiere
unterdrückte	unterdrückte
Hochsommern	Hochsommern
dekompiliertest	dekompiliertest
verscheißert	verscheißert
gedachtest	gedachtest
schlag	schlag
Generation	Generation
legst	legst
raten	raten
Binden	Binden
Held	Held
kugelten	kugelten
Grabbeltischen	Grabbeltischen
Fusselbärten	Fusselbärten
zerstreut	zerstreut
Reliquiare	Reliquiare
steige	steige
quantisierte	quantisierte
Strafraum	Strafraum
dingten	dingten
Mittelaltermarktes	Mittelaltermarktes
hell	hell
Könige	Könige
Brieftaubenzüchters	Brieftaubenzüchters
Rauten	Rauten
brandeten	brandeten
lochtest	lochtest
brichst	brichst
anders	anders
kramen	kramen
süsst	süsst
geniertest	geniertest
aktualisiere	aktualisiere
wolle	wolle
Lautschrift	Lautschrift
Ösophagospasmen	Ösophagospasmen
Halle	Halle
hicksest	hicksest
blende	blende
Hahnenkämmen	Hahnenkämmen
impfst	impfst
wollten	wollten
Gerät	Gerät
Eingabe	Eingabe
lobe	lobe
Almanache	Almanache
Karikaturistinnen	Karikaturistinnen
besprächen	besprächen
Grufti	Grufti
plagen	plagen
Überziehens	Überziehens
fingieret	fingieret
verkaufe	verkaufe
addierest	addierest
erstürmet	erstürmet
Farbstoffe	Farbstoffe
danket	danket
angehört	angehört
vandalieren	vandalieren
ermahnet	ermahnet
lest	lest
verdammet	verdammet
gekröst	gekröst
widmend	widmend
evaluiert	evaluiert
Wehr	Wehr
bestanden	bestanden
Deine	Deine
stifte	stifte
funktionalisierte	funktionalisierte
Gefangenen	Gefangenen
rühmst	rühmst
predigte	predigte
feiern	feiern
aase	aase
Dobermännern	Dobermännern
Cola	Cola
bestellten	bestellten
Tut	Tut
kräusle	kräusle
Prügelstrafen	Prügelstrafen
hydrolysierest	hydrolysierest
bescheiße	bescheiße
grünet	grünet
ausführte	ausführte
ermordet	ermordet
Schwester	Schwester
Darlehen	Darlehen
Abtrünnige	Abtrünnige
Name	Name
Trotzkisten	Trotzkisten
gerne	gerne
borgst	borgst
manövrieret	manövrieret
schaust	schaust
beißet	beißet
Mopps	Mopps
injiziert	injiziert
Weichlote	Weichlote
schwimmen	schwimmen
Genies	Genies
regiert	regiert
stirbst	stirbst
schäme	schäme
Pforten	Pforten
beleidigst	beleidigst
Schwirrvögel	Schwirrvögel
lebest	lebest
Badezimmers	Badezimmers
bemächtigte	bemächtigte
elften	elften
liehe	liehe
Esset	Esset
schmuggle	schmuggle
Rehböcken	Rehböcken
Laien	Laien
rekrutierest	rekrutierest
wegen	wegen
Gasen	Gasen
Gedicht	Gedicht
Jagdhund	Jagdhund
Bärenfelle	Bärenfelle
sitzt	sitzt
Luftschiff	Luftschiff
sorgen	sorgen
Blitzableiter	Blitzableiter
lostest	lostest
mögt	mögt
Empörung	Empörung
schwangt	schwangt
Schaffnerin	Schaffnerin
Spannt	Spannt
Menschenhandel	Menschenhandel
benützt	benützt
Polizeisprechern	Polizeisprechern
Tollkirsche	Tollkirsche
verarbeite	verarbeite
Thioacetalen	Thioacetalen
bereitet	bereitet
Kuckucken	Kuckucken
überschneidet	überschneidet
Chelatkomplex	Chelatkomplex
gebieten	gebieten
erfahrest	erfahrest
handhaben	handhaben
Märkten	Märkten
denaturierten	denaturierten
schätzt	schätzt
Bademäntel	Bademäntel
Flöten	Flöten
verführt	verführt
lohnt	lohnt
Halbmonden	Halbmonden
lärmte	lärmte
fügt	fügt
Glatteis	Glatteis
verzögerten	verzögerten
finanziert	finanziert
Sehne	Sehne
massierend	massierend
Brieftaubenzüchter	Brieftaubenzüchter
bekehret	bekehret
Erste	Erste
protestiere	protestiere
Möbelstoffen	Möbelstoffen
henken	henken
überstehst	überstehst
Pfählen	Pfählen
Wahn	Wahn
Hunden	Hunden
Mischelement	Mischelement
Verwaltungsakten	Verwaltungsakten
verziehen	verziehen
Rotgüssen	Rotgüssen
evaluierten	evaluierten
zentrifugieren	zentrifugieren
vernichtest	vernichtest
Flamingo	Flamingo
Bertrandit	Bertrandit
verkleide	verkleide
verdammen	verdammen
Schaffe	Schaffe
knistern	knistern
füllen	füllen
Gedränge	Gedränge
Kohlen	Kohlen
Moren	Moren
eures	eures
Ausgangssperren	Ausgangssperren
erscheine	erscheine
Rabe	Rabe
schnelle	schnelle
respektiert	respektiert
bummelet	bummelet
Polierstahl	Polierstahl
hieltest	hieltest
verbrauchte	verbrauchte
Nullpunktes	Nullpunktes
Türklingeln	Türklingeln
hebet	hebet
knurrt	knurrt
häuftet	häuftet
liebten	liebten
vertagt	vertagt
offenbarest	offenbarest
Rooibos	Rooibos
gereichte	gereichte
beides	beides
grünen	grünen
knuffend	knuffend
Noseanen	Noseanen
Büchereien	Büchereien
gewitterest	gewitterest
Lazarette	Lazarette
steig	steig
Exilanten	Exilanten
wetzte	wetzte
Frösche	Frösche
sucht	sucht
kletteret	kletteret
Büstenhaltern	Büstenhaltern
verführtest	verführtest
Montagmittag	Montagmittag
Selbstsicherheit	Selbstsicherheit
leget	leget
Amputierten	Amputierten
Eutektikum	Eutektikum
Achatschnecken	Achatschnecken
faule	faule
Alkalien	Alkalien
Hadith	Hadith
verbündete	verbündete
zwängtet	zwängtet
neidest	neidest
Fußbodens	Fußbodens
verschreibt	verschreibt
schreien	schreien
Sabbate	Sabbate
erstehen	erstehen
Abfertigungsgebäuden	Abfertigungsgebäuden
vermeßest	vermeßest
könnt	könnt
versteigerest	versteigerest
steigeret	steigeret
gleich	gleich
Genkinit	Genkinit
Polyphosphat	Polyphosphat
flirre	flirre
Zeile	Zeile
Recitativ	Recitativ
heil	heil
Fusseln	Fusseln
verrosteten	verrosteten
Hornunges	Hornunges
schlagt	schlagt
schlängelest	schlängelest
versteckte	versteckte
zürntet	zürntet
eggte	eggte
Ängsten	Ängsten
Stäbe	Stäbe
posierst	posierst
Flosse	Flosse
Zehe	Zehe
desertiertet	desertiertet
Rutheniumisotopen	Rutheniumisotopen
Datentypen	Datentypen
Halogenatom	Halogenatom
Stierkämpfen	Stierkämpfen
Neuigkeit	Neuigkeit
lebet	lebet
tasteten	tasteten
Beobachtung	Beobachtung
Kardinal	Kardinal
Dienstgrade	Dienstgrade
oxidierst	oxidierst
Elstern	Elstern
funktionierte	funktionierte
Schotten	Schotten
Als	Als
Durchbruches	Durchbruches
quatschest	quatschest
Einrad	Einrad
erpresst	erpresst
befestigt	befestigt
lösest	lösest
klagte	klagte
Wolle	Wolle
Europameisters	Europameisters
Spitze	Spitze
Haben	Haben
Minimierungen	Minimierungen
Ringen	Ringen
Tollkirschen	Tollkirschen
bedenket	bedenket
Klotzes	Klotzes
wurstelten	wurstelten
Seelöwen	Seelöwen
Lehrkörpers	Lehrkörpers
verurteilen	verurteilen
rittest	rittest
Zeilen	Zeilen
Weihen	Weihen
erntest	erntest
strandend	strandend
hingehst	hingehst
jeden	jeden
wallet	wallet
verzweifelt	verzweifelt
sprüht	sprüht
wallfahrteten	wallfahrteten
schleißt	schleißt
wähnet	wähnet
Hummern	Hummern
ritt	ritt
Weißflügelpinguin	Weißflügelpinguin
Gefäße	Gefäße
Pfleglingen	Pfleglingen
vertreiben	vertreiben
Mein	Mein
gähnten	gähnten
teile	teile
imprägnieret	imprägnieret
frappiere	frappiere
Testamenten	Testamenten
konvertiere	konvertiere
krank	krank
Frommen	Frommen
amputierten	amputierten
ärgerte	ärgerte
höhnte	höhnte
Hallelujas	Hallelujas
Leitkegeln	Leitkegeln
Kronsbeere	Kronsbeere
Teufel	Teufel
formiret	formiret
Amt	Amt
Neumonden	Neumonden
attackieren	attackieren
beweiset	beweiset
mache	mache
streiften	streiften
beweise	beweise
fritieret	fritieret
Freibrief	Freibrief
schicke	schicke
aufhebt	aufhebt
gute	gute
verbitterten	verbitterten
Sauberfrauen	Sauberfrauen
bewahrst	bewahrst
räumen	räumen
ermächtige	ermächtige
entzögen	entzögen
griffe	griffe
Wehklagen	Wehklagen
Diebe	Diebe
Maß	Maß
entsetzen	entsetzen
Bombardierung	Bombardierung
quasselten	quasselten
schichteten	schichteten
jede	jede
dressieret	dressieret
rebellieret	rebellieret
gedachte	gedachte
verlobt	verlobt
verunzierte	verunzierte
dissentierten	dissentierten
entmineralisieret	entmineralisieret
erstarre	erstarre
deinen	deinen
Epoxide	Epoxide
wirst	wirst
Seetaucher	Seetaucher
Rechnungen	Rechnungen
liste	liste
Linien	Linien
erweckt	erweckt
wechselte	wechselte
verbündest	verbündest
Pest	Pest
verseuchen	verseuchen
Briefen	Briefen
tastet	tastet
Baiser	Baiser
plissiere	plissiere
anrührt	anrührt
ungefälschter	ungefälschter
tabuisierten	tabuisierten
Rundbriefen	Rundbriefen
erpress	erpress
illustriertet	illustriertet
strafe	strafe
belauere	belauere
entsetzten	entsetzten
Tausche	Tausche
heulet	heulet
dankte	dankte
benehme	benehme
Arbeitsunfähigkeit	Arbeitsunfähigkeit
Erdkruste	Erdkruste
Kautschuken	Kautschuken
Safrane	Safrane
sorgte	sorgte
wechseln	wechseln
knüpfen	knüpfen
amenagiere	amenagiere
Küstenwachen	Küstenwachen
wogen	wogen
eingehst	eingehst
belohnte	belohnte
Rosinenkuchenmodell	Rosinenkuchenmodell
vergaste	vergaste
Türme	Türme
ausführen	ausführen
Schreibtischtäter	Schreibtischtäter
Donor	Donor
messen	messen
weich	weich
Ratsherren	Ratsherren
liebtet	liebtet
verschlingt	verschlingt
sponsert	sponsert
Organisationen	Organisationen
verließet	verließet
schwöre	schwöre
jenen	jenen
attackieret	attackieret
lose	lose
verdeckten	verdeckten
Knabe	Knabe
Aerosolen	Aerosolen
restaurieret	restaurieret
repräsentieret	repräsentieret
zittertest	zittertest
lauf	lauf
füllst	füllst
zerreißt	zerreißt
Wadenbein	Wadenbein
glawbten	glawbten
billigte	billigte
trinkst	trinkst
Taufe	Taufe
Taube	Taube
sannen	sannen
Atommasse	Atommasse
zürnest	zürnest
gefügt	gefügt
taufet	taufet
Teile	Teile
vermag	vermag
fällt	fällt
Vogelscheuche	Vogelscheuche
ungeistlichen	ungeistlichen
labe	labe
fluchet	fluchet
Abfertigungsschalters	Abfertigungsschalters
Eissteinen	Eissteinen
fallt	fallt
lachet	lachet
Hardwareentwicklerin	Hardwareentwicklerin
Kleptokratien	Kleptokratien
verewiget	verewiget
Regenwald	Regenwald
verlassen	verlassen
Hinterwäldlern	Hinterwäldlern
einführte	einführte
Gewalttäter	Gewalttäter
öle	öle
Träumer	Träumer
beben	beben
wünschte	wünschte
Patres	Patres
gleite	gleite
eggten	eggten
tun	tun
Adenosin	Adenosin
erwachend	erwachend
einführt	einführt
verdeckt	verdeckt
machet	machet
touchiere	touchiere
fluchten	fluchten
kappten	kappten
Epidemie	Epidemie
knitterte	knitterte
scheinet	scheinet
harmonierte	harmonierte
tagest	tagest
zerrüttet	zerrüttet
lebte	lebte
flehte	flehte
zerrissen	zerrissen
Deutung	Deutung
gehört	gehört
verwiesen	verwiesen
entschädigte	entschädigte
beschert	beschert
gewärtigten	gewärtigten
Grizzlybären	Grizzlybären
dechiffriere	dechiffriere
zweite	zweite
enträtselst	enträtselst
harrten	harrten
leiste	leiste
Flamme	Flamme
borgte	borgte
ansehet	ansehet
verforme	verforme
Grab	Grab
wende	wende
gelobten	gelobten
Falzen	Falzen
Konfitüren	Konfitüren
leiden	leiden
Plumpsen	Plumpsen
hättet	hättet
besuche	besuche
Zäumen	Zäumen
Blicksilber	Blicksilber
Präservativs	Präservativs
Buchhalterinnen	Buchhalterinnen
gedenkst	gedenkst
Mopp	Mopp
Heuschrecken	Heuschrecken
laben	laben
spezialisierst	spezialisierst
sei	sei
tage	tage
hörest	hörest
arme	arme
Sagen	Sagen
Preis	Preis
scheucht	scheucht
Campingplätzen	Campingplätzen
erziehst	erziehst
Habe	Habe
Arsenite	Arsenite
auszieht	auszieht
weichest	weichest
zweifel	zweifel
teilet	teilet
vertonten	vertonten
schmelzt	schmelzt
Armband	Armband
notlande	notlande
zerbrechest	zerbrechest
glänzten	glänzten
jedes	jedes
drillte	drillte
Schaffnerinnen	Schaffnerinnen
gelobst	gelobst
Stämme	Stämme
Nadelbäume	Nadelbäume
Aluminaten	Aluminaten
Fledermaus	Fledermaus
Halter	Halter
Gewinnungen	Gewinnungen
Fiebermittel	Fiebermittel
Heere	Heere
Geschichtsbücher	Geschichtsbücher
gelobet	gelobet
Zahnfleischentzündung	Zahnfleischentzündung
binden	binden
verdammten	verdammten
Kettenraucher	Kettenraucher
Geburtsnamen	Geburtsnamen
erbringen	erbringen
Deuterium	Deuterium
Spielen	Spielen
aufrichtest	aufrichtest
ihre	ihre
moppst	moppst
verallgemeinerst	verallgemeinerst
Verkehrsflugzeug	Verkehrsflugzeug
eingehest	eingehest
dritten	dritten
transportierte	transportierte
Gefängnisse	Gefängnisse
bündelest	bündelest
Knöllchen	Knöllchen
Gebirgen	Gebirgen
Lüste	Lüste
scheute	scheute
Kontraindikation	Kontraindikation
stoppte	stoppte
Fahrzeugkatalysator	Fahrzeugkatalysator
Wühltische	Wühltische
besprenget	besprenget
habe	habe
zappten	zappten
merke	merke
zerschlagt	zerschlagt
fluppe	fluppe
Hin	Hin
Sorget	Sorget
Höhlen	Höhlen
prosteten	prosteten
Seil	Seil
Klappertöpfen	Klappertöpfen
Pumpellyiten	Pumpellyiten
erlöset	erlöset
Aspartame	Aspartame
ungehorsam	ungehorsam
lodertet	lodertet
waren	waren
Geräte	Geräte
schmettern	schmettern
ringe	ringe
Deutungen	Deutungen
imkernd	imkernd
verbot	verbot
winke	winke
verhören	verhören
Substanzen	Substanzen
manche	manche
speichertest	speichertest
filzst	filzst
scherze	scherze
Eingeweide	Eingeweide
Lunisolarkalender	Lunisolarkalender
Götze	Götze
glaube	glaube
Höschens	Höschens
Brieföffners	Brieföffners
Seines	Seines
Abfahrtsliste	Abfahrtsliste
Ränken	Ränken
Dolde	Dolde
erbringst	erbringst
ungeistlich	ungeistlich
eingeht	eingeht
träumen	träumen
verfehlten	verfehlten
Teppiche	Teppiche
beschotteret	beschotteret
kein	kein
Stadtbezirke	Stadtbezirke
vergiftet	vergiftet
konntest	konntest
spaltest	spaltest
lüge	lüge
Gespenstern	Gespenstern
Gepäckträgern	Gepäckträgern
Retter	Retter
ringele	ringele
zuppte	zuppte
entflieht	entflieht
nähernd	nähernd
bestand	bestand
Signalen	Signalen
Toypudeln	Toypudeln
Kirgisinnen	Kirgisinnen
Mikrometer	Mikrometer
begründetest	begründetest
hobt	hobt
Maultieren	Maultieren
Premieren	Premieren
Galoppen	Galoppen
Atemgas	Atemgas
Böse	Böse
Kurkumen	Kurkumen
verschlimmerte	verschlimmerte
fluktuiert	fluktuiert
imkeret	imkeret
wähnt	wähnt
regiere	regiere
erwärmten	erwärmten
schlafet	schlafet
Tumult	Tumult
gewöhnt	gewöhnt
verbarg	verbarg
helle	helle
Chlorats	Chlorats
Skorpione	Skorpione
kabeln	kabeln
Robe	Robe
Überziehen	Überziehen
wallte	wallte
Dudelsack	Dudelsack
hantierte	hantierte
assimilieret	assimilieret
vertrieb	vertrieb
Meines	Meines
Jünglingen	Jünglingen
entsündigten	entsündigten
drücken	drücken
befehlen	befehlen
Juden	Juden
dehydrierte	dehydrierte
erfreute	erfreute
lege	lege
ärgerst	ärgerst
vierte	vierte
erhebst	erhebst
Schwermetallion	Schwermetallion
Schreien	Schreien
selber	selber
pflücke	pflücke
saget	saget
strecken	strecken
geschlummert	geschlummert
erwärmet	erwärmet
schmeicheln	schmeicheln
bestimmten	bestimmten
Steuerwagens	Steuerwagens
verblieben	verblieben
sezierte	sezierte
sagt	sagt
Bestecken	Bestecken
fremden	fremden
lancierst	lancierst
Gefügen	Gefügen
Stimmen	Stimmen
sichere	sichere
Ächselchen	Ächselchen
vertrauten	vertrauten
glaubest	glaubest
Enthärtungen	Enthärtungen
erriet	erriet
Ausländern	Ausländern
ihn	ihn
vertilgest	vertilgest
Weinet	Weinet
mischst	mischst
Bürzel	Bürzel
messet	messet
grübelten	grübelten
Reinelementen	Reinelementen
Metallquirlen	Metallquirlen
verdinglichest	verdinglichest
versteckst	versteckst
WebHooks	WebHooks
Wirtschaftswissenschaft	Wirtschaftswissenschaft
frisch	frisch
Überfamilie	Überfamilie
älteste	älteste
speiest	speiest
Rechten	Rechten
benähmen	benähmen
Bundesgebieten	Bundesgebieten
loben	loben
feierst	feierst
lispelt	lispelt
auflöst	auflöst
Dorsch	Dorsch
entfachten	entfachten
Loparite	Loparite
extemporieret	extemporieret
setztest	setztest
Tore	Tore
Fanmeile	Fanmeile
geloben	geloben
ortete	ortete
tätowiertet	tätowiertet
Knüppeln	Knüppeln
Autonomien	Autonomien
streckte	streckte
Decken	Decken
gewährte	gewährte
Apfelbäumen	Apfelbäumen
Nachteile	Nachteile
stammeln	stammeln
bombardiert	bombardiert
schimmerst	schimmerst
harren	harren
vergrabest	vergrabest
Märchenbuches	Märchenbuches
Werdet	Werdet
Führet	Führet
wehren	wehren
zerrisset	zerrisset
Proton	Proton
betreten	betreten
ratet	ratet
brachen	brachen
vernichtete	vernichtete
Traubenlesen	Traubenlesen
Halt	Halt
säusele	säusele
glaubst	glaubst
begliche	begliche
entwaffneten	entwaffneten
Feierabende	Feierabende
schnappt	schnappt
lehrte	lehrte
Gasflasche	Gasflasche
gönnst	gönnst
Galeere	Galeere
unterfordern	unterfordern
Barschaften	Barschaften
Verehrer	Verehrer
Zain	Zain
Omnibus	Omnibus
Böreks	Böreks
Stiefvätern	Stiefvätern
erinnerest	erinnerest
folge	folge
Am	Am
Maße	Maße
Wiederbelebung	Wiederbelebung
hineinbrächte	hineinbrächte
Paradiesäpfeln	Paradiesäpfeln
Bazziten	Bazziten
scherzt	scherzt
unterwerft	unterwerft
zagest	zagest
Geschichtsbüchern	Geschichtsbüchern
Rehen	Rehen
Gebäcken	Gebäcken
Girls	Girls
Schlägen	Schlägen
Physikerinnen	Physikerinnen
bekehrte	bekehrte
schmuggele	schmuggele
Raten	Raten
Lautschriften	Lautschriften
Schaden	Schaden
ertönst	ertönst
Minischwein	Minischwein
zuteil	zuteil
Löwen	Löwen
Haarverlust	Haarverlust
Glauben	Glauben
Technetiumatom	Technetiumatom
zerstreuet	zerstreuet
flötete	flötete
verzieret	verzieret
rede	rede
googelten	googelten
Radfahrer	Radfahrer
Trichter	Trichter
Werden	Werden
regieren	regieren
herrschen	herrschen
wispern	wispern
verbirgt	verbirgt
erlaube	erlaube
Bär	Bär
überreichend	überreichend
blamierten	blamierten
Schenke	Schenke
entzogen	entzogen
bestimmst	bestimmst
lavierend	lavierend
bequemest	bequemest
rodete	rodete
Schwirrvogel	Schwirrvogel
Unternehmung	Unternehmung
schwächst	schwächst
vermöget	vermöget
Geschwindigkeitsmessern	Geschwindigkeitsmessern
Gegenleistung	Gegenleistung
Lümmeltüten	Lümmeltüten
Schneidern	Schneidern
bedient	bedient
bis	bis
Anhängseln	Anhängseln
Rinde	Rinde
initiierst	initiierst
Pardelkatze	Pardelkatze
Trägerwellen	Trägerwellen
werdet	werdet
könnte	könnte
wälzt	wälzt
Amputierte	Amputierte
wichste	wichste
erbrüte	erbrüte
Tritt	Tritt
verlötest	verlötest
fluppten	fluppten
kautest	kautest
Isobar	Isobar
faltest	faltest
Kreise	Kreise
Weiblein	Weiblein
unterschiede	unterschiede
Vorstädten	Vorstädten
Gebeine	Gebeine
Jagdhunden	Jagdhunden
blätteret	blätteret
Operationssaal	Operationssaal
verspätete	verspätete
Silbersulfidbelag	Silbersulfidbelag
essen	essen
ruckelst	ruckelst
Apostels	Apostels
kriegte	kriegte
Fussel	Fussel
Operationssälen	Operationssälen
erschüttere	erschüttere
trompete	trompete
Polizeisprecher	Polizeisprecher
bewahret	bewahret
verführte	verführte
Stierkämpfe	Stierkämpfe
Bienen	Bienen
Äxte	Äxte
Brechnuss	Brechnuss
glänzen	glänzen
bestellte	bestellte
gebet	gebet
Hat	Hat
Feste	Feste
führe	führe
Komponistinnen	Komponistinnen
nachwandelt	nachwandelt
besitzet	besitzet
Tische	Tische
Anlass	Anlass
dringen	dringen
abziehen	abziehen
Gaschromatographie	Gaschromatographie
durften	durften
henket	henket
betätigest	betätigest
Schnallen	Schnallen
bimmelten	bimmelten
Röcken	Röcken
liebend	liebend
Sprachraum	Sprachraum
Anhängsel	Anhängsel
eng	eng
Rechte	Rechte
Martyrologien	Martyrologien
ausfuhren	ausfuhren
hegst	hegst
Gemurmel	Gemurmel
Hehler	Hehler
rufst	rufst
drifte	drifte
Ach	Ach
haare	haare
parkierten	parkierten
Elektrophil	Elektrophil
setzen	setzen
Gründungsprivileg	Gründungsprivileg
schabst	schabst
babbelten	babbelten
entwickelten	entwickelten
Notständen	Notständen
überwachest	überwachest
ziere	ziere
Drohkulissen	Drohkulissen
Sitz	Sitz
Gasflaschen	Gasflaschen
anzeige	anzeige
vereinbaren	vereinbaren
beunruhigte	beunruhigte
Auszüge	Auszüge
blaset	blaset
Fremden	Fremden
Weste	Weste
zweifeln	zweifeln
Pedanten	Pedanten
murmelst	murmelst
folgt	folgt
zürnst	zürnst
Freitagnachmittage	Freitagnachmittage
Spiralen	Spiralen
Kakadu	Kakadu
Fromme	Fromme
tagen	tagen
Rechtsruck	Rechtsruck
besinnen	besinnen
Kraftfahrzeugen	Kraftfahrzeugen
Bazzit	Bazzit
concessionieren	concessionieren
Reinelemente	Reinelemente
Mageninhalt	Mageninhalt
Futtermittel	Futtermittel
Schatten	Schatten
erhöhet	erhöhet
tattre	tattre
geschämt	geschämt
Playlist	Playlist
vereinbarten	vereinbarten
Vergrößerungen	Vergrößerungen
hegten	hegten
Schwänzen	Schwänzen
begräbt	begräbt
dienest	dienest
gebietet	gebietet
verlähmt	verlähmt
straften	straften
Urheimaten	Urheimaten
Pedant	Pedant
erwähnet	erwähnet
bejubelst	bejubelst
Preisanstieg	Preisanstieg
Helden	Helden
verunglimpfen	verunglimpfen
höben	höben
Spurensicherung	Spurensicherung
bebten	bebten
Werkzeugen	Werkzeugen
gedenkt	gedenkt
klicket	klicket
wacht	wacht
lochten	lochten
Halleluja	Halleluja
Säcken	Säcken
sollst	sollst
entkämen	entkämen
colorierten	colorierten
beschottert	beschottert
Fett	Fett
fegst	fegst
Unterschlagung	Unterschlagung
näht	näht
spanne	spanne
überprüftest	überprüftest
Sprödmetall	Sprödmetall
entfachet	entfachet
Organistin	Organistin
reicht	reicht
erwürgest	erwürgest
überfällst	überfällst
absagt	absagt
Schobern	Schobern
pflügen	pflügen
inspirierten	inspirierten
Schlot	Schlot
zügelten	zügelten
Plüschtier	Plüschtier
konvergiere	konvergiere
beichten	beichten
sondern	sondern
Altären	Altären
konjugiere	konjugiere
privatisierest	privatisierest
umkämen	umkämen
Blaumeise	Blaumeise
denaturieret	denaturieret
fladerst	fladerst
listeten	listeten
machte	machte
preise	preise
Hypochlorit	Hypochlorit
kontaktiere	kontaktiere
warntet	warntet
herrschet	herrschet
erweckest	erweckest
Imperialismen	Imperialismen
Katamaranen	Katamaranen
Physikerin	Physikerin
versagen	versagen
stürze	stürze
möpperst	möpperst
Milzen	Milzen
Geschäften	Geschäften
verlasset	verlasset
koste	koste
Bittersüß	Bittersüß
Magier	Magier
Pfunden	Pfunden
traget	traget
Nachruf	Nachruf
lehnen	lehnen
Ektoplasmen	Ektoplasmen
bebte	bebte
nehmt	nehmt
zwang	zwang
sehnst	sehnst
Euter	Euter
erbest	erbest
Schlüchte	Schlüchte
Flussbetten	Flussbetten
peiltest	peiltest
Aas	Aas
Heiratsgut	Heiratsgut
ferne	ferne
emendierte	emendierte
Collagen	Collagen
schichtet	schichtet
drängest	drängest
Penis	Penis
teilen	teilen
mästet	mästet
könne	könne
eine	eine
genieret	genieret
mußten	mußten
fluppen	fluppen
reich	reich
begleicht	begleicht
Hände	Hände
duschten	duschten
Früchtchen	Früchtchen
sündigten	sündigten
Kronsbeeren	Kronsbeeren
schnorrest	schnorrest
funkeln	funkeln
knautsche	knautsche
stolz	stolz
baggerst	baggerst
taufen	taufen
Organisation	Organisation
bedürftet	bedürftet
Irrtumes	Irrtumes
schon	schon
geherrscht	geherrscht
Märtyrer	Märtyrer
Trinken	Trinken
Myriade	Myriade
Buchhalterin	Buchhalterin
Rutheniumkomplexen	Rutheniumkomplexen
Herabsetzungen	Herabsetzungen
erschrickst	erschrickst
ersparen	ersparen
Citrat	Citrat
Knüppels	Knüppels
Portale	Portale
Dank	Dank
Lob	Lob
haderte	haderte
geratest	geratest
Abschirmung	Abschirmung
nähret	nähret
Kopfsalat	Kopfsalat
Atombomben	Atombomben
glaubend	glaubend
heißt	heißt
sinterte	sinterte
blitz	blitz
Schwänzchen	Schwänzchen
Leide	Leide
googelest	googelest
kaufst	kaufst
steinigst	steinigst
Kairiner	Kairiner
rauschen	rauschen
empört	empört
Grenze	Grenze
Schlössern	Schlössern
torpedieret	torpedieret
Schote	Schote
dümpelest	dümpelest
zierte	zierte
Volltreffer	Volltreffer
Ärzte	Ärzte
Kaliumdichromat	Kaliumdichromat
Sorgen	Sorgen
einigte	einigte
Spitzen	Spitzen
ausgeht	ausgeht
Idolatrien	Idolatrien
föhnten	föhnten
geleite	geleite
erlabe	erlabe
laden	laden
Füllfederhalters	Füllfederhalters
lehrest	lehrest
Sphäre	Sphäre
gut	gut
frohlocke	frohlocke
ernte	ernte
Primärenergie	Primärenergie
schaute	schaute
Nahrungsbestandteil	Nahrungsbestandteil
schlagest	schlagest
Isobars	Isobars
Schuhe	Schuhe
Kriegsschauplatz	Kriegsschauplatz
erfüllst	erfüllst
helfet	helfet
Verwundeten	Verwundeten
Eine	Eine
frevler	frevler
sprechet	sprechet
verdeckst	verdeckst
abtrünnige	abtrünnige
verprügelte	verprügelte
baust	baust
Chlorid	Chlorid
rüstete	rüstete
entfolgst	entfolgst
verwechseltet	verwechseltet
verwaiset	verwaiset
Notstand	Notstand
aber	aber
Ihren	Ihren
weise	weise
ermahnt	ermahnt
Linguistinnen	Linguistinnen
wehen	wehen
Schlangen	Schlangen
entschleieret	entschleieret
berufe	berufe
Zwetschgen	Zwetschgen
untersagtest	untersagtest
stützet	stützet
puste	puste
überweist	überweist
grünte	grünte
mußte	mußte
Stücken	Stücken
Vorstädte	Vorstädte
grün	grün
trübe	trübe
Oxalate	Oxalate
Leuchtkäfern	Leuchtkäfern
Trümmersprachen	Trümmersprachen
eigene	eigene
Quatsch	Quatsch
optimierte	optimierte
Fahrt	Fahrt
Möbelstoff	Möbelstoff
sortiert	sortiert
Inder	Inder
verbraucht	verbraucht
Klaue	Klaue
rekrutiere	rekrutiere
Oberbegriff	Oberbegriff
Aromastoffen	Aromastoffen
Geflecktheiten	Geflecktheiten
Würfen	Würfen
erkannte	erkannte
kaserniert	kaserniert
recycelten	recycelten
Technetaten	Technetaten
liebte	liebte
stiftete	stiftete
halbierest	halbierest
Weinstöcken	Weinstöcken
erntete	erntete
fülle	fülle
Pater	Pater
bestrafe	bestrafe
Fürst	Fürst
Rotzinkerzen	Rotzinkerzen
aasend	aasend
Stempeluhren	Stempeluhren
Rasterkraftmikroskop	Rasterkraftmikroskop
verkriechst	verkriechst
den	den
kaufe	kaufe
Borkenkäfer	Borkenkäfer
Apotheose	Apotheose
Kraftfahrzeuges	Kraftfahrzeuges
Herbstwinde	Herbstwinde
Thioester	Thioester
ermutigt	ermutigt
Achsel	Achsel
Entmachtungen	Entmachtungen
löst	löst
gestatteten	gestatteten
thematisierten	thematisierten
streue	streue
Sabbatjahr	Sabbatjahr
verscheißerte	verscheißerte
lachen	lachen
Fallt	Fallt
charakterisierend	charakterisierend
faschierst	faschierst
pressiert	pressiert
enttäusche	enttäusche
verzieht	verzieht
Kanzleien	Kanzleien
verabschiedeten	verabschiedeten
konsolidierest	konsolidierest
applizirte	applizirte
befürchtet	befürchtet
widerstanden	widerstanden
zanket	zanket
Normdaten	Normdaten
Zirkelschlüssen	Zirkelschlüssen
heftetest	heftetest
extemporiere	extemporiere
schnappet	schnappet
tendiertet	tendiertet
besprengen	besprengen
unsre	unsre
Markise	Markise
konntet	konntet
Erzeugung	Erzeugung
Hainbuche	Hainbuche
Dorsche	Dorsche
Sollte	Sollte
verkapselt	verkapselt
Anfechtungen	Anfechtungen
zerstreust	zerstreust
klemmt	klemmt
betrübt	betrübt
hasset	hasset
Gästen	Gästen
zeuge	zeuge
erzwangt	erzwangt
Abkömmlingen	Abkömmlingen
Hirsche	Hirsche
Sorge	Sorge
trompetete	trompetete
inhalier	inhalier
Schnarchralle	Schnarchralle
gezügelt	gezügelt
weh	weh
misstrauest	misstrauest
befestigte	befestigte
gesellt	gesellt
lohnten	lohnten
Treibhausgase	Treibhausgase
verdränge	verdränge
vergleichet	vergleichet
wärt	wärt
überreichst	überreichst
Homodimere	Homodimere
Fingerspitze	Fingerspitze
Schwächungen	Schwächungen
Scheck	Scheck
werten	werten
keines	keines
meine	meine
Europium	Europium
Eiszapfen	Eiszapfen
Döner	Döner
kommest	kommest
versuche	versuche
Innenschau	Innenschau
toten	toten
Räten	Räten
überwachten	überwachten
motivierte	motivierte
beschlug	beschlug
Primatologen	Primatologen
Götzen	Götzen
kaufte	kaufte
verklagst	verklagst
Steuerwagen	Steuerwagen
Erstarren	Erstarren
ander	ander
strömte	strömte
Nährmedien	Nährmedien
abzieht	abzieht
desensibilisierten	desensibilisierten
Städten	Städten
Elementarzellen	Elementarzellen
idealisierten	idealisierten
Brite	Brite
kehrte	kehrte
Gehorchet	Gehorchet
Finanzministerien	Finanzministerien
pflanzt	pflanzt
Zeitplanes	Zeitplanes
Westen	Westen
Linguisten	Linguisten
segmentierten	segmentierten
sezierst	sezierst
schnürest	schnürest
mineralisierten	mineralisierten
Schaffet	Schaffet
gelangte	gelangte
Einheimischen	Einheimischen
sehnte	sehnte
müssest	müssest
rännen	rännen
brillieren	brillieren
verspäteten	verspäteten
Wer	Wer
Hirt	Hirt
baue	baue
Füßen	Füßen
Fremde	Fremde
Ein	Ein
Mäusespeck	Mäusespeck
verwirrt	verwirrt
erzwinget	erzwinget
Molybdit	Molybdit
stille	stille
Bushaltestellen	Bushaltestellen
Hubschrauber	Hubschrauber
schlabbere	schlabbere
vermahnen	vermahnen
Bienenstock	Bienenstock
Ranzigkeit	Ranzigkeit
Aktenkoffer	Aktenkoffer
löge	löge
Arsch	Arsch
ratschlagen	ratschlagen
Dienstgrad	Dienstgrad
Auge	Auge
verberge	verberge
Otavit	Otavit
herrschest	herrschest
Fokusse	Fokusse
Kräfte	Kräfte
beschottre	beschottre
mampfen	mampfen
Untiefe	Untiefe
scheuchtest	scheuchtest
liebet	liebet
referenzierte	referenzierte
Pinguin	Pinguin
Gnaden	Gnaden
Sinnen	Sinnen
blockiert	blockiert
nehmest	nehmest
assimiliertest	assimiliertest
reglementiert	reglementiert
Sollst	Sollst
Waren	Waren
verschickte	verschickte
ältesten	ältesten
Dochten	Dochten
Bildpunkten	Bildpunkten
Sekten	Sekten
wollte	wollte
Landstreichereien	Landstreichereien
Pflaume	Pflaume
legen	legen
Schreiber	Schreiber
fälle	fälle
Deck	Deck
Geheimdienst	Geheimdienst
möchte	möchte
läuten	läuten
Denunziationen	Denunziationen
beäugen	beäugen
geleitet	geleitet
Buchfink	Buchfink
Jungfernflüge	Jungfernflüge
gehst	gehst
Kaufleute	Kaufleute
Wunden	Wunden
lade	lade
grüßest	grüßest
hintertreiben	hintertreiben
Quellflüssen	Quellflüssen
Reichweiten	Reichweiten
fragmentiert	fragmentiert
beantrage	beantrage
Herkünften	Herkünften
lautete	lautete
Palästen	Palästen
zeugen	zeugen
Licht	Licht
Referenz	Referenz
flense	flense
Kriege	Kriege
Lobe	Lobe
beklage	beklage
Frettchen	Frettchen
geliebt	geliebt
zeugst	zeugst
filzte	filzte
tote	tote
verallgemeinerest	verallgemeinerest
Bruchstrich	Bruchstrich
generiertet	generiertet
bezahlt	bezahlt
erzeigt	erzeigt
zuppe	zuppe
dotierst	dotierst
entmineralisieren	entmineralisieren
Drehtüren	Drehtüren
verkleinern	verkleinern
Astats	Astats
unterstützten	unterstützten
behalte	behalte
stürzt	stürzt
Hunde	Hunde
Solchen	Solchen
einigst	einigst
halltet	halltet
Werkzeuge	Werkzeuge
Schiffe	Schiffe
Einbrecher	Einbrecher
verwahrt	verwahrt
verbaselte	verbaselte
Steiget	Steiget
verfange	verfange
formirend	formirend
Oxonium	Oxonium
pflücktet	pflücktet
Röcke	Röcke
Keiner	Keiner
Eure	Eure
Premierministerinnen	Premierministerinnen
glühenden	glühenden
Anschläge	Anschläge
eiterten	eiterten
knufften	knufften
Indern	Indern
Hirnstämme	Hirnstämme
trüb	trüb
rächest	rächest
schauspielert	schauspielert
beteuerten	beteuerten
schöpfest	schöpfest
Monate	Monate
meldeten	meldeten
Seehechte	Seehechte
solches	solches
gebühren	gebühren
durchwachen	durchwachen
sedimentierte	sedimentierte
Knechten	Knechten
kämmtet	kämmtet
sterilisiert	sterilisiert
Meine	Meine
piesackest	piesackest
Tiegel	Tiegel
verlobte	verlobte
Abbild	Abbild
Briefe	Briefe
grüble	grüble
Dewargefäße	Dewargefäße
Fotosynthese	Fotosynthese
widerlegest	widerlegest
Unwahrheiten	Unwahrheiten
jaule	jaule
untertretet	untertretet
Fluorgehalt	Fluorgehalt
Mauten	Mauten
Prostylos	Prostylos
trägt	trägt
wiederkamen	wiederkamen
schnitten	schnitten
Kreisen	Kreisen
belüftet	belüftet
sprühend	sprühend
haschiert	haschiert
stiege	stiege
Schauen	Schauen
verderbet	verderbet
fritierst	fritierst
surrst	surrst
einer	einer
gedacht	gedacht
entheiligten	entheiligten
seien	seien
geknautscht	geknautscht
entschädiget	entschädiget
segmentiere	segmentiere
Bettlers	Bettlers
ihnen	ihnen
Ausnahmen	Ausnahmen
deaktivierst	deaktivierst
Ionenaustauscher	Ionenaustauscher
Fäusten	Fäusten
Stoffwechselwegen	Stoffwechselwegen
drescht	drescht
Laiben	Laiben
mästest	mästest
Woge	Woge
Chlorwasserstoffmolekül	Chlorwasserstoffmolekül
Schlepper	Schlepper
Tiefen	Tiefen
Stärke	Stärke
suchen	suchen
finanzierest	finanzierest
schimmerest	schimmerest
Katamarane	Katamarane
beliefen	beliefen
Leichtmetalle	Leichtmetalle
grünt	grünt
babbeltet	babbeltet
stärket	stärket
Donnerstagabenden	Donnerstagabenden
Denkmünze	Denkmünze
Geckos	Geckos
habt	habt
bölkte	bölkte
konvergierest	konvergierest
kurz	kurz
still	still
betrügen	betrügen
Zapfen	Zapfen
zerstreuest	zerstreuest
verspielest	verspielest
arrivieren	arrivieren
ratschlagt	ratschlagt
frottier	frottier
liebtest	liebtest
Abschiedsbriefe	Abschiedsbriefe
Malaysier	Malaysier
verfinstere	verfinstere
fahret	fahret
kritzele	kritzele
erfreu	erfreu
außer	außer
Stufen	Stufen
Buch	Buch
Sichelzellenanämien	Sichelzellenanämien
befehle	befehle
reformieren	reformieren
Speeren	Speeren
Felle	Felle
täuschet	täuschet
Aprikosen	Aprikosen
Funktionalität	Funktionalität
velarisierend	velarisierend
Hackern	Hackern
winkt	winkt
fliehe	fliehe
Auguren	Auguren
unterforderten	unterforderten
Äste	Äste
bringst	bringst
fremde	fremde
Unternehmensanwendungsintegrationen	Unternehmensanwendungsintegrationen
stickten	stickten
Grenzwert	Grenzwert
ziehet	ziehet
Linie	Linie
schlabberten	schlabberten
rauben	rauben
meuternd	meuternd
sedimentiertet	sedimentiertet
Metonymie	Metonymie
Chemikerinnen	Chemikerinnen
Küstenwache	Küstenwache
Zeithorizonte	Zeithorizonte
kämpfte	kämpfte
bauten	bauten
Genkinits	Genkinits
Acetat	Acetat
Rotscheitelreiher	Rotscheitelreiher
babbelst	babbelst
vor	vor
höbe	höbe
parlieren	parlieren
geräuchert	geräuchert
denaturierte	denaturierte
verachtet	verachtet
Kompromissen	Kompromissen
Bettler	Bettler
kehret	kehret
Krumen	Krumen
Pläsier	Pläsier
Kehre	Kehre
Welche	Welche
Fische	Fische
warte	warte
Arme	Arme
restaurierten	restaurierten
Weg	Weg
Höfe	Höfe
Kanzlei	Kanzlei
scheue	scheue
Graben	Graben
Büsche	Büsche
knusperst	knusperst
pilgert	pilgert
handhabt	handhabt
Aufsätzen	Aufsätzen
Schönrednern	Schönrednern
infiziertet	infiziertet
unser	unser
Krusten	Krusten
Schrei	Schrei
produzierest	produzierest
bereite	bereite
köderet	köderet
verzeigt	verzeigt
flirtest	flirtest
Bären	Bären
lögest	lögest
Zwangsarbeiterin	Zwangsarbeiterin
idealisieret	idealisieret
sintertest	sintertest
Privatsachen	Privatsachen
arbeiten	arbeiten
verleumdete	verleumdete
filzten	filzten
Vorstoß	Vorstoß
reglementierte	reglementierte
strullerst	strullerst
grau	grau
folgend	folgend
betrieben	betrieben
Leset	Leset
sollte	sollte
stäupte	stäupte
Muhme	Muhme
Braunrallen	Braunrallen
Trinkgefäßen	Trinkgefäßen
versüße	versüße
Samen	Samen
Gässchen	Gässchen
Kissenschlacht	Kissenschlacht
pflügten	pflügten
Krustentier	Krustentier
Bagger	Bagger
Betainen	Betainen
weisen	weisen
weinet	weinet
Assistentin	Assistentin
begründest	begründest
halbe	halbe
laut	laut
Gigapascal	Gigapascal
verschärfst	verschärfst
fabulierest	fabulierest
Falz	Falz
stehet	stehet
verewigt	verewigt
WebHook	WebHook
Unglauben	Unglauben
verlasse	verlasse
verknüpft	verknüpft
begehrtet	begehrtet
Einzelgänger	Einzelgänger
pilgerte	pilgerte
Briefwechsel	Briefwechsel
glawbte	glawbte
sollt	sollt
verletzte	verletzte
Gehör	Gehör
Carbid	Carbid
formulierst	formulierst
zertifiziertest	zertifiziertest
schützt	schützt
Friedensforscherinnen	Friedensforscherinnen
Reiterschwertern	Reiterschwertern
Hallen	Hallen
hinterzöge	hinterzöge
misstrauen	misstrauen
Anwendungsgebiete	Anwendungsgebiete
zerstücken	zerstücken
durchzuckest	durchzuckest
moppet	moppet
vollendest	vollendest
Finanzministern	Finanzministern
Hobbys	Hobbys
Dezernat	Dezernat
schläft	schläft
bewahrt	bewahrt
wahre	wahre
erwähnten	erwähnten
ankerst	ankerst
Öfchens	Öfchens
versteigernd	versteigernd
suchet	suchet
Biokraftstoff	Biokraftstoff
meißelt	meißelt
umbrächten	umbrächten
Leichname	Leichname
Playlists	Playlists
gestikuliere	gestikuliere
konnte	konnte
Kommoden	Kommoden
lockerst	lockerst
nächsten	nächsten
entfolgte	entfolgte
verkündigten	verkündigten
Trichtern	Trichtern
übrigbleibt	übrigbleibt
feiert	feiert
kühle	kühle
verkaufst	verkaufst
weine	weine
downloadete	downloadete
schwöllen	schwöllen
Bleiglanz	Bleiglanz
Flamen	Flamen
offenbare	offenbare
Kryostat	Kryostat
klöne	klöne
erkundigte	erkundigte
Geschäfte	Geschäfte
Maximierung	Maximierung
gefällst	gefällst
legt	legt
gedenket	gedenket
Hode	Hode
Zäume	Zäume
haschieret	haschieret
velarisiert	velarisiert
Antimusters	Antimusters
tatteret	tatteret
schlaget	schlaget
sich	sich
Rast	Rast
hätte	hätte
Türkinnen	Türkinnen
Hirten	Hirten
impfte	impfte
ärgertest	ärgertest
schauten	schauten
wachte	wachte
schneide	schneide
imitiertet	imitiertet
Monarchie	Monarchie
begebet	begebet
umarbeitest	umarbeitest
gebäret	gebäret
Zähnen	Zähnen
Arreste	Arreste
umhüllt	umhüllt
verringertet	verringertet
Tatsachenbeschöniger	Tatsachenbeschöniger
lachte	lachte
Stiefmütterchen	Stiefmütterchen
regelet	regelet
tappten	tappten
ihrem	ihrem
Kerzenfischen	Kerzenfischen
warntest	warntest
Gummibaumes	Gummibaumes
Volkslehre	Volkslehre
Blitze	Blitze
erwürgten	erwürgten
erzeigten	erzeigten
wegführe	wegführe
Siglen	Siglen
verziehst	verziehst
verselbstständige	verselbstständige
irgendeine	irgendeine
Rubinen	Rubinen
Denen	Denen
bröckelten	bröckelten
Eingeweiden	Eingeweiden
begehren	begehren
parametrisierte	parametrisierte
blitzet	blitzet
Schönredner	Schönredner
Kirchhof	Kirchhof
Geschrei	Geschrei
steckte	steckte
Monaten	Monaten
betonierte	betonierte
Wembley-Toren	Wembley-Toren
baggerte	baggerte
Heringe	Heringe
Tauben	Tauben
Zensus	Zensus
Anfänger	Anfänger
zirpe	zirpe
bewiese	bewiese
Treppe	Treppe
Keilen	Keilen
Klärungen	Klärungen
querte	querte
werden	werden
sehet	sehet
privilegiere	privilegiere
Trübsal	Trübsal
hänge	hänge
Taschenwörterbuch	Taschenwörterbuch
regeln	regeln
heiß	heiß
knurrtet	knurrtet
Äther	Äther
sterbest	sterbest
Urbaren	Urbaren
Epiker	Epiker
wechselwirkt	wechselwirkt
Rückumlaute	Rückumlaute
polymerisierte	polymerisierte
enträtselten	enträtselten
Eilande	Eilande
Geigerzähler	Geigerzähler
widmest	widmest
beschuldiget	beschuldiget
Katz-und-Maus-Spiele	Katz-und-Maus-Spiele
Blässe	Blässe
kabelte	kabelte
achte	achte
Geber	Geber
Dinge	Dinge
Aktienkursen	Aktienkursen
fastetest	fastetest
Rumänin	Rumänin
mopst	mopst
Haltepunkt	Haltepunkt
erkennest	erkennest
Herr	Herr
irgendein	irgendein
nötig	nötig
Ackerschachtelhalm	Ackerschachtelhalm
scheinest	scheinest
vergaset	vergaset
steiget	steiget
Wärt	Wärt
gewähret	gewähret
fertigte	fertigte
skypet	skypet
Ersten	Ersten
verdammtet	verdammtet
einen	einen
aufrichte	aufrichte
versklavte	versklavte
lostet	lostet
frikassierend	frikassierend
kommet	kommet
Industrienation	Industrienation
gebt	gebt
Fahlflanken-Ameisenwürger	Fahlflanken-Ameisenwürger
vertilgt	vertilgt
Kontrollboxen	Kontrollboxen
ungefälschtem	ungefälschtem
schämest	schämest
bequemtet	bequemtet
reichet	reichet
Angabe	Angabe
implodiere	implodiere
schreie	schreie
verführten	verführten
Taufen	Taufen
opferte	opferte
verzweigst	verzweigst
reizet	reizet
eins	eins
Laufet	Laufet
verhalten	verhalten
verwaisten	verwaisten
Animation	Animation
überliefere	überliefere
beichteten	beichteten
werdest	werdest
Pentaborat	Pentaborat
schwadroniert	schwadroniert
versüßtet	versüßtet
Ausbeuterei	Ausbeuterei
Managementsystemen	Managementsystemen
blitztet	blitztet
Fellen	Fellen
Kein	Kein
verzehrt	verzehrt
Untern	Untern
Satzung	Satzung
tobend	tobend
Abnahmen	Abnahmen
gleitest	gleitest
deinem	deinem
Telefonverkäufer	Telefonverkäufer
Pflanzenstoff	Pflanzenstoff
keinem	keinem
wärmet	wärmet
Geldautomaten	Geldautomaten
dramatisieren	dramatisieren
Meter	Meter
Palme	Palme
Weißt	Weißt
versuchen	versuchen
Herden	Herden
strecke	strecke
Beten	Beten
grüßte	grüßte
Herrn	Herrn
stärke	stärke
berücksichtiget	berücksichtiget
zagt	zagt
Asiatin	Asiatin
letzten	letzten
Geliebten	Geliebten
trüge	trüge
Seinen	Seinen
maß	maß
legest	legest
brenne	brenne
beeinflusst	beeinflusst
bemerken	bemerken
Ende	Ende
dürftet	dürftet
gelobend	gelobend
Technikerinnen	Technikerinnen
Verkehrsflugzeuge	Verkehrsflugzeuge
verunreinigt	verunreinigt
offenbar	offenbar
erlauben	erlauben
Verbrechen	Verbrechen
changieren	changieren
regiertest	regiertest
Indianer	Indianer
Butzemann	Butzemann
Außenministerien	Außenministerien
Metallquirle	Metallquirle
Nahrungsbestandteilen	Nahrungsbestandteilen
funzen	funzen
vertrieben	vertrieben
baute	baute
Keine	Keine
Kompromiss	Kompromiss
entheilige	entheilige
ausgerecktem	ausgerecktem
Pflichten	Pflichten
zeichnet	zeichnet
meinen	meinen
Zwergschwan	Zwergschwan
Orte	Orte
brechet	brechet
Irrtümern	Irrtümern
besetzest	besetzest
defragmentierten	defragmentierten
Kaufhäuser	Kaufhäuser
offenbartest	offenbartest
schreckt	schreckt
tyrannisierte	tyrannisierte
Klassenzimmern	Klassenzimmern
punktest	punktest
Roben	Roben
machest	machest
beschlügen	beschlügen
ausziehst	ausziehst
aufnahmt	aufnahmt
explodierst	explodierst
bescheißt	bescheißt
Alten	Alten
harrest	harrest
überfischte	überfischte
neigest	neigest
Aphasien	Aphasien
sortierte	sortierte
weist	weist
Gerichten	Gerichten
Amnestie	Amnestie
appellierst	appellierst
Gesetzen	Gesetzen
trotzt	trotzt
Germanisten	Germanisten
Greyerzern	Greyerzern
producieret	producieret
wiederkamt	wiederkamt
anrufen	anrufen
vermahnte	vermahnte
lüg	lüg
Bestechungsgelder	Bestechungsgelder
gehorchten	gehorchten
faschieret	faschieret
Herabsetzung	Herabsetzung
Bausch	Bausch
backt	backt
Blockflöten	Blockflöten
Kommet	Kommet
gedächten	gedächten
bombardiere	bombardiere
Fahrzeugkatalysatoren	Fahrzeugkatalysatoren
Kernspaltungen	Kernspaltungen
bürsten	bürsten
Ebenen	Ebenen
Gedanke	Gedanke
haarten	haarten
Gut	Gut
beneidest	beneidest
Gibst	Gibst
Reinstoff	Reinstoff
Massage	Massage
schießt	schießt
Metaphern	Metaphern
Bleiglanzes	Bleiglanzes
binde	binde
vertilgen	vertilgen
entsündigte	entsündigte
Traggasen	Traggasen
malt	malt
Orten	Orten
umbrächte	umbrächte
Schwänze	Schwänze
kämpfet	kämpfet
Linguist	Linguist
Urbare	Urbare
sedimentiert	sedimentiert
bereuest	bereuest
füsilierte	füsilierte
nächste	nächste
seinem	seinem
vertiefet	vertiefet
fladerten	fladerten
seine	seine
verderbest	verderbest
vertonet	vertonet
irren	irren
häufte	häufte
wegführen	wegführen
Alibi	Alibi
Flame	Flame
respektieren	respektieren
rüstetet	rüstetet
destabilisierte	destabilisierte
überschnitten	überschnitten
feire	feire
hinterfragten	hinterfragten
entrümpelest	entrümpelest
vier	vier
Exzentriker	Exzentriker
begebe	begebe
Rußen	Rußen
bilden	bilden
inneren	inneren
vergrubt	vergrubt
Fittiche	Fittiche
gewarnt	gewarnt
Generatoren	Generatoren
gedurft	gedurft
Chronisten	Chronisten
entständen	entständen
verstehst	verstehst
spurtest	spurtest
steigen	steigen
Gepäckträger	Gepäckträger
strömt	strömt
taten	taten
leer	leer
Fremdwort	Fremdwort
Pausbacken	Pausbacken
Meere	Meere
anzeigt	anzeigt
Ebene	Ebene
Affenbrotbäumen	Affenbrotbäumen
Beryll	Beryll
bollerest	bollerest
bezahlst	bezahlst
Wehret	Wehret
revoltierte	revoltierte
Stiefvater	Stiefvater
Firnisse	Firnisse
Samstagnachmittag	Samstagnachmittag
bummeltet	bummeltet
hinterfragst	hinterfragst
schwenkt	schwenkt
Kunstgeschichte	Kunstgeschichte
hängen	hängen
deren	deren
massakrierte	massakrierte
pflanzet	pflanzet
gebären	gebären
Wirte	Wirte
Anführer	Anführer
Zitronensaft	Zitronensaft
interpretiert	interpretiert
Beschuldigungen	Beschuldigungen
Stimme	Stimme
anzögen	anzögen
mißversteht	mißversteht
Baisers	Baisers
harmoniert	harmoniert
überfischt	überfischt
Basiliken	Basiliken
tatet	tatet
verkleidete	verkleidete
meldet	meldet
schleimte	schleimte
Fäuste	Fäuste
löstet	löstet
besprachen	besprachen
pflanzte	pflanzte
führen	führen
Kürass	Kürass
Lasten	Lasten
Aprikose	Aprikose
Ställe	Ställe
rangieret	rangieret
grüßend	grüßend
Toten	Toten
Asthenosphäre	Asthenosphäre
behauptete	behauptete
lebst	lebst
backen	backen
UND-Gattern	UND-Gattern
verprügelet	verprügelet
Hehlern	Hehlern
zensiere	zensiere
verliert	verliert
schaffet	schaffet
breche	breche
stärken	stärken
sagten	sagten
emendieret	emendieret
Judenräte	Judenräte
Warte	Warte
Feiertage	Feiertage
Anwendungsgebiet	Anwendungsgebiet
verdamme	verdamme
überschattet	überschattet
Dünungen	Dünungen
Rundbriefe	Rundbriefe
Brote	Brote
installierten	installierten
möchtest	möchtest
haltet	haltet
speicherten	speicherten
Dürren	Dürren
Regiert	Regiert
Astat	Astat
Spanne	Spanne
schläfst	schläfst
erobern	erobern
springst	springst
brillierest	brillierest
verschafft	verschafft
jene	jene
assimilierte	assimilierte
hydrogentartrate	hydrogentartrate
Nukleinsäuren	Nukleinsäuren
Feierabend	Feierabend
raffinier	raffinier
stimmet	stimmet
kurze	kurze
betrüge	betrüge
seines	seines
kategorisierte	kategorisierte
harmonierest	harmonierest
Kornnattern	Kornnattern
Gebete	Gebete
schämst	schämst
zeichnest	zeichnest
Wissen	Wissen
Futur	Futur
zürne	zürne
endlagern	endlagern
spalten	spalten
Ställen	Ställen
wehrtest	wehrtest
hätten	hätten
grienest	grienest
lehrst	lehrst
Aha-Erlebnisse	Aha-Erlebnisse
bedingst	bedingst
schwirret	schwirret
verringerten	verringerten
Königreiche	Königreiche
zentrierest	zentrierest
verstört	verstört
Version	Version
bist	bist
einst	einst
konnten	konnten
Blechen	Blechen
erstaunst	erstaunst
Mönchen	Mönchen
verständig	verständig
Hektaren	Hektaren
reparierten	reparierten
dechiffrierend	dechiffrierend
Letzten	Letzten
Fittichen	Fittichen
transportierten	transportierten
Däumlings	Däumlings
fastetet	fastetet
reifst	reifst
jeder	jeder
gestalten	gestalten
frohlockte	frohlockte
plärrtest	plärrtest
Abnahme	Abnahme
Perle	Perle
strafend	strafend
führest	führest
Berber	Berber
Fiesling	Fiesling
Lammfellhandschuhen	Lammfellhandschuhen
Zwetschge	Zwetschge
Busen	Busen
verklärest	verklärest
Saiblingen	Saiblingen
klickte	klickte
kapiert	kapiert
produzierten	produzierten
Gram	Gram
Aktivist	Aktivist
wenden	wenden
Platte	Platte
Schwächung	Schwächung
Atommodellen	Atommodellen
verseucht	verseucht
nötigte	nötigte
Kochfeldern	Kochfeldern
schenken	schenken
umkäme	umkäme
schwellen	schwellen
predigt	predigt
Ausländer	Ausländer
Excimerlasern	Excimerlasern
Acetaten	Acetaten
planschest	planschest
ernten	ernten
aufrichtet	aufrichtet
Zäune	Zäune
Fingerhüte	Fingerhüte
Empörungen	Empörungen
Bilderstürmers	Bilderstürmers
Videoaufzeichnung	Videoaufzeichnung
beschrifte	beschrifte
bedurftest	bedurftest
kitzele	kitzele
grabe	grabe
türmt	türmt
Bauwerken	Bauwerken
Drohkulisse	Drohkulisse
verringeret	verringeret
log	log
Krokus	Krokus
verfängt	verfängt
höbest	höbest
begehr	begehr
dressierten	dressierten
kupieren	kupieren
hauest	hauest
gebührt	gebührt
warne	warne
Linken	Linken
Aller	Aller
verschärftet	verschärftet
Schalen	Schalen
bekennst	bekennst
Welchen	Welchen
Stätte	Stätte
hadertet	hadertet
werte	werte
Bilderstürmer	Bilderstürmer
Meldezettel	Meldezettel
Hacker	Hacker
Nussknacker	Nussknacker
siegen	siegen
besorgten	besorgten
Numerus	Numerus
vermahnten	vermahnten
vertraute	vertraute
langte	langte
Tetraiodiden	Tetraiodiden
duckmäusere	duckmäusere
Ausnahme	Ausnahme
wünschst	wünschst
lockerte	lockerte
stationierten	stationierten
gereicht	gereicht
Heptamolybdat	Heptamolybdat
Bürzeln	Bürzeln
Last	Last
läutetet	läutetet
Anhang	Anhang
gehorcht	gehorcht
lackieren	lackieren
verletzt	verletzt
suchten	suchten
auflegst	auflegst
Schnittlauche	Schnittlauche
karikieret	karikieret
Fußballweltmeisterschaftsqualifikationsspiel	Fußballweltmeisterschaftsqualifikationsspiel
Metallothioneinen	Metallothioneinen
bekehrst	bekehrst
emailliert	emailliert
ringet	ringet
schubse	schubse
Sekte	Sekte
Kühen	Kühen
nähert	nähert
dirigieren	dirigieren
zirpen	zirpen
generiert	generiert
Klauen	Klauen
Republikflucht	Republikflucht
Rubine	Rubine
trinket	trinket
fistete	fistete
mehret	mehret
naschst	naschst
verliere	verliere
Afrikaner	Afrikaner
Oheim	Oheim
steigest	steigest
Extrems	Extrems
hineinbrächten	hineinbrächten
knacktest	knacktest
Drillinge	Drillinge
Apostel	Apostel
Senkung	Senkung
Tote	Tote
platzt	platzt
loste	loste
kooperierte	kooperierte
Zubrötchen	Zubrötchen
Obszönität	Obszönität
Raucherin	Raucherin
Sitzfleisches	Sitzfleisches
sündigt	sündigt
möppertet	möppertet
Decks	Decks
amen	amen
laufe	laufe
Erstlingen	Erstlingen
austilgen	austilgen
Kuckucke	Kuckucke
Rhabarber	Rhabarber
kramst	kramst
meinem	meinem
Geflecktheit	Geflecktheit
Graphem	Graphem
Großfürst	Großfürst
Entmachtung	Entmachtung
Bärte	Bärte
zappen	zappen
seist	seist
versuchtet	versuchtet
Gläubigern	Gläubigern
Coventrisierung	Coventrisierung
reformierten	reformierten
Rheumatismus	Rheumatismus
illustriere	illustriere
Anschlägen	Anschlägen
treibst	treibst
brause	brause
gewöhnte	gewöhnte
Würfelspiele	Würfelspiele
verbirgst	verbirgst
feierten	feierten
speiset	speiset
alarmiere	alarmiere
bereiteten	bereiteten
Bande	Bande
ankern	ankern
Taschenwörterbuches	Taschenwörterbuches
gezählt	gezählt
verzehrst	verzehrst
Quellfluss	Quellfluss
veranstaltest	veranstaltest
ummantelten	ummantelten
Biokraftstoffes	Biokraftstoffes
Lobet	Lobet
hingehet	hingehet
zittere	zittere
bekannten	bekannten
Raben	Raben
untertreten	untertreten
fallest	fallest
Konzentrat	Konzentrat
Argentits	Argentits
Anrufbeantworter	Anrufbeantworter
hupet	hupet
griff	griff
stapften	stapften
ducktest	ducktest
Weihe	Weihe
schließt	schließt
Steinen	Steinen
spielen	spielen
klappen	klappen
geboten	geboten
Dichten	Dichten
narret	narret
Flenser	Flenser
Vetter	Vetter
vielen	vielen
gaffest	gaffest
überdenkest	überdenkest
schämet	schämet
vergliche	vergliche
Soge	Soge
konnotieret	konnotieret
bereits	bereits
Bildschirmfotos	Bildschirmfotos
beeindruckt	beeindruckt
wehr	wehr
bandagierte	bandagierte
predigtest	predigtest
scheltet	scheltet
gehörte	gehörte
Sprüchen	Sprüchen
Atemgasen	Atemgasen
rebelliere	rebelliere
funkelet	funkelet
Edelsteine	Edelsteine
missverstände	missverstände
vereinigte	vereinigte
Mobilfunknetze	Mobilfunknetze
Wespen	Wespen
ummantle	ummantle
Kerl	Kerl
Äthern	Äthern
Leiste	Leiste
Rufet	Rufet
Reinigungsschritten	Reinigungsschritten
Tyrannen	Tyrannen
Beine	Beine
Heben	Heben
besitze	besitze
Halte	Halte
rufe	rufe
erinnre	erinnre
flucht	flucht
erlasset	erlasset
Arbeitsgruppen	Arbeitsgruppen
dolmetschst	dolmetschst
äussern	äussern
duckt	duckt
Pausbacke	Pausbacke
bleiben	bleiben
rollten	rollten
Geldautomat	Geldautomat
Euren	Euren
kabbelet	kabbelet
verpuffe	verpuffe
Abfertigungsschalter	Abfertigungsschalter
schautest	schautest
scheiterst	scheiterst
mangelte	mangelte
wehrend	wehrend
Fettsack	Fettsack
Kriegsknechten	Kriegsknechten
Automatikgetrieben	Automatikgetrieben
zeltest	zeltest
Tatsachenbeschönigern	Tatsachenbeschönigern
Wiedergutmachungen	Wiedergutmachungen
forschen	forschen
fällst	fällst
Erfahrung	Erfahrung
Nanokondensatoren	Nanokondensatoren
sprecht	sprecht
kauerten	kauerten
musizieret	musizieret
jagst	jagst
offenbarten	offenbarten
besorg	besorg
süsse	süsse
Kaufleuten	Kaufleuten
Schneepflug	Schneepflug
verwerten	verwerten
mißverstehet	mißverstehet
ersparten	ersparten
schiesst	schiesst
schiebest	schiebest
prostituierte	prostituierte
fresset	fresset
verselbständigt	verselbständigt
Atombombe	Atombombe
Großstädtern	Großstädtern
Bevölkerungsdichte	Bevölkerungsdichte
krieget	krieget
Introjektion	Introjektion
willst	willst
Artischocken	Artischocken
Mähnenwolf	Mähnenwolf
Wasserquellen	Wasserquellen
stand	stand
anrichte	anrichte
trägst	trägst
vertreibt	vertreibt
lobet	lobet
Isolatoren	Isolatoren
bölket	bölket
Ding	Ding
prostet	prostet
Recht	Recht
verzierten	verzierten
schöpfen	schöpfen
Radfahrern	Radfahrern
zählte	zählte
speiste	speiste
Pimmel	Pimmel
Lehrbüchern	Lehrbüchern
Banden	Banden
Seelöwe	Seelöwe
Gegenleistungen	Gegenleistungen
freiwillige	freiwillige
Ästen	Ästen
erlaubest	erlaubest
konnotierst	konnotierst
redetet	redetet
mangeln	mangeln
wehrten	wehrten
klappest	klappest
Dewargefäß	Dewargefäß
ab	ab
Butike	Butike
stillest	stillest
Brikette	Brikette
setzest	setzest
wert	wert
Gefilden	Gefilden
behütet	behütet
Massenanteilen	Massenanteilen
Judenrat	Judenrat
meinet	meinet
suchest	suchest
Monarchien	Monarchien
Mammut	Mammut
Fischzucht	Fischzucht
Vollkornbrot	Vollkornbrot
bleibet	bleibet
Malaysierin	Malaysierin
regierst	regierst
Aussätzigen	Aussätzigen
jaulst	jaulst
Handbüchern	Handbüchern
Anfängern	Anfängern
Verwundete	Verwundete
treibest	treibest
substituierend	substituierend
argumentierest	argumentierest
Sanatorien	Sanatorien
Schreiben	Schreiben
Seilen	Seilen
Stühle	Stühle
sollten	sollten
weissagten	weissagten
bedeckest	bedeckest
beunruhige	beunruhige
reparieret	reparieret
Ruße	Ruße
Signal	Signal
opfern	opfern
hüpfen	hüpfen
Silberdrahts	Silberdrahts
Hörspiel	Hörspiel
gehetzt	gehetzt
vermischten	vermischten
manchen	manchen
watete	watete
dümpelte	dümpelte
heile	heile
erfreuen	erfreuen
Helmen	Helmen
zerschlaget	zerschlaget
Lammfellhandschuhs	Lammfellhandschuhs
Wachen	Wachen
harrtest	harrtest
protestieret	protestieret
emittiert	emittiert
Substanz	Substanz
achten	achten
Toren	Toren
bereiten	bereiten
Membran	Membran
Otaviten	Otaviten
dramatisiert	dramatisiert
lehnte	lehnte
Pailletten	Pailletten
gedenke	gedenke
lieb	lieb
Adelungen	Adelungen
Streichen	Streichen
Altäre	Altäre
privatisiert	privatisiert
defragmentierest	defragmentierest
verkündigest	verkündigest
betrübtest	betrübtest
aufrichten	aufrichten
Alte	Alte
Gasgemisch	Gasgemisch
berücksichtigt	berücksichtigt
Kehret	Kehret
unterbrächest	unterbrächest
klone	klone
assimilierten	assimilierten
Schlaraffenlandes	Schlaraffenlandes
begehrt	begehrt
höret	höret
Weinbergen	Weinbergen
sehn	sehn
rächte	rächte
erschütterte	erschütterte
deckte	deckte
übersteht	übersteht
Meinen	Meinen
Jünglinge	Jünglinge
Quellen	Quellen
abalienierest	abalienierest
rufest	rufest
beförderet	beförderet
Abarten	Abarten
prediget	prediget
kristallisierest	kristallisierest
durchwacht	durchwacht
Bärenfellen	Bärenfellen
Prostyloi	Prostyloi
stapele	stapele
Spende	Spende
berühret	berühret
Sprichwörtern	Sprichwörtern
Rufen	Rufen
Meinet	Meinet
Öfchen	Öfchen
erkalten	erkalten
Langschwanzpinguin	Langschwanzpinguin
verkürztest	verkürztest
Gallanen	Gallanen
Verdachtes	Verdachtes
Füchsinnen	Füchsinnen
Untier	Untier
holet	holet
Neuigkeiten	Neuigkeiten
Nanosatelliten	Nanosatelliten
grabble	grabble
Strahlentierchen	Strahlentierchen
hämmerst	hämmerst
Feuerteufels	Feuerteufels
Deuteriums	Deuteriums
Berufe	Berufe
stäupt	stäupt
Überschüssen	Überschüssen
wechselwirkte	wechselwirkte
beweist	beweist
Märtyrern	Märtyrern
Besuch	Besuch
instrumentalisierest	instrumentalisierest
irrte	irrte
Gemeinde	Gemeinde
Anlässe	Anlässe
verbleibet	verbleibet
Gehilfen	Gehilfen
Kaffeelöffel	Kaffeelöffel
Solcher	Solcher
Hummel	Hummel
unterwerfest	unterwerfest
kreieren	kreieren
Ingredienzen	Ingredienzen
tust	tust
Indianern	Indianern
Rutheniumkomplex	Rutheniumkomplex
ersparet	ersparet
Abfahrtslisten	Abfahrtslisten
reinstitutionalisiert	reinstitutionalisiert
entschleiert	entschleiert
Leiden	Leiden
stoßet	stoßet
verformen	verformen
verbüßest	verbüßest
herrschst	herrschst
skypst	skypst
finanziere	finanziere
erbrütet	erbrütet
Regierung	Regierung
Auszügen	Auszügen
verdunsten	verdunsten
Rehbock	Rehbock
ernteten	ernteten
möchten	möchten
entsetzet	entsetzet
Brettspiele	Brettspiele
rotten	rotten
Muster	Muster
weichet	weichet
niemanden	niemanden
hinterzögen	hinterzögen
steigerten	steigerten
nahte	nahte
Pfeilen	Pfeilen
Tintenfische	Tintenfische
folgen	folgen
dringst	dringst
Senkungen	Senkungen
besänftiget	besänftiget
versagt	versagt
panaschieret	panaschieret
vergast	vergast
Orgeln	Orgeln
Streife	Streife
frevles	frevles
watet	watet
Politologe	Politologe
Reiterschwert	Reiterschwert
Wunde	Wunde
Erzherzogshüten	Erzherzogshüten
Friede	Friede
Bluffs	Bluffs
eure	eure
Bäche	Bäche
raubet	raubet
diversifiziere	diversifiziere
Trioxiden	Trioxiden
bricht	bricht
heiligten	heiligten
Schläfchens	Schläfchens
trödele	trödele
Türkenbünden	Türkenbünden
Temperaturanstieg	Temperaturanstieg
beider	beider
raffiniere	raffiniere
ermutigte	ermutigte
dunkelt	dunkelt
verwirren	verwirren
stapfst	stapfst
mampfte	mampfte
Videoaufzeichnungen	Videoaufzeichnungen
schnatternd	schnatternd
ringelten	ringelten
jungen	jungen
Erfahrungen	Erfahrungen
Höhe	Höhe
entkäme	entkäme
Trockendocks	Trockendocks
streutet	streutet
wässerten	wässerten
Hirte	Hirte
herrschte	herrschte
Türkenbund	Türkenbund
Ablösung	Ablösung
Unrechten	Unrechten
fahrt	fahrt
Versorgungen	Versorgungen
dürft	dürft
herrschten	herrschten
betrübten	betrübten
Reinigungsschrittes	Reinigungsschrittes
Steige	Steige
verfügten	verfügten
reizt	reizt
Atomphysiker	Atomphysiker
heiligte	heiligte
Oberlippe	Oberlippe
Testamente	Testamente
Abflug	Abflug
Schlaraffenländern	Schlaraffenländern
heischten	heischten
verschränken	verschränken
brauste	brauste
verachte	verachte
Rechenbrettern	Rechenbrettern
simuliertet	simuliertet
bang	bang
wiederholte	wiederholte
Kerzenlichter	Kerzenlichter
reanimierten	reanimierten
stutzt	stutzt
zürntest	zürntest
erratet	erratet
sitzen	sitzen
Bette	Bette
schießen	schießen
verteidigte	verteidigte
schreist	schreist
durchläuterte	durchläuterte
interagiert	interagiert
Stilllegungen	Stilllegungen
härten	härten
verkauften	verkauften
Hie	Hie
Borhydrid	Borhydrid
Werken	Werken
Langzeichen	Langzeichen
trefft	trefft
schwadronierten	schwadronierten
wehre	wehre
Stadtbezirken	Stadtbezirken
gedenkest	gedenkest
Zeitschlitze	Zeitschlitze
befördert	befördert
lüftet	lüftet
falteten	falteten
Arsenit	Arsenit
überqueren	überqueren
Inkarnationen	Inkarnationen
entwendet	entwendet
Weichloten	Weichloten
Polarisation	Polarisation
vermahne	vermahne
Buchstaben	Buchstaben
Blumensträußen	Blumensträußen
Membranen	Membranen
deklarierte	deklarierte
stoppten	stoppten
Maut	Maut
frikassiert	frikassiert
Druckfehlern	Druckfehlern
zerstreuten	zerstreuten
lobte	lobte
Firnis	Firnis
verhalte	verhalte
decket	decket
berührt	berührt
zeugten	zeugten
Bleigehalt	Bleigehalt
webte	webte
vermischen	vermischen
am	am
benütztest	benütztest
Attentäter	Attentäter
Markisen	Markisen
angehören	angehören
Same	Same
zwingst	zwingst
lüftetet	lüftetet
Augur	Augur
pipettierten	pipettierten
fluche	fluche
amenagierst	amenagierst
Spektralbereichen	Spektralbereichen
stoßest	stoßest
Überschüsse	Überschüsse
aufkommen	aufkommen
begrub	begrub
lügen	lügen
Spektralbereich	Spektralbereich
fünften	fünften
kritzeln	kritzeln
geleiteten	geleiteten
Theologie	Theologie
Abbindebeschleunigern	Abbindebeschleunigern
posierten	posierten
schlachten	schlachten
hievst	hievst
chloroformiere	chloroformiere
weinen	weinen
beanspruchest	beanspruchest
Gebirge	Gebirge
erzürnst	erzürnst
bemächtigest	bemächtigest
Anliegen	Anliegen
inszenierst	inszenierst
Badezimmer	Badezimmer
Kohlenstoffgehalten	Kohlenstoffgehalten
Herde	Herde
Strontiumamalgamen	Strontiumamalgamen
flenstet	flenstet
Weil	Weil
begrübe	begrübe
gestaltest	gestaltest
amenagieren	amenagieren
hatten	hatten
Anmeldern	Anmeldern
Fahlflanken-Ameisenwürgern	Fahlflanken-Ameisenwürgern
Wachteln	Wachteln
keulst	keulst
Sauberfrau	Sauberfrau
kürze	kürze
verwechsele	verwechsele
Haarshampoos	Haarshampoos
Brüder	Brüder
liebt	liebt
weinte	weinte
verzweifelten	verzweifelten
Bluff	Bluff
erkältete	erkältete
Arbeitskreis	Arbeitskreis
beseht	beseht
Freizeitzentrum	Freizeitzentrum
Wasserbädern	Wasserbädern
mein	mein
malten	malten
Halbgott	Halbgott
Knöllchens	Knöllchens
Aufpralle	Aufpralle
Aachener	Aachener
leid	leid
Leichen	Leichen
begrabet	begrabet
Leichenschauhäuser	Leichenschauhäuser
rufen	rufen
Honigbären	Honigbären
orgelt	orgelt
rangierst	rangierst
Metapher	Metapher
Arsenbergwerken	Arsenbergwerken
bewiest	bewiest
Fortsetzungen	Fortsetzungen
Fluoratom	Fluoratom
entrümpelst	entrümpelst
genehmigt	genehmigt
deponiere	deponiere
billige	billige
Flussbett	Flussbett
setzten	setzten
warten	warten
weg	weg
Hummer	Hummer
stützen	stützen
hoben	hoben
Kassiteriten	Kassiteriten
Bilderstürmereien	Bilderstürmereien
grüntet	grüntet
plagte	plagte
Feind	Feind
dringest	dringest
verschicket	verschicket
Düften	Düften
erhebet	erhebet
Gerichte	Gerichte
verifizierten	verifizierten
weichen	weichen
reichen	reichen
werde	werde
fragte	fragte
kabelst	kabelst
stärkte	stärkte
Empfängnisverhütungen	Empfängnisverhütungen
Ionen	Ionen
bewürben	bewürben
Flossen	Flossen
unseres	unseres
Wären	Wären
Säue	Säue
Basilisk	Basilisk
sponsertest	sponsertest
Kaktusfeige	Kaktusfeige
bemüht	bemüht
Schober	Schober
Verwaltungsakte	Verwaltungsakte
solcher	solcher
brauche	brauche
zeiget	zeiget
vergibst	vergibst
konstatiertest	konstatiertest
Bromidquelle	Bromidquelle
Blitzen	Blitzen
rechten	rechten
jaget	jaget
verkriechet	verkriechet
folgtet	folgtet
erwürgtest	erwürgtest
zeugt	zeugt
Alibis	Alibis
einerntest	einerntest
beklagte	beklagte
verkaufte	verkaufte
Sonnenfinsternissen	Sonnenfinsternissen
initiierten	initiierten
Körpergeruches	Körpergeruches
beziehen	beziehen
lös	lös
fraget	fraget
vertilge	vertilge
bereue	bereue
folterte	folterte
ruhe	ruhe
Serverzugriffe	Serverzugriffe
colorierend	colorierend
Kannen	Kannen
generalisiere	generalisiere
Rücktrittbremsen	Rücktrittbremsen
gehorchst	gehorchst
Fällt	Fällt
empörte	empörte
Verdacht	Verdacht
ausgereckten	ausgereckten
aufkäme	aufkäme
verdreht	verdreht
Lehrbücher	Lehrbücher
Kaufhäusern	Kaufhäusern
Störe	Störe
Domänen	Domänen
Unterwerfungen	Unterwerfungen
angehöret	angehöret
formulieren	formulieren
türmen	türmen
Solches	Solches
umarmet	umarmet
schmetterst	schmetterst
oxidierte	oxidierte
wäre	wäre
lehre	lehre
bewässertet	bewässertet
Oberlandesgericht	Oberlandesgericht
Neumonde	Neumonde
Rückumlauten	Rückumlauten
Waldbränden	Waldbränden
kühlen	kühlen
gedächte	gedächte
referenziere	referenziere
rolltet	rolltet
hilfst	hilfst
observierst	observierst
abtrünnigen	abtrünnigen
Sippe	Sippe
Katalanen	Katalanen
Kernspaltung	Kernspaltung
trinken	trinken
begrübest	begrübest
zwänget	zwänget
Grizzlybär	Grizzlybär
möget	möget
fasset	fasset
ritze	ritze
verlähmte	verlähmte
erzeigte	erzeigte
Nährmediums	Nährmediums
Falle	Falle
zerstückte	zerstückte
verschlungen	verschlungen
dekoriere	dekoriere
Königreichen	Königreichen
bestraft	bestraft
heilte	heilte
Zehen	Zehen
Meerschweinchen	Meerschweinchen
Harpune	Harpune
Selbstversuche	Selbstversuche
Germanist	Germanist
Großstädter	Großstädter
verlautet	verlautet
hupen	hupen
erkannten	erkannten
Ölspur	Ölspur
Berufen	Berufen
bezahlest	bezahlest
Dezernaten	Dezernaten
Gase	Gase
kriegen	kriegen
erziehen	erziehen
Reststoff	Reststoff
entert	entert
strafest	strafest
Staatsführungen	Staatsführungen
betätigtet	betätigtet
klappst	klappst
zuhörte	zuhörte
Rehe	Rehe
Suffix	Suffix
Eisenkräutern	Eisenkräutern
Alteritäten	Alteritäten
Jahre	Jahre
gelobtet	gelobtet
folg	folg
Gar	Gar
unschuldige	unschuldige
äusserst	äusserst
Bajonette	Bajonette
rinnt	rinnt
nähe	nähe
pflegst	pflegst
Mitschuld	Mitschuld
moppen	moppen
erlassen	erlassen
bückest	bückest
immunisiere	immunisiere
Wehklage	Wehklage
Tukanen	Tukanen
Weinstöcke	Weinstöcke
verjährte	verjährte
Tasten	Tasten
schmierte	schmierte
gepuddelt	gepuddelt
lang	lang
Autonomie	Autonomie
schaben	schaben
Euphemismen	Euphemismen
reifen	reifen
kennest	kennest
Willst	Willst
besichtigt	besichtigt
Kakao	Kakao
fragest	fragest
halten	halten
Schnute	Schnute
keulte	keulte
Spieße	Spieße
beweisest	beweisest
glaubten	glaubten
unterscheide	unterscheide
Noseans	Noseans
torpediert	torpediert
Hochsommer	Hochsommer
Genie	Genie
destabilisierst	destabilisierst
Massagen	Massagen
leiten	leiten
unterrichtet	unterrichtet
Denn	Denn
ermordetest	ermordetest
graben	graben
ahne	ahne
unehret	unehret
beauftragt	beauftragt
verfinstert	verfinstert
Steuerbord	Steuerbord
fassest	fassest
salzen	salzen
entgehe	entgehe
wünschest	wünschest
Renegaten	Renegaten
glaubtet	glaubtet
Tintenklecks	Tintenklecks
murmelte	murmelte
Ölfässern	Ölfässern
erbauet	erbauet
heiße	heiße
besicheret	besicheret
Silberdrähten	Silberdrähten
duzet	duzet
Cholesterin	Cholesterin
Flensern	Flensern
Anzeichen	Anzeichen
Unsere	Unsere
Broten	Broten
Backenbärten	Backenbärten
Apportierhunde	Apportierhunde
Werte	Werte
Ärzten	Ärzten
sage	sage
liehen	liehen
Kardinäle	Kardinäle
anzeigen	anzeigen
Bezeugungen	Bezeugungen
Eiland	Eiland
Filzläusen	Filzläusen
Weile	Weile
bezichtigt	bezichtigt
Sportlerin	Sportlerin
Bedenken	Bedenken
rufet	rufet
gehorchest	gehorchest
unschuldigen	unschuldigen
Höret	Höret
Gefängnissen	Gefängnissen
Abbindebeschleuniger	Abbindebeschleuniger
Schale	Schale
Zuschauer	Zuschauer
führet	führet
erhöht	erhöht
sagtet	sagtet
Vogelscheuchen	Vogelscheuchen
Aggressor	Aggressor
grause	grause
knackt	knackt
verbasele	verbasele
folterst	folterst
Besprechungen	Besprechungen
fünfte	fünfte
kochte	kochte
losten	losten
Toypudel	Toypudel
schwebte	schwebte
Abhänge	Abhänge
batest	batest
Außenministerium	Außenministerium
preist	preist
fabuliere	fabuliere
spannt	spannt
sterbt	sterbt
Harpunen	Harpunen
beten	beten
welchen	welchen
habet	habet
bewies	bewies
attestierten	attestierten
Gehörst	Gehörst
Trickbetrügern	Trickbetrügern
Kaufkraft	Kaufkraft
überwiese	überwiese
Klüften	Klüften
Ludwigsburger	Ludwigsburger
gabelst	gabelst
gründen	gründen
Bauwerke	Bauwerke
schluchze	schluchze
Panzerschreck	Panzerschreck
gibt	gibt
Angaben	Angaben
Inauguration	Inauguration
analysierest	analysierest
drängst	drängst
besäen	besäen
gewähr	gewähr
Berylle	Berylle
Feldzug	Feldzug
Radsätzen	Radsätzen
brennen	brennen
Ratet	Ratet
verantwortet	verantwortet
Totgeburten	Totgeburten
addierte	addierte
jammerte	jammerte
der	der
prangest	prangest
zürnte	zürnte
sabbere	sabbere
schmeichelest	schmeichelest
schummelst	schummelst
Abartigkeit	Abartigkeit
gafften	gafften
Talismanen	Talismanen
hattest	hattest
schmuste	schmuste
Jungen	Jungen
blitzt	blitzt
fabulierte	fabulierte
scheiterest	scheiterest
überschatteten	überschatteten
Metallspiegeln	Metallspiegeln
Gebeten	Gebeten
Adeliepinguin	Adeliepinguin
Zeithorizonten	Zeithorizonten
Bächen	Bächen
Hüfte	Hüfte
durchzuck	durchzuck
sündigte	sündigte
Elementen	Elementen
Abschußring	Abschußring
grüßten	grüßten
Selbstversuch	Selbstversuch
Hektare	Hektare
Schlüchten	Schlüchten
Zapfhahn	Zapfhahn
Kautschuke	Kautschuke
Kruste	Kruste
Huflattich	Huflattich
Galopps	Galopps
Fellhandschuh	Fellhandschuh
lügst	lügst
Krume	Krume
Hansen	Hansen
Haue	Haue
hickste	hickste
bescherten	bescherten
führte	führte
Sitzfleisch	Sitzfleisch
stellte	stellte
abweichest	abweichest
Minimierung	Minimierung
quietschest	quietschest
Kälber	Kälber
egge	egge
sedimentieret	sedimentieret
beeindrucket	beeindrucket
Händedruck	Händedruck
Epidemien	Epidemien
Samarskit	Samarskit
prophezeiet	prophezeiet
bürsteten	bürsteten
Abbildern	Abbildern
erhörest	erhörest
missversteht	missversteht
verschmelzen	verschmelzen
umhüll	umhüll
Piratensendern	Piratensendern
Unter	Unter
Hebet	Hebet
Fehlen	Fehlen
Fällen	Fällen
Fettes	Fettes
springen	springen
speisest	speisest
überbewerte	überbewerte
Dochte	Dochte
Weichseln	Weichseln
Handbuch	Handbuch
wisperest	wisperest
Grüßet	Grüßet
hetzte	hetzte
scheuchen	scheuchen
stoße	stoße
verschmelze	verschmelze
Blockflöte	Blockflöte
lauten	lauten
Strahlentierchens	Strahlentierchens
besichtiget	besichtiget
drosselt	drosselt
kooperierst	kooperierst
Leuchtstoff	Leuchtstoff
Puffersystem	Puffersystem
Andrologie	Andrologie
punktetest	punktetest
wirft	wirft
erklinge	erklinge
addieren	addieren
häufen	häufen
Päckchen	Päckchen
Maßen	Maßen
übersehest	übersehest
zwölfte	zwölfte
tränke	tränke
Kadavergehorsam	Kadavergehorsam
zieren	zieren
vernehmest	vernehmest
verbrauchet	verbrauchet
ob	ob
auflöste	auflöste
säte	säte
verlieren	verlieren
Fellhandschuhen	Fellhandschuhen
Hälsen	Hälsen
Wehe	Wehe
Trockendock	Trockendock
Wasserquelle	Wasserquelle
Mikrometern	Mikrometern
steinigte	steinigte
beansprucht	beansprucht
Äquatoren	Äquatoren
Dominicanerin	Dominicanerin
gehorchte	gehorchte
Arm	Arm
protestierest	protestierest
Pläsieren	Pläsieren
tattert	tattert
umgäben	umgäben
tappst	tappst
Schneider	Schneider
Dunkelkammern	Dunkelkammern
weinest	weinest
verachtend	verachtend
Knechte	Knechte
Bonzen	Bonzen
schämten	schämten
unterwirft	unterwirft
erwachte	erwachte
Erzeugungen	Erzeugungen
Mageninhalten	Mageninhalten
reifte	reifte
Sollten	Sollten
verantwortetest	verantwortetest
Mönche	Mönche
urbanisier	urbanisier
Dich	Dich
auszögen	auszögen
rebellieren	rebellieren
Puffersystemen	Puffersystemen
Dingen	Dingen
erzeigen	erzeigen
Preisen	Preisen
Füllfeder	Füllfeder
Landstreicher	Landstreicher
dein	dein
Gleitzeiten	Gleitzeiten
deaktiviere	deaktiviere
Aufträgen	Aufträgen
ehrte	ehrte
Suffixen	Suffixen
sinke	sinke
begnügt	begnügt
Sehnen	Sehnen
Übelkeit	Übelkeit
Scherzen	Scherzen
Diethylether	Diethylether
Rutheniumisotop	Rutheniumisotop
Buntwaschmittel	Buntwaschmittel
sehest	sehest
glaubet	glaubet
bedenken	bedenken
Banketten	Banketten
Dorngesträuch	Dorngesträuch
Eiszapfens	Eiszapfens
Bleche	Bleche
Pfleglinge	Pfleglinge
Herkunft	Herkunft
gespeist	gespeist
halle	halle
möchtet	möchtet
kasernierte	kasernierte
imprägniere	imprägniere
christianisiere	christianisiere
begehrend	begehrend
fegte	fegte
meinte	meinte
übersiehst	übersiehst
Malen	Malen
erweckst	erweckst
liebe	liebe
verzieh	verzieh
Zeugnissen	Zeugnissen
armen	armen
überbewertet	überbewertet
Telefonnummer	Telefonnummer
Füllet	Füllet
dotiere	dotiere
Entree	Entree
plazierest	plazierest
Händedrücken	Händedrücken
Führe	Führe
verspätest	verspätest
Tintenklecksen	Tintenklecksen
Volkslehren	Volkslehren
duzen	duzen
besser	besser
kremierten	kremierten
müsse	müsse
unterwerfe	unterwerfe
Willen	Willen
sagtest	sagtest
Paragraphenreitern	Paragraphenreitern
Donoren	Donoren
entzweiest	entzweiest
Abschreckung	Abschreckung
grünest	grünest
gelobe	gelobe
quantisiere	quantisiere
Grabbeltisch	Grabbeltisch
Satzungen	Satzungen
fritiert	fritiert
gratuliert	gratuliert
Bevölkerungsdichten	Bevölkerungsdichten
Türkis	Türkis
verkündet	verkündet
Besprechung	Besprechung
reim	reim
Rückweg	Rückweg
vollendete	vollendete
angehöre	angehöre
Gehorcht	Gehorcht
Beschleuniger	Beschleuniger
initiieret	initiieret
Tübingern	Tübingern
emigriert	emigriert
Wechselstuben	Wechselstuben
Dilettanten	Dilettanten
Nadel	Nadel
verwahret	verwahret
geraten	geraten
manövrierte	manövrierte
rekonstruieret	rekonstruieret
Regenten	Regenten
späht	späht
verrostet	verrostet
Zerfällen	Zerfällen
Heide	Heide
schlummerte	schlummerte
Schickse	Schickse
wohnet	wohnet
Küchenmaschine	Küchenmaschine
platz	platz
unterstützet	unterstützet
Laubbaum	Laubbaum
Antitranspirante	Antitranspirante
Paralipse	Paralipse
vertraget	vertraget
malträtiert	malträtiert
Pfandgeld	Pfandgeld
klettert	klettert
entgegenkamen	entgegenkamen
schöpfte	schöpfte
bezichtigten	bezichtigten
gelangen	gelangen
verkapselten	verkapselten
Chlorwasserstoffmoleküls	Chlorwasserstoffmoleküls
Fehden	Fehden
fragst	fragst
Kleinoden	Kleinoden
schäumtest	schäumtest
begnügte	begnügte
überdenkst	überdenkst
erhört	erhört
Panzerschrecke	Panzerschrecke
aller	aller
merket	merket
schummelten	schummelten
eurer	eurer
Gefangene	Gefangene
Ecken	Ecken
reizte	reizte
eigenen	eigenen
erdacht	erdacht
begraben	begraben
erfüllet	erfüllet
Schlange	Schlange
weissagst	weissagst
Suche	Suche
Gewicht	Gewicht
Stearat	Stearat
Hörst	Hörst
Erzherzogshüte	Erzherzogshüte
bitten	bitten
Den	Den
jappte	jappte
erstände	erstände
plaziert	plaziert
verlaßt	verlaßt
Chlorat	Chlorat
Puder	Puder
vermöge	vermöge
entsündigt	entsündigt
übte	übte
Lusitaners	Lusitaners
Anker	Anker
grübelte	grübelte
wichsten	wichsten
Arsenbergwerk	Arsenbergwerk
gewurstelt	gewurstelt
verließen	verließen
Wollte	Wollte
Jahr	Jahr
Chasaren	Chasaren
blast	blast
Gehorsam	Gehorsam
ein	ein
Trioxid	Trioxid
Rekursion	Rekursion
malochte	malochte
Kannst	Kannst
wirfst	wirfst
Kürasse	Kürasse
Verselbstständigung	Verselbstständigung
Zinkat	Zinkat
mühe	mühe
merken	merken
Kerls	Kerls
offenbart	offenbart
nützt	nützt
solch	solch
Zitronensäften	Zitronensäften
zürn	zürn
Pflanzenwachstum	Pflanzenwachstum
freuet	freuet
Bombardierungen	Bombardierungen
verdunstet	verdunstet
links	links
Kleptokratie	Kleptokratie
predigen	predigen
überreicht	überreicht
bespracht	bespracht
bräunst	bräunst
Trickbetrüger	Trickbetrüger
Weinen	Weinen
Hertz	Hertz
Hüllenelektronen	Hüllenelektronen
begrabe	begrabe
kristallisiertest	kristallisiertest
Basilisken	Basilisken
polymerisier	polymerisier
fern	fern
plissieren	plissieren
verkürztet	verkürztet
mobilisierten	mobilisierten
Lenkstange	Lenkstange
bemühet	bemühet
heilige	heilige
Dorngesträuchen	Dorngesträuchen
abweichet	abweichet
pendele	pendele
pflüget	pflüget
Wände	Wände
vertrage	vertrage
Drachen	Drachen
feiere	feiere
Bienenstöcke	Bienenstöcke
drücke	drücke
bekehrten	bekehrten
unsres	unsres
hüten	hüten
Mähnenwölfen	Mähnenwölfen
umarmen	umarmen
Rhabarbern	Rhabarbern
argumentierten	argumentierten
bemerket	bemerket
Wille	Wille
enterten	enterten
verdammend	verdammend
Kirgisin	Kirgisin
Kopfverletzungen	Kopfverletzungen
reanimiere	reanimiere
zerbräche	zerbräche
strandeten	strandeten
Arsenolithen	Arsenolithen
Steuerberatern	Steuerberatern
schonte	schonte
zeugte	zeugte
Fragen	Fragen
folgst	folgst
Generationen	Generationen
kostet	kostet
gehörst	gehörst
bekriegt	bekriegt
segelte	segelte
Peptid	Peptid
sinnst	sinnst
flitzen	flitzen
verflog	verflog
Schwebfliegen	Schwebfliegen
Ärztin	Ärztin
Agoraphobie	Agoraphobie
dich	dich
stellet	stellet
hieltet	hieltet
Aderhaut	Aderhaut
malochet	malochet
Schnitzeljagd	Schnitzeljagd
würdest	würdest
Vordenker	Vordenker
taufte	taufte
Serverzugriffen	Serverzugriffen
Ring	Ring
Sanatoriums	Sanatoriums
präsentier	präsentier
erzeigest	erzeigest
Quelle	Quelle
anzeigte	anzeigte
Schläfchen	Schläfchen
gedenken	gedenken
lösten	lösten
Zankapfel	Zankapfel
bereitete	bereitete
erforscht	erforscht
verstand	verstand
Radiergummi	Radiergummi
blitzen	blitzen
Anmelder	Anmelder
verboten	verboten
Pferden	Pferden
Päckchens	Päckchens
erhebest	erhebest
bündelten	bündelten
wohnst	wohnst
lauft	lauft
trügen	trügen
lispelten	lispelten
Zehnt	Zehnt
kontaktieret	kontaktieret
Aktienkurs	Aktienkurs
Blutgefäß	Blutgefäß
Lobgesängen	Lobgesängen
Feldbett	Feldbett
Freizeitzentren	Freizeitzentren
Maultier	Maultier
Melanteriten	Melanteriten
Wandergesellen	Wandergesellen
kramten	kramten
innere	innere
fluktuierte	fluktuierte
eiterte	eiterte
malträtierte	malträtierte
Pfarrerinnen	Pfarrerinnen
Streiten	Streiten
erstehet	erstehet
Wache	Wache
Schafe	Schafe
vandaliere	vandaliere
Kontaktierungen	Kontaktierungen
rekonstruieren	rekonstruieren
Temperaturanstiege	Temperaturanstiege
Unrecht	Unrecht
dekorieren	dekorieren
Mobilfunknetzen	Mobilfunknetzen
besäest	besäest
Gefäßen	Gefäßen
holte	holte
räucheret	räucheret
Fallturm	Fallturm
Petersfischen	Petersfischen
Herzchen	Herzchen
Primärenergien	Primärenergien
Einsätzen	Einsätzen
allen	allen
Sonderberichte	Sonderberichte
Ansichtskarte	Ansichtskarte
zerbricht	zerbricht
greinen	greinen
Dessous	Dessous
Trinket	Trinket
Acht	Acht
Prüfberichten	Prüfberichten
Hochzeitstorten	Hochzeitstorten
Freunde	Freunde
hebräisch	hebräisch
Löwe	Löwe
Briketten	Briketten
vertäte	vertäte
betrübend	betrübend
replizierten	replizierten
Riesen	Riesen
Wüste	Wüste
Unterseite	Unterseite
zuppen	zuppen
sticke	sticke
prangte	prangte
zerrütteten	zerrütteten
Wüsten	Wüsten
meißeltest	meißeltest
beäugst	beäugst
Münzsammlungen	Münzsammlungen
verkehrte	verkehrte
trinkest	trinkest
Adler	Adler
Besteck	Besteck
Bäusche	Bäusche
plumpsten	plumpsten
entflöhen	entflöhen
Bertrandite	Bertrandite
klonet	klonet
fastete	fastete
sündiget	sündiget
beteuerest	beteuerest
verbluteten	verbluteten
Prüfbericht	Prüfbericht
Kosten	Kosten
betrübtet	betrübtet
sabbelt	sabbelt
Frieden	Frieden
Silbererzen	Silbererzen
knistert	knistert
koexistierte	koexistierte
entwischten	entwischten
bekotete	bekotete
könnest	könnest
gewinnen	gewinnen
Einsatz	Einsatz
bedeckst	bedeckst
Kupferkiesen	Kupferkiesen
koche	koche
Blumenstrauß	Blumenstrauß
Hypochlorite	Hypochlorite
sichten	sichten
Sonnenfinsternis	Sonnenfinsternis
Gammastrahlen	Gammastrahlen
Rücktrittes	Rücktrittes
Iberers	Iberers
Assimilationen	Assimilationen
anrichtet	anrichtet
Charakteristika	Charakteristika
Fellachin	Fellachin
kauern	kauern
Messiassen	Messiassen
Fischen	Fischen
kämmt	kämmt
beschotterten	beschotterten
schließe	schließe
Reizt	Reizt
schlaft	schlaft
nippend	nippend
Ångström	Ångström
Band	Band
kehrst	kehrst
stürzen	stürzen
Begünstigung	Begünstigung
Ringe	Ringe
Drache	Drache
Tust	Tust
jammern	jammern
Elf	Elf
Beschuldigung	Beschuldigung
Deckenfarbe	Deckenfarbe
Gehorsams	Gehorsams
negierte	negierte
Beziehung	Beziehung
Pflicht	Pflicht
nehmet	nehmet
ehrest	ehrest
Gewalttätern	Gewalttätern
Jüngern	Jüngern
aufnahmen	aufnahmen
pfände	pfände
Thioestere	Thioestere
Schamentzündungen	Schamentzündungen
lösend	lösend
Speere	Speere
Königen	Königen
Innenministerien	Innenministerien
tragest	tragest
Nullpunkt	Nullpunkt
wünsche	wünsche
Transportweg	Transportweg
kürzten	kürzten
Ansteckern	Ansteckern
Lazarett	Lazarett
werfet	werfet
beleidige	beleidige
demütige	demütige
Chasar	Chasar
fabuliert	fabuliert
motivieren	motivieren
Druckfehler	Druckfehler
anhanget	anhanget
vertagest	vertagest
Aase	Aase
schauen	schauen
bekannte	bekannte
fistet	fistet
Zirkelschluss	Zirkelschluss
stigmatisierest	stigmatisierest
fotzt	fotzt
malet	malet
zweifelte	zweifelte
verlaß	verlaß
begehrte	begehrte
übrigbleiben	übrigbleiben
grabbelten	grabbelten
pfänden	pfänden
Kriegsenden	Kriegsenden
verbluten	verbluten
Anspielungen	Anspielungen
versteckend	versteckend
fragmentierst	fragmentierst
Leisten	Leisten
emittierte	emittierte
gelobest	gelobest
Feuerteufel	Feuerteufel
Gedächtnisse	Gedächtnisse
Dödel	Dödel
verglühest	verglühest
Gläubiger	Gläubiger
Dann	Dann
belüftete	belüftete
entkörperlichte	entkörperlichte
trotzest	trotzest
wünscht	wünscht
blondiert	blondiert
Ausstiegstüren	Ausstiegstüren
verkündiget	verkündiget
nütze	nütze
Abfertigungsgebäude	Abfertigungsgebäude
überfallen	überfallen
Paradiesapfel	Paradiesapfel
ermordetet	ermordetet
Laufring	Laufring
demoralisiere	demoralisiere
leistete	leistete
flambierten	flambierten
gebündelt	gebündelt
knüpfet	knüpfet
wurden	wurden
Buchstabe	Buchstabe
Ärgernisse	Ärgernisse
Nanosatellit	Nanosatellit
Armen	Armen
begehret	begehret
plärrt	plärrt
blättertet	blättertet
diesen	diesen
Kassettenrekordern	Kassettenrekordern
deine	deine
Schlager	Schlager
sabbre	sabbre
Rechnung	Rechnung
diese	diese
Setzt	Setzt
Wolfesgrube	Wolfesgrube
erkaltest	erkaltest
pendelt	pendelt
Mähnenwolfes	Mähnenwolfes
gelang	gelang
Bajonetten	Bajonetten
beherrschest	beherrschest
transportierst	transportierst
Gemütes	Gemütes
folgte	folgte
krösest	krösest
frohlockten	frohlockten
helft	helft
Pflanzung	Pflanzung
Durchbruch	Durchbruch
Hüftgelenken	Hüftgelenken
Kohlrübe	Kohlrübe
Binde	Binde
zuppst	zuppst
Zeitungsenten	Zeitungsenten
schätzte	schätzte
pustet	pustet
verzweigt	verzweigt
installiert	installiert
designiertet	designiertet
gern	gern
verbaseln	verbaseln
Vordenkern	Vordenkern
unserem	unserem
Garben	Garben
erliegen	erliegen
produzierte	produzierte
Holzquirl	Holzquirl
begehrst	begehrst
flambiert	flambiert
Sexte	Sexte
hassest	hassest
Panamaer	Panamaer
säet	säet
Feinde	Feinde
Aggressoren	Aggressoren
verlöteten	verlöteten
ölt	ölt
Halsabschneider	Halsabschneider
wehe	wehe
zerfielen	zerfielen
Nachteilen	Nachteilen
dampfst	dampfst
annektierst	annektierst
trage	trage
Uranerz	Uranerz
zähle	zähle
Zementen	Zementen
Optimisten	Optimisten
vorn	vorn
Carbiden	Carbiden
Heeren	Heeren
holst	holst
kräuselten	kräuselten
Hinkelsteine	Hinkelsteine
drängten	drängten
gelost	gelost
schwirrt	schwirrt
Klotz	Klotz
Schanktisch	Schanktisch
Münzsammlung	Münzsammlung
Naturen	Naturen
Aerosole	Aerosole
Zunge	Zunge
strafte	strafte
überquerst	überquerst
ackerst	ackerst
Reliquiar	Reliquiar
Lautwandel	Lautwandel
konsumiere	konsumiere
exmatrikuliertet	exmatrikuliertet
grübelt	grübelt
Katz-und-Maus-Spielen	Katz-und-Maus-Spielen
hastete	hastete
verwechselet	verwechselet
Sage	Sage
taufe	taufe
schwöret	schwöret
eggt	eggt
demütiget	demütiget
charakterisiert	charakterisiert
raubest	raubest
ratschlagten	ratschlagten
verwertete	verwertete
Saget	Saget
Fingerhüten	Fingerhüten
Schnipsel	Schnipsel
absagen	absagen
massakrierten	massakrierten
entgehst	entgehst
Warten	Warten
gewitterte	gewitterte
Golfplatz	Golfplatz
Gemeinden	Gemeinden
stehest	stehest
Reflexionen	Reflexionen
besitzest	besitzest
Rekursionen	Rekursionen
Raucherinnen	Raucherinnen
wer	wer
Klassenzimmer	Klassenzimmer
Gebäck	Gebäck
werft	werft
Ihr	Ihr
scheu	scheu
kommst	kommst
diskutiere	diskutiere
Prozedur	Prozedur
gravierten	gravierten
Elle	Elle
Pflanzungen	Pflanzungen
eskalieret	eskalieret
Zeugen	Zeugen
ausführe	ausführe
gelobte	gelobte
linsten	linsten
Zeitungsente	Zeitungsente
Jungfernflug	Jungfernflug
Pi	Pi
Marjellchen	Marjellchen
Seile	Seile
widerlegte	widerlegte
beschwöre	beschwöre
Unglaube	Unglaube
unterrichten	unterrichten
außen	außen
baten	baten
ziert	ziert
Reinstoffen	Reinstoffen
mobilisieret	mobilisieret
besehet	besehet
reiftet	reiftet
überweis	überweis
verdamm	verdamm
verkleinerest	verkleinerest
halbierte	halbierte
löstest	löstest
Abartigkeiten	Abartigkeiten
griffen	griffen
privilegierst	privilegierst
wehrte	wehrte
Abschirmungen	Abschirmungen
Gasgemischen	Gasgemischen
Fetzen	Fetzen
Ankern	Ankern
strullerte	strullerte
wohnte	wohnte
Schwarzseherin	Schwarzseherin
Freibergits	Freibergits
Begrenzung	Begrenzung
regelten	regelten
Rechenbrett	Rechenbrett
Einheimische	Einheimische
Trinker	Trinker
Fadenlauf	Fadenlauf
käbbelnd	käbbelnd
markiere	markiere
Argentit	Argentit
schlängelt	schlängelt
Trägergasen	Trägergasen
Keile	Keile
naschten	naschten
bedrückest	bedrückest
Chinakohl	Chinakohl
ausführt	ausführt
bange	bange
Seehechten	Seehechten
lieben	lieben
filzen	filzen
aßest	aßest
quietsche	quietsche
verstörten	verstörten
lügt	lügt
haste	haste
Loben	Loben
besänftigtest	besänftigtest
quatschen	quatschen
Reiseleiter	Reiseleiter
boykottierten	boykottierten
schauet	schauet
Bunde	Bunde
verbaselt	verbaselt
Kalifeldspate	Kalifeldspate
predigend	predigend
labert	labert
rodet	rodet
Lüsten	Lüsten
Überweisung	Überweisung
Gläubigen	Gläubigen
Kapitalverkehr	Kapitalverkehr
Garten	Garten
Flitzer	Flitzer
Berichterstattungen	Berichterstattungen
ermächtigest	ermächtigest
Bienenzüchter	Bienenzüchter
zürnten	zürnten
tiefe	tiefe
schautet	schautet
arrivierst	arrivierst
evakuieret	evakuieret
ehret	ehret
solle	solle
leuchten	leuchten
bewahrest	bewahrest
ritzten	ritzten
Stör	Stör
Entsetzet	Entsetzet
besorgend	besorgend
dirigiert	dirigiert
Gespenst	Gespenst
Leichnamen	Leichnamen
sagte	sagte
Tübinger	Tübinger
stammelest	stammelest
salz	salz
gefällt	gefällt
Locken	Locken
betrübest	betrübest
Zement	Zement
absolviere	absolviere
Essen	Essen
Brechnüssen	Brechnüssen
Benzol	Benzol
enttäuschet	enttäuschet
entsündigen	entsündigen
heißest	heißest
Zwingburgen	Zwingburgen
Freeganer	Freeganer
Festen	Festen
bringet	bringet
emaillieret	emaillieret
auflegte	auflegte
heulte	heulte
Einfältigkeit	Einfältigkeit
Weh	Weh
verklagt	verklagt
Diesen	Diesen
schenket	schenket
Gelobt	Gelobt
eher	eher
straftet	straftet
mögest	mögest
brauchst	brauchst
Mäppchen	Mäppchen
verkürze	verkürze
ansehen	ansehen
verkröchet	verkröchet
weichst	weichst
nagelest	nagelest
Wadenbeines	Wadenbeines
Sprachräumen	Sprachräumen
mogelten	mogelten
Türkise	Türkise
Desserts	Desserts
Hirschen	Hirschen
mehrte	mehrte
Düfte	Düfte
Darlegungen	Darlegungen
Arbeitsleistung	Arbeitsleistung
Nachweisreagenzien	Nachweisreagenzien
frevle	frevle
Kontrollkästchen	Kontrollkästchen
Meeren	Meeren
erst	erst
fertige	fertige
anrührte	anrührte
Hadithe	Hadithe
Stärkungsmittel	Stärkungsmittel
Silbererze	Silbererze
Junge	Junge
Excimerlaser	Excimerlaser
flirtete	flirtete
liege	liege
zürnet	zürnet
Zainen	Zainen
glauben	glauben
austilge	austilge
Mops	Mops
entmineralisierten	entmineralisierten
nagelte	nagelte
saht	saht
Suchanfragen	Suchanfragen
duschte	duschte
Komplexionen	Komplexionen
Wiedergutmachung	Wiedergutmachung
auflegt	auflegt
stelle	stelle
attestiertet	attestiertet
Edelsteinen	Edelsteinen
inspirierest	inspirierest
tobet	tobet
vermagst	vermagst
setzet	setzet
schenke	schenke
Eisenkraut	Eisenkraut
Wanderfalken	Wanderfalken
schätzen	schätzen
Scherzes	Scherzes
Butzemänner	Butzemänner
Trägergas	Trägergas
Bleigehalten	Bleigehalten
niemand	niemand
Amen	Amen
Ängste	Ängste
exmatrikulierte	exmatrikulierte
fressen	fressen
Milz	Milz
aufstanden	aufstanden
überlieferten	überlieferten
fließt	fließt
Aromastoffe	Aromastoffe
Unterschlagungen	Unterschlagungen
maximierten	maximierten
pflanzen	pflanzen
injizierest	injizierest
filtern	filtern
seht	seht
Brotkästen	Brotkästen
greinet	greinet
schaffest	schaffest
Machet	Machet
Boten	Boten
Laubbläser	Laubbläser
Fußmatte	Fußmatte
entsetzt	entsetzt
erklingt	erklingt
respektierten	respektierten
Lautwandeln	Lautwandeln
Rücktritt	Rücktritt
Pferde	Pferde
erkennet	erkennet
Zöpfe	Zöpfe
heparinisierten	heparinisierten
rüste	rüste
Sachen	Sachen
zentrifugierst	zentrifugierst
Pianos	Pianos
Drachenblut	Drachenblut
deponierte	deponierte
Ich	Ich
zuhört	zuhört
verzehre	verzehre
warnet	warnet
Anhänge	Anhänge
erben	erben
drosselten	drosselten
bewerbet	bewerbet
Gaunern	Gaunern
kapiertet	kapiertet
Flaschenhälsen	Flaschenhälsen
fokussierten	fokussierten
freiwilligen	freiwilligen
anzeigest	anzeigest
macht	macht
Lehrkörpern	Lehrkörpern
chloroformieret	chloroformieret
widmeten	widmeten
haben	haben
verschonet	verschonet
konsumieren	konsumieren
Aufsätze	Aufsätze
Begünstigungen	Begünstigungen
Aderhäuten	Aderhäuten
regen	regen
amputiere	amputiere
erliegst	erliegst
verwechselst	verwechselst
Klappertopf	Klappertopf
anhangt	anhangt
Gegebenheiten	Gegebenheiten
zuppt	zuppt
fragen	fragen
harmoniere	harmoniere
Zehnten	Zehnten
billigen	billigen
Provinzen	Provinzen
Beiblättern	Beiblättern
wünschtest	wünschtest
inszeniere	inszeniere
fette	fette
Decket	Decket
löset	löset
demütigte	demütigte
bewässerst	bewässerst
Füchsen	Füchsen
Macht	Macht
besänne	besänne
ballaste	ballaste
verführen	verführen
Dödeln	Dödeln
rühmte	rühmte
sagst	sagst
standet	standet
Hirnstämmen	Hirnstämmen
Danket	Danket
suche	suche
vernickele	vernickele
predige	predige
Schulleiterin	Schulleiterin
Bällchen	Bällchen
schlage	schlage
Anachronismen	Anachronismen
kategorisierst	kategorisierst
schnüren	schnüren
frohlockest	frohlockest
umgaben	umgaben
negierest	negierest
Gäste	Gäste
Leuchtstoffen	Leuchtstoffen
Marokkanern	Marokkanern
Helme	Helme
esset	esset
eines	eines
Grießen	Grießen
Diagnostik	Diagnostik
Greyerzer	Greyerzer
arm	arm
untersagest	untersagest
reinstitutionalisierten	reinstitutionalisierten
deckst	deckst
fingiere	fingiere
wachset	wachset
interpretierten	interpretierten
legte	legte
Für	Für
Piratensender	Piratensender
Kriegsknechte	Kriegsknechte
Nehmet	Nehmet
verunreinigst	verunreinigst
Schlagzeuger	Schlagzeuger
Aspartamen	Aspartamen
Kühe	Kühe
leerst	leerst
wässerst	wässerst
Worten	Worten
Abgaskatalysatoren	Abgaskatalysatoren
Konfitüre	Konfitüre
knutschst	knutschst
besucht	besucht
ausgereckte	ausgereckte
Töpfen	Töpfen
Ölfasses	Ölfasses
zähltet	zähltet
kitzeln	kitzeln
Wiederauferstehung	Wiederauferstehung
Strafräume	Strafräume
stiftest	stiftest
aufwachte	aufwachte
verwirkliche	verwirkliche
sponseret	sponseret
höbet	höbet
Glaubet	Glaubet
parametrisierten	parametrisierten
Sprechers	Sprechers
Hast	Hast
verstehest	verstehest
streute	streute
föchten	föchten
essest	essest
weiche	weiche
Urologe	Urologe
zerfetzte	zerfetzte
Stolz	Stolz
boßte	boßte
erste	erste
habest	habest
Beilen	Beilen
Recitativen	Recitativen
gestikulierst	gestikulierst
Vorhäuten	Vorhäuten
Beteiligte	Beteiligte
erlöst	erlöst
schälte	schälte
verunglimpfte	verunglimpfte
Füllfedern	Füllfedern
Solche	Solche
kehren	kehren
sicherst	sicherst
surre	surre
versuchet	versuchet
Haarverlusten	Haarverlusten
halt	halt
bewährt	bewährt
fällte	fällte
Kacke	Kacke
sedimentiere	sedimentiere
tunet	tunet
Leitungsweg	Leitungsweg
Gute	Gute
stirbt	stirbt
Mäuse	Mäuse
zuteilte	zuteilte
forschte	forschte
drängte	drängte
Steigen	Steigen
funktioniertest	funktioniertest
Treppen	Treppen
Gangster	Gangster
Schnipseln	Schnipseln
thematisierte	thematisierte
punkteten	punkteten
Selbstversuchen	Selbstversuchen
parametrisierst	parametrisierst
hure	hure
zerfetzt	zerfetzt
zentriert	zentriert
bewässerest	bewässerest
vertiefe	vertiefe
schaffst	schaffst
Sabbaten	Sabbaten
abalieniertest	abalieniertest
glänzt	glänzt
Sekretärinnen	Sekretärinnen
würdet	würdet
aufhobt	aufhobt
Seit	Seit
aufwacht	aufwacht
analysiert	analysiert
greife	greife
verfliegest	verfliegest
Regent	Regent
zählet	zählet
verdammst	verdammst
Hinterwäldler	Hinterwäldler
Staatsanleihe	Staatsanleihe
grüßt	grüßt
revoltiert	revoltiert
Teekessel	Teekessel
schaffen	schaffen
darfst	darfst
Stechpalmen	Stechpalmen
gelobt	gelobt
käbbelte	käbbelte
Ass	Ass
Rotgusses	Rotgusses
jappten	jappten
zeugtest	zeugtest
Schneepflügen	Schneepflügen
Asylrechten	Asylrechten
neigte	neigte
köderte	köderte
Adeliepinguins	Adeliepinguins
jemanden	jemanden
Eingaben	Eingaben
Gelobet	Gelobet
entkörperlichten	entkörperlichten
Solch	Solch
schenkest	schenkest
gründe	gründe
observiertest	observiertest
seufzest	seufzest
Drillingen	Drillingen
schnell	schnell
ackerest	ackerest
Kerzenfische	Kerzenfische
bauest	bauest
Sagte	Sagte
begruben	begruben
Entrées	Entrées
Freibergit	Freibergit
Mop	Mop
liegen	liegen
versteckten	versteckten
Spießen	Spießen
schaut	schaut
entwaffnest	entwaffnest
dingt	dingt
Extremen	Extremen
brillieret	brillieret
Liebchen	Liebchen
schwängen	schwängen
Ambiguitäten	Ambiguitäten
optimiert	optimiert
Linke	Linke
verpufftest	verpufftest
Türkin	Türkin
Fülle	Fülle
fallet	fallet
decke	decke
brecht	brecht
Setzet	Setzet
beschuldigt	beschuldigt
Meinst	Meinst
vermahnt	vermahnt
gewärtigt	gewärtigt
mikrominiaturisierten	mikrominiaturisierten
Bete	Bete
fehlte	fehlte
Buntspechte	Buntspechte
Trübsalen	Trübsalen
bekennt	bekennt
verfolgt	verfolgt
Assistentinnen	Assistentinnen
mühte	mühte
Treibhausgasen	Treibhausgasen
spezialisiere	spezialisiere
gestatte	gestatte
Gesetze	Gesetze
nippst	nippst
Provinz	Provinz
verhungert	verhungert
verirrt	verirrt
analysiere	analysiere
bekriegtet	bekriegtet
referenzierst	referenzierst
Sünders	Sünders
Märchenbüchern	Märchenbüchern
erlabet	erlabet
Funkfeuer	Funkfeuer
Bedeutung	Bedeutung
Kräften	Kräften
seit	seit
Gehilfe	Gehilfe
Gefilde	Gefilde
Leugnungen	Leugnungen
Ei	Ei
Ihre	Ihre
Laken	Laken
Wirst	Wirst
dunkelten	dunkelten
Ausbeuter	Ausbeuter
brauchte	brauchte
gehöre	gehöre
schneidet	schneidet
Ältesten	Ältesten
klingt	klingt
brausen	brausen
Türklingel	Türklingel
zweiten	zweiten
Unterseiten	Unterseiten
Asteroid	Asteroid
verbitterte	verbitterte
Schuhen	Schuhen
Wisset	Wisset
Malaysierinnen	Malaysierinnen
suchst	suchst
streuen	streuen
beschwören	beschwören
Arresten	Arresten
Gehirnwellen	Gehirnwellen
berufen	berufen
Heringen	Heringen
gedachten	gedachten
klagen	klagen
Fluorkohlenwasserstoffe	Fluorkohlenwasserstoffe
dirigieret	dirigieret
bezieht	bezieht
Subspezies	Subspezies
mischt	mischt
moppte	moppte
Teufeln	Teufeln
läute	läute
Schiffen	Schiffen
konvertieren	konvertieren
Händen	Händen
schöpfe	schöpfe
Ärzteblättern	Ärzteblättern
hintertreibt	hintertreibt
posiertet	posiertet
Huren	Huren
taufst	taufst
Hochhäusern	Hochhäusern
Abkürzungsverzeichnisse	Abkürzungsverzeichnisse
Laufen	Laufen
Tetraiodide	Tetraiodide
Einöde	Einöde
Fette	Fette
Raute	Raute
absolviertet	absolviertet
reife	reife
forschet	forschet
Smaragdkehlkolibris	Smaragdkehlkolibris
Nukleinsäure	Nukleinsäure
lange	lange
wisperten	wisperten
jedem	jedem
verabschiedetet	verabschiedetet
tränkten	tränkten
Fischotter	Fischotter
erliegest	erliegest
alle	alle
vermahnet	vermahnet
planschtest	planschtest
verwirklicht	verwirklicht
funktionalisiertest	funktionalisiertest
nötige	nötige
bromiert	bromiert
hebst	hebst
Oxalaten	Oxalaten
frommen	frommen
Augen	Augen
Dein	Dein
Mitwisserschaft	Mitwisserschaft
streiten	streiten
nimmst	nimmst
Welteninsel	Welteninsel
Grieche	Grieche
Tier	Tier
keiner	keiner
stillte	stillte
sagen	sagen
Zapfhähnen	Zapfhähnen
Vorhäute	Vorhäute
Ärschen	Ärschen
Elektronenschale	Elektronenschale
schwimmst	schwimmst
Halbzeiten	Halbzeiten
bejubelte	bejubelte
Kompass	Kompass
Gummibäumen	Gummibäumen
Adlerbussard	Adlerbussard
Kalb	Kalb
sonderte	sonderte
Zeitüberschreitung	Zeitüberschreitung
Arbeitsbereich	Arbeitsbereich
kurbelte	kurbelte
Traubenlese	Traubenlese
reichst	reichst
Lehnen	Lehnen
verbündeten	verbündeten
Ärztinnen	Ärztinnen
pulsiert	pulsiert
begäben	begäben
trauerten	trauerten
Riegel	Riegel
stickt	stickt
gewinnet	gewinnet
schweigen	schweigen
Sabotagen	Sabotagen
massierst	massierst
Schlagzeugern	Schlagzeugern
spritzt	spritzt
grüne	grüne
verfolgst	verfolgst
prostete	prostete
Shortcuts	Shortcuts
Krankenscheinen	Krankenscheinen
drückte	drückte
schöben	schöben
Trotzkist	Trotzkist
speisend	speisend
entdeckst	entdeckst
Rücktrittbremse	Rücktrittbremse
Gallan	Gallan
stürzte	stürzte
implodier	implodier
bewässern	bewässern
letzte	letzte
laute	laute
unserer	unserer
leuchtete	leuchtete
Sinne	Sinne
partitionierten	partitionierten
Tischen	Tischen
fallen	fallen
leite	leite
Prozeduren	Prozeduren
frottierten	frottierten
Glühwürmchen	Glühwürmchen
hinterlege	hinterlege
greifet	greifet
Erbse	Erbse
Planern	Planern
merkte	merkte
wehret	wehret
losest	losest
Darlegung	Darlegung
Anfechtung	Anfechtung
schäumt	schäumt
heiliget	heiliget
dürfen	dürfen
löse	löse
grauten	grauten
kram	kram
bedürft	bedürft
Deinem	Deinem
verdrängen	verdrängen
gedenk	gedenk
ungehorsame	ungehorsame
verstecktet	verstecktet
schwelle	schwelle
predig	predig
welche	welche
willen	willen
er	er
wünschet	wünschet
speise	speise
Wachet	Wachet
substituierest	substituierest
Pudern	Pudern
Kuttern	Kuttern
Sigle	Sigle
Eines	Eines
Musters	Musters
führst	führst
Kassettenrekorder	Kassettenrekorder
Ochsen	Ochsen
wahr	wahr
Fellachinnen	Fellachinnen
spannen	spannen
Kristalle	Kristalle
entwendete	entwendete
kritzelst	kritzelst
finanzieret	finanzieret
rundest	rundest
addieret	addieret
Cyanat	Cyanat
hattet	hattet
Streite	Streite
sinkest	sinkest
krähte	krähte
Pis	Pis
vereinigt	vereinigt
Beteiligten	Beteiligten
stellst	stellst
Remis	Remis
urbanisiert	urbanisiert
diversifiziert	diversifiziert
verblute	verblute
Welpen	Welpen
gehet	gehet
Verbindungsdraht	Verbindungsdraht
verknüpfet	verknüpfet
Kontraindikationen	Kontraindikationen
stoßt	stoßt
gräbst	gräbst
bestimmt	bestimmt
spukest	spukest
bebet	bebet
Ichs	Ichs
errötest	errötest
tabuisiert	tabuisiert
bleibst	bleibst
Deckenzapfen	Deckenzapfen
lanciertet	lanciertet
wälzet	wälzet
Ärgernissen	Ärgernissen
verbrauchten	verbrauchten
schlabberte	schlabberte
schluchzte	schluchzte
Stämmen	Stämmen
urteilte	urteilte
setze	setze
Gerücht	Gerücht
versteckt	versteckt
speisen	speisen
folget	folget
Sizilianer	Sizilianer
Konifere	Konifere
Korrosionsschutzen	Korrosionsschutzen
Kindergeld	Kindergeld
betrete	betrete
eroberte	eroberte
reden	reden
verkündigte	verkündigte
Erbsen	Erbsen
pensionierten	pensionierten
gequasselt	gequasselt
Kurkuma	Kurkuma
verdränget	verdränget
begrabt	begrabt
Jochen	Jochen
beleuchte	beleuchte
besorgest	besorgest
bildest	bildest
Bushaltestelle	Bushaltestelle
mehr	mehr
verglühte	verglühte
Tumulten	Tumulten
Normdatum	Normdatum
verglichest	verglichest
wache	wache
reagierte	reagierte
Koniferen	Koniferen
verziehe	verziehe
Asteroide	Asteroide
Leitkegel	Leitkegel
Magiern	Magiern
schmiert	schmiert
schlafe	schlafe
beißt	beißt
Buchfinken	Buchfinken
Männlein	Männlein
Fiasko	Fiasko
streckst	streckst
Krankenschein	Krankenschein
nachwandeln	nachwandeln
Dieben	Dieben
stolze	stolze
Brieföffner	Brieföffner
sterilisierten	sterilisierten
Krieg	Krieg
generalisiert	generalisiert
Reiseleitern	Reiseleitern
verkauft	verkauft
Androiden	Androiden
sündigst	sündigst
klumpe	klumpe
dividiert	dividiert
Dans	Dans
schrecken	schrecken
denen	denen
dekompilierten	dekompilierten
Mensch	Mensch
heiligem	heiligem
reinige	reinige
Lärchen	Lärchen
Erdbirnen	Erdbirnen
hüte	hüte
Bebauungsplänen	Bebauungsplänen
ihren	ihren
porträtiere	porträtiere
Blütenachse	Blütenachse
entmineralisierst	entmineralisierst
gare	gare
substituierten	substituierten
versklavt	versklavt
Brandbeschleuniger	Brandbeschleuniger
Floß	Floß
Wucher	Wucher
Päderast	Päderast
Prophet	Prophet
Qualifikationen	Qualifikationen
Sportlerinnen	Sportlerinnen
überweise	überweise
pensionierest	pensionierest
Würzen	Würzen
buddelten	buddelten
wallfahrest	wallfahrest
Teilnehmerin	Teilnehmerin
Kleinod	Kleinod
prophezeie	prophezeie
Bruchstriches	Bruchstriches
Pflaumen	Pflaumen
wehte	wehte
imitiert	imitiert
Schenken	Schenken
Abszisse	Abszisse
Eins	Eins
Wasserbades	Wasserbades
Scheißkerlen	Scheißkerlen
besäet	besäet
Amtsträger	Amtsträger
spaltetest	spaltetest
formirte	formirte
Gurt	Gurt
hatte	hatte
Alkali	Alkali
parkierst	parkierst
erlösen	erlösen
löste	löste
Stühlen	Stühlen
sprichst	sprichst
Paragraphenreiter	Paragraphenreiter
Breiten	Breiten
verdrängt	verdrängt
vierten	vierten
dehydrierten	dehydrierten
Brüdern	Brüdern
tagten	tagten
dienet	dienet
entsetzte	entsetzte
wachen	wachen
beiden	beiden
Arbeitsbereichen	Arbeitsbereichen
Trübsale	Trübsale
Gänge	Gänge
kennet	kennet
schauspieleren	schauspieleren
bewähret	bewähret
Atemluft	Atemluft
ertragen	ertragen
amenagier	amenagier
erlösest	erlösest
fladern	fladern
Eistaucher	Eistaucher
Gruftis	Gruftis
boß	boß
prahlte	prahlte
Großfürsten	Großfürsten
vibriere	vibriere
Planer	Planer
leistest	leistest
raubte	raubte
Massenarbeitslosigkeit	Massenarbeitslosigkeit
Kortholt	Kortholt
Sei	Sei
wachse	wachse
begrubt	begrubt
Bis	Bis
Asylrechte	Asylrechte
Briefköpfen	Briefköpfen
Elastomer	Elastomer
Tannen	Tannen
Worte	Worte
Anzeichens	Anzeichens
Deinen	Deinen
Azubi	Azubi
Barbareien	Barbareien
blasen	blasen
Stilllegung	Stilllegung
Halogenatomen	Halogenatomen
Halbzeit	Halbzeit
Atmosphäre	Atmosphäre
Sonderbericht	Sonderbericht
Charakteristikan	Charakteristikan
schreibst	schreibst
Beobachtungen	Beobachtungen
begehre	begehre
verzögerte	verzögerte
Steine	Steine
Hahnenkämme	Hahnenkämme
Soll	Soll
Pfründe	Pfründe
blondierten	blondierten
Rückwege	Rückwege
Schwermetallionen	Schwermetallionen
wach	wach
Bildpunkt	Bildpunkt
Adlerbussarden	Adlerbussarden
stimme	stimme
Wegen	Wegen
Gitarrenspieler	Gitarrenspieler
Gigapascaln	Gigapascaln
linken	linken
prahlet	prahlet
wild	wild
Nigger	Nigger
Abkürzungsverzeichnis	Abkürzungsverzeichnis
Buntspechten	Buntspechten
laufet	laufet
Zeugnisse	Zeugnisse
Technetate	Technetate
Gebern	Gebern
Felsboden	Felsboden
annektierten	annektierten
idealisierest	idealisierest
Leiche	Leiche
verseifet	verseifet
sprachen	sprachen
Vanadaten	Vanadaten
Haltepunkten	Haltepunkten
Anachronismus	Anachronismus
Hälmchen	Hälmchen
bequemte	bequemte
Tukans	Tukans
Ringeltauben	Ringeltauben
schauend	schauend
Polierstählen	Polierstählen
Monden	Monden
erfüllt	erfüllt
scheitern	scheitern
Werk	Werk
bimmelte	bimmelte
verstrahlet	verstrahlet
porträtiert	porträtiert
frische	frische
kupiert	kupiert
Apportierhund	Apportierhund
verdinglichtest	verdinglichtest
Omnibusse	Omnibusse
flitzte	flitzte
Seine	Seine
lodert	lodert
anderen	anderen
Europameistern	Europameistern
viele	viele
Vipernatter	Vipernatter
war	war
trieben	trieben
begehrten	begehrten
Gauner	Gauner
batet	batet
verkürzest	verkürzest
wart	wart
überprüfte	überprüfte
frappierte	frappierte
pressiere	pressiere
durfte	durfte
filteret	filteret
umhüllst	umhüllst
spritzet	spritzet
besichert	besichert
benachrichtiget	benachrichtiget
bröckeln	bröckeln
aufhebest	aufhebest
ehre	ehre
beantragt	beantragt
Gewichten	Gewichten
nahe	nahe
träumte	träumte
dichten	dichten
Referenzen	Referenzen
Laib	Laib
Komponisten	Komponisten
Paläste	Paläste
vergibt	vergibt
schweigst	schweigst
koordinierte	koordinierte
flambierest	flambierest
Nehmt	Nehmt
leider	leider
verleumdetest	verleumdetest
wollest	wollest
geahnt	geahnt
ehren	ehren
mikrominiaturisiere	mikrominiaturisiere
Einrädern	Einrädern
leset	leset
Büschen	Büschen
begnadigst	begnadigst
Lebenskräften	Lebenskräften
Schlägst	Schlägst
schaffte	schaffte
putzt	putzt
Uranerzen	Uranerzen
blitze	blitze
Aufprall	Aufprall
Lötzinn	Lötzinn
inhalierest	inhalierest
Klüfte	Klüfte
protestierst	protestierst
weinst	weinst
Gegebenheit	Gegebenheit
gleiche	gleiche
Zeitplan	Zeitplan
posiert	posiert
hämmerte	hämmerte
behauptest	behauptest
separieren	separieren
wurde	wurde
heiligest	heiligest
Alterität	Alterität
anruft	anruft
erniedrigst	erniedrigst
Sphären	Sphären
Dachdeckerinnen	Dachdeckerinnen
Eutern	Eutern
gehören	gehören
Autokraten	Autokraten
linke	linke
dürfe	dürfe
rauschte	rauschte
Nanoteslan	Nanoteslan
leben	leben
ach	ach
betrübst	betrübst
Forschung	Forschung
alles	alles
Säuen	Säuen
erhöhest	erhöhest
Android	Android
Massenanteil	Massenanteil
widmet	widmet
Ehren	Ehren
Automatikgetriebe	Automatikgetriebe
Dampfschiffen	Dampfschiffen
NAND-Gatter	NAND-Gatter
stürzest	stürzest
glühende	glühende
Präservativen	Präservativen
Einwirkungen	Einwirkungen
Beile	Beile
flehst	flehst
füsilierten	füsilierten
Flöte	Flöte
plissierten	plissierten
Stäben	Stäben
Vergeltungen	Vergeltungen
Abtrünnigen	Abtrünnigen
respektiere	respektiere
Schwärmereien	Schwärmereien
verführe	verführe
Insulaner	Insulaner
konstatiere	konstatiere
grünend	grünend
unterschieden	unterschieden
Einer	Einer
Molybdite	Molybdite
einführen	einführen
Managementsystem	Managementsystem
kappet	kappet
Küchenmaschinen	Küchenmaschinen
deklarierten	deklarierten
verstecken	verstecken
kickend	kickend
traueret	traueret
härte	härte
Steuerborden	Steuerborden
stimmte	stimmte
Theologien	Theologien
Marokkaners	Marokkaners
halte	halte
gesagt	gesagt
verführest	verführest
ausgereckter	ausgereckter
kürzest	kürzest
Nanotesla	Nanotesla
Kindergeldern	Kindergeldern
Kost	Kost
Beziehungen	Beziehungen
mußt	mußt
kremieren	kremieren
Käsereibe	Käsereibe
Habt	Habt
Halsabschneidern	Halsabschneidern
Kutter	Kutter
Karern	Karern
Diamantringen	Diamantringen
bedingten	bedingten
Zahnfleischentzündungen	Zahnfleischentzündungen
linstest	linstest
liebest	liebest
schwächend	schwächend
Sogen	Sogen
steuerte	steuerte
Zur-Schau-Stellen	Zur-Schau-Stellen
aufstand	aufstand
sterilisierte	sterilisierte
vergiften	vergiften
Würze	Würze
schnorrtet	schnorrtet
Iberer	Iberer
geleitest	geleitest
feierte	feierte
Wembley-Tore	Wembley-Tore
Finanzministerium	Finanzministerium
warnt	warnt
behütetest	behütetest
spiele	spiele
Aha-Erlebnis	Aha-Erlebnis
verhörest	verhörest
boykottierst	boykottierst
schaue	schaue
ausrufen	ausrufen
nähte	nähte
reimte	reimte
sehnet	sehnet
verteidigt	verteidigt
übet	übet
Teekesseln	Teekesseln
grünst	grünst
helfest	helfest
übrigbleibe	übrigbleibe
fresse	fresse
produziert	produziert
widerstand	widerstand
verludet	verludet
Wiederauferstehungen	Wiederauferstehungen
Fieberanfall	Fieberanfall
streifte	streifte
verbesserten	verbesserten
kennst	kennst
misstrauet	misstrauet
Schnittlauch	Schnittlauch
teil	teil
Alles	Alles
veranstalten	veranstalten
erwachet	erwachet
selbst	selbst
Altbau	Altbau
räumet	räumet
besprichst	besprichst
Propheten	Propheten
erwärmst	erwärmst
erstaunte	erstaunte
Lümmeltüte	Lümmeltüte
Amokläuferinnen	Amokläuferinnen
All	All
Achseln	Achseln
ritten	ritten
Gipfeltreffen	Gipfeltreffen
Hobby	Hobby
Zinkionen	Zinkionen
Wurzelwachstum	Wurzelwachstum
Falltürme	Falltürme
Pfahl	Pfahl
Tiere	Tiere
klemmen	klemmen
Früchte	Früchte
Gurten	Gurten
Atemlüfte	Atemlüfte
Mischelementen	Mischelementen
verladet	verladet
Lärche	Lärche
lesen	lesen
Atommodelle	Atommodelle
Regieren	Regieren
Gebeinen	Gebeinen
griechisch	griechisch
Fröschen	Fröschen
haltest	haltest
Tun	Tun
Golfplätzen	Golfplätzen
Leuchtkäfer	Leuchtkäfer
Katamaran	Katamaran
verzeichnete	verzeichnete
Ha	Ha
Werke	Werke
Wogen	Wogen
brandet	brandet
fluchte	fluchte
Dreieinigkeit	Dreieinigkeit
Ypecaharallen	Ypecaharallen
zersetzte	zersetzte
Suchet	Suchet
schlachtet	schlachtet
meines	meines
verkündigt	verkündigt
notlandet	notlandet
Impedanz	Impedanz
durchläutert	durchläutert
schenkte	schenkte
handhabest	handhabest
flupptest	flupptest
läutet	läutet
Affenbrotbaum	Affenbrotbaum
Enden	Enden
langweiltest	langweiltest
Hurriter	Hurriter
zelte	zelte
pflanzest	pflanzest
reizen	reizen
Pforte	Pforte
Fermium	Fermium
prostituieret	prostituieret
Abschußringe	Abschußringe
erforschest	erforschest
Möbiusbändern	Möbiusbändern
Denkmünzen	Denkmünzen
dividiere	dividiere
Gleitzeit	Gleitzeit
Sprecher	Sprecher
Sabbatjahre	Sabbatjahre
Flöße	Flöße
erzürnet	erzürnet
Backpflaumen	Backpflaumen
Stall	Stall
ermordeten	ermordeten
verschont	verschont
huren	huren
Schafen	Schafen
losen	losen
Atommassen	Atommassen
schau	schau
verstecke	verstecke
versuchst	versuchst
überreichen	überreichen
Schlöte	Schlöte
Spektroskopie	Spektroskopie
säume	säume
Entsetzt	Entsetzt
bedeckt	bedeckt
foppten	foppten
Ackerschachtelhalme	Ackerschachtelhalme
Reizen	Reizen
verkehrten	verkehrten
regierten	regierten
Buche	Buche
erkälteten	erkälteten
Gammastrahl	Gammastrahl
Schal	Schal
verstörte	verstörte
Radiergummis	Radiergummis
Apfelbäume	Apfelbäume
erbte	erbte
aufheben	aufheben
gratuliere	gratuliere
aufstehet	aufstehet
entstände	entstände
Aktivisten	Aktivisten
spielte	spielte
entgegenkamst	entgegenkamst
Fanatiker	Fanatiker
hebräischen	hebräischen
bleibest	bleibest
enge	enge
maßen	maßen
Tiefe	Tiefe
Abschreckungen	Abschreckungen
ausrufest	ausrufest
Mutagenen	Mutagenen
Trümmersprache	Trümmersprache
Höhen	Höhen
Gedächtnissen	Gedächtnissen
Hure	Hure
Würfelspiel	Würfelspiel
bereitend	bereitend
Telefonnummern	Telefonnummern
Fahret	Fahret
fotzte	fotzte
Jünger	Jünger
Höhle	Höhle
Uterus	Uterus
krähen	krähen
aufsteht	aufsteht
knusperten	knusperten
desertierst	desertierst
Füchse	Füchse
Werde	Werde
Laufringe	Laufringe
musizierte	musizierte
Strontiumamalgams	Strontiumamalgams
Zipfelmütze	Zipfelmütze
gehorchet	gehorchet
erstarrten	erstarrten
egalisierten	egalisierten
Sündern	Sündern
grien	grien
Ringeltaube	Ringeltaube
redetest	redetest
Aussätzige	Aussätzige
erstürmt	erstürmt
fehle	fehle
tendierst	tendierst
haust	haust
transportiere	transportiere
wir	wir
pressierten	pressierten
Putschisten	Putschisten
kaufest	kaufest
Gemüseläden	Gemüseläden
teilte	teilte
solchem	solchem
verkürzte	verkürzte
Zerfall	Zerfall
evakuierte	evakuierte
zählend	zählend
Kernladungszahl	Kernladungszahl
Heiden	Heiden
ruhte	ruhte
ladest	ladest
bekehrt	bekehrt
versuchten	versuchten
Protonen	Protonen
grünten	grünten
Peptids	Peptids
substituieren	substituieren
verunglimpftet	verunglimpftet
schmelzen	schmelzen
Kohle	Kohle
betrübte	betrübte
Gewinnung	Gewinnung
Namen	Namen
Käsereiben	Käsereiben
instanziiere	instanziiere
leertet	leertet
suchte	suchte
Räte	Räte
Augenglases	Augenglases
fokussieret	fokussieret
Lichte	Lichte
ersparte	ersparte
Wechselstube	Wechselstube
Erlösungen	Erlösungen
flöteten	flöteten
überdenkend	überdenkend
Äxten	Äxten
verurteile	verurteile
Gläubige	Gläubige
vertilgst	vertilgst
blenden	blenden
stiften	stiften
Bankettes	Bankettes
scheitertet	scheitertet
Grönländer	Grönländer
treffen	treffen
Schreiet	Schreiet
säumet	säumet
hintertriebe	hintertriebe
verselbständigst	verselbständigst
rebelliertet	rebelliertet
reichtet	reichtet
ramme	ramme
murmelten	murmelten
Basilikum	Basilikum
fromme	fromme
Ochse	Ochse
Kavalier	Kavalier
Antimustern	Antimustern
schütze	schütze
klappten	klappten
Ösophagospasmus	Ösophagospasmus
verringert	verringert
regierest	regierest
zupfte	zupfte
pflegte	pflegte
Begrenzungen	Begrenzungen
Kupferkiese	Kupferkiese
gibst	gibst
heparinisiere	heparinisiere
Reißnagel	Reißnagel
reinigst	reinigst
Schläge	Schläge
Libellen	Libellen
verbitterest	verbitterest
erntet	erntet
kühl	kühl
Perlen	Perlen
ihr	ihr
klaget	klaget
Büstenhalters	Büstenhalters
ertraget	ertraget
knutschest	knutschest
sieht	sieht
Ansteckers	Ansteckers
begehrest	begehrest
verhungerte	verhungerte
emigrieret	emigrieret
rechte	rechte
Dithiolane	Dithiolane
erlagst	erlagst
Theistin	Theistin
schwebe	schwebe
Jahren	Jahren
griechischen	griechischen
hurst	hurst
Schreibern	Schreibern
erniedrigt	erniedrigt
betrübe	betrübe
dürfte	dürfte
desensibilisierte	desensibilisierte
driftete	driftete
karikierten	karikierten
fehlet	fehlet
Almanachen	Almanachen
Wehre	Wehre
schmusen	schmusen
Schild	Schild
globalisieret	globalisieret
schleim	schleim
verdeckte	verdeckte
verkürzten	verkürzten
Wir	Wir
glühten	glühten
Kakaos	Kakaos
dissentierte	dissentierte
bräunen	bräunen
lögen	lögen
benachrichtige	benachrichtige
Wandergewerbe	Wandergewerbe
blockierten	blockierten
schaffe	schaffe
globalisier	globalisier
kürzt	kürzt
spielet	spielet
Langeweile	Langeweile
tragen	tragen
predigten	predigten
erkanntet	erkanntet
reif	reif
zeugest	zeugest
umarbeiten	umarbeiten
verunziere	verunziere
Efeu	Efeu
Schleppern	Schleppern
koordinieret	koordinieret
sitzest	sitzest
seinen	seinen
glänzte	glänzte
redete	redete
Randbemerkung	Randbemerkung
zerrüttete	zerrüttete
parfümierst	parfümierst
vertuest	vertuest
funzt	funzt
Lebenskraft	Lebenskraft
Aacheners	Aacheners
Landwirte	Landwirte
Drang	Drang
Stoffwechselweg	Stoffwechselweg
Dattel	Dattel
ringen	ringen
schubset	schubset
trotze	trotze
Fallet	Fallet
Hälse	Hälse
kranken	kranken
Emmer	Emmer
Metallothionein	Metallothionein
umhüllend	umhüllend
dümpelt	dümpelt
spaltete	spaltete
Portal	Portal
vertilgte	vertilgte
Berge	Berge
überlebest	überlebest
putzte	putzte
ziehst	ziehst
Wänden	Wänden
Übertretung	Übertretung
Ölspuren	Ölspuren
Dürre	Dürre
Letzte	Letzte
zersetzet	zersetzet
Stätten	Stätten
Betten	Betten
Honigbär	Honigbär
Städte	Städte
egalisiertet	egalisiertet
spekulieren	spekulieren
Effekten	Effekten
pharyngalisierst	pharyngalisierst
Vaginen	Vaginen
heftete	heftete
War	War
beschlaget	beschlaget
Plüschtiere	Plüschtiere
Petersfisch	Petersfisch
feiertest	feiertest
Brettspielen	Brettspielen
Körpergeruch	Körpergeruch
Besuchen	Besuchen
tat	tat
verschlimmere	verschlimmere
Pfunde	Pfunde
erdachten	erdachten
heben	heben
tyrannisiertest	tyrannisiertest
foppst	foppst
Zirkelbeweis	Zirkelbeweis
Merkel-Rauten	Merkel-Rauten
bracht	bracht
Bundesgebiet	Bundesgebiet
nachwandelst	nachwandelst
Genetikerin	Genetikerin
Sprichwort	Sprichwort
jemand	jemand
machst	machst
Funkfeuern	Funkfeuern
Sternen	Sternen
bewiesen	bewiesen
Transportwegen	Transportwegen
Geschwindigkeitsmesser	Geschwindigkeitsmesser
Verbindungsdrähten	Verbindungsdrähten
braust	braust
ärger	ärger
austilgest	austilgest
More	More
kämpfen	kämpfen
Taschendiebe	Taschendiebe
hadere	hadere
ahnten	ahnten
Montagmittagen	Montagmittagen
dampfte	dampfte
verblutete	verblutete
meinst	meinst
Dominicanerinnen	Dominicanerinnen
nahest	nahest
fluppt	fluppt
Adelung	Adelung
verselbstständigest	verselbstständigest
Kerzenlichtern	Kerzenlichtern
Geringschätzung	Geringschätzung
jauchzt	jauchzt
verspäte	verspäte
überdächte	überdächte
einernten	einernten
begrabest	begrabest
Adhäsionen	Adhäsionen
setzt	setzt
Zeitschlitzen	Zeitschlitzen
Tiefschutz	Tiefschutz
punkten	punkten
Gesamtmengen	Gesamtmengen
Jagdbomber	Jagdbomber
Plumpse	Plumpse
Leichenschauhäusern	Leichenschauhäusern
Abschiedsbrief	Abschiedsbrief
Talisman	Talisman
deute	deute
beeinflusste	beeinflusste
wärst	wärst
Theistinnen	Theistinnen
siegte	siegte
Erstlinge	Erstlinge
Minischweine	Minischweine
Finanzminister	Finanzminister
plagest	plagest
Augengläsern	Augengläsern
freute	freute
babbelt	babbelt
triebe	triebe
Dachdecker	Dachdecker
tätowierest	tätowierest
designierst	designierst
zerstückt	zerstückt
gähne	gähne
revoltieren	revoltieren
jappen	jappen
euren	euren
bestellt	bestellt
legend	legend
Nagellackentferner	Nagellackentferner
Dachdeckerin	Dachdeckerin
Kassiterits	Kassiterits
Tiefschutzen	Tiefschutzen
klingest	klingest
stapelten	stapelten
Bildschirmfoto	Bildschirmfoto
Schreibtischtätern	Schreibtischtätern
Crescendo	Crescendo
Californium	Californium
oben	oben
dümpelst	dümpelst
Schau	Schau
unsere	unsere
vernickelte	vernickelte
haarte	haarte
dürfest	dürfest
widerrufe	widerrufe
träge	träge
schämte	schämte
appellierte	appellierte
hänget	hänget
Essigsäurechloriden	Essigsäurechloriden
glaubte	glaubte
beanspruchte	beanspruchte
Anarchisten	Anarchisten
Eisstein	Eisstein
wachsen	wachsen
erzeige	erzeige
bandagiert	bandagiert
verstanden	verstanden
unseren	unseren
verifizieret	verifizieret
kichern	kichern
föhnest	föhnest
Eselsohren	Eselsohren
Klärung	Klärung
Lusitaner	Lusitaner
Säcke	Säcke
betrüben	betrüben
spähet	spähet
verdammte	verdammte
irre	irre
Borhydride	Borhydride
faul	faul
Kopfsalaten	Kopfsalaten
tragt	tragt
schmuggelest	schmuggelest
Blattgewebe	Blattgewebe
ehe	ehe
Kerfe	Kerfe
schreiet	schreiet
widerriefe	widerriefe
sagest	sagest
peilst	peilst
bewahrheitetet	bewahrheitetet
erzürnt	erzürnt
aufkämen	aufkämen
strafen	strafen
spricht	spricht
tobte	tobte
anrichten	anrichten
Gaschromatographien	Gaschromatographien
Konzentrate	Konzentrate
decken	decken
Lobgesänge	Lobgesänge
kosten	kosten
bat	bat
drangen	drangen
Hubschraubern	Hubschraubern
Reststoffen	Reststoffen
Ruß	Ruß
interagierte	interagierte
versuchte	versuchte
Notizen	Notizen
Kleinodien	Kleinodien
Anführern	Anführern
erforschet	erforschet
narren	narren
Elementarzelle	Elementarzelle
denaturiert	denaturiert
Agoraphobien	Agoraphobien
rühmet	rühmet
besetzen	besetzen
föchte	föchte
Botokuden	Botokuden
gelegt	gelegt
pflügest	pflügest
Shortcut	Shortcut
aßet	aßet
kritzelet	kritzelet
fahrest	fahrest
Essigsäurechlorid	Essigsäurechlorid
beleuchteten	beleuchteten
überführt	überführt
Hochhäuser	Hochhäuser
Bromidquellen	Bromidquellen
überweisend	überweisend
gewinne	gewinne
Alkin	Alkin
Abkömmling	Abkömmling
Reisebüro	Reisebüro
zerstreute	zerstreute
dingte	dingte
danke	danke
Bube	Bube
zeigst	zeigst
Herd	Herd
verweise	verweise
Literaturen	Literaturen
Mikrowellenfilter	Mikrowellenfilter
besuchen	besuchen
kollidierten	kollidierten
vermeße	vermeße
zerbrechen	zerbrechen
setzte	setzte
regierte	regierte
ärgernd	ärgernd
obfuskieren	obfuskieren
Bergsteiger	Bergsteiger
infizieret	infizieret
verseift	verseift
Ärzteblatt	Ärzteblatt
lehret	lehret
zupftet	zupftet
Fischotters	Fischotters
nähet	nähet
stimmen	stimmen
bromiertet	bromiertet
erhörst	erhörst
überstehend	überstehend
kugele	kugele
eskaliert	eskaliert
verfehle	verfehle
möge	möge
brechen	brechen
wilden	wilden
Wollt	Wollt
querest	querest
lackiere	lackiere
malträtiere	malträtiere
kaufet	kaufet
betreibet	betreibet
Halbmond	Halbmond
erschrickt	erschrickt
vermutest	vermutest
Langschwanzpinguinen	Langschwanzpinguinen
strafet	strafet
weisest	weisest
Narkotikum	Narkotikum
blamierte	blamierte
Gängen	Gängen
hauen	hauen
streite	streite
duckmäuseret	duckmäuseret
verkündigst	verkündigst
Grenzen	Grenzen
eurem	eurem
Safran	Safran
Ente	Ente
Fanmeilen	Fanmeilen
pflügte	pflügte
erwache	erwache
bewahrheitete	bewahrheitete
Brötchen	Brötchen
Rotzinkerz	Rotzinkerz
Heteroatome	Heteroatome
entwischtet	entwischtet
erstehst	erstehst
Metallspiegel	Metallspiegel
Hanse	Hanse
erlöse	erlöse
bücktest	bücktest
Ränke	Ränke
Gesamtmenge	Gesamtmenge
gravierst	gravierst
andere	andere
Gründungsprivilegien	Gründungsprivilegien
Griechen	Griechen
Füllfederhalter	Füllfederhalter
brach	brach
Kompassen	Kompassen
belauerten	belauerten
betrübet	betrübet
ruckeln	ruckeln
Marjellchens	Marjellchens
Pfeile	Pfeile
verzeichne	verzeichne
befestigten	befestigten
trieb	trieb
meuterest	meuterest
bauet	bauet
Kernladungszahlen	Kernladungszahlen
Märkte	Märkte
hingeht	hingeht
unehrt	unehrt
concessioniert	concessioniert
erwischten	erwischten
solche	solche
Feiertagen	Feiertagen
Martyrologium	Martyrologium
Zeug	Zeug
füllte	füllte
Domäne	Domäne
verschaffte	verschaffte
wären	wären
lausche	lausche
verjährest	verjährest
Sterne	Sterne
Uteri	Uteri
bemühten	bemühten
erfahret	erfahret
lieget	lieget
Kanzlerinnen	Kanzlerinnen
soll	soll
bitte	bitte
schlafest	schlafest
aufkommt	aufkommt
rundet	rundet
Alltag	Alltag
verspielte	verspielte
preiset	preiset
beherrscht	beherrscht
diskutierst	diskutierst
nachwandelte	nachwandelte
kauten	kauten
lehren	lehren
Kristallen	Kristallen
hängte	hängte
erbaust	erbaust
heiligt	heiligt
setztet	setztet
hievten	hievten
protokollierst	protokollierst
Schlagern	Schlagern
anfinge	anfinge
hebe	hebe
Argyrodite	Argyrodite
faschieren	faschieren
leere	leere
wachet	wachet
Energiespeicher	Energiespeicher
Futtermitteln	Futtermitteln
gelobtest	gelobtest
auszogen	auszogen
Teppichen	Teppichen
ziehest	ziehest
wiederholten	wiederholten
Kohlenstoffgehalt	Kohlenstoffgehalt
befehlt	befehlt
webet	webet
unterbewertete	unterbewertete
pharyngalisierten	pharyngalisierten
spekuliere	spekuliere
Schwan	Schwan
Pinguinen	Pinguinen
höhnest	höhnest
konsolidierend	konsolidierend
ruhest	ruhest
Fokus	Fokus
zankte	zankte
koexistierten	koexistierten
Stolze	Stolze
Heuschrecke	Heuschrecke
Gebote	Gebote
Kriegen	Kriegen
Alle	Alle
Diäresen	Diäresen
lösen	lösen
fehlen	fehlen
Gedrängen	Gedrängen
vermutet	vermutet
Antitranspiranten	Antitranspiranten
Früchten	Früchten
Ecke	Ecke
fladerest	fladerest
Philerast	Philerast
Samarskite	Samarskite
reagiert	reagiert
Biene	Biene
beneidete	beneidete
Blaumeisen	Blaumeisen
Füchsin	Füchsin
Messies	Messies
Sucht	Sucht
Karer	Karer
radierte	radierte
Reisebüros	Reisebüros
downloadet	downloadet
Zäunen	Zäunen
Geboten	Geboten
schreiben	schreiben
UND-Gatter	UND-Gatter
deines	deines
stellen	stellen
segeln	segeln
Ambiguität	Ambiguität
arbeit	arbeit
tanzen	tanzen
bedrücktest	bedrücktest
würde	würde
kabelten	kabelten
schnitt	schnitt
Küsserei	Küsserei
rüstetest	rüstetest
Heiratsgütern	Heiratsgütern
ehrst	ehrst
Tieren	Tieren
bete	bete
anfingst	anfingst
begnadigte	begnadigte
vernehmen	vernehmen
verfanget	verfanget
Lopariten	Lopariten
gabelt	gabelt
bediene	bediene
Fußballweltmeisterschaftsqualifikationsspielen	Fußballweltmeisterschaftsqualifikationsspielen
Leitungswegs	Leitungswegs
Gewürze	Gewürze
spracht	spracht
changiere	changiere
Silbergeschirr	Silbergeschirr
dürften	dürften
neige	neige
Gicht	Gicht
Alkine	Alkine
erbet	erbet
Schilden	Schilden
seufzt	seufzt
Wimpertierchen	Wimpertierchen
Einem	Einem
Atomphysikern	Atomphysikern
Forschungen	Forschungen
radiertest	radiertest
verstehet	verstehet
hasse	hasse
malen	malen
Fiebermitteln	Fiebermitteln
blamierest	blamierest
urteilen	urteilen
verlautete	verlautete
Stücke	Stücke
Epoxiden	Epoxiden
Effekt	Effekt
Friesen	Friesen
fällen	fällen
fluppst	fluppst
Beinen	Beinen
Campingplatzes	Campingplatzes
Tyrann	Tyrann
Fluorgehalte	Fluorgehalte
Komponistin	Komponistin
Sprüche	Sprüche
Ypecaharalle	Ypecaharalle
Mache	Mache
Schätze	Schätze
schneidend	schneidend
knüpfte	knüpfte
Malaysiers	Malaysiers
zertifizierst	zertifizierst
Wachtel	Wachtel
beanspruchet	beanspruchet
wilde	wilde
drillest	drillest
Herbstwinden	Herbstwinden
preisen	preisen
denn	denn
gewünscht	gewünscht
Rhodochrositen	Rhodochrositen
ausgereckt	ausgereckt
falle	falle
kickst	kickst
obfuskierten	obfuskierten
hinterlegt	hinterlegt
Programmiererinnen	Programmiererinnen
ratschlagte	ratschlagte
Ochs	Ochs
greifen	greifen
gelangt	gelangt
Stufe	Stufe
Brauhaus	Brauhaus
Bote	Bote
sortierest	sortierest
Gebot	Gebot
Schuldner	Schuldner
kabbelnd	kabbelnd
dringt	dringt
hydrogentartrat	hydrogentartrat
Geliebte	Geliebte
anhangen	anhangen
Ellen	Ellen
schlaf	schlaf
Beiblätter	Beiblätter
schauest	schauest
langweilst	langweilst
wollt	wollt
Landesverräterinnen	Landesverräterinnen
Monde	Monde
blase	blase
Mischung	Mischung
Fischer	Fischer
fetten	fetten
Grüße	Grüße
ärgere	ärgere
schenkst	schenkst
Ratsherr	Ratsherr
Schwestern	Schwestern
Zebrahaies	Zebrahaies
Remisen	Remisen
Einstufung	Einstufung
Laufringen	Laufringen
blondieret	blondieret
Rückumschlägen	Rückumschlägen
säumen	säumen
Totenglocke	Totenglocke
touchierte	touchierte
bemühst	bemühst
Höschen	Höschen
Laie	Laie
bombardiertet	bombardiertet
steckst	steckst
ihres	ihres
Füllen	Füllen
hüpfest	hüpfest
Stellen	Stellen
Freitagnachmittagen	Freitagnachmittagen
Skorpionen	Skorpionen
junge	junge
Möbiusbänder	Möbiusbänder
Däumlingen	Däumlingen
Zeitbomben	Zeitbomben
Somite	Somite
all	all
Joche	Joche
Fußmatten	Fußmatten
panaschieren	panaschieren
keinen	keinen
Erdboden	Erdboden
beweisen	beweisen
Riese	Riese
lavierte	lavierte
gedolmetscht	gedolmetscht
unterdrücke	unterdrücke
präsentiere	präsentiere
Kleinode	Kleinode
klumpt	klumpt
dresche	dresche
strafst	strafst
allem	allem
simulierst	simulierst
Gedanken	Gedanken
täuschte	täuschte
parfümierte	parfümierte
demütigst	demütigst
wehrt	wehrt
Kandidaturen	Kandidaturen
reichtest	reichtest
Fettsäcken	Fettsäcken
erfahrt	erfahrt
Türmen	Türmen
verständige	verständige
Einöden	Einöden
mopsend	mopsend
Sexten	Sexten
hintertrieben	hintertrieben
auszöge	auszöge
stigmatisierst	stigmatisierst
gebot	gebot
regieret	regieret
grüßet	grüßet
klönen	klönen
demütig	demütig
Festons	Festons
auszogst	auszogst
bequemen	bequemen
entdecket	entdecket
piesacken	piesacken
Bifurkationen	Bifurkationen
jauchzte	jauchzte
zeug	zeug
Jude	Jude
gedächtet	gedächtet
pflanze	pflanze
Buben	Buben
Bergen	Bergen
lauschte	lauschte
Ausbeutern	Ausbeutern
nähre	nähre
Dithiolan	Dithiolan
Wühltischen	Wühltischen
dritte	dritte
regte	regte
Zipfelmützen	Zipfelmützen
Menschen	Menschen
überführen	überführen
Glaubst	Glaubst
Knaben	Knaben
hydrolysierend	hydrolysierend
hättest	hättest
Laubbläsern	Laubbläsern
Ahnen	Ahnen
vermögen	vermögen
ausfuhr	ausfuhr
reizest	reizest
separieret	separieret
Banknoten	Banknoten
motivierten	motivierten
parliere	parliere
heilet	heilet
Entsetzen	Entsetzen
Lesen	Lesen
Steuerberater	Steuerberater
verderben	verderben
hebräische	hebräische
schmuggelte	schmuggelte
zwölften	zwölften
anzöge	anzöge
vibrierend	vibrierend
Kalifeldspat	Kalifeldspat
Aphasie	Aphasie
könnet	könnet
instanziier	instanziier
schleiß	schleiß
verschränkest	verschränkest
Teilen	Teilen
Milchflaschen	Milchflaschen
stiegen	stiegen
verkürzt	verkürzt
Gemüt	Gemüt
verdammt	verdammt
Orgel	Orgel
Blattgeweben	Blattgeweben
scheinen	scheinen
Wäre	Wäre
antworte	antworte
entzweit	entzweit
explodierten	explodierten
keine	keine
Galeeren	Galeeren
überschattete	überschattete
Gichten	Gichten
Älteste	Älteste
gönnest	gönnest
schätze	schätze
Einfältigkeiten	Einfältigkeiten
bekennet	bekennet
Korrosionsschutz	Korrosionsschutz
tanze	tanze
Cyclodextrinen	Cyclodextrinen
Geschreis	Geschreis
verstrahlten	verstrahlten
bewieset	bewieset
rammte	rammte
Notärztinnen	Notärztinnen
sorge	sorge
reiche	reiche
erscheinest	erscheinest
Grabe	Grabe
kreierten	kreierten
übrigbleibet	übrigbleibet
säuselest	säuselest
Fremdwörter	Fremdwörter
Milchflasche	Milchflasche
verwirrest	verwirrest
Bund	Bund
Adventskalender	Adventskalender
beschwindele	beschwindele
blondieren	blondieren
einem	einem
Reichweite	Reichweite
spukte	spukte
Blättchen	Blättchen
Fluoratomen	Fluoratomen
Akkadierinnen	Akkadierinnen
Füße	Füße
Fluoratome	Fluoratome
neiden	neiden
Schicksen	Schicksen
liegst	liegst
hantiert	hantiert
vertilgten	vertilgten
Pentaboraten	Pentaboraten
sorget	sorget
Schätzen	Schätzen
Stärket	Stärket
Coventrisierungen	Coventrisierungen
flieh	flieh
trödeltest	trödeltest
wurdet	wurdet
wischt	wischt
belohnten	belohnten
Rhodochrosite	Rhodochrosite
Leugnung	Leugnung
ersten	ersten
besät	besät
Streich	Streich
grüße	grüße
Fetten	Fetten
kehre	kehre
Autoklaven	Autoklaven
Schanktischen	Schanktischen
Gymnasien	Gymnasien
Schade	Schade
Saiblinge	Saiblinge
verwirrte	verwirrte
liebst	liebst
Zwingburg	Zwingburg
verwirft	verwirft
unterbrächen	unterbrächen
pulsiere	pulsiere
Nussknackern	Nussknackern
Träumers	Träumers
Seetauchers	Seetauchers
bekannt	bekannt
klage	klage
ratschlaget	ratschlaget
sitzet	sitzet
Adamsäpfeln	Adamsäpfeln
fertig	fertig
maximiere	maximiere
würden	würden
Einen	Einen
beschrifteten	beschrifteten
wohnest	wohnest
verdrehet	verdrehet
Adamsapfel	Adamsapfel
Kriegsschauplätze	Kriegsschauplätze
Zebrahai	Zebrahai
fasse	fasse
Färsen	Färsen
überweiset	überweiset
Hinkelstein	Hinkelstein
heißet	heißet
tief	tief
foppte	foppte
siehst	siehst
Homodimeren	Homodimeren
Kommst	Kommst
Heuhaufen	Heuhaufen
Nervenzellen	Nervenzellen
Gehirnwelle	Gehirnwelle
Kerf	Kerf
zerbrichst	zerbrichst
Fetzens	Fetzens
nimmt	nimmt
kollidierte	kollidierte
sterbet	sterbet
grüßen	grüßen
endlagerten	endlagerten
bollerte	bollerte
geselle	geselle
gebäre	gebäre
reichte	reichte
Freunden	Freunden
verbündet	verbündet
Welteninseln	Welteninseln
Palisade	Palisade
analysieret	analysieret
Schamentzündung	Schamentzündung
Wert	Wert
ringst	ringst
unterbewerte	unterbewerte
häufe	häufe
tut	tut
Unwahrheit	Unwahrheit
steuerst	steuerst
beide	beide
warst	warst
härtet	härtet
Libelle	Libelle
gestattest	gestattest
Mutagen	Mutagen
plumpse	plumpse
versuchest	versuchest
Briten	Briten
Höfen	Höfen
unsrer	unsrer
Somiten	Somiten
verkündige	verkündige
Mittelaltermarkt	Mittelaltermarkt
Abhängen	Abhängen
legten	legten
murmeln	murmeln
Fusselbart	Fusselbart
eingehet	eingehet
säst	säst
Autoklav	Autoklav
ausgehst	ausgehst
hegt	hegt
Schneepflüge	Schneepflüge
leide	leide
Dudelsäcken	Dudelsäcken
Argyroditen	Argyroditen
Ion	Ion
Thioacetal	Thioacetal
