убийцу	убийцу
выкупите	выкупите
распростерла	распростерла
огорчали	огорчали
три	три
оставляй	оставляй
проходи	проходи
бедные	бедные
почитал	почитал
могли	могли
взяли	взяли
сотворите	сотворите
имеете	имеете
сходила	сходила
ужин	ужин
назидать	назидать
глазу	глазу
напоминай	напоминай
мала	мала
последовало	последовало
доброю	доброю
рогом	рогом
живых	живых
хочу	хочу
помните	помните
призвала	призвала
левою	левою
отступили	отступили
заключи	заключи
начать	начать
послужить	послужить
пьяною	пьяною
язык	язык
напоили	напоили
бела	бела
приступили	приступили
приготовила	приготовила
порядку	порядку
испытывали	испытывали
петь	петь
почетных	почетных
телом	телом
скал	скал
чудное	чудное
известила	известила
избавляйте	избавляйте
слышим	слышим
восклицать	восклицать
сказали	сказали
переходишь	переходишь
устрашить	устрашить
вмещать	вмещать
Которым	Которым
таланту	таланту
молодую	молодую
приступить	приступить
учился	учился
восходить	восходить
возьми	возьми
тленного	тленного
растаяли	растаяли
разводите	разводите
чем	чем
исполнился	исполнился
отцов	отцов
испытывайте	испытывайте
зеленых	зеленых
истреби	истреби
оцепенением	оцепенением
брани	брани
посадите	посадите
желчь	желчь
отпустите	отпустите
устройстве	устройстве
малым	малым
произвели	произвели
завещевайте	завещевайте
добыча	добыча
превратился	превратился
устроили	устроили
охраняющий	охраняющий
терафима	терафима
твердых	твердых
скоту	скоту
окружить	окружить
упоена	упоена
полюби	полюби
снегу	снегу
сокрытую	сокрытую
почтили	почтили
Мои	Мои
собой	собой
посвящать	посвящать
достать	достать
сия	сия
значить	значить
удерживать	удерживать
торга	торга
живые	живые
возненавидели	возненавидели
дорогою	дорогою
отличен	отличен
посвятите	посвятите
двум	двум
вся	вся
противостал	противостал
похорони	похорони
допускали	допускали
дворе	дворе
услышали	услышали
войска	войска
миновали	миновали
Святым	Святым
взалкали	взалкали
внимали	внимали
обходите	обходите
болоте	болоте
подносят	подносят
исчисли	исчисли
преследуйте	преследуйте
рассеянный	рассеянный
малые	малые
всесожжении	всесожжении
возросли	возросли
сделанным	сделанным
вынимать	вынимать
Христе	Христе
узнаешь	узнаешь
голубой	голубой
садите	садите
тысячи	тысячи
возросло	возросло
лицо	лицо
проклинать	проклинать
царях	царях
расположился	расположился
вытрут	вытрут
исполнить	исполнить
находят	находят
вложи	вложи
натянуть	натянуть
устрашился	устрашился
отказать	отказать
сожгли	сожгли
вело	вело
овладел	овладел
скорую	скорую
соделает	соделает
слушайте	слушайте
божествах	божествах
ночевали	ночевали
развязала	развязала
исполнила	исполнила
копить	копить
вонзила	вонзила
Пила	Пила
уходит	уходит
забыла	забыла
мечу	мечу
всякой	всякой
месте	месте
отвори	отвори
убили	убили
заграждай	заграждай
произнесли	произнесли
простертой	простертой
целых	целых
повторили	повторили
тьмы	тьмы
захватить	захватить
Апостолом	Апостолом
воскурить	воскурить
было	было
иссохло	иссохло
чудные	чудные
литые	литые
вторых	вторых
устранить	устранить
какого	какого
произносите	произносите
пересказала	пересказала
леса	леса
засевайте	засевайте
отняты	отняты
каждой	каждой
добыч	добыч
исполнили	исполнили
наушника	наушника
соединить	соединить
низринь	низринь
выходят	выходят
любимых	любимых
возлюбленных	возлюбленных
просите	просите
одетым	одетым
сожигать	сожигать
побить	побить
обольстить	обольстить
хочет	хочет
верх	верх
передвигают	передвигают
окропи	окропи
Котором	Котором
наполняйте	наполняйте
множестве	множестве
самая	самая
погубите	погубите
умертвила	умертвила
пересчитайте	пересчитайте
отпустили	отпустили
умышляли	умышляли
рассудить	рассудить
которою	которою
восстановим	восстановим
колене	колене
прислугу	прислугу
пощадили	пощадили
семействе	семействе
проклятою	проклятою
яму	яму
камня	камня
тысяч	тысяч
возделывать	возделывать
неверен	неверен
домой	домой
наполняй	наполняй
выбросить	выбросить
привели	привели
прямые	прямые
уговори	уговори
нагою	нагою
самых	самых
засыпать	засыпать
лишили	лишили
спрятала	спрятала
звать	звать
убеди	убеди
принесло	принесло
мешке	мешке
Тобою	Тобою
рассуждать	рассуждать
поразите	поразите
черви	черви
засели	засели
камни	камни
устранили	устранили
дереве	дереве
сажен	сажен
исцеляла	исцеляла
терпим	терпим
погряз	погряз
умертвить	умертвить
Силе	Силе
святого	святого
сынах	сынах
содержали	содержали
преследуй	преследуй
венцом	венцом
поядать	поядать
лизать	лизать
Будет	Будет
сошли	сошли
устремился	устремился
отведи	отведи
жребии	жребии
чьи	чьи
начерпали	начерпали
животным	животным
грешите	грешите
сожигают	сожигают
ослабели	ослабели
впала	впала
мытарь	мытарь
зданием	зданием
вперед	вперед
вили	вили
издерживать	издерживать
познаете	познаете
забирали	забирали
прославлять	прославлять
владычествовать	владычествовать
кончили	кончили
учили	учили
рыдайте	рыдайте
сейте	сейте
переспит	переспит
немалую	немалую
напасти	напасти
добро	добро
рассказывали	рассказывали
смело	смело
возмутился	возмутился
оказывайте	оказывайте
завтрашнем	завтрашнем
хотел	хотел
блудить	блудить
ожесточили	ожесточили
Возлюбленный	Возлюбленный
превратить	превратить
сокрушить	сокрушить
двором	двором
если	если
славить	славить
поднимали	поднимали
удерживали	удерживали
мог	мог
посадили	посадили
случая	случая
замолчу	замолчу
отяготили	отяготили
созывать	созывать
желала	желала
палить	палить
стану	стану
покрою	покрою
ставить	ставить
мыслить	мыслить
хвали	хвали
козлам	козлам
спит	спит
вскормила	вскормила
окончи	окончи
потускло	потускло
отвален	отвален
пылу	пылу
Можете	Можете
забыли	забыли
поносили	поносили
сразила	сразила
останови	останови
жемчуга	жемчуга
посвятить	посвятить
заграждали	заграждали
траве	траве
пожирала	пожирала
Хвалите	Хвалите
стояли	стояли
призванные	призванные
бесчестите	бесчестите
твердая	твердая
отвозят	отвозят
Силу	Силу
почерпнула	почерпнула
возвратился	возвратился
уцелело	уцелело
отложился	отложился
родит	родит
слепым	слепым
меньшая	меньшая
внутреннему	внутреннему
торжествуй	торжествуй
раскрыли	раскрыли
жертв	жертв
чья	чья
расположен	расположен
успокоить	успокоить
преступлением	преступлением
восстать	восстать
возбудите	возбудите
осматривали	осматривали
усилили	усилили
восстало	восстало
смешанное	смешанное
обгорела	обгорела
никакое	никакое
доставили	доставили
призови	призови
написать	написать
была	была
получите	получите
возгласите	возгласите
лица	лица
обрела	обрела
духе	духе
наступить	наступить
соблюдали	соблюдали
захватили	захватили
нехорош	нехорош
дрогнули	дрогнули
разбудила	разбудила
посмотри	посмотри
перебило	перебило
молока	молока
свари	свари
возьмут	возьмут
известили	известили
прямых	прямых
надел	надел
два	два
покой	покой
отнесли	отнесли
получить	получить
раздражили	раздражили
допустила	допустила
талант	талант
человекоубийц	человекоубийц
изгоняйте	изгоняйте
разрушили	разрушили
родословных	родословных
сковать	сковать
поглотили	поглотили
велите	велите
сатану	сатану
сердечной	сердечной
человеческую	человеческую
страшился	страшился
свекрови	свекрови
половину	половину
благовестить	благовестить
служили	служили
получали	получали
укрепите	укрепите
смешанная	смешанная
оставляли	оставляли
наследует	наследует
проходить	проходить
открой	открой
поручен	поручен
дворах	дворах
оказывать	оказывать
наполнили	наполнили
составлять	составлять
выдавали	выдавали
растворить	растворить
просты	просты
жару	жару
освятили	освятили
подарили	подарили
раздели	раздели
областеначальников	областеначальников
новые	новые
заключить	заключить
Ком	Ком
отсекли	отсекли
горды	горды
давире	давире
избить	избить
тьму	тьму
Трое	Трое
пропасти	пропасти
наступите	наступите
читали	читали
уменьши	уменьши
пророчествуйте	пророчествуйте
открывайте	открывайте
ненадежно	ненадежно
большой	большой
свету	свету
тельцу	тельцу
пожалел	пожалел
написал	написал
новое	новое
сосчитай	сосчитай
слепого	слепого
мечи	мечи
рак	рак
разреши	разреши
Благо	Благо
покрыли	покрыли
семейством	семейством
тесните	тесните
рассуди	рассуди
било	било
пройди	пройди
чужою	чужою
умертвили	умертвили
окружали	окружали
сокрыт	сокрыт
запрет	запрет
познаю	познаю
оказала	оказала
подвиг	подвиг
открывать	открывать
пропасть	пропасть
крыло	крыло
выносит	выносит
подкрепить	подкрепить
увели	увели
открытой	открытой
брака	брака
связанные	связанные
козлах	козлах
утаили	утаили
направился	направился
Который	Который
отрезал	отрезал
белою	белою
наш	наш
благослови	благослови
постигло	постигло
положите	положите
тайны	тайны
призывали	призывали
истребить	истребить
встречали	встречали
бы	бы
богатого	богатого
счет	счет
пленных	пленных
испытанного	испытанного
связанных	связанных
отсчитай	отсчитай
могла	могла
ехидны	ехидны
стоишь	стоишь
убитые	убитые
смертные	смертные
миновать	миновать
верить	верить
безумных	безумных
овнов	овнов
отплыли	отплыли
появлении	появлении
нанять	нанять
онемеешь	онемеешь
разодрала	разодрала
цветами	цветами
держали	держали
заходят	заходят
черта	черта
белым	белым
выбрасывайте	выбрасывайте
защити	защити
Израильской	Израильской
вопросить	вопросить
служите	служите
желай	желай
отнеси	отнеси
продолжало	продолжало
чести	чести
крыле	крыле
растворила	растворила
разговаривают	разговаривают
оставила	оставила
вытру	вытру
простираешь	простираешь
вострепетал	вострепетал
убийц	убийц
прекрати	прекрати
Начало	Начало
ином	ином
чтобы	чтобы
говорить	говорить
проводят	проводят
половины	половины
добром	добром
носильщиков	носильщиков
воспоминайте	воспоминайте
потаенном	потаенном
истукану	истукану
сварили	сварили
фараонов	фараонов
остановился	остановился
поехал	поехал
нечистота	нечистота
позавидовал	позавидовал
топтали	топтали
красоты	красоты
сделали	сделали
преданным	преданным
сей	сей
постыди	постыди
Стану	Стану
открытою	открытою
преданный	преданный
собирали	собирали
рабу	рабу
меньше	меньше
исправлять	исправлять
пища	пища
отослать	отослать
разбросали	разбросали
низложи	низложи
разбросайте	разбросайте
остановили	остановили
затрепетали	затрепетали
ожили	ожили
одною	одною
достаем	достаем
рассуждали	рассуждали
искало	искало
тысяченачальнику	тысяченачальнику
каков	каков
подражайте	подражайте
укрепи	укрепи
обитать	обитать
получили	получили
отягощай	отягощай
искушай	искушай
произошло	произошло
целовали	целовали
воротился	воротился
прославился	прославился
расспросите	расспросите
областеначальникам	областеначальникам
расслабленные	расслабленные
одержимого	одержимого
пострадал	пострадал
переменить	переменить
отдели	отдели
мечом	мечом
родишь	родишь
четвертою	четвертою
изнеженный	изнеженный
перестать	перестать
убогие	убогие
дал	дал
сохрани	сохрани
какой	какой
засохли	засохли
духов	духов
сила	сила
честным	честным
мертвых	мертвых
встретился	встретился
повреди	повреди
почиет	почиет
выходила	выходила
похвалили	похвалили
раздирать	раздирать
родят	родят
предшествовать	предшествовать
читать	читать
берет	берет
принадлежащую	принадлежащую
умерщвляй	умерщвляй
выведите	выведите
силу	силу
претерпели	претерпели
говорила	говорила
поручился	поручился
гвозди	гвозди
умирали	умирали
уничижали	уничижали
научи	научи
откормленного	откормленного
воздали	воздали
кропили	кропили
произносили	произносили
заключили	заключили
приношением	приношением
Тем	Тем
печи	печи
заколают	заколают
располагает	располагает
воспламенился	воспламенился
из	из
превознесли	превознесли
самое	самое
показали	показали
приведем	приведем
очистился	очистился
сидеть	сидеть
владели	владели
терафим	терафим
представлять	представлять
мехе	мехе
жары	жары
подходите	подходите
положить	положить
пьяные	пьяные
богов	богов
знаком	знаком
голодного	голодного
раздражали	раздражали
вторым	вторым
обрати	обрати
кадить	кадить
молила	молила
божества	божества
погреби	погреби
выслушали	выслушали
родила	родила
считаете	считаете
отделить	отделить
насадила	насадила
полы	полы
звали	звали
сокрой	сокрой
противоречили	противоречили
доходила	доходила
избранной	избранной
рассказывайте	рассказывайте
заменили	заменили
изменишь	изменишь
белом	белом
вешать	вешать
нечистой	нечистой
написала	написала
рули	рули
новых	новых
плече	плече
страшного	страшного
самым	самым
поразила	поразила
привить	привить
приходите	приходите
располагал	располагал
хвалите	хвалите
смели	смели
упился	упился
поношением	поношением
Какая	Какая
иного	иного
пожелали	пожелали
находим	находим
новом	новом
каждого	каждого
попирали	попирали
помышляли	помышляли
предупредили	предупредили
щади	щади
преподали	преподали
носить	носить
эту	эту
свободные	свободные
жало	жало
обмануть	обмануть
дохни	дохни
выводи	выводи
ставили	ставили
вопроси	вопроси
смешанной	смешанной
тверда	тверда
огорчить	огорчить
возрос	возрос
восемь	восемь
Какое	Какое
восполнить	восполнить
погубить	погубить
входить	входить
отсчитайте	отсчитайте
взять	взять
приняло	приняло
поядающий	поядающий
Самая	Самая
снискала	снискала
променяли	променяли
четвертую	четвертую
воспой	воспой
исходит	исходит
производите	производите
возвысился	возвысился
полагали	полагали
приводили	приводили
образую	образую
сохранить	сохранить
уступили	уступили
провожу	провожу
блудодействуете	блудодействуете
отрезали	отрезали
отпускать	отпускать
страсти	страсти
побивали	побивали
избрали	избрали
саранчу	саранчу
бедный	бедный
засохло	засохло
успокоился	успокоился
умалился	умалился
выстроился	выстроился
уповать	уповать
богами	богами
летали	летали
предстали	предстали
воспитанный	воспитанный
доводит	доводит
думать	думать
проводив	проводив
осудили	осудили
прибыл	прибыл
обгорели	обгорели
восемью	восемью
пристали	пристали
сухая	сухая
проклятые	проклятые
притворился	притворился
сердечною	сердечною
кровопролитием	кровопролитием
собирать	собирать
кидары	кидары
вскричали	вскричали
выслать	выслать
презирали	презирали
золотою	золотою
научили	научили
чудным	чудным
какую	какую
змею	змею
скрепите	скрепите
воплю	воплю
спустился	спустился
несмысленны	несмысленны
рассекали	рассекали
попросите	попросите
умоляла	умоляла
осенила	осенила
доказать	доказать
рассудите	рассудите
доказали	доказали
подняли	подняли
наполняла	наполняла
вносить	вносить
поникло	поникло
быть	быть
отрезать	отрезать
сверху	сверху
верили	верили
просила	просила
зимой	зимой
согрешив	согрешив
отступите	отступите
откормленных	откормленных
обрезывай	обрезывай
награбило	награбило
пролился	пролился
уразумели	уразумели
кончен	кончен
стража	стража
Иудиной	Иудиной
саранчи	саранчи
припали	припали
охраняйте	охраняйте
ночные	ночные
рождали	рождали
тысяченачальникам	тысяченачальникам
развели	развели
почернели	почернели
областеначальнику	областеначальнику
подтвердить	подтвердить
слепой	слепой
пили	пили
враждовали	враждовали
духовные	духовные
наполнила	наполнила
вводить	вводить
открывай	открывай
черпать	черпать
одетый	одетый
рассказывай	рассказывай
открыть	открыть
переменили	переменили
молили	молили
творила	творила
поставили	поставили
начале	начале
принимали	принимали
ком	ком
смешанные	смешанные
худо	худо
пасть	пасть
мой	мой
изрекали	изрекали
пленили	пленили
доносят	доносят
замечать	замечать
половина	половина
возвращали	возвращали
ваши	ваши
строился	строился
воплем	воплем
откажет	откажет
спешить	спешить
смешанный	смешанный
трава	трава
проходят	проходят
впереди	впереди
перерезал	перерезал
другого	другого
заколите	заколите
прибыла	прибыла
поступали	поступали
закрою	закрою
иным	иным
сухою	сухою
нынешнем	нынешнем
птичкою	птичкою
головах	головах
вами	вами
выступив	выступив
плечом	плечом
пропало	пропало
принимать	принимать
подносить	подносить
дай	дай
пострадали	пострадали
беременную	беременную
богом	богом
сводом	сводом
изменили	изменили
унизить	унизить
помышляйте	помышляйте
отделите	отделите
духам	духам
умоляли	умоляли
ели	ели
нечистых	нечистых
сади	сади
пьяного	пьяного
приехали	приехали
благословляли	благословляли
сожигали	сожигали
Хочешь	Хочешь
низкою	низкою
заперла	заперла
страдать	страдать
имеют	имеют
благословлять	благословлять
убитым	убитым
одушевленных	одушевленных
избранное	избранное
откажу	откажу
появлением	появлением
предложи	предложи
благотворить	благотворить
тысяченачальников	тысяченачальников
первые	первые
Цари	Цари
бога	бога
жилами	жилами
бел	бел
членом	членом
вымой	вымой
умудрился	умудрился
отыщите	отыщите
хранить	хранить
вдовы	вдовы
приняты	приняты
унывать	унывать
отвела	отвела
предавай	предавай
прямой	прямой
Приветствуй	Приветствуй
уходить	уходить
округа	округа
выговори	выговори
черные	черные
рыдали	рыдали
черный	черный
вызывающий	вызывающий
она	она
вымерла	вымерла
козлов	козлов
написанное	написанное
отложите	отложите
мутите	мутите
ударить	ударить
подкрепи	подкрепи
Нем	Нем
языке	языке
ехидна	ехидна
разгласили	разгласили
мне	мне
изо	изо
пожирали	пожирали
увеличили	увеличили
скверною	скверною
минует	минует
подкрепился	подкрепился
Самый	Самый
поехали	поехали
поместить	поместить
завладели	завладели
управляй	управляй
взглянул	взглянул
будут	будут
воздух	воздух
поднять	поднять
литого	литого
глазом	глазом
разбогатели	разбогатели
Самой	Самой
сравните	сравните
могло	могло
блаженным	блаженным
семь	семь
говорите	говорите
беззаконием	беззаконием
приводить	приводить
поговорить	поговорить
обрезывали	обрезывали
вооружите	вооружите
истуканом	истуканом
поднял	поднял
жертву	жертву
наследуйте	наследуйте
Боге	Боге
отходить	отходить
бабки	бабки
потекли	потекли
вечером	вечером
одела	одела
кропить	кропить
точило	точило
проповедуйте	проповедуйте
иссохли	иссохли
объяви	объяви
тьма	тьма
осквернить	осквернить
молодых	молодых
преклонили	преклонили
искали	искали
избранных	избранных
притворы	притворы
кадила	кадила
ожесточи	ожесточи
возвеличился	возвеличился
совершила	совершила
сестры	сестры
соорудили	соорудили
отошли	отошли
счета	счета
благочестии	благочестии
лег	лег
который	который
постигли	постигли
возвратите	возвратите
страшных	страшных
сложить	сложить
целую	целую
пило	пило
хулить	хулить
мех	мех
вылитых	вылитых
переносит	переносит
соляною	соляною
отгадать	отгадать
наступили	наступили
поноси	поноси
одре	одре
влекла	влекла
опьянейте	опьянейте
заколи	заколи
обвязывай	обвязывай
чужое	чужое
удивлении	удивлении
отнятых	отнятых
провозгласите	провозгласите
привозить	привозить
раскинуть	раскинуть
хромых	хромых
правосудии	правосудии
сверкали	сверкали
злодействе	злодействе
вспомните	вспомните
мал	мал
вопрошающий	вопрошающий
променять	променять
изнеженная	изнеженная
дрогнуло	дрогнуло
среди	среди
перейди	перейди
имели	имели
мертвые	мертвые
поднята	поднята
бесовскую	бесовскую
составляли	составляли
ослабела	ослабела
обманули	обманули
выпросили	выпросили
лицу	лицу
второю	второю
обложила	обложила
взяла	взяла
постиг	постиг
наливала	наливала
ним	ним
одет	одет
меча	меча
твердо	твердо
принеси	принеси
брак	брак
бросили	бросили
имевшие	имевшие
восклицайте	восклицайте
отнято	отнято
отходите	отходите
строят	строят
последуйте	последуйте
твори	твори
избавили	избавили
губи	губи
лукавых	лукавых
сатаною	сатаною
отводит	отводит
страшилищем	страшилищем
доставляло	доставляло
уходите	уходите
главных	главных
заплатить	заплатить
могу	могу
доставляла	доставляла
преподать	преподать
ищем	ищем
совершите	совершите
гусенице	гусенице
образовала	образовала
Тысяча	Тысяча
выполняйте	выполняйте
расслабленный	расслабленный
матери	матери
стереги	стереги
уповайте	уповайте
весу	весу
удерживайте	удерживайте
поглотить	поглотить
Божию	Божию
засохла	засохла
наскучили	наскучили
били	били
мертвою	мертвою
испортите	испортите
пролили	пролили
сирота	сирота
собрать	собрать
прилагайте	прилагайте
Кому	Кому
жило	жило
первое	первое
служи	служи
образуем	образуем
подпали	подпали
поядал	поядал
молодым	молодым
подпал	подпал
большом	большом
владеть	владеть
победить	победить
исправить	исправить
покровом	покровом
выбежали	выбежали
вымыли	вымыли
сердечные	сердечные
беззаконии	беззаконии
Матерь	Матерь
выслушай	выслушай
несмысленный	несмысленный
вспомнила	вспомнила
обитаем	обитаем
другие	другие
сковали	сковали
тверди	тверди
призывать	призывать
стенали	стенали
подбирала	подбирала
спрятали	спрятали
посылали	посылали
старою	старою
считаешь	считаешь
жертвою	жертвою
сидели	сидели
вопросите	вопросите
давали	давали
воевать	воевать
нечистые	нечистые
душу	душу
выгнали	выгнали
управляющий	управляющий
приводите	приводите
озере	озере
ничтожества	ничтожества
чужие	чужие
лукавый	лукавый
познай	познай
принято	принято
твою	твою
ожидать	ожидать
жив	жив
приносить	приносить
прямым	прямым
отворили	отворили
другой	другой
увещевали	увещевали
завещевает	завещевает
жили	жили
кадили	кадили
молоке	молоке
исполняй	исполняй
женщиной	женщиной
ожил	ожил
хулите	хулите
исходили	исходили
желающий	желающий
оробели	оробели
разделился	разделился
счету	счету
фараона	фараона
наложить	наложить
Одни	Одни
сама	сама
сосчитать	сосчитать
очистили	очистили
последовать	последовать
услышите	услышите
сделать	сделать
камню	камню
мало	мало
управляли	управляли
хвалить	хвалить
предложили	предложили
развратился	развратился
умножился	умножился
восхвалили	восхвалили
переноси	переноси
истребила	истребила
поднят	поднят
простертая	простертая
ненадежное	ненадежное
гусеница	гусеница
морскую	морскую
украсила	украсила
веке	веке
Христом	Христом
мертвого	мертвого
покрывало	покрывало
понесли	понесли
Жертвы	Жертвы
путевой	путевой
смешанною	смешанною
привела	привела
объявили	объявили
померкли	померкли
простираете	простираете
Знайте	Знайте
зарыдал	зарыдал
воевали	воевали
возложите	возложите
невежды	невежды
полированную	полированную
правый	правый
соделай	соделай
овладели	овладели
тысячам	тысячам
померк	померк
покрывал	покрывал
великой	великой
прославляй	прославляй
чтите	чтите
приступали	приступали
проходит	проходит
разных	разных
умерло	умерло
растянула	растянула
собранный	собранный
склонили	склонили
принятые	принятые
серебре	серебре
сохраните	сохраните
неправы	неправы
вскорми	вскорми
скорым	скорым
умилостивить	умилостивить
пророчествуй	пророчествуй
благотворите	благотворите
вели	вели
судите	судите
воспылали	воспылали
открытого	открытого
испекли	испекли
доходили	доходили
подчинен	подчинен
настаивали	настаивали
омыли	омыли
подкрепите	подкрепите
вознегодовал	вознегодовал
уставом	уставом
подносили	подносили
открытое	открытое
переносить	переносить
матерях	матерях
рулем	рулем
умолять	умолять
умертви	умертви
превозносите	превозносите
лицами	лицами
можем	можем
поступили	поступили
поправили	поправили
переходить	переходить
просили	просили
покрой	покрой
снохи	снохи
управлять	управлять
язв	язв
манна	манна
родных	родных
умертвите	умертвите
страж	страж
потаенных	потаенных
вороной	вороной
оскорблять	оскорблять
прибавляй	прибавляй
еси	еси
забытых	забытых
благи	благи
затворив	затворив
сходили	сходили
ступили	ступили
замерло	замерло
поселился	поселился
напоминать	напоминать
научите	научите
каждое	каждое
затыкает	затыкает
наследуешь	наследуешь
доводить	доводить
проклятую	проклятую
одержимых	одержимых
переночевать	переночевать
познать	познать
замедлить	замедлить
пребыли	пребыли
Дух	Дух
левша	левша
подстерегали	подстерегали
посрамить	посрамить
сели	сели
пленным	пленным
отнимите	отнимите
поцелую	поцелую
моя	моя
изменит	изменит
скот	скот
теста	теста
града	града
гуслистов	гуслистов
легли	легли
блаженный	блаженный
сирот	сирот
явить	явить
какая	какая
служанке	служанке
родившая	родившая
котором	котором
покрывали	покрывали
прикрепила	прикрепила
пророчеством	пророчеством
чьем	чьем
утешить	утешить
голодных	голодных
убийцы	убийцы
отделен	отделен
отдала	отдала
связанного	связанного
воду	воду
поддерживать	поддерживать
низком	низком
привалите	привалите
разрешите	разрешите
Хочет	Хочет
мстили	мстили
Сделай	Сделай
страшить	страшить
вылитая	вылитая
развалинам	развалинам
разит	разит
Сене	Сене
восходили	восходили
зарыдали	зарыдали
родословные	родословные
отказывай	отказывай
обнажи	обнажи
томился	томился
собирайте	собирайте
сии	сии
выкопай	выкопай
изнеженных	изнеженных
священнодействовали	священнодействовали
большая	большая
обветшало	обветшало
Она	Она
соделается	соделается
Он	Он
заходить	заходить
всякое	всякое
хотим	хотим
выводить	выводить
принят	принят
вводите	вводите
превозмогло	превозмогло
носился	носился
скалу	скалу
написанных	написанных
бока	бока
ваш	ваш
построили	построили
внимайте	внимайте
тысяченачальники	тысяченачальники
Будут	Будут
будете	будете
сразился	сразился
ударила	ударила
рога	рога
мухи	мухи
онемело	онемело
возненавидела	возненавидела
черпали	черпали
спасали	спасали
имея	имея
думали	думали
испытанных	испытанных
пропали	пропали
прокаженным	прокаженным
благословите	благословите
убедила	убедила
посрамился	посрамился
Богами	Богами
поспешили	поспешили
уходили	уходили
явился	явился
потекло	потекло
отступив	отступив
ослепить	ослепить
красные	красные
сходишь	сходишь
пары	пары
занятые	занятые
почетном	почетном
пухли	пухли
считают	считают
поясом	поясом
позавидовали	позавидовали
которую	которую
Святом	Святом
имевшая	имевшая
срывать	срывать
низринут	низринут
чью	чью
стену	стену
простерла	простерла
расслабленного	расслабленного
засыпали	засыпали
условие	условие
соорудить	соорудить
окончить	окончить
начали	начали
выпросился	выпросился
пиши	пиши
посмотрите	посмотрите
ожить	ожить
пойте	пойте
оценить	оценить
убитою	убитою
трогай	трогай
определить	определить
соделали	соделали
братьями	братьями
допускать	допускать
хулили	хулили
заграждать	заграждать
наложите	наложите
сладкою	сладкою
находить	находить
рабе	рабе
устроить	устроить
послужили	послужили
ворону	ворону
раздражите	раздражите
чудовище	чудовище
завладел	завладел
называть	называть
купи	купи
второй	второй
унизили	унизили
плачу	плачу
новорожденного	новорожденного
поешь	поешь
сбили	сбили
спрашивали	спрашивали
убила	убила
познайте	познайте
забирать	забирать
продать	продать
Они	Они
землетрясении	землетрясении
обесчестили	обесчестили
каждый	каждый
обложили	обложили
удалите	удалите
дохну	дохну
змеи	змеи
обветшала	обветшала
обитая	обитая
царствовали	царствовали
избранная	избранная
прочитайте	прочитайте
очищен	очищен
помни	помни
погребали	погребали
последовала	последовала
покрыла	покрыла
смирите	смирите
отнесла	отнесла
богам	богам
взирать	взирать
заключен	заключен
личном	личном
неверные	неверные
бесчестить	бесчестить
разложили	разложили
сатане	сатане
принимай	принимай
стерегла	стерегла
одетые	одетые
благовествуйте	благовествуйте
навыком	навыком
животных	животных
богу	богу
преуспевайте	преуспевайте
положен	положен
выкупи	выкупи
затворите	затворите
повисла	повисла
лежали	лежали
выходить	выходить
се	се
вам	вам
ходу	ходу
язва	язва
бегу	бегу
преуспевали	преуспевали
избирали	избирали
сотворили	сотворили
ухом	ухом
объедать	объедать
влекло	влекло
ввело	ввело
велико	велико
медлить	медлить
покрывать	покрывать
девяносто	девяносто
спорите	спорите
утопать	утопать
ртом	ртом
стоят	стоят
дайте	дайте
святою	святою
покрывала	покрывала
досадовать	досадовать
отпали	отпали
постанови	постанови
искушали	искушали
целовала	целовала
образе	образе
долга	долга
исследуй	исследуй
золотого	золотого
сохраняйте	сохраняйте
подложи	подложи
затворить	затворить
возлюбленной	возлюбленной
блуждать	блуждать
отворить	отворить
смирен	смирен
гола	гола
пролить	пролить
главные	главные
уснул	уснул
пола	пола
принуждали	принуждали
духу	духу
надели	надели
простирает	простирает
Вила	Вила
Теми	Теми
чину	чину
изгнали	изгнали
каждом	каждом
отступить	отступить
бедного	бедного
толки	толки
скованного	скованного
приклонили	приклонили
пригласите	пригласите
вил	вил
храните	храните
сажали	сажали
искупи	искупи
раскрытую	раскрытую
реке	реке
звала	звала
Кис	Кис
возбудили	возбудили
чему	чему
уверить	уверить
выи	выи
садился	садился
сию	сию
препроводить	препроводить
черным	черным
Свою	Свою
жила	жила
возлюбленною	возлюбленною
открыт	открыт
почти	почти
Духа	Духа
Сии	Сии
воспитанные	воспитанные
колет	колет
яви	яви
запри	запри
выбрасывать	выбрасывать
птенцов	птенцов
порядке	порядке
царю	царю
вынесли	вынесли
утвердите	утвердите
отважился	отважился
лукавого	лукавого
сожигает	сожигает
занято	занято
бросали	бросали
беременною	беременною
замолчи	замолчи
подтверди	подтверди
погнать	погнать
избирай	избирай
выпало	выпало
счетом	счетом
имеет	имеет
возлюбила	возлюбила
защитить	защитить
оборотился	оборотился
пока	пока
глухие	глухие
подходили	подходили
молотили	молотили
доводите	доводите
чудных	чудных
отпусти	отпусти
прельстить	прельстить
покрыло	покрыло
прогнать	прогнать
целое	целое
оставлять	оставлять
запретить	запретить
купили	купили
расположите	расположите
голове	голове
иная	иная
подумали	подумали
спросите	спросите
лесу	лесу
благ	благ
людях	людях
жабах	жабах
отяжелели	отяжелели
лично	лично
приучила	приучила
принята	принята
отплыл	отплыл
подстерегать	подстерегать
небольшую	небольшую
приветствуете	приветствуете
погнали	погнали
страшные	страшные
выступили	выступили
спрятать	спрятать
поднятою	поднятою
населенного	населенного
Приветствуют	Приветствуют
вопили	вопили
петля	петля
возлюбленным	возлюбленным
легкое	легкое
жертвами	жертвами
обнажен	обнажен
наушник	наушник
погрязли	погрязли
убедили	убедили
простертым	простертым
подбирать	подбирать
Израилеву	Израилеву
язвам	язвам
освятите	освятите
утром	утром
имущество	имущество
выходи	выходи
скалами	скалами
поселили	поселили
язвах	язвах
извратить	извратить
нареки	нареки
пугал	пугал
принесли	принесли
неверным	неверным
весе	весе
выкупали	выкупали
доставить	доставить
пара	пара
огорчился	огорчился
Моисеевым	Моисеевым
надевай	надевай
разбогатеть	разбогатеть
обгорелою	обгорелою
утихло	утихло
собою	собою
столпе	столпе
обе	обе
благочестием	благочестием
претерпеть	претерпеть
Тысячу	Тысячу
бесчестили	бесчестили
тайною	тайною
духа	духа
золотой	золотой
обирай	обирай
Богом	Богом
молодой	молодой
срубить	срубить
наступив	наступив
творили	творили
козлом	козлом
обратила	обратила
насади	насади
кому	кому
плату	плату
главного	главного
возлюбленном	возлюбленном
преподала	преподала
скованный	скованный
своди	своди
возвестится	возвестится
воздухе	воздухе
закрыла	закрыла
служанкою	служанкою
отринь	отринь
двое	двое
снимали	снимали
налагайте	налагайте
пожалуйте	пожалуйте
браните	браните
овну	овну
слепые	слепые
привалили	привалили
сделанной	сделанной
назвала	назвала
призраку	призраку
какою	какою
свободных	свободных
кончился	кончился
Белы	Белы
благословляйте	благословляйте
пусти	пусти
серебром	серебром
сторож	сторож
сделайте	сделайте
немым	немым
достали	достали
каплют	каплют
уразумел	уразумел
кровопролитии	кровопролитии
потонуло	потонуло
цвет	цвет
ослабеть	ослабеть
смирить	смирить
соблазнили	соблазнили
любимым	любимым
возроптал	возроптал
живая	живая
крестить	крестить
разделила	разделила
ночного	ночного
заразы	заразы
прости	прости
велишь	велишь
силе	силе
одушевленное	одушевленное
приветствовала	приветствовала
никакой	никакой
сострадали	сострадали
посвящай	посвящай
придворных	придворных
придворным	придворным
посвятили	посвятили
любимый	любимый
заплатили	заплатили
черту	черту
обольстили	обольстили
создать	создать
всякую	всякую
языческую	языческую
Велики	Велики
Яви	Яви
Три	Три
обратите	обратите
духами	духами
страшным	страшным
стеснили	стеснили
уничижила	уничижила
расслабленным	расслабленным
звезду	звезду
запретили	запретили
устремили	устремили
воспоминать	воспоминать
госпожи	госпожи
вкусить	вкусить
разбудили	разбудили
Духе	Духе
семи	семи
называй	называй
значила	значила
матерь	матерь
отходят	отходят
разделили	разделили
строим	строим
Слушай	Слушай
рождала	рождала
встретили	встретили
одели	одели
столах	столах
чад	чад
дворами	дворами
уразумейте	уразумейте
написанного	написанного
освободился	освободился
соделал	соделал
осени	осени
согласного	согласного
Сам	Сам
решите	решите
родили	родили
ходи	ходи
сладкое	сладкое
сказать	сказать
вышли	вышли
срубили	срубили
решали	решали
внимать	внимать
ненаказанным	ненаказанным
восстановили	восстановили
истребите	истребите
вороны	вороны
затворит	затворит
почитаю	почитаю
немногое	немногое
немых	немых
необрезанных	необрезанных
почиешь	почиешь
посмеянием	посмеянием
бедным	бедным
протоках	протоках
пересказывать	пересказывать
временные	временные
беременные	беременные
вымыла	вымыла
скрывай	скрывай
восстали	восстали
отнят	отнят
истощила	истощила
полюбила	полюбила
растила	растила
заплатите	заплатите
похулили	похулили
внутрь	внутрь
главным	главным
познала	познала
моли	моли
гусеницы	гусеницы
пас	пас
удержали	удержали
преследовала	преследовала
как	как
попускаешь	попускаешь
выливай	выливай
поразить	поразить
бери	бери
смутить	смутить
почернела	почернела
отвратите	отвратите
вин	вин
разбила	разбила
портить	портить
поставила	поставила
вине	вине
оба	оба
просить	просить
поднимите	поднимите
любимой	любимой
поступи	поступи
знакомые	знакомые
молите	молите
обручу	обручу
изливали	изливали
Галилейской	Галилейской
переправили	переправили
злак	злак
Воздай	Воздай
выдайте	выдайте
оскорбляли	оскорбляли
жаб	жаб
распознать	распознать
кидару	кидару
прибыли	прибыли
затыкали	затыкали
оправдать	оправдать
проезжая	проезжая
варите	варите
посвятила	посвятила
соверши	соверши
доносили	доносили
скрепить	скрепить
кричали	кричали
святых	святых
худа	худа
сходи	сходи
заклятым	заклятым
переправился	переправился
захватила	захватила
покров	покров
преступлении	преступлении
ходите	ходите
своротить	своротить
заговоришь	заговоришь
искусили	искусили
даруй	даруй
ненаказанно	ненаказанно
нового	нового
выдать	выдать
правым	правым
перерезали	перерезали
обирать	обирать
увела	увела
пострадать	пострадать
хромой	хромой
утомленных	утомленных
произнеси	произнеси
Будь	Будь
строишь	строишь
другом	другом
распознает	распознает
выросло	выросло
уступи	уступи
возлегли	возлегли
никакою	никакою
приветствующий	приветствующий
почитает	почитает
скале	скале
освятить	освятить
кричите	кричите
Слове	Слове
овнами	овнами
раздавали	раздавали
проводит	проводит
мною	мною
духом	духом
трогать	трогать
смирился	смирился
Твои	Твои
малом	малом
принудить	принудить
научился	научился
нарушили	нарушили
первых	первых
горькая	горькая
поступив	поступив
отнял	отнял
отлучился	отлучился
развратили	развратили
считать	считать
разбирайте	разбирайте
допускала	допускала
последовали	последовали
Благослови	Благослови
преступили	преступили
иной	иной
тельцов	тельцов
накормить	накормить
царя	царя
утверди	утверди
блаженного	блаженного
возьмете	возьмете
простерли	простерли
укрепляй	укрепляй
отложи	отложи
требуй	требуй
осматривать	осматривать
похороните	похороните
птичка	птичка
гвоздем	гвоздем
почитали	почитали
схватите	схватите
саранчою	саранчою
созывайте	созывайте
пояса	пояса
утомили	утомили
отнята	отнята
возмутили	возмутили
страха	страха
которые	которые
чада	чада
назидает	назидает
нечестии	нечестии
питай	питай
видите	видите
поднятых	поднятых
попускал	попускал
раздирайте	раздирайте
погубили	погубили
взыскали	взыскали
приноси	приноси
Можешь	Можешь
страдающий	страдающий
призванным	призванным
Одно	Одно
звездам	звездам
язвами	язвами
разбирать	разбирать
дороге	дороге
каждые	каждые
исцелить	исцелить
горд	горд
испеки	испеки
повредить	повредить
держите	держите
возносили	возносили
нарекли	нарекли
Слушайте	Слушайте
вопросили	вопросили
сострадать	сострадать
оцепенении	оцепенении
встал	встал
детях	детях
отличить	отличить
приблизить	приблизить
понять	понять
святую	святую
образу	образу
копали	копали
вынимали	вынимали
бейте	бейте
обвязывать	обвязывать
защищайте	защищайте
добра	добра
Мать	Мать
распознаем	распознаем
аспидов	аспидов
выходит	выходит
омывали	омывали
воспитывайте	воспитывайте
сотвори	сотвори
делить	делить
скрытые	скрытые
возбуди	возбуди
права	права
утомился	утомился
светили	светили
Будете	Будете
есть	есть
купила	купила
возвратить	возвратить
золото	золото
исцели	исцели
обгорел	обгорел
отгадали	отгадали
исходят	исходят
приходить	приходить
споры	споры
любили	любили
языков	языков
обманывайте	обманывайте
сокройте	сокройте
теснить	теснить
обманула	обманула
провозгласи	провозгласи
положили	положили
берете	берете
напоить	напоить
берегу	берегу
твари	твари
ступите	ступите
стояло	стояло
Дина	Дина
грешили	грешили
правою	правою
воспрепятствовали	воспрепятствовали
опьянел	опьянел
областеначальника	областеначальника
стражам	стражам
живою	живою
эти	эти
перейдем	перейдем
намерен	намерен
усилить	усилить
поядает	поядает
половине	половине
оплакивали	оплакивали
благодарите	благодарите
пожирать	пожирать
буду	буду
красный	красный
крестит	крестит
разори	разори
возливать	возливать
бесноватого	бесноватого
Духом	Духом
видимо	видимо
читай	читай
приходили	приходили
чужд	чужд
спросить	спросить
известите	известите
совершали	совершали
строила	строила
ночное	ночное
цари	цари
составили	составили
засевай	засевай
выговорить	выговорить
перехватите	перехватите
подули	подули
давир	давир
презирайте	презирайте
обозрели	обозрели
кидара	кидара
отвратили	отвратили
произносить	произносить
одолела	одолела
почитаете	почитаете
спросили	спросили
носила	носила
учи	учи
вспоминать	вспоминать
собранным	собранным
сходим	сходим
обратить	обратить
больным	больным
градом	градом
отворила	отворила
исходила	исходила
пристал	пристал
звезды	звезды
знакомого	знакомого
ела	ела
растерзать	растерзать
жившая	жившая
плену	плену
смертный	смертный
расспроси	расспроси
пожалели	пожалели
объявить	объявить
бич	бич
выломать	выломать
любить	любить
завещеваю	завещеваю
теснили	теснили
выть	выть
онемеют	онемеют
открытом	открытом
немые	немые
ваше	ваше
числе	числе
открыто	открыто
уподобить	уподобить
замесила	замесила
петли	петли
наставить	наставить
взял	взял
забытая	забытая
беременная	беременная
счете	счете
привился	привился
Моисеевой	Моисеевой
утвердить	утвердить
возопил	возопил
небольшой	небольшой
воспылал	воспылал
видим	видим
подтвердили	подтвердили
реши	реши
умирающий	умирающий
пернатые	пернатые
бесславить	бесславить
дщерь	дщерь
хромого	хромого
питать	питать
рои	рои
влекли	влекли
исследуйте	исследуйте
малого	малого
приняли	приняли
ослабевайте	ослабевайте
светила	светила
превозносить	превозносить
столе	столе
голоса	голоса
возбудить	возбудить
сокрытой	сокрытой
благе	благе
половиною	половиною
несмысленное	несмысленное
собранные	собранные
рака	рака
Даном	Даном
выказала	выказала
погрешили	погрешили
носите	носите
люби	люби
пищи	пищи
утомленного	утомленного
покрова	покрова
воспламенили	воспламенили
обрели	обрели
садили	садили
открывали	открывали
протяни	протяни
подражать	подражать
обложи	обложи
замеси	замеси
приветствовал	приветствовал
осквернился	осквернился
вопрошать	вопрошать
умерли	умерли
оном	оном
отягощала	отягощала
больного	больного
управляем	управляем
молодая	молодая
жил	жил
препроводили	препроводили
ведите	ведите
творите	творите
выведи	выведи
варили	варили
похоронен	похоронен
поникла	поникла
замышляли	замышляли
разложите	разложите
Приветствуйте	Приветствуйте
увеличился	увеличился
влез	влез
вышло	вышло
входите	входите
пух	пух
бесноватый	бесноватый
стражи	стражи
пробыла	пробыла
голодным	голодным
самый	самый
почитай	почитай
отягощать	отягощать
твердым	твердым
твердою	твердою
разгласите	разгласите
об	об
оборотили	оборотили
сруби	сруби
решился	решился
нехороши	нехороши
обличить	обличить
внуки	внуки
томить	томить
жернов	жернов
оскверните	оскверните
вашу	вашу
отвалит	отвалит
вороные	вороные
населенный	населенный
почитают	почитают
Благословите	Благословите
потускли	потускли
человеческой	человеческой
Одного	Одного
мирен	мирен
страхе	страхе
Дину	Дину
сатаны	сатаны
вывели	вывели
оставить	оставить
тварь	тварь
большую	большую
сходить	сходить
показывали	показывали
обладайте	обладайте
требуйте	требуйте
изделием	изделием
предложить	предложить
очистить	очистить
вела	вела
выпал	выпал
посылайте	посылайте
пой	пой
множеством	множеством
изнеженную	изнеженную
навестить	навестить
призрак	призрак
можешь	можешь
исполняйте	исполняйте
осмоли	осмоли
паре	паре
следующем	следующем
провозгласить	провозгласить
воссияло	воссияло
похитила	похитила
девяноста	девяноста
наполняло	наполняло
бедных	бедных
простертою	простертою
затворила	затворила
скотом	скотом
начало	начало
води	води
голубого	голубого
благо	благо
разговаривать	разговаривать
заколать	заколать
отяготить	отяготить
Жертва	Жертва
сосчитайте	сосчитайте
скрыла	скрыла
одни	одни
гордою	гордою
немноги	немноги
горькою	горькою
пожалуй	пожалуй
рабы	рабы
которого	которого
блуждали	блуждали
граду	граду
испытанный	испытанный
нечистою	нечистою
укрепили	укрепили
допустили	допустили
великою	великою
изменила	изменила
стоит	стоит
лицом	лицом
другое	другое
определили	определили
отцах	отцах
снискать	снискать
отнимали	отнимали
признает	признает
поселить	поселить
вдовою	вдовою
принудили	принудили
закрой	закрой
пребывайте	пребывайте
зле	зле
затрепетал	затрепетал
возьмешь	возьмешь
возлюбите	возлюбите
показывать	показывать
благодарили	благодарили
взяло	взяло
тьме	тьме
облаке	облаке
молчали	молчали
приносила	приносила
избивали	избивали
яме	яме
право	право
немого	немого
образа	образа
морскою	морскою
согрешите	согрешите
презирать	презирать
налетело	налетело
протянут	протянут
взглянуть	взглянуть
золоте	золоте
всякая	всякая
сложи	сложи
видимою	видимою
охраняй	охраняй
представляй	представляй
которых	которых
обличились	обличились
вы	вы
сем	сем
своем	своем
посвяти	посвяти
воронам	воронам
возделывали	возделывали
суди	суди
бегите	бегите
развалиною	развалиною
член	член
братьям	братьям
веди	веди
оскудела	оскудела
соляным	соляным
сделала	сделала
имейте	имейте
приветствовали	приветствовали
истребили	истребили
считал	считал
никакого	никакого
всякого	всякого
подними	подними
поводом	поводом
враждовать	враждовать
жилищах	жилищах
вкусите	вкусите
любила	любила
умерщвляйте	умерщвляйте
спешила	спешила
Словом	Словом
разбогател	разбогател
осадили	осадили
извратила	извратила
поворотить	поворотить
убийца	убийца
положила	положила
похвалился	похвалился
страдали	страдали
одолело	одолело
смотри	смотри
чадо	чадо
убить	убить
необрезан	необрезан
раздражить	раздражить
попускаете	попускаете
отпирать	отпирать
свободного	свободного
родным	родным
составить	составить
навести	навести
обитали	обитали
Сия	Сия
пил	пил
слушало	слушало
молодые	молодые
пронзила	пронзила
Мне	Мне
никакая	никакая
одинокою	одинокою
лишен	лишен
восхотел	восхотел
святая	святая
утешали	утешали
скакать	скакать
тысяченачальниками	тысяченачальниками
нечиста	нечиста
десяти	десяти
блага	блага
прокаженных	прокаженных
каждая	каждая
растить	растить
уходят	уходят
трубите	трубите
грешить	грешить
узнать	узнать
низложить	низложить
избило	избило
венце	венце
обо	обо
наклонили	наклонили
отсчитать	отсчитать
спешит	спешит
испекла	испекла
видали	видали
оставили	оставили
целого	целого
устроен	устроен
привезла	привезла
прекратился	прекратился
спустили	спустили
вознегодовали	вознегодовали
осадить	осадить
подняла	подняла
поносить	поносить
смутился	смутился
надевать	надевать
сими	сими
возвестить	возвестить
думайте	думайте
выдавать	выдавать
большою	большою
мучила	мучила
удила	удила
уха	уха
сладкого	сладкого
наказывай	наказывай
ожидали	ожидали
необрезаны	необрезаны
выступить	выступить
горькие	горькие
громом	громом
чужом	чужом
растянули	растянули
несмысленного	несмысленного
траву	траву
божество	божество
выстрели	выстрели
открыла	открыла
скалах	скалах
перестал	перестал
вложили	вложили
пощади	пощади
цвете	цвете
голосом	голосом
твердом	твердом
землетрясением	землетрясением
путевые	путевые
злословили	злословили
первого	первого
празднуйте	празднуйте
упали	упали
подходить	подходить
белых	белых
светить	светить
прогнали	прогнали
овцою	овцою
осади	осади
избавился	избавился
возьмем	возьмем
воззовем	воззовем
благом	благом
долгом	долгом
сокрушите	сокрушите
неверных	неверных
Мал	Мал
великую	великую
привезли	привезли
платите	платите
хотите	хотите
нашем	нашем
двумя	двумя
напоен	напоен
порти	порти
сказывали	сказывали
сошло	сошло
жертве	жертве
Иудину	Иудину
рождать	рождать
вредили	вредили
спроси	спроси
узнали	узнали
жала	жала
Христов	Христов
ходить	ходить
местом	местом
кормите	кормите
начала	начала
хотели	хотели
вступали	вступали
наливай	наливай
сторожу	сторожу
победит	победит
возлагать	возлагать
торжествующий	торжествующий
отпустила	отпустила
выходите	выходите
нами	нами
Твою	Твою
бросился	бросился
предавала	предавала
сказала	сказала
Души	Души
блудили	блудили
полагай	полагай
поспешив	поспешив
стеснен	стеснен
рубить	рубить
хром	хром
неправ	неправ
погасили	погасили
помнила	помнила
отлучите	отлучите
поразили	поразили
излился	излился
самой	самой
внутреннем	внутреннем
убийце	убийце
этой	этой
соедини	соедини
бабке	бабке
возопили	возопили
разрешить	разрешить
Тире	Тире
снега	снега
ободрился	ободрился
поговорив	поговорив
воспели	воспели
юношах	юношах
отказал	отказал
платили	платили
сторожа	сторожа
узнаете	узнаете
мозгов	мозгов
Велик	Велик
оценили	оценили
захотели	захотели
попроси	попроси
саранче	саранче
помнили	помнили
Духу	Духу
сухой	сухой
пристало	пристало
озером	озером
сироты	сироты
сокрушен	сокрушен
обществом	обществом
выпали	выпали
отправляли	отправляли
изумился	изумился
второе	второе
обратился	обратился
честные	честные
вытащи	вытащи
погрешите	погрешите
возносите	возносите
пронзить	пронзить
сказывать	сказывать
развалинах	развалинах
горькой	горькой
слушать	слушать
трое	трое
добре	добре
нарекла	нарекла
покоить	покоить
встревожили	встревожили
замедли	замедли
небе	небе
будь	будь
исправляли	исправляли
полированной	полированной
Всем	Всем
отлучить	отлучить
любимую	любимую
пересчитай	пересчитай
исчислить	исчислить
отпустим	отпустим
рабою	рабою
блуди	блуди
вложить	вложить
восхвалите	восхвалите
умножила	умножила
похитили	похитили
веса	веса
признайте	признайте
возноси	возноси
благодарить	благодарить
он	он
возложили	возложили
сестрою	сестрою
невежд	невежд
подчинился	подчинился
устав	устав
стояла	стояла
сверкающий	сверкающий
огорчен	огорчен
свои	свои
священнодействовать	священнодействовать
снегом	снегом
любимая	любимая
твоя	твоя
ожесточите	ожесточите
головами	головами
язву	язву
гуслиста	гуслиста
осквернили	осквернили
исполним	исполним
убитый	убитый
примером	примером
смертного	смертного
отложили	отложили
святой	святой
испортили	испортили
перехватили	перехватили
Моисеевы	Моисеевы
слепых	слепых
замечайте	замечайте
скрытая	скрытая
Буду	Буду
дети	дети
всем	всем
родившие	родившие
кормила	кормила
искусить	искусить
шести	шести
обветшали	обветшали
возлег	возлег
Моя	Моя
обгорело	обгорело
берем	берем
облегчи	облегчи
раздирающий	раздирающий
поддерживайте	поддерживайте
успокоили	успокоили
поникли	поникли
налагали	налагали
пьем	пьем
спите	спите
обходили	обходили
Христа	Христа
найдем	найдем
дать	дать
мою	мою
пройду	пройду
вызывали	вызывали
ослабело	ослабело
переносят	переносят
выбери	выбери
возвысить	возвысить
вступили	вступили
вешали	вешали
давили	давили
подарила	подарила
умер	умер
теми	теми
целые	целые
принесла	принесла
возложить	возложить
очистите	очистите
глядеть	глядеть
простился	простился
возвестим	возвестим
смотрите	смотрите
выдавай	выдавай
нечист	нечист
соделать	соделать
умоляй	умоляй
пишем	пишем
разорить	разорить
снисходить	снисходить
натянули	натянули
прожили	прожили
виден	виден
кидаре	кидаре
накормили	накормили
приготовили	приготовили
входили	входили
отправился	отправился
преуспевать	преуспевать
отправить	отправить
лицах	лицах
нам	нам
божеству	божеству
ждите	ждите
вытащить	вытащить
уцелел	уцелел
нагой	нагой
наняли	наняли
похитить	похитить
держу	держу
какие	какие
заклятое	заклятое
волах	волах
Бела	Бела
аспидом	аспидом
дополнить	дополнить
нашла	нашла
производили	производили
жабы	жабы
построила	построила
жали	жали
вытащили	вытащили
несмысленным	несмысленным
нашу	нашу
отвратить	отвратить
Мало	Мало
лиц	лиц
узнает	узнает
приклоните	приклоните
наклонился	наклонился
дух	дух
спрашивать	спрашивать
осквернила	осквернила
возвестила	возвестила
садить	садить
смертным	смертным
образовали	образовали
считай	считай
выбежал	выбежал
горькую	горькую
извести	извести
поручали	поручали
каждым	каждым
отступали	отступали
лице	лице
всесожжением	всесожжением
стражами	стражами
всходить	всходить
встали	встали
обличи	обличи
будем	будем
рой	рой
повис	повис
толкали	толкали
познаем	познаем
начерпала	начерпала
выливайте	выливайте
схоронить	схоронить
четвертой	четвертой
сироту	сироту
узнаем	узнаем
любим	любим
славословили	славословили
неради	неради
поту	поту
оживлять	оживлять
обратили	обратили
замышляй	замышляй
немой	немой
мести	мести
исчислили	исчислили
уснули	уснули
проходишь	проходишь
отстали	отстали
шестом	шестом
иною	иною
посадить	посадить
получила	получила
пустою	пустою
крестился	крестился
поместила	поместила
сел	сел
уповали	уповали
сохранился	сохранился
самого	самого
доли	доли
прямою	прямою
страх	страх
Которой	Которой
убитого	убитого
мертвым	мертвым
имело	имело
козлы	козлы
помнить	помнить
усилился	усилился
терпи	терпи
превозносили	превозносили
каждую	каждую
поя	поя
выберем	выберем
Этого	Этого
голодный	голодный
лгали	лгали
пьющий	пьющий
красных	красных
приветствуй	приветствуй
белы	белы
челе	челе
своя	своя
столом	столом
учить	учить
разговаривал	разговаривал
обещал	обещал
Лазаря	Лазаря
мучить	мучить
пребыло	пребыло
челах	челах
выслали	выслали
защищать	защищать
мужчины	мужчины
страшное	страшное
убийством	убийством
влезли	влезли
сварите	сварите
искала	искала
пребывали	пребывали
необрезанный	необрезанный
приложить	приложить
похоронили	похоронили
Марка	Марка
призвать	призвать
оказывай	оказывай
пленный	пленный
меха	меха
изблюешь	изблюешь
восстанови	восстанови
лизали	лизали
заколали	заколали
блудила	блудила
вострепетали	вострепетали
приведи	приведи
сравнить	сравнить
померкло	померкло
жилищу	жилищу
молотить	молотить
котлом	котлом
растаяло	растаяло
рада	рада
гордо	гордо
умножали	умножали
овладейте	овладейте
заплати	заплати
выступите	выступите
снимите	снимите
помет	помет
взывайте	взывайте
раскрыла	раскрыла
слез	слез
сберегите	сберегите
чудовища	чудовища
мужчинах	мужчинах
язычески	язычески
нынешнему	нынешнему
вари	вари
богах	богах
вечере	вечере
приобрела	приобрела
посвящали	посвящали
льстить	льстить
принужден	принужден
Соляной	Соляной
объяснили	объяснили
обнови	обнови
живой	живой
приносили	приносили
тысяча	тысяча
пригласи	пригласи
признать	признать
опусти	опусти
переходите	переходите
накорми	накорми
лишить	лишить
сынов	сынов
черных	черных
познали	познали
обещать	обещать
летите	летите
скверны	скверны
исполни	исполни
молчите	молчите
мертво	мертво
чужая	чужая
пить	пить
областеначальником	областеначальником
начертай	начертай
Был	Был
орудием	орудием
исцелился	исцелился
фараон	фараон
головою	головою
второго	второго
роду	роду
червь	червь
запустением	запустением
отсек	отсек
восстановите	восстановите
рубили	рубили
уснуть	уснуть
прославили	прославили
унывали	унывали
скрепился	скрепился
красоту	красоту
юноше	юноше
строить	строить
оказать	оказать
душа	душа
морю	морю
Велика	Велика
начинай	начинай
устрашили	устрашили
каплет	каплет
замер	замер
посети	посети
злодейством	злодейством
хоронили	хоронили
молодом	молодом
люди	люди
это	это
рассвирепел	рассвирепел
изумили	изумили
обирал	обирал
помилуйте	помилуйте
хочешь	хочешь
узнай	узнай
предсказывайте	предсказывайте
судить	судить
медлите	медлите
жилища	жилища
обманывай	обманывай
потерянною	потерянною
молоти	молоти
считайте	считайте
Адам	Адам
свободный	свободный
нему	нему
со	со
был	был
объясни	объясни
простирали	простирали
изливайте	изливайте
царствовать	царствовать
прочитай	прочитай
одолели	одолели
укрепился	укрепился
воспрепятствовал	воспрепятствовал
возьмет	возьмет
начинайте	начинайте
захотела	захотела
рассвирепели	рассвирепели
узнала	узнала
снабдили	снабдили
фараону	фараону
случай	случай
льстили	льстили
подкрепили	подкрепили
варить	варить
простите	простите
жди	жди
бросить	бросить
вороти	вороти
строите	строите
торжествуйте	торжествуйте
красота	красота
обходить	обходить
ненавидела	ненавидела
вопрошали	вопрошали
посылала	посылала
выдавайте	выдавайте
кидар	кидар
направили	направили
скоте	скоте
сатана	сатана
судив	судив
поношении	поношении
опустошен	опустошен
облегчить	облегчить
приказывали	приказывали
сними	сними
отходила	отходила
согрешали	согрешали
убегали	убегали
тысяченачальник	тысяченачальник
возливай	возливай
скрывала	скрывала
подняло	подняло
воскури	воскури
выстроили	выстроили
напасть	напасть
брали	брали
отделили	отделили
условии	условии
благодарив	благодарив
рассеянного	рассеянного
гуслист	гуслист
манны	манны
духовных	духовных
предстал	предстал
грабить	грабить
подняты	подняты
вырос	вырос
славословить	славословить
скрывать	скрывать
купить	купить
разить	разить
Хвали	Хвали
благословила	благословила
пути	пути
признаешь	признаешь
пыли	пыли
говорили	говорили
письме	письме
восполнили	восполнили
повредили	повредили
Соляную	Соляную
дополните	дополните
выслушать	выслушать
безумные	безумные
над	над
набрали	набрали
показывай	показывай
возвестите	возвестите
произвела	произвела
наполнился	наполнился
скрытое	скрытое
схватили	схватили
осмолила	осмолила
вступить	вступить
слеп	слеп
повод	повод
среды	среды
приступив	приступив
нечисты	нечисты
вознесли	вознесли
негодованием	негодованием
страшилищ	страшилищ
избранного	избранного
столп	столп
хромые	хромые
переносим	переносим
выходим	выходим
сухую	сухую
весах	весах
собирай	собирай
поспешите	поспешите
мертвый	мертвый
принять	принять
изменился	изменился
представляла	представляла
высох	высох
надо	надо
ростом	ростом
сторожам	сторожам
утвердили	утвердили
объявите	объявите
переходили	переходили
выносите	выносите
признали	признали
склонился	склонился
времени	времени
малое	малое
град	град
познаешь	познаешь
желало	желало
прокаженные	прокаженные
жилы	жилы
внуши	внуши
называли	называли
благовестием	благовестием
терафимы	терафимы
следовали	следовали
нем	нем
отличился	отличился
постановить	постановить
самом	самом
Вся	Вся
возьму	возьму
Царю	Царю
провожали	провожали
явили	явили
вымойте	вымойте
созвать	созвать
веруйте	веруйте
золотом	золотом
считает	считает
рабах	рабах
начертали	начертали
возлюбленную	возлюбленную
отвалят	отвалят
оробел	оробел
Новы	Новы
твердое	твердое
временное	временное
развалинами	развалинами
прикрепи	прикрепи
Было	Было
тьмою	тьмою
пронзили	пронзили
соделались	соделались
Нему	Нему
белого	белого
приклонить	приклонить
наложили	наложили
имущества	имущества
почерпнули	почерпнули
укрепляли	укрепляли
Твой	Твой
чужой	чужой
вспоминай	вспоминай
выдай	выдай
тельца	тельца
отягощали	отягощали
берег	берег
рубите	рубите
бить	бить
жернова	жернова
вознеси	вознеси
беременной	беременной
обвинить	обвинить
преступите	преступите
поем	поем
блудодействуешь	блудодействуешь
преступить	преступить
пример	пример
напоила	напоила
Дине	Дине
расти	расти
подбирай	подбирай
посетили	посетили
ослабевать	ослабевать
взглянули	взглянули
сбереги	сбереги
смешанного	смешанного
уменьшить	уменьшить
укрепить	укрепить
саранча	саранча
храни	храни
ворона	ворона
бесславии	бесславии
терафимов	терафимов
мои	мои
жертвах	жертвах
сказало	сказало
назидается	назидается
позвали	позвали
снабди	снабди
налагай	налагай
протоки	протоки
падали	падали
молился	молился
приняла	приняла
совершили	совершили
воле	воле
лгите	лгите
давира	давира
нехорошо	нехорошо
человекоубийца	человекоубийца
бывшую	бывшую
мешка	мешка
познает	познает
Может	Может
потаенные	потаенные
ваша	ваша
соблазнить	соблазнить
проходила	проходила
зло	зло
вспоминали	вспоминали
проклятого	проклятого
принимайте	принимайте
Начала	Начала
учите	учите
фараоне	фараоне
старое	старое
затрубите	затрубите
оставится	оставится
стражу	стражу
излить	излить
возливайте	возливайте
напился	напился
проклят	проклят
взывали	взывали
отпирали	отпирали
поступите	поступите
отправлять	отправлять
мучился	мучился
выбросите	выбросите
голодные	голодные
роптали	роптали
растили	растили
тайна	тайна
нечистым	нечистым
заговорит	заговорит
глухого	глухого
святом	святом
постыдить	постыдить
души	души
опустошили	опустошили
хранили	хранили
смел	смел
отходит	отходит
воздать	воздать
бесславием	бесславием
рыдать	рыдать
выстроить	выстроить
преданного	преданного
звездах	звездах
укреплять	укреплять
разделите	разделите
подул	подул
высохли	высохли
бесноватые	бесноватые
освободить	освободить
Матери	Матери
числом	числом
удалили	удалили
ободри	ободри
назидайте	назидайте
приготовить	приготовить
произошли	произошли
тысяче	тысяче
большого	большого
убит	убит
проси	проси
простертого	простертого
приехал	приехал
заразою	заразою
твердой	твердой
Христу	Христу
завещал	завещал
города	города
возгласи	возгласи
ничтожество	ничтожество
направить	направить
превратили	превратили
прислуги	прислуги
воззови	воззови
вонзили	вонзили
умилостивился	умилостивился
водить	водить
огорчили	огорчили
владейте	владейте
созрели	созрели
вносите	вносите
отстать	отстать
избранные	избранные
весом	весом
страже	страже
Свой	Свой
почтить	почтить
Возьму	Возьму
отыщи	отыщи
устроила	устроила
разрывают	разрывают
две	две
слушала	слушала
пребывать	пребывать
Твоя	Твоя
тысячу	тысячу
составился	составился
вопить	вопить
порядка	порядка
удивлением	удивлением
предавать	предавать
разрушен	разрушен
богатым	богатым
река	река
победили	победили
неверующие	неверующие
соединился	соединился
оказали	оказали
богатые	богатые
призовем	призовем
строит	строит
сходите	сходите
даровала	даровала
следовать	следовать
целом	целом
служить	служить
написанные	написанные
утешился	утешился
пребыл	пребыл
унывайте	унывайте
нарушить	нарушить
верху	верху
поднято	поднято
фараоном	фараоном
спорили	спорили
искушайте	искушайте
твоем	твоем
чужого	чужого
оных	оных
заперли	заперли
наполнить	наполнить
снисходите	снисходите
сходят	сходят
умножить	умножить
совратили	совратили
поцелуй	поцелуй
хвалился	хвалился
спрашивай	спрашивай
возвести	возвести
опустошить	опустошить
боком	боком
сестре	сестре
Тобой	Тобой
разным	разным
старые	старые
образует	образует
блудодействуя	блудодействуя
приложился	приложился
зла	зла
наг	наг
левый	левый
встречу	встречу
оправдай	оправдай
пол	пол
пасли	пасли
требовать	требовать
порази	порази
воскликнул	воскликнул
судился	судился
столпом	столпом
произноси	произноси
окончили	окончили
всякою	всякою
бросила	бросила
воскликнули	воскликнули
гумном	гумном
осудить	осудить
Царя	Царя
привалив	привалив
вывези	вывези
предавайте	предавайте
опротивел	опротивел
Возьмет	Возьмет
Благ	Благ
извратили	извратили
нечистоте	нечистоте
желать	желать
избирать	избирать
находила	находила
злаков	злаков
узнайте	узнайте
превозмогла	превозмогла
сему	сему
разбит	разбит
проклинали	проклинали
запрудите	запрудите
встревожился	встревожился
этого	этого
наказывали	наказывали
пчеле	пчеле
отвели	отвели
вину	вину
теле	теле
обещали	обещали
противостать	противостать
изблюет	изблюет
налагать	налагать
змея	змея
срамить	срамить
овладеть	овладеть
избранный	избранный
раба	раба
твердые	твердые
жилищ	жилищ
мозгом	мозгом
губили	губили
спали	спали
отводили	отводили
Мою	Мою
делили	делили
падите	падите
заклятого	заклятого
навык	навык
покоился	покоился
красив	красив
воздала	воздала
принесем	принесем
содержите	содержите
отошлите	отошлите
удержи	удержи
бесноватых	бесноватых
воздайте	воздайте
свободным	свободным
стоим	стоим
умалить	умалить
громов	громов
побили	побили
налагала	налагала
передвигает	передвигает
истукан	истукан
мстите	мстите
владычествовали	владычествовали
отвозили	отвозили
соделала	соделала
пророчестве	пророчестве
здании	здании
наставили	наставили
одну	одну
ужина	ужина
побила	побила
Сию	Сию
войске	войске
мухе	мухе
развей	развей
втором	втором
утру	утру
верха	верха
отказывал	отказывал
дали	дали
хромым	хромым
заходи	заходи
утвердился	утвердился
расположи	расположи
послужив	послужив
погребен	погребен
понесло	понесло
разорили	разорили
торгу	торгу
возвысили	возвысили
носильщиками	носильщиками
избавлять	избавлять
сложили	сложили
утопает	утопает
пожалеть	пожалеть
разделить	разделить
Святых	Святых
вес	вес
язвою	язвою
иное	иное
трубить	трубить
Святого	Святого
уразуметь	уразуметь
схоронили	схоронили
повторите	повторите
поняли	поняли
выстрелили	выстрелили
Своем	Своем
червю	червю
чье	чье
унизился	унизился
бил	бил
разные	разные
упоены	упоены
возроптали	возроптали
вывезли	вывезли
языком	языком
приложили	приложили
даруешь	даруешь
почетного	почетного
знакомых	знакомых
труби	труби
ставила	ставила
раздражен	раздражен
почитать	почитать
которое	которое
вспомни	вспомни
смири	смири
поступить	поступить
благовествуй	благовествуй
стерегли	стерегли
прозрел	прозрел
выгнать	выгнать
безумным	безумным
пухла	пухла
которым	которым
необрезанное	необрезанное
темных	темных
помета	помета
отдать	отдать
Вил	Вил
умудрить	умудрить
скрывайте	скрывайте
требовали	требовали
схватить	схватить
умножили	умножили
запрудили	запрудили
сосчитали	сосчитали
согрешить	согрешить
весами	весами
дала	дала
сделанный	сделанный
поручили	поручили
выслушайте	выслушайте
отведите	отведите
разодрали	разодрали
воспитывали	воспитывали
продолжала	продолжала
соделаю	соделаю
произвело	произвело
жертва	жертва
подумайте	подумайте
животные	животные
слове	слове
свитке	свитке
противоречить	противоречить
госпоже	госпоже
отними	отними
потаенного	потаенного
поддерживали	поддерживали
пожелал	пожелал
легкие	легкие
самые	самые
старых	старых
прогони	прогони
исследовали	исследовали
позвать	позвать
сверх	сверх
затворили	затворили
святые	святые
словом	словом
новорожденные	новорожденные
искушать	искушать
попирать	попирать
отмени	отмени
благословляй	благословляй
меньшие	меньшие
Израилевой	Израилевой
протоками	протоками
расположили	расположили
крестишь	крестишь
Бог	Бог
поглотила	поглотила
очисти	очисти
возлюби	возлюби
объедал	объедал
разрывал	разрывал
настаивал	настаивал
исцеляйте	исцеляйте
заключила	заключила
лукавые	лукавые
вскричал	вскричал
искать	искать
Это	Это
дерзновением	дерзновением
разорите	разорите
исполните	исполните
слезу	слезу
молоком	молоком
точиле	точиле
лукавым	лукавым
раздавить	раздавить
кадите	кадите
пою	пою
худ	худ
пробыть	пробыть
деревом	деревом
сокруши	сокруши
покройте	покройте
заключите	заключите
языческой	языческой
Аду	Аду
черного	черного
научен	научен
восходите	восходите
доставляй	доставляй
Возлюбленного	Возлюбленного
внука	внука
травы	травы
одру	одру
странствуйте	странствуйте
письмом	письмом
истощился	истощился
человеческою	человеческою
поручи	поручи
звезде	звезде
областеначальник	областеначальник
вкусили	вкусили
правые	правые
Дан	Дан
собирала	собирала
нерадите	нерадите
ввели	ввели
пали	пали
изменить	изменить
сим	сим
производить	производить
вымерли	вымерли
жемчугом	жемчугом
тысяченачальником	тысяченачальником
полу	полу
зеленого	зеленого
утих	утих
чтили	чтили
поверили	поверили
проводить	проводить
заколения	заколения
завладеть	завладеть
завтрашнему	завтрашнему
Приветствует	Приветствует
женщиною	женщиною
другую	другую
блудодействуют	блудодействуют
пересказали	пересказали
уведомить	уведомить
само	само
завещаю	завещаю
язвы	язвы
прельстился	прельстился
замолчали	замолчали
питали	питали
дало	дало
обручился	обручился
бесовской	бесовской
минуло	минуло
показать	показать
иссох	иссох
домом	домом
Нового	Нового
убогого	убогого
Рабы	Рабы
даем	даем
пожалело	пожалело
жившую	жившую
ходили	ходили
жребием	жребием
наги	наги
сухие	сухие
назвали	назвали
жилищами	жилищами
проклинай	проклинай
скрытых	скрытых
возвращен	возвращен
твой	твой
образ	образ
взалкал	взалкал
самую	самую
следующему	следующему
цели	цели
слышали	слышали
поддерживала	поддерживала
рассмотрите	рассмотрите
возливали	возливали
произносила	произносила
первою	первою
рта	рта
призванный	призванный
похвалить	похвалить
поверить	поверить
были	были
окропили	окропили
уговаривать	уговаривать
будешь	будешь
постигла	постигла
находили	находили
точил	точил
Самого	Самого
искупить	искупить
ослепила	ослепила
Божием	Божием
заняты	заняты
лежите	лежите
благоговеть	благоговеть
вынеси	вынеси
звезд	звезд
Марком	Марком
заколал	заколал
пересказывай	пересказывай
построить	построить
попросили	попросили
нечистоту	нечистоту
несмысленные	несмысленные
завладейте	завладейте
пернатых	пернатых
сознаю	сознаю
шестой	шестой
возлюбленный	возлюбленный
давиром	давиром
оказывали	оказывали
малых	малых
миру	миру
избранным	избранным
лесом	лесом
избивать	избивать
подражали	подражали
сожигания	сожигания
иных	иных
отдали	отдали
внукам	внукам
обладать	обладать
намерены	намерены
птичку	птичку
совратить	совратить
погасить	погасить
обозреть	обозреть
увещевать	увещевать
Господню	Господню
приблизился	приблизился
обесчестить	обесчестить
золота	золота
своротила	своротила
опротивело	опротивело
любите	любите
литых	литых
начал	начал
вводили	вводили
нерадит	нерадит
крылом	крылом
раскинули	раскинули
начинали	начинали
ночевать	ночевать
тысячах	тысячах
лесах	лесах
приношении	приношении
Знаем	Знаем
козлами	козлами
кормить	кормить
прикрепили	прикрепили
Самом	Самом
слушали	слушали
ослепили	ослепили
разводное	разводное
посылать	посылать
располагая	располагая
терпите	терпите
котлов	котлов
рассмотри	рассмотри
переночевали	переночевали
призванных	призванных
выходишь	выходишь
Ханаанскую	Ханаанскую
изгнать	изгнать
утаить	утаить
приветствуют	приветствуют
среду	среду
одержимый	одержимый
простирать	простирать
перебить	перебить
уведомили	уведомили
откажи	откажи
любимое	любимое
омыть	омыть
благую	благую
пьяных	пьяных
повторился	повторился
разрушить	разрушить
ревнуй	ревнуй
празднуй	празднуй
окружили	окружили
помилуй	помилуй
белый	белый
отважен	отважен
тысячами	тысячами
Мой	Мой
принадлежащие	принадлежащие
оскудели	оскудели
согласные	согласные
припал	припал
украсить	украсить
овце	овце
восклицали	восклицали
тень	тень
эта	эта
чужды	чужды
десятой	десятой
Сделали	Сделали
цвета	цвета
напоены	напоены
вступился	вступился
взывать	взывать
этом	этом
увещевай	увещевай
дерзновении	дерзновении
беременных	беременных
завещевал	завещевал
научить	научить
внушили	внушили
помогите	помогите
узнаю	узнаю
злом	злом
выкупить	выкупить
темным	темным
исчислите	исчислите
служила	служила
вступите	вступите
манною	манною
выказать	выказать
назидая	назидая
совершился	совершился
душе	душе
внушить	внушить
купите	купите
дома	дома
потом	потом
сопровождали	сопровождали
ищи	ищи
простирала	простирала
прогоните	прогоните
найди	найди
рассудили	рассудили
козлу	козлу
одетого	одетого
птенцах	птенцах
Надо	Надо
духовным	духовным
нага	нага
бог	бог
откормленные	откормленные
посетить	посетить
созрела	созрела
избавить	избавить
зиму	зиму
оставляйте	оставляйте
нашли	нашли
предшествовали	предшествовали
внутри	внутри
тестом	тестом
изреки	изреки
передвигай	передвигай
налетели	налетели
обществе	обществе
жабам	жабам
какое	какое
восстал	восстал
поворотили	поворотили
пригласили	пригласили
приклонился	приклонился
мутить	мутить
может	может
злою	злою
лев	лев
расслабленных	расслабленных
преклонился	преклонился
выломали	выломали
открытых	открытых
аспида	аспида
имуществом	имуществом
свитком	свитком
изгонять	изгонять
полагать	полагать
отослали	отослали
посмеянии	посмеянии
кругу	кругу
городом	городом
изгоняли	изгоняли
сам	сам
скакали	скакали
носили	носили
потерпела	потерпела
каждою	каждою
отправили	отправили
нарушали	нарушали
Лазарь	Лазарь
Раба	Раба
шипов	шипов
спросила	спросила
Как	Как
переходи	переходи
изделии	изделии
досадовали	досадовали
награбили	награбили
правосудием	правосудием
точила	точила
коленом	коленом
ждали	ждали
удали	удали
чужую	чужую
первым	первым
Галилейскую	Галилейскую
подумал	подумал
да	да
Реву	Реву
новым	новым
отдайте	отдайте
теснился	теснился
убегу	убегу
Силом	Силом
животного	животного
изливай	изливай
другою	другою
прилагать	прилагать
утомленный	утомленный
встретить	встретить
животное	животное
лишился	лишился
сохраняла	сохраняла
запустении	запустении
помышлять	помышлять
необрезанные	необрезанные
упросить	упросить
прочитать	прочитать
говори	говори
образом	образом
собрали	собрали
плачем	плачем
духи	духи
одинокую	одинокую
мучили	мучили
живого	живого
закричал	закричал
возлюбленные	возлюбленные
воссиять	воссиять
отнятое	отнятое
живом	живом
делали	делали
Твоем	Твоем
тельцам	тельцам
находился	находился
засел	засел
возлюбили	возлюбили
завещевали	завещевали
голов	голов
небом	небом
воссиял	воссиял
потерпели	потерпели
любимы	любимы
переспим	переспим
прилагай	прилагай
обвини	обвини
сокрытые	сокрытые
узнают	узнают
похули	похули
приучили	приучили
славили	славили
страсть	страсть
снохе	снохе
встать	встать
посохом	посохом
положи	положи
корму	корму
самою	самою
окружите	окружите
привозили	привозили
проезжал	проезжал
спорить	спорить
царскою	царскою
аспид	аспид
пленные	пленные
кормили	кормили
смутили	смутили
вооружился	вооружился
уговаривали	уговаривали
неверующая	неверующая
раскрытая	раскрытая
утихли	утихли
написали	написали
отдай	отдай
причинить	причинить
поручите	поручите
ними	ними
похоронить	похоронить
разбудить	разбудить
Какой	Какой
благословить	благословить
Которого	Которого
всходили	всходили
гумне	гумне
простирал	простирал
открытый	открытый
последуй	последуй
отняли	отняли
приготовился	приготовился
Господнем	Господнем
спаси	спаси
соли	соли
Пи	Пи
прославить	прославить
больных	больных
очистим	очистим
Моем	Моем
исправили	исправили
выросли	выросли
разбили	разбили
главы	главы
освободи	освободи
продолжали	продолжали
ревнуйте	ревнуйте
освяти	освяти
выкопали	выкопали
перебили	перебили
согласился	согласился
Сила	Сила
разграбить	разграбить
обновить	обновить
тени	тени
возносить	возносить
отдало	отдало
объявила	объявила
жилищам	жилищам
мыслите	мыслите
мешки	мешки
потонули	потонули
упоминать	упоминать
благословили	благословили
больше	больше
страху	страху
голою	голою
необрезанным	необрезанным
соблюдите	соблюдите
сделало	сделало
наполните	наполните
восстановить	восстановить
пару	пару
восхотели	восхотели
населенные	населенные
Душа	Душа
выводили	выводили
откройте	откройте
исследовать	исследовать
пьяный	пьяный
Мною	Мною
помогали	помогали
имеем	имеем
напоминайте	напоминайте
растерзали	растерзали
променяй	променяй
пьяным	пьяным
Бога	Бога
предупреди	предупреди
тому	тому
началом	началом
Над	Над
давить	давить
надеть	надеть
выполняла	выполняла
смущали	смущали
родить	родить
объяснить	объяснить
жабами	жабами
приказывала	приказывала
окончила	окончила
проклятых	проклятых
отсеки	отсеки
встретила	встретила
беременным	беременным
до	до
губить	губить
топтать	топтать
блаженных	блаженных
могут	могут
нехороша	нехороша
вином	вином
распростерли	распростерли
прославляли	прославляли
целовать	целовать
предавали	предавали
творить	творить
оживляй	оживляй
продолжай	продолжай
объясним	объясним
больные	больные
запрети	запрети
бесчести	бесчести
призвали	призвали
признаю	признаю
глухой	глухой
малый	малый
набрать	набрать
прибавлять	прибавлять
сказывала	сказывала
верующий	верующий
свекровь	свекровь
твои	твои
выводит	выводит
напали	напали
созвали	созвали
сокрытый	сокрытый
продай	продай
онемел	онемел
каждых	каждых
заставить	заставить
изливать	изливать
злословить	злословить
литое	литое
старейшины	старейшины
молодого	молодого
путем	путем
отправляйте	отправляйте
прозрели	прозрели
невежда	невежда
обличать	обличать
сделай	сделай
вспомнили	вспомнили
освети	освети
Богов	Богов
рассеянных	рассеянных
оно	оно
очищали	очищали
бывшая	бывшая
старейшинах	старейшинах
слушай	слушай
почитайте	почитайте
сокрушили	сокрушили
перестали	перестали
щадите	щадите
вноси	вноси
удалить	удалить
познают	познают
одержимая	одержимая
возлюбленного	возлюбленного
Свои	Свои
приложите	приложите
устройством	устройством
удалился	удалился
причинили	причинили
пробыл	пробыл
твердую	твердую
постыдился	постыдился
уходи	уходи
возмутить	возмутить
возвеличить	возвеличить
проводили	проводили
разбился	разбился
роптать	роптать
провозгласили	провозгласили
одинокая	одинокая
печь	печь
Рев	Рев
одолеть	одолеть
превознесем	превознесем
пила	пила
находит	находит
спустила	спустила
скрыли	скрыли
сожигай	сожигай
тверд	тверд
остановить	остановить
красоте	красоте
век	век
аспиды	аспиды
ней	ней
сопровождать	сопровождать
проклинайте	проклинайте
заменим	заменим
благоговели	благоговели
отяжелело	отяжелело
убитой	убитой
языку	языку
проходили	проходили
мной	мной
добычу	добычу
берега	берега
дозволяйте	дозволяйте
простирай	простирай
возложила	возложила
Возлюбленном	Возлюбленном
разговаривали	разговаривали
орудии	орудии
богатый	богатый
утре	утре
окружила	окружила
отменить	отменить
срамили	срамили
умышлять	умышлять
опустили	опустили
скала	скала
преследовали	преследовали
Оно	Оно
мстить	мстить
живым	живым
облаком	облаком
выходили	выходили
Киса	Киса
округ	округ
спасу	спасу
жертвы	жертвы
велик	велик
выбросили	выбросили
убийстве	убийстве
войском	войском
наши	наши
ночных	ночных
возвестили	возвестили
палит	палит
каком	каком
зелени	зелени
худом	худом
отринут	отринут
тысяченачальника	тысяченачальника
приклони	приклони
отходили	отходили
Иудин	Иудин
змей	змей
приносите	приносите
богатых	богатых
срывай	срывай
Ханаанскою	Ханаанскою
наскучил	наскучил
мысли	мысли
отврати	отврати
уговорить	уговорить
села	села
старого	старого
потерянной	потерянной
Израильскою	Израильскою
родился	родился
превозносился	превозносился
пробыли	пробыли
долги	долги
закричали	закричали
Тиром	Тиром
погуби	погуби
звезда	звезда
притвору	притвору
сотворила	сотворила
взыскать	взыскать
глядела	глядела
сожги	сожги
страхом	страхом
жертвам	жертвам
проповедуй	проповедуй
превозмогли	превозмогли
возливала	возливала
устраните	устраните
избили	избили
прям	прям
камнем	камнем
пели	пели
правого	правого
язве	язве
царски	царски
предложила	предложила
левши	левши
побивать	побивать
возлегло	возлегло
вина	вина
переходят	переходят
глухою	глухою
вывез	вывез
прожил	прожил
спешите	спешите
рассеките	рассеките
подложили	подложили
развязать	развязать
поправить	поправить
сироте	сироте
станом	станом
пленила	пленила
Явился	Явился
иные	иные
совершить	совершить
уподобился	уподобился
издерживали	издерживали
имеешь	имеешь
пугать	пугать
добыче	добыче
смешанных	смешанных
желали	желали
моря	моря
мытаря	мытаря
хоронить	хоронить
открытую	открытую
хотят	хотят
глядели	глядели
Моисееву	Моисееву
держи	держи
упросила	упросила
согрешили	согрешили
заходит	заходит
отнятого	отнятого
уду	уду
возврати	возврати
возвратили	возвратили
камнях	камнях
отделился	отделился
немногие	немногие
простить	простить
проток	проток
поставить	поставить
сказывай	сказывай
немало	немало
предсказывали	предсказывали
возлагали	возлагали
подвигли	подвигли
создали	создали
бичом	бичом
Воздайте	Воздайте
нею	нею
всю	всю
грабили	грабили
сами	сами
перемените	перемените
тверды	тверды
пейте	пейте
срывали	срывали
сердечным	сердечным
имеющий	имеющий
даровать	даровать
позвала	позвала
тельцами	тельцами
верхом	верхом
тленным	тленным
исследовал	исследовал
кругом	кругом
глаза	глаза
реки	реки
откормленный	откормленный
разбить	разбить
красного	красного
продали	продали
судили	судили
посрами	посрами
велят	велят
рад	рад
омывать	омывать
Сеном	Сеном
ворон	ворон
колу	колу
всходите	всходите
пустую	пустую
проходите	проходите
вечера	вечера
можете	можете
негодовании	негодовании
отпустить	отпустить
разводить	разводить
убитых	убитых
дщери	дщери
морем	морем
выполнить	выполнить
доходит	доходит
сбить	сбить
избрала	избрала
Стань	Стань
половинах	половинах
стоите	стоите
ввела	ввела
сказывайте	сказывайте
новой	новой
приветствуйте	приветствуйте
открытым	открытым
сходит	сходит
дорогой	дорогой
жилой	жилой
срубите	срубите
нечестием	нечестием
брить	брить
они	они
посох	посох
осветила	осветила
чтить	чтить
невеждам	невеждам
проводите	проводите
умирать	умирать
венца	венца
которая	которая
отпал	отпал
святым	святым
вызывать	вызывать
разграбили	разграбили
схватила	схватила
уверен	уверен
призывайте	призывайте
роста	роста
увеличить	увеличить
смущен	смущен
ненавидели	ненавидели
набрала	набрала
первом	первом
малы	малы
Богу	Богу
возложи	возложи
болотом	болотом
называйте	называйте
воронов	воронов
бабкам	бабкам
воспойте	воспойте
бесноватым	бесноватым
пар	пар
повороти	повороти
чтоб	чтоб
всяком	всяком
белые	белые
дозволяй	дозволяй
сознает	сознает
правых	правых
граде	граде
переходит	переходит
взирали	взирали
закрыли	закрыли
упоминайте	упоминайте
сладкие	сладкие
принимала	принимала
оплакивала	оплакивала
воспитывала	воспитывала
приобрели	приобрели
областеначальники	областеначальники
преследовать	преследовать
отпускайте	отпускайте
Апостол	Апостол
странствующий	странствующий
которой	которой
воздай	воздай
моем	моем
платить	платить
слушающий	слушающий
славила	славила
века	века
наклони	наклони
известить	известить
медлили	медлили
трубили	трубили
будет	будет
удерживай	удерживай
сохранили	сохранили
пчелы	пчелы
шипа	шипа
выполним	выполним
чинили	чинили
хотела	хотела
желчи	желчи
впал	впал
рассеянным	рассеянным
заставили	заставили
другая	другая
выносили	выносили
головы	головы
рождайте	рождайте
ожесточился	ожесточился
соблюди	соблюди
обольстила	обольстила
наполни	наполни
строили	строили
вывело	вывело
открыли	открыли
вредить	вредить
возлагай	возлагай
признают	признают
избрать	избрать
воспела	воспела
вмещала	вмещала
затрубили	затрубили
остановила	остановила
главу	главу
