мухи	мухи
отцов	отцов
благодарив	благодарив
открытым	открытым
доводите	доводите
хранили	хранили
проводят	проводят
устроить	устроить
можем	можем
жала	жала
исходила	исходила
растворить	растворить
согласного	согласного
ходи	ходи
приносили	приносили
весе	весе
преданным	преданным
усилить	усилить
кругом	кругом
расположен	расположен
воле	воле
изменила	изменила
носильщиков	носильщиков
наполняй	наполняй
положить	положить
подарила	подарила
простирает	простирает
стражам	стражам
судите	судите
тесните	тесните
поставили	поставили
Воздайте	Воздайте
божествах	божествах
воронов	воронов
обвини	обвини
варите	варите
пленные	пленные
украсила	украсила
устройством	устройством
верха	верха
поговорить	поговорить
предложи	предложи
пустою	пустою
духам	духам
потаенного	потаенного
имеем	имеем
пишем	пишем
богам	богам
венца	венца
член	член
Иудин	Иудин
считает	считает
уцелел	уцелел
уходили	уходили
занятые	занятые
призраку	призраку
подносили	подносили
теле	теле
злословили	злословили
явить	явить
слушайте	слушайте
голодным	голодным
мысли	мысли
литые	литые
испытывайте	испытывайте
ухом	ухом
слепого	слепого
сынов	сынов
кадить	кадить
вывело	вывело
Хвали	Хвали
одетый	одетый
рыдать	рыдать
хулили	хулили
заразы	заразы
умертвить	умертвить
белые	белые
возвестим	возвестим
ослабело	ослабело
зла	зла
бабки	бабки
заключить	заключить
окружили	окружили
помнили	помнили
свободные	свободные
пленили	пленили
рабу	рабу
тьма	тьма
иные	иные
Соляную	Соляную
противоречить	противоречить
поспешили	поспешили
покрой	покрой
малые	малые
тверда	тверда
разрешите	разрешите
научен	научен
восстановили	восстановили
доводить	доводить
подносят	подносят
пары	пары
укрепите	укрепите
сладкого	сладкого
приняло	приняло
постиг	постиг
подумали	подумали
подняло	подняло
ела	ела
отворили	отворили
крыле	крыле
поручи	поручи
поручили	поручили
слушали	слушали
затрубите	затрубите
учите	учите
обновить	обновить
горькие	горькие
творить	творить
защищать	защищать
Возлюбленный	Возлюбленный
погубите	погубите
Возлюбленного	Возлюбленного
ослепили	ослепили
темным	темным
ртом	ртом
сотворили	сотворили
выведите	выведите
воспой	воспой
сердечною	сердечною
оставляй	оставляй
подтвердили	подтвердили
морем	морем
выливайте	выливайте
растить	растить
обратите	обратите
постановить	постановить
сказывала	сказывала
велико	велико
молодую	молодую
познала	познала
больным	больным
малы	малы
голубой	голубой
делить	делить
меньше	меньше
оценить	оценить
возвысили	возвысили
унывали	унывали
возлюбленном	возлюбленном
лице	лице
искусить	искусить
разрушен	разрушен
убогие	убогие
злак	злак
виден	виден
Силе	Силе
ростом	ростом
освятите	освятите
беременною	беременною
напоминай	напоминай
обитать	обитать
брани	брани
обгорело	обгорело
кадили	кадили
безумных	безумных
голою	голою
пьющий	пьющий
откройте	откройте
сосчитать	сосчитать
узнаем	узнаем
пощади	пощади
открой	открой
пьем	пьем
божества	божества
наполняйте	наполняйте
гусенице	гусенице
чада	чада
говорила	говорила
мозгом	мозгом
гумне	гумне
заключила	заключила
побить	побить
чужой	чужой
попроси	попроси
помета	помета
поникла	поникла
ужин	ужин
отходить	отходить
поддерживайте	поддерживайте
страха	страха
грешить	грешить
отвозят	отвозят
помнила	помнила
лицу	лицу
жали	жали
Новы	Новы
переходишь	переходишь
торжествующий	торжествующий
завладеть	завладеть
уходят	уходят
исчислите	исчислите
умер	умер
божеству	божеству
исполняй	исполняй
всходили	всходили
искупи	искупи
берега	берега
оном	оном
лицами	лицами
посылать	посылать
сатаною	сатаною
царскою	царскою
носился	носился
снега	снега
любимы	любимы
любим	любим
держи	держи
первым	первым
гола	гола
счетом	счетом
чужого	чужого
случай	случай
похоронили	похоронили
язве	язве
подняли	подняли
мозгов	мозгов
слепым	слепым
благодарить	благодарить
сокрушить	сокрушить
ожесточили	ожесточили
обходили	обходили
столах	столах
щади	щади
умирали	умирали
затворила	затворила
саранча	саранча
сирота	сирота
поместить	поместить
кадите	кадите
вступить	вступить
остановила	остановила
царях	царях
доброю	доброю
моря	моря
письме	письме
хранить	хранить
сади	сади
напоены	напоены
жабах	жабах
мстить	мстить
помышлять	помышлять
восхвалили	восхвалили
свари	свари
расти	расти
помилуй	помилуй
первых	первых
громов	громов
называйте	называйте
погребен	погребен
язвы	язвы
замерло	замерло
говорить	говорить
предложила	предложила
известите	известите
почитайте	почитайте
наклони	наклони
онемел	онемел
умертви	умертви
ночного	ночного
тысячам	тысячам
тестом	тестом
живою	живою
рогом	рогом
жертву	жертву
простирай	простирай
хвалился	хвалился
находили	находили
вопрошающий	вопрошающий
тьме	тьме
Иудиной	Иудиной
славословили	славословили
щадите	щадите
труби	труби
всходите	всходите
имеют	имеют
выслушайте	выслушайте
убогого	убогого
лежите	лежите
научили	научили
скрепите	скрепите
проклинайте	проклинайте
истребили	истребили
отпускайте	отпускайте
исправили	исправили
животного	животного
имеющий	имеющий
сохранить	сохранить
душа	душа
онемело	онемело
проводить	проводить
медлить	медлить
положили	положили
выговори	выговори
искусили	искусили
мытарь	мытарь
прикрепи	прикрепи
твердо	твердо
засохла	засохла
родила	родила
отпусти	отпусти
сестры	сестры
разорили	разорили
талант	талант
звезда	звезда
внуки	внуки
прочитай	прочитай
добра	добра
пересчитайте	пересчитайте
отпустить	отпустить
хотят	хотят
любили	любили
суди	суди
восстал	восстал
любимый	любимый
открывать	открывать
обличить	обличить
звезд	звезд
петли	петли
бабке	бабке
фараона	фараона
богатые	богатые
дух	дух
порази	порази
заговоришь	заговоришь
унывать	унывать
вышли	вышли
варили	варили
защитить	защитить
хромого	хромого
велик	велик
рождайте	рождайте
отошли	отошли
посмотри	посмотри
белом	белом
наследуйте	наследуйте
бросили	бросили
глухого	глухого
обгорел	обгорел
засевай	засевай
приклонили	приклонили
цвете	цвете
благовествуйте	благовествуйте
отходите	отходите
дереве	дереве
бесноватого	бесноватого
бока	бока
веруйте	веруйте
управляем	управляем
вина	вина
вороны	вороны
заставили	заставили
богу	богу
страсть	страсть
встретила	встретила
странствующий	странствующий
причинили	причинили
собранным	собранным
заходит	заходит
возросло	возросло
простирали	простирали
отправляйте	отправляйте
сходить	сходить
половине	половине
другом	другом
была	была
судили	судили
положила	положила
желай	желай
развалинами	развалинами
исполнили	исполнили
находить	находить
раба	раба
напоминайте	напоминайте
убийцы	убийцы
Велика	Велика
немых	немых
злаков	злаков
разрушить	разрушить
поверить	поверить
попросили	попросили
явили	явили
снохе	снохе
посрамить	посрамить
козлов	козлов
строят	строят
называли	называли
уха	уха
возливайте	возливайте
красных	красных
столп	столп
содержите	содержите
почтили	почтили
удерживали	удерживали
свои	свои
прямой	прямой
связанных	связанных
отступите	отступите
тьму	тьму
убитого	убитого
считал	считал
прямою	прямою
возвысить	возвысить
молоком	молоком
уведомили	уведомили
узнает	узнает
утопает	утопает
сухие	сухие
навестить	навестить
камню	камню
прославили	прославили
подкрепите	подкрепите
выходят	выходят
звезду	звезду
ждали	ждали
проклятые	проклятые
обитая	обитая
вызывающий	вызывающий
замолчи	замолчи
приучила	приучила
совершите	совершите
уразумели	уразумели
повредили	повредили
глухие	глухие
заняты	заняты
жертвы	жертвы
доносят	доносят
простирал	простирал
бедный	бедный
считай	считай
называй	называй
желало	желало
родившая	родившая
изменит	изменит
блага	блага
расслабленные	расслабленные
охраняйте	охраняйте
сказывать	сказывать
граде	граде
Галилейскую	Галилейскую
жребии	жребии
славила	славила
исцеляла	исцеляла
родословных	родословных
снисходите	снисходите
озером	озером
выведи	выведи
белою	белою
открывай	открывай
наполняло	наполняло
принесло	принесло
трубить	трубить
левою	левою
утром	утром
переходит	переходит
превозносите	превозносите
выпал	выпал
вскормила	вскормила
потекло	потекло
бесовскую	бесовскую
семейством	семейством
рождала	рождала
матери	матери
граду	граду
обладайте	обладайте
отошлите	отошлите
умерщвляй	умерщвляй
окропили	окропили
просили	просили
заходить	заходить
второй	второй
весами	весами
глазом	глазом
убитых	убитых
сделайте	сделайте
исполнить	исполнить
мешки	мешки
продолжай	продолжай
красные	красные
молодым	молодым
главным	главным
таланту	таланту
рассеянных	рассеянных
заключи	заключи
потаенные	потаенные
удерживать	удерживать
онемеешь	онемеешь
крестишь	крестишь
звезде	звезде
слушала	слушала
новых	новых
приветствуйте	приветствуйте
проповедуйте	проповедуйте
Матерь	Матерь
заколите	заколите
одержимая	одержимая
напасти	напасти
людях	людях
ходить	ходить
запрети	запрети
дворе	дворе
снегу	снегу
обветшало	обветшало
охраняющий	охраняющий
лукавым	лукавым
взяли	взяли
выносите	выносите
силу	силу
объясним	объясним
Матери	Матери
очистим	очистим
целого	целого
одержимого	одержимого
пали	пали
богатым	богатым
замесила	замесила
любимым	любимым
кадила	кадила
буду	буду
огорчили	огорчили
поднять	поднять
осудить	осудить
раздели	раздели
наступить	наступить
рассеянного	рассеянного
дали	дали
оскудела	оскудела
венце	венце
празднуй	празднуй
сравнить	сравнить
аспидом	аспидом
приветствуете	приветствуете
поясом	поясом
обольстили	обольстили
подложили	подложили
исцеляйте	исцеляйте
пойте	пойте
вину	вину
морскую	морскую
познаю	познаю
порядка	порядка
гордо	гордо
мешке	мешке
мечу	мечу
избранная	избранная
носильщиками	носильщиками
подними	подними
Слове	Слове
онемеют	онемеют
ожесточи	ожесточи
лесом	лесом
построили	построили
языческую	языческую
манны	манны
погрешите	погрешите
огорчен	огорчен
покрою	покрою
строить	строить
наставили	наставили
принят	принят
пути	пути
устрашили	устрашили
исчисли	исчисли
отступить	отступить
бога	бога
благи	благи
предупредили	предупредили
передвигай	передвигай
старейшинах	старейшинах
пленила	пленила
возьмешь	возьмешь
отдайте	отдайте
переходите	переходите
живые	живые
голове	голове
кончили	кончили
выдавай	выдавай
служили	служили
счету	счету
духовным	духовным
весом	весом
знакомые	знакомые
выросло	выросло
лукавый	лукавый
был	был
звездах	звездах
целую	целую
сироте	сироте
волах	волах
молодом	молодом
пленный	пленный
устрашить	устрашить
выводили	выводили
строит	строит
разбирать	разбирать
служите	служите
поверили	поверили
грабить	грабить
думали	думали
столпе	столпе
скот	скот
покрывал	покрывал
заключен	заключен
поглотила	поглотила
выбросить	выбросить
засохло	засохло
сохрани	сохрани
рассеянным	рассеянным
возносите	возносите
головою	головою
удалите	удалите
реки	реки
испытанный	испытанный
мучила	мучила
разложили	разложили
половиною	половиною
смешанная	смешанная
ставить	ставить
случая	случая
срубите	срубите
искала	искала
возрос	возрос
смешанного	смешанного
вложили	вложили
принята	принята
убедили	убедили
разить	разить
населенный	населенный
растили	растили
столпом	столпом
познай	познай
Приветствует	Приветствует
потекли	потекли
половинах	половинах
сейте	сейте
терпи	терпи
души	души
убедила	убедила
превозмогла	превозмогла
скоту	скоту
льстить	льстить
козлом	козлом
произносили	произносили
сторож	сторож
вытру	вытру
пьяных	пьяных
счете	счете
тысяча	тысяча
святые	святые
возлюбленную	возлюбленную
мертвые	мертвые
разбросали	разбросали
наушник	наушник
убитый	убитый
губить	губить
рассказывайте	рассказывайте
служила	служила
дать	дать
молодые	молодые
объявила	объявила
мертвый	мертвый
худа	худа
обманывай	обманывай
строишь	строишь
Знайте	Знайте
Дан	Дан
служанке	служанке
овладел	овладел
приготовить	приготовить
раздирать	раздирать
выходит	выходит
сладкою	сладкою
сделанный	сделанный
каплет	каплет
дщерь	дщерь
убийце	убийце
червю	червю
сохраните	сохраните
встретить	встретить
поводом	поводом
открытых	открытых
отпускать	отпускать
жили	жили
постигли	постигли
почитаю	почитаю
другого	другого
образом	образом
переменить	переменить
выходишь	выходишь
истребите	истребите
уверен	уверен
ином	ином
новое	новое
реке	реке
черный	черный
расположи	расположи
низложить	низложить
затыкали	затыкали
сделать	сделать
считайте	считайте
собранные	собранные
скорым	скорым
рассудили	рассудили
возлег	возлег
выполнить	выполнить
сделало	сделало
ищем	ищем
пленных	пленных
избавляйте	избавляйте
уцелело	уцелело
купили	купили
душе	душе
жилищах	жилищах
лев	лев
поступите	поступите
тленным	тленным
войском	войском
животные	животные
иных	иных
преступили	преступили
окружите	окружите
воронам	воронам
Галилейской	Галилейской
усилили	усилили
передвигает	передвигает
человеческую	человеческую
направили	направили
замедли	замедли
соляною	соляною
воздайте	воздайте
устраните	устраните
заходи	заходи
признаешь	признаешь
перебить	перебить
пророчеством	пророчеством
обходить	обходить
ослабела	ослабела
узнаете	узнаете
пожалеть	пожалеть
учили	учили
рассеянный	рассеянный
успокоили	успокоили
простертая	простертая
жаб	жаб
сторожа	сторожа
искушайте	искушайте
язвами	язвами
жила	жила
множеством	множеством
бить	бить
раскрыли	раскрыли
Может	Может
большой	большой
сей	сей
ослепить	ослепить
отходит	отходит
мстили	мстили
Царя	Царя
доводит	доводит
возвестили	возвестили
помнить	помнить
глухой	глухой
темных	темных
обгорелою	обгорелою
проходит	проходит
рассудите	рассудите
стоишь	стоишь
твори	твори
согрешите	согрешите
сделанным	сделанным
составили	составили
неверующая	неверующая
повторите	повторите
пара	пара
одержимый	одержимый
сними	сними
извести	извести
владейте	владейте
живая	живая
води	води
поговорив	поговорив
ослепила	ослепила
снисходить	снисходить
мечи	мечи
аспидов	аспидов
завещаю	завещаю
рабы	рабы
унизить	унизить
золота	золота
последуй	последуй
свободных	свободных
превозмогло	превозмогло
рулем	рулем
благом	благом
правый	правый
благовествуй	благовествуй
одетого	одетого
делили	делили
стояла	стояла
окончила	окончила
пола	пола
путем	путем
бесчести	бесчести
возросли	возросли
померкли	померкли
свекрови	свекрови
желчи	желчи
родили	родили
похитила	похитила
образ	образ
овну	овну
напасть	напасть
дозволяй	дозволяй
легкое	легкое
сосчитай	сосчитай
тварь	тварь
признать	признать
удержи	удержи
будете	будете
осветила	осветила
заключите	заключите
провозгласить	провозгласить
удержали	удержали
выслушали	выслушали
крыло	крыло
отходят	отходят
произносить	произносить
жилищу	жилищу
слушало	слушало
увеличить	увеличить
остановили	остановили
привалите	привалите
Святого	Святого
воссияло	воссияло
обманывайте	обманывайте
познаем	познаем
потаенных	потаенных
приступить	приступить
примером	примером
наследует	наследует
наши	наши
поднял	поднял
служи	служи
изменить	изменить
Христов	Христов
твердых	твердых
грабили	грабили
оставлять	оставлять
очисти	очисти
черным	черным
поворотить	поворотить
черту	черту
возвратите	возвратите
опустошить	опустошить
теснили	теснили
смирить	смирить
царски	царски
воздух	воздух
прибыл	прибыл
приносила	приносила
пили	пили
управляй	управляй
перехватите	перехватите
отдали	отдали
избавлять	избавлять
скорую	скорую
обложи	обложи
могла	могла
выдавали	выдавали
изнеженных	изнеженных
проводите	проводите
поникло	поникло
располагает	располагает
разит	разит
собирала	собирала
одушевленных	одушевленных
кормите	кормите
путевые	путевые
уходить	уходить
совершить	совершить
малое	малое
славить	славить
осквернили	осквернили
думайте	думайте
сироту	сироту
защити	защити
смотрите	смотрите
увеличили	увеличили
выбрасывать	выбрасывать
стеснили	стеснили
почиешь	почиешь
восстать	восстать
снабди	снабди
главные	главные
оробел	оробел
образует	образует
насади	насади
саранчи	саранчи
бичом	бичом
могут	могут
страшных	страшных
уговори	уговори
проси	проси
отправляли	отправляли
возлегли	возлегли
нага	нага
почти	почти
образе	образе
первое	первое
схватила	схватила
насадила	насадила
устроен	устроен
посылайте	посылайте
перебило	перебило
обличи	обличи
наполняла	наполняла
посвятите	посвятите
цари	цари
доставить	доставить
родит	родит
считают	считают
простите	простите
спорить	спорить
похитили	похитили
светили	светили
познайте	познайте
облегчить	облегчить
согласные	согласные
прославить	прославить
преданный	преданный
исполни	исполни
пребывать	пребывать
мала	мала
разделить	разделить
оставляйте	оставляйте
дай	дай
даем	даем
презирать	презирать
развалиною	развалиною
переносим	переносим
отринут	отринут
созывать	созывать
опустошен	опустошен
смири	смири
схватить	схватить
рада	рада
хулить	хулить
Ханаанскую	Ханаанскую
поноси	поноси
пояса	пояса
проток	проток
свитком	свитком
населенные	населенные
раскрытую	раскрытую
нечистоту	нечистоту
построить	построить
крылом	крылом
платить	платить
осквернила	осквернила
воскури	воскури
простертого	простертого
посохом	посохом
подвиг	подвиг
смутили	смутили
истребила	истребила
Иудину	Иудину
точиле	точиле
тысячи	тысячи
расслабленным	расслабленным
прямые	прямые
доходит	доходит
черта	черта
проклинать	проклинать
горд	горд
переносить	переносить
Души	Души
богатый	богатый
чужое	чужое
составить	составить
страсти	страсти
скрытых	скрытых
немым	немым
искали	искали
отяжелело	отяжелело
судить	судить
налагай	налагай
кормила	кормила
сходили	сходили
принятые	принятые
потускли	потускли
открывайте	открывайте
пролили	пролили
животное	животное
верх	верх
кругу	кругу
соверши	соверши
возливали	возливали
мертвых	мертвых
сокрытые	сокрытые
посвятили	посвятили
черные	черные
познают	познают
убитой	убитой
вымойте	вымойте
мужчины	мужчины
правою	правою
посвяти	посвяти
леса	леса
левша	левша
отмени	отмени
мертво	мертво
накорми	накорми
иссохло	иссохло
Рев	Рев
горькая	горькая
истукан	истукан
благословляли	благословляли
оробели	оробели
Воздай	Воздай
возлюбленный	возлюбленный
славили	славили
вспомнили	вспомнили
добыче	добыче
цвета	цвета
права	права
устройстве	устройстве
пронзить	пронзить
ночное	ночное
возлюбленного	возлюбленного
простить	простить
рассуди	рассуди
простирать	простирать
разные	разные
худ	худ
возьмет	возьмет
носить	носить
налагать	налагать
приклони	приклони
провозгласите	провозгласите
защищайте	защищайте
страшного	страшного
распознаем	распознаем
изливать	изливать
Свою	Свою
Жертва	Жертва
твердое	твердое
молока	молока
расположите	расположите
доставили	доставили
умирать	умирать
домом	домом
подражайте	подражайте
померк	померк
купи	купи
упоминать	упоминать
проходили	проходили
судился	судился
перебили	перебили
выступите	выступите
предложили	предложили
приветствуют	приветствуют
утаили	утаили
святую	святую
поносили	поносили
жару	жару
веса	веса
вкусили	вкусили
засохли	засохли
покрова	покрова
рака	рака
вечером	вечером
большую	большую
двором	двором
принять	принять
любимая	любимая
рассказывай	рассказывай
пчеле	пчеле
Велик	Велик
возьмете	возьмете
воспитывала	воспитывала
мертвою	мертвою
произносите	произносите
жернов	жернов
палит	палит
превозмогли	превозмогли
производить	производить
избранным	избранным
старых	старых
умерло	умерло
страхе	страхе
лица	лица
гумном	гумном
Велики	Велики
получила	получила
сухая	сухая
соедини	соедини
голосом	голосом
снохи	снохи
забытых	забытых
манна	манна
даруй	даруй
отними	отними
взяло	взяло
возложите	возложите
чужом	чужом
вторых	вторых
учи	учи
среду	среду
прибыла	прибыла
пребывали	пребывали
избило	избило
дал	дал
проклятую	проклятую
Мою	Мою
стеснен	стеснен
медлили	медлили
овцою	овцою
пасли	пасли
гвозди	гвозди
Бог	Бог
проходить	проходить
уведомить	уведомить
сказала	сказала
привалив	привалив
ожесточите	ожесточите
посети	посети
сказало	сказало
черных	черных
имущества	имущества
ничтожество	ничтожество
богами	богами
гордою	гордою
мало	мало
убитые	убитые
оставить	оставить
доставляй	доставляй
старою	старою
схватили	схватили
изливали	изливали
страдать	страдать
влекло	влекло
принеси	принеси
тверд	тверд
святом	святом
своем	своем
пожалуйте	пожалуйте
украсить	украсить
торжествуйте	торжествуйте
стояло	стояло
пустую	пустую
одолели	одолели
чудных	чудных
раскрыла	раскрыла
проходи	проходи
уповайте	уповайте
заходят	заходят
проходила	проходила
желающий	желающий
пьяною	пьяною
сверкающий	сверкающий
овнов	овнов
нашу	нашу
духу	духу
молили	молили
собирали	собирали
познать	познать
посылала	посылала
собирай	собирай
болоте	болоте
умножила	умножила
красоту	красоту
шестом	шестом
принесем	принесем
воспитанные	воспитанные
утих	утих
вытащить	вытащить
похоронен	похоронен
страхом	страхом
торга	торга
тельцам	тельцам
Силом	Силом
саранчу	саранчу
затыкает	затыкает
козлам	козлам
начинай	начинай
отложи	отложи
хромые	хромые
посадите	посадите
неверующие	неверующие
язв	язв
будут	будут
подражали	подражали
жало	жало
вытащили	вытащили
помни	помни
сухой	сухой
превратили	превратили
признали	признали
прилагать	прилагать
чадо	чадо
пригласите	пригласите
изменили	изменили
числом	числом
шипа	шипа
производите	производите
переспим	переспим
Израилевой	Израилевой
Слушай	Слушай
имеете	имеете
немые	немые
теснить	теснить
дрогнуло	дрогнуло
неверен	неверен
осадить	осадить
открыто	открыто
ослабевать	ослабевать
распознать	распознать
садился	садился
благотворите	благотворите
правого	правого
пронзила	пронзила
отвори	отвори
мою	мою
возвестить	возвестить
возьму	возьму
открытого	открытого
сокрушили	сокрушили
называть	называть
небом	небом
черви	черви
свободного	свободного
жилищ	жилищ
входите	входите
порядке	порядке
имело	имело
ставили	ставили
святого	святого
провозгласили	провозгласили
предсказывайте	предсказывайте
выкупить	выкупить
немого	немого
замолчали	замолчали
протоками	протоками
быть	быть
переходят	переходят
объявили	объявили
налагайте	налагайте
бедного	бедного
отяжелели	отяжелели
осквернить	осквернить
откормленный	откормленный
видим	видим
обходите	обходите
странствуйте	странствуйте
утомленный	утомленный
уповать	уповать
бела	бела
юношах	юношах
сходим	сходим
жди	жди
немалую	немалую
наложить	наложить
весах	весах
утопать	утопать
послужить	послужить
имеет	имеет
пророчестве	пророчестве
объявить	объявить
допустили	допустили
вороной	вороной
верить	верить
считаете	считаете
уходит	уходит
ослабели	ослабели
гвоздем	гвоздем
наложите	наложите
Богу	Богу
отвалит	отвалит
твердая	твердая
вызывать	вызывать
слепой	слепой
саранчою	саранчою
получили	получили
желчь	желчь
сатана	сатана
вели	вели
сокрытую	сокрытую
старое	старое
теснился	теснился
подкрепи	подкрепи
учился	учился
похвалить	похвалить
возлюбленным	возлюбленным
разводить	разводить
челе	челе
второе	второе
реши	реши
отсеки	отсеки
окружить	окружить
почтить	почтить
благословляйте	благословляйте
забытая	забытая
оставили	оставили
соблюди	соблюди
восклицать	восклицать
влекла	влекла
взял	взял
разреши	разреши
котлом	котлом
большою	большою
пропасть	пропасть
сложи	сложи
восстанови	восстанови
беременным	беременным
сложили	сложили
узнай	узнай
собирать	собирать
полированную	полированную
Был	Был
малом	малом
рои	рои
возвестите	возвестите
срубить	срубить
малого	малого
благослови	благослови
избавить	избавить
намерен	намерен
иссох	иссох
произноси	произноси
отвратите	отвратите
матерях	матерях
соорудили	соорудили
браните	браните
предсказывали	предсказывали
познаешь	познаешь
овладеть	овладеть
беременной	беременной
устав	устав
Хочешь	Хочешь
Благо	Благо
отдало	отдало
созрели	созрели
птенцах	птенцах
возлюбила	возлюбила
возливать	возливать
страшное	страшное
язычески	язычески
скала	скала
открытое	открытое
Богом	Богом
воротился	воротился
козлах	козлах
нагой	нагой
злою	злою
Христа	Христа
садили	садили
поя	поя
отступив	отступив
ослабевайте	ослабевайте
смотри	смотри
берегу	берегу
чужие	чужие
бывшая	бывшая
вытрут	вытрут
благ	благ
возврати	возврати
возлюбите	возлюбите
берег	берег
ставила	ставила
погасить	погасить
поселили	поселили
плачу	плачу
ревнуй	ревнуй
владели	владели
познаете	познаете
поступили	поступили
отличен	отличен
напоен	напоен
Приветствуйте	Приветствуйте
знакомых	знакомых
наложили	наложили
свободный	свободный
покоить	покоить
тысячах	тысячах
повреди	повреди
тени	тени
сотворила	сотворила
полюбила	полюбила
влекли	влекли
призванные	призванные
жилищами	жилищами
пас	пас
будешь	будешь
хвалите	хвалите
пой	пой
узнала	узнала
смешанные	смешанные
переспит	переспит
твердою	твердою
пило	пило
дворами	дворами
срамить	срамить
отыщи	отыщи
твердым	твердым
строили	строили
пролить	пролить
выи	выи
всходить	всходить
поддерживать	поддерживать
известили	известили
богом	богом
приложили	приложили
значила	значила
камни	камни
тельцу	тельцу
точила	точила
приводили	приводили
Мал	Мал
проклятых	проклятых
разори	разори
получите	получите
трубили	трубили
заразою	заразою
внимали	внимали
положите	положите
обнажи	обнажи
поддерживали	поддерживали
рубили	рубили
исполняйте	исполняйте
выстрели	выстрели
переменили	переменили
отсчитайте	отсчитайте
продолжала	продолжала
предали	предали
обольстила	обольстила
признают	признают
расположили	расположили
переходить	переходить
похвалили	похвалили
брака	брака
Апостол	Апостол
восстановим	восстановим
наступили	наступили
началом	началом
весу	весу
принадлежащую	принадлежащую
покрывала	покрывала
скованный	скованный
имея	имея
благословила	благословила
восстановить	восстановить
скале	скале
управлять	управлять
белого	белого
манною	манною
морскою	морскою
горькой	горькой
страху	страху
лишить	лишить
приклонить	приклонить
новым	новым
жилой	жилой
живым	живым
поносить	поносить
прочитать	прочитать
Знаем	Знаем
призванный	призванный
помните	помните
отвален	отвален
приготовили	приготовили
выносит	выносит
дала	дала
подпали	подпали
второго	второго
град	град
смешанное	смешанное
решите	решите
держите	держите
ехидна	ехидна
другие	другие
отделите	отделите
правым	правым
зле	зле
злом	злом
подкрепить	подкрепить
возбудили	возбудили
утаить	утаить
по	по
ворон	ворон
истукану	истукану
знакомого	знакомого
обладать	обладать
втором	втором
гусеницы	гусеницы
мечом	мечом
повороти	повороти
принудили	принудили
иного	иного
пересчитай	пересчитай
продолжали	продолжали
терпим	терпим
разложите	разложите
приводить	приводить
скотом	скотом
снабдили	снабдили
легкие	легкие
разграбили	разграбили
жары	жары
вводите	вводите
невежда	невежда
мой	мой
погуби	погуби
восходите	восходите
велите	велите
отлучите	отлучите
хочу	хочу
сделанной	сделанной
отложите	отложите
любила	любила
посрами	посрами
пожалуй	пожалуй
хочет	хочет
пожалел	пожалел
подпал	подпал
окончи	окончи
отсчитай	отсчитай
молодой	молодой
открытый	открытый
одолела	одолела
смешанный	смешанный
заставить	заставить
любите	любите
подумал	подумал
смели	смели
вылитых	вылитых
Словом	Словом
избранный	избранный
учить	учить
сатане	сатане
злодейством	злодейством
призывать	призывать
чужую	чужую
нечистых	нечистых
небе	небе
скалу	скалу
успокоить	успокоить
возбудить	возбудить
почитай	почитай
Начало	Начало
берем	берем
обрати	обрати
преданного	преданного
изгоняли	изгоняли
принято	принято
вином	вином
отлучить	отлучить
рубите	рубите
потускло	потускло
утвердить	утвердить
узнаю	узнаю
дорогою	дорогою
лишили	лишили
главных	главных
поступив	поступив
котлов	котлов
запретить	запретить
похулили	похулили
вопрошали	вопрошали
больше	больше
тысячами	тысячами
ступили	ступили
сходила	сходила
оказывай	оказывай
обольстить	обольстить
золотою	золотою
лицом	лицом
помышляйте	помышляйте
одинокую	одинокую
иссохли	иссохли
кричите	кричите
вкусите	вкусите
льстили	льстили
творите	творите
владеть	владеть
поспешите	поспешите
проходишь	проходишь
затворите	затворите
воплем	воплем
нечистым	нечистым
Слушайте	Слушайте
аспиды	аспиды
заплати	заплати
платили	платили
языческой	языческой
распознает	распознает
приносить	приносить
выкупи	выкупи
раздирающий	раздирающий
исполните	исполните
местом	местом
Духа	Духа
окружила	окружила
приложить	приложить
дало	дало
проходите	проходите
узнайте	узнайте
убеди	убеди
бесноватым	бесноватым
бог	бог
занято	занято
исцелить	исцелить
убила	убила
поставить	поставить
вспомните	вспомните
послужив	послужив
лгали	лгали
осени	осени
связанные	связанные
теста	теста
слеп	слеп
нечистые	нечистые
спешила	спешила
спите	спите
прилагай	прилагай
чудным	чудным
посетили	посетили
отложили	отложили
поразили	поразили
великую	великую
мстите	мстите
услышали	услышали
белых	белых
коленом	коленом
поворотили	поворотили
рад	рад
невеждам	невеждам
овце	овце
значить	значить
пленным	пленным
последовало	последовало
вывели	вывели
вспомнила	вспомнила
оценили	оценили
дополнить	дополнить
замолчу	замолчу
сделали	сделали
твердом	твердом
объявите	объявите
точило	точило
срамили	срамили
Белы	Белы
почетных	почетных
имуществом	имуществом
сердечные	сердечные
принимать	принимать
возливала	возливала
подарили	подарили
требуй	требуй
пред	пред
открыт	открыт
вечере	вечере
глаза	глаза
исполнила	исполнила
зло	зло
пример	пример
вступите	вступите
посадить	посадить
роста	роста
захватить	захватить
долги	долги
сокрытый	сокрытый
молодых	молодых
превозносили	превозносили
наступите	наступите
одинокою	одинокою
верху	верху
покройте	покройте
желала	желала
взяла	взяла
исправить	исправить
схватите	схватите
опьянейте	опьянейте
плачем	плачем
отводит	отводит
ради	ради
изгоняйте	изгоняйте
поставила	поставила
чад	чад
отведи	отведи
обитали	обитали
Апостолом	Апостолом
молчали	молчали
Святом	Святом
попускаете	попускаете
поглотить	поглотить
избранных	избранных
ходили	ходили
снегом	снегом
избранное	избранное
облаком	облаком
вопросить	вопросить
язва	язва
рыдали	рыдали
осади	осади
благодарите	благодарите
блудила	блудила
неверных	неверных
благословляй	благословляй
отдать	отдать
половину	половину
низринут	низринут
рак	рак
козлами	козлами
вышло	вышло
проклят	проклят
любимую	любимую
возбудите	возбудите
святой	святой
налагала	налагала
блаженного	блаженного
вторым	вторым
придворным	придворным
испытанных	испытанных
рубить	рубить
целых	целых
оказывали	оказывали
встретили	встретили
глазу	глазу
мои	мои
открытой	открытой
скрепить	скрепить
лежали	лежали
любимой	любимой
блуди	блуди
сохранили	сохранили
положен	положен
узнать	узнать
соблазнить	соблазнить
морю	морю
временное	временное
облегчи	облегчи
временные	временные
выходить	выходить
замер	замер
предавала	предавала
могу	могу
сердечным	сердечным
замечать	замечать
освети	освети
поправили	поправили
велишь	велишь
святых	святых
фараон	фараон
золотого	золотого
мучили	мучили
бел	бел
телом	телом
убийцу	убийцу
согрешили	согрешили
утре	утре
пить	пить
растворила	растворила
сирот	сирот
мучить	мучить
бесчестите	бесчестите
Духом	Духом
смешанною	смешанною
затворит	затворит
убийца	убийца
свитке	свитке
последовала	последовала
войска	войска
научите	научите
воскурить	воскурить
горды	горды
подложи	подложи
приветствующий	приветствующий
отходили	отходили
язык	язык
пища	пища
останови	останови
бедных	бедных
продолжало	продолжало
грешите	грешите
исследуй	исследуй
простираете	простираете
заклятым	заклятым
отведите	отведите
возьмут	возьмут
Приветствуй	Приветствуй
тьмы	тьмы
разбросайте	разбросайте
объясни	объясни
убит	убит
утвердите	утвердите
обвинить	обвинить
купила	купила
Будут	Будут
дороге	дороге
подвигли	подвигли
получить	получить
выносили	выносили
сознаю	сознаю
переноси	переноси
свекровь	свекровь
отдала	отдала
Благ	Благ
обнажен	обнажен
голодные	голодные
выросли	выросли
удерживай	удерживай
намерены	намерены
тельца	тельца
вари	вари
погасили	погасили
велят	велят
сокруши	сокруши
носите	носите
повод	повод
простертой	простертой
возлюбленных	возлюбленных
садить	садить
имеешь	имеешь
языке	языке
отходила	отходила
смутить	смутить
попускал	попускал
отяготили	отяготили
восклицайте	восклицайте
воссиял	воссиял
восхвалите	восхвалите
страже	страже
крестит	крестит
пернатых	пернатых
Духу	Духу
безумным	безумным
светить	светить
мутить	мутить
Дух	Дух
вин	вин
ночных	ночных
первого	первого
лиц	лиц
дома	дома
Израильской	Израильской
посадили	посадили
животных	животных
первом	первом
дайте	дайте
глухою	глухою
поразить	поразить
красного	красного
заплатили	заплатили
осмоли	осмоли
благодарили	благодарили
возгласи	возгласи
обществе	обществе
большая	большая
выходи	выходи
изливайте	изливайте
войске	войске
соляным	соляным
опусти	опусти
узнают	узнают
строим	строим
приняты	приняты
спешите	спешите
тьмою	тьмою
вредить	вредить
внушили	внушили
ходите	ходите
Израилеву	Израилеву
наклонили	наклонили
приветствуй	приветствуй
рога	рога
побила	побила
пророчествуй	пророчествуй
напоили	напоили
заклятого	заклятого
золотом	золотом
исходит	исходит
голоса	голоса
округа	округа
честным	честным
испортили	испортили
находился	находился
покоился	покоился
страшился	страшился
дрогнули	дрогнули
скрытое	скрытое
одержимых	одержимых
Сеном	Сеном
жертвах	жертвах
вводили	вводили
неверным	неверным
почитают	почитают
Тиром	Тиром
душу	душу
похороните	похороните
осадили	осадили
Тем	Тем
соединить	соединить
жемчуга	жемчуга
меча	меча
прогони	прогони
призванным	призванным
точил	точил
каплют	каплют
беременные	беременные
слышали	слышали
отступили	отступили
слепые	слепые
призывали	призывали
избранной	избранной
век	век
пригласи	пригласи
соблазнили	соблазнили
провозгласи	провозгласи
разгласите	разгласите
Реву	Реву
шипов	шипов
родить	родить
красота	красота
Царю	Царю
округ	округ
исполним	исполним
принудить	принудить
внукам	внукам
очистить	очистить
одру	одру
освободить	освободить
расслабленный	расслабленный
обратила	обратила
обратили	обратили
обнови	обнови
откормленного	откормленного
шестой	шестой
содержали	содержали
убили	убили
Свои	Свои
исходят	исходят
томить	томить
разорить	разорить
саранче	саранче
целом	целом
поешь	поешь
мешка	мешка
сходят	сходят
камнях	камнях
тайны	тайны
погреби	погреби
строила	строила
своя	своя
согрешить	согрешить
нечистота	нечистота
признайте	признайте
померкло	померкло
мехе	мехе
возвести	возвести
одинокая	одинокая
сказали	сказали
прочитайте	прочитайте
любимое	любимое
целое	целое
рули	рули
рабою	рабою
низложи	низложи
обществом	обществом
помилуйте	помилуйте
беременную	беременную
научи	научи
сохраняла	сохраняла
выкупите	выкупите
определить	определить
вырос	вырос
выходим	выходим
узнали	узнали
взывать	взывать
допустила	допустила
имейте	имейте
победили	победили
проводили	проводили
верующий	верующий
злословить	злословить
Можете	Можете
смешанной	смешанной
письмом	письмом
разрушили	разрушили
доставляло	доставляло
устроили	устроили
раздражите	раздражите
разделили	разделили
боком	боком
отправить	отправить
связанного	связанного
замечайте	замечайте
понесли	понесли
купите	купите
половины	половины
предложить	предложить
прилагайте	прилагайте
искушать	искушать
оскудели	оскудели
белым	белым
нечист	нечист
духи	духи
воспоминать	воспоминать
сварите	сварите
сынах	сынах
спешить	спешить
восполнили	восполнили
воздай	воздай
объяснили	объяснили
твердые	твердые
лгите	лгите
мухе	мухе
поступить	поступить
располагая	располагая
отврати	отврати
низком	низком
Христом	Христом
Адам	Адам
тайна	тайна
приступив	приступив
мал	мал
страж	страж
возливай	возливай
поразила	поразила
оскверните	оскверните
серебре	серебре
истребить	истребить
раздражен	раздражен
разгласили	разгласили
отпустили	отпустили
отворить	отворить
облаке	облаке
рассказывали	рассказывали
сходите	сходите
почетном	почетном
Мой	Мой
зимой	зимой
заклятое	заклятое
другой	другой
спасу	спасу
сухою	сухою
сделай	сделай
святая	святая
Будете	Будете
жертве	жертве
веке	веке
слушающий	слушающий
смирите	смирите
брак	брак
озере	озере
духов	духов
выговорить	выговорить
отнимите	отнимите
уразумел	уразумел
полированной	полированной
выходите	выходите
носили	носили
подходите	подходите
навести	навести
ударила	ударила
нем	нем
отворила	отворила
молился	молился
бесчестить	бесчестить
Хочет	Хочет
разбит	разбит
Цари	Цари
понесло	понесло
выстроить	выстроить
чудовище	чудовище
новом	новом
страшные	страшные
признаю	признаю
оказывать	оказывать
снимите	снимите
лесу	лесу
умирающий	умирающий
белый	белый
принимали	принимали
производили	производили
Ханаанскою	Ханаанскою
сосчитайте	сосчитайте
родившие	родившие
Своем	Своем
произносила	произносила
бывшую	бывшую
нечисты	нечисты
великой	великой
созрела	созрела
пол	пол
повис	повис
скалами	скалами
зиму	зиму
разбили	разбили
восстало	восстало
безумные	безумные
поспешив	поспешив
входить	входить
ищи	ищи
освободи	освободи
молила	молила
очистите	очистите
говорили	говорили
головами	головами
выбросите	выбросите
освятили	освятили
разбирайте	разбирайте
сделала	сделала
худом	худом
ведите	ведите
жертвами	жертвами
посвятить	посвятить
преступить	преступить
крестить	крестить
бесноватые	бесноватые
входили	входили
трава	трава
осудили	осудили
месте	месте
соорудить	соорудить
нового	нового
любить	любить
меха	меха
спит	спит
мог	мог
моя	моя
хромым	хромым
лукавых	лукавых
опьянел	опьянел
предупреди	предупреди
напоить	напоить
возложила	возложила
крестился	крестился
огорчить	огорчить
сверкали	сверкали
яме	яме
вложи	вложи
умертвите	умертвите
возносить	возносить
да	да
устроила	устроила
одре	одре
вороти	вороти
смешанных	смешанных
давили	давили
прогоните	прогоните
звездам	звездам
молчите	молчите
пощадили	пощадили
призванных	призванных
овладейте	овладейте
прислуги	прислуги
немало	немало
жертв	жертв
истуканом	истуканом
лишен	лишен
помышляли	помышляли
внука	внука
рассмотрите	рассмотрите
челах	челах
старейшины	старейшины
отыщите	отыщите
право	право
очистили	очистили
сравните	сравните
отцах	отцах
согрешив	согрешив
победит	победит
откормленные	откормленные
человеческою	человеческою
благословили	благословили
повисла	повисла
невежд	невежд
проводив	проводив
смертные	смертные
хромой	хромой
сестре	сестре
родных	родных
превозносился	превозносился
Бога	Бога
избранные	избранные
находит	находит
возбуди	возбуди
избранного	избранного
можешь	можешь
яви	яви
молотить	молотить
возмутить	возмутить
верхом	верхом
Богов	Богов
превратить	превратить
празднуйте	празднуйте
бери	бери
проклинай	проклинай
устранить	устранить
окончили	окончили
просите	просите
укрепили	укрепили
воспойте	воспойте
чтите	чтите
скверною	скверною
изменишь	изменишь
накормили	накормили
сатану	сатану
противоречили	противоречили
жертвам	жертвам
презирали	презирали
нарушить	нарушить
пожалели	пожалели
храните	храните
ворона	ворона
приступили	приступили
вдовою	вдовою
дщери	дщери
Христе	Христе
ужина	ужина
выдать	выдать
открытом	открытом
беременная	беременная
родят	родят
пьяного	пьяного
похорони	похорони
бедные	бедные
доходили	доходили
спали	спали
замеси	замеси
стоят	стоят
иное	иное
бы	бы
уговорить	уговорить
напоминать	напоминать
Мало	Мало
сестрою	сестрою
избили	избили
рабах	рабах
сказывайте	сказывайте
восходить	восходить
страх	страх
остановить	остановить
имущество	имущество
преуспевать	преуспевать
напоила	напоила
раздражили	раздражили
расслабленных	расслабленных
града	града
скоте	скоте
скрытые	скрытые
переходили	переходили
утомленного	утомленного
возьми	возьми
выступив	выступив
сбереги	сбереги
выполняйте	выполняйте
раскрытая	раскрытая
малый	малый
судив	судив
свободным	свободным
отличить	отличить
плечом	плечом
тайною	тайною
долгом	долгом
жертвою	жертвою
новой	новой
головах	головах
проходят	проходят
воплю	воплю
обгорела	обгорела
кому	кому
духом	духом
молоке	молоке
духами	духами
меньшие	меньшие
пила	пила
путевой	путевой
затворили	затворили
переносит	переносит
стражами	стражами
старые	старые
постыди	постыди
искать	искать
посмотрите	посмотрите
восстали	восстали
повредить	повредить
числе	числе
отсчитать	отсчитать
погубили	погубили
поддерживала	поддерживала
большом	большом
страшным	страшным
тысячу	тысячу
посох	посох
низринь	низринь
петля	петля
вес	вес
убить	убить
словом	словом
выполним	выполним
нарушили	нарушили
думать	думать
услышите	услышите
сокрушен	сокрушен
разных	разных
выдай	выдай
бил	бил
палить	палить
ничтожества	ничтожества
беременных	беременных
поцелуй	поцелуй
духовные	духовные
пару	пару
пчелы	пчелы
расспросите	расспросите
сатаны	сатаны
скрытая	скрытая
Буду	Буду
пухла	пухла
скалах	скалах
оных	оных
вела	вела
сказать	сказать
грешили	грешили
медлите	медлите
твердую	твердую
печи	печи
Силу	Силу
портить	портить
вылитая	вылитая
покров	покров
нечистою	нечистою
рождали	рождали
сокройте	сокройте
творили	творили
преуспевайте	преуспевайте
вызывали	вызывали
срубили	срубили
языку	языку
даруешь	даруешь
унизили	унизили
удерживайте	удерживайте
городом	городом
чтить	чтить
скверны	скверны
родишь	родишь
фараоне	фараоне
чудовища	чудовища
замедлить	замедлить
почитает	почитает
тверды	тверды
пою	пою
колене	колене
Святых	Святых
говори	говори
уступили	уступили
кропили	кропили
умножить	умножить
обложили	обложили
привалили	привалили
поселить	поселить
горькою	горькою
хвали	хвали
возложи	возложи
изливай	изливай
добыч	добыч
взывали	взывали
прикрепили	прикрепили
хром	хром
наследуешь	наследуешь
исчислить	исчислить
лукавого	лукавого
выслушать	выслушать
выбрасывайте	выбрасывайте
сознает	сознает
одолеть	одолеть
божество	божество
голодный	голодный
чтили	чтили
упоминайте	упоминайте
торжествуй	торжествуй
закрой	закрой
приклоните	приклоните
строите	строите
малых	малых
переходи	переходи
скал	скал
принесли	принесли
ком	ком
разорите	разорите
прям	прям
вложить	вложить
утверди	утверди
жил	жил
жилищам	жилищам
предавайте	предавайте
исцели	исцели
сходит	сходит
цветами	цветами
деревом	деревом
последуйте	последуйте
разбить	разбить
восполнить	восполнить
приходите	приходите
небольшую	небольшую
скованного	скованного
спросите	спросите
бедным	бедным
засевайте	засевайте
честные	честные
отвозили	отвозили
утвердили	утвердили
желать	желать
Даном	Даном
отводили	отводили
верили	верили
придворных	придворных
возноси	возноси
большого	большого
приходить	приходить
малым	малым
твердой	твердой
направить	направить
губи	губи
богатых	богатых
предавать	предавать
светила	светила
расслабленного	расслабленного
добыча	добыча
построила	построила
литое	литое
сладкие	сладкие
люби	люби
сруби	сруби
звезды	звезды
невежды	невежды
внуши	внуши
язвам	язвам
вопроси	вопроси
утихло	утихло
сварили	сварили
уходи	уходи
внушить	внушить
почетного	почетного
блудили	блудили
мыслить	мыслить
сторожам	сторожам
разным	разным
унывайте	унывайте
молите	молите
кормили	кормили
восстановите	восстановите
пух	пух
населенного	населенного
затворив	затворив
возмутили	возмутили
среды	среды
наги	наги
затрубили	затрубили
подражать	подражать
Бела	Бела
жило	жило
правые	правые
удалили	удалили
Тире	Тире
отвратить	отвратить
литых	литых
могли	могли
иным	иным
утихли	утихли
умертвили	умертвили
отсек	отсек
пищи	пищи
вопрошать	вопрошать
скрывай	скрывай
мытаря	мытаря
искушали	искушали
Раба	Раба
стоите	стоите
преуспевали	преуспевали
Христу	Христу
уразуметь	уразуметь
испытывали	испытывали
покровом	покровом
протяни	протяни
целые	целые
первые	первые
Ком	Ком
духе	духе
похоронить	похоронить
возгласите	возгласите
низкою	низкою
чужая	чужая
родным	родным
счет	счет
почитаете	почитаете
язвою	язвою
говорите	говорите
нечистоте	нечистоте
призрак	призрак
вопросили	вопросили
простираешь	простираешь
проезжая	проезжая
вымой	вымой
подкрепили	подкрепили
творила	творила
Было	Было
госпоже	госпоже
принимала	принимала
выводит	выводит
рыдайте	рыдайте
обветшали	обветшали
лицах	лицах
оставила	оставила
познали	познали
вопросите	вопросите
были	были
любимых	любимых
юноше	юноше
почитал	почитал
старого	старого
освятить	освятить
половина	половина
прислугу	прислугу
налагали	налагали
перемените	перемените
воссиять	воссиять
наступив	наступив
твари	твари
человеческой	человеческой
видите	видите
болотом	болотом
расспроси	расспроси
начало	начало
бросила	бросила
отделить	отделить
благословите	благословите
держу	держу
посылали	посылали
живой	живой
разделите	разделите
потаенном	потаенном
новорожденные	новорожденные
умерщвляйте	умерщвляйте
пухли	пухли
золоте	золоте
сокрой	сокрой
отринь	отринь
Возлюбленном	Возлюбленном
страдающий	страдающий
опустили	опустили
выводить	выводить
второю	второю
хвалить	хвалить
лесах	лесах
сотвори	сотвори
открытою	открытою
бесчестили	бесчестили
рождать	рождать
сказывали	сказывали
начале	начале
убитою	убитою
язву	язву
прямых	прямых
тысяче	тысяче
воспитывали	воспитывали
чудные	чудные
избить	избить
Будет	Будет
доносили	доносили
сложить	сложить
стояли	стояли
возьмем	возьмем
овнами	овнами
сокрытой	сокрытой
красоте	красоте
держали	держали
узнаешь	узнаешь
сухую	сухую
победить	победить
возвестила	возвестила
отяготить	отяготить
трубите	трубите
вине	вине
бросить	бросить
внимайте	внимайте
протоки	протоки
исчислили	исчислили
приучили	приучили
находим	находим
кончен	кончен
бесовской	бесовской
отдели	отдели
уменьшить	уменьшить
разбила	разбила
поразите	поразите
стражи	стражи
Теми	Теми
стражу	стражу
покрывать	покрывать
выливай	выливай
строился	строился
бесноватых	бесноватых
хотите	хотите
подходили	подходили
поту	поту
убитым	убитым
подумайте	подумайте
плече	плече
уставом	уставом
добычу	добычу
прибыли	прибыли
располагал	располагал
укрепить	укрепить
тленного	тленного
губили	губили
приготовила	приготовила
камнем	камнем
нечиста	нечиста
возвратить	возвратить
козлы	козлы
выводи	выводи
берет	берет
возлюбленной	возлюбленной
принимайте	принимайте
вкусить	вкусить
изнеженный	изнеженный
запретили	запретили
приносите	приносите
Нового	Нового
левый	левый
поем	поем
протянут	протянут
небольшой	небольшой
неверные	неверные
храни	храни
подтверди	подтверди
объяви	объяви
возлюбленною	возлюбленною
прикрепила	прикрепила
наг	наг
голов	голов
одушевленное	одушевленное
воспитанный	воспитанный
полюби	полюби
приводите	приводите
Израильскою	Израильскою
спустили	спустили
простирала	простирала
одетые	одетые
худо	худо
камня	камня
презирайте	презирайте
берете	берете
поправить	поправить
фараону	фараону
постанови	постанови
вело	вело
больного	больного
языков	языков
слове	слове
испытанного	испытанного
красоты	красоты
выдавайте	выдавайте
заплатите	заплатите
Богами	Богами
спроси	спроси
утомленных	утомленных
вечера	вечера
Благословите	Благословите
смело	смело
принимай	принимай
объяснить	объяснить
спорили	спорили
добре	добре
козлу	козлу
пропасти	пропасти
будь	будь
Свой	Свой
хочешь	хочешь
столом	столом
помет	помет
осенила	осенила
одет	одет
горькую	горькую
новорожденного	новорожденного
приноси	приноси
почитали	почитали
ночные	ночные
новые	новые
Святым	Святым
приняли	приняли
посвятила	посвятила
литого	литого
Кому	Кому
окончить	окончить
обратить	обратить
жабам	жабам
уходите	уходите
почиет	почиет
богов	богов
смертным	смертным
пригласили	пригласили
убийством	убийством
погрешили	погрешили
благословлять	благословлять
благотворить	благотворить
служить	служить
выстроили	выстроили
умертвила	умертвила
жив	жив
может	может
принесла	принесла
пьяный	пьяный
мыслите	мыслите
зеленого	зеленого
сокрушите	сокрушите
наполнили	наполнили
считаешь	считаешь
выслушай	выслушай
Дина	Дина
ели	ели
мертвым	мертвым
воздать	воздать
навыком	навыком
больные	больные
выступили	выступили
слушай	слушай
стоит	стоит
уступи	уступи
умерли	умерли
восходили	восходили
совершила	совершила
взять	взять
вводить	вводить
скрывала	скрывала
аспида	аспида
головы	головы
траву	траву
слепых	слепых
возлюби	возлюби
Мои	Мои
отменить	отменить
сосчитали	сосчитали
мутите	мутите
веди	веди
открывали	открывали
воздали	воздали
проклятого	проклятого
обветшала	обветшала
выдавать	выдавать
оказывайте	оказывайте
Душа	Душа
исследуйте	исследуйте
черного	черного
изнеженная	изнеженная
отдай	отдай
Моем	Моем
образа	образа
оставляли	оставляли
вскорми	вскорми
добро	добро
царю	царю
завладел	завладел
сотворите	сотворите
множестве	множестве
возлюбленные	возлюбленные
созывайте	созывайте
потом	потом
было	было
определили	определили
проезжал	проезжал
великою	великою
бабкам	бабкам
благословить	благословить
могло	могло
возложить	возложить
мех	мех
просила	просила
Жертвы	Жертвы
золотой	золотой
постигло	постигло
поступи	поступи
образуем	образуем
жабы	жабы
червь	червь
травы	травы
скрывать	скрывать
слушать	слушать
счета	счета
вспомни	вспомни
яму	яму
прямым	прямым
отправлять	отправлять
прости	прости
добром	добром
завладейте	завладейте
приложите	приложите
рассудить	рассудить
долга	долга
поручите	поручите
нагою	нагою
больных	больных
наш	наш
подносить	подносить
послужили	послужили
рабе	рабе
молотили	молотили
призывайте	призывайте
соблюдите	соблюдите
убийц	убийц
наполните	наполните
кормить	кормить
покрывало	покрывало
ждите	ждите
рта	рта
лицо	лицо
вноси	вноси
жабами	жабами
рой	рой
членом	членом
уразумейте	уразумейте
паре	паре
приняла	приняла
выполняла	выполняла
фараонов	фараонов
Благослови	Благослови
смирен	смирен
изгонять	изгонять
смел	смел
умножили	умножили
открытую	открытую
города	города
чужою	чужою
варить	варить
имели	имели
закрою	закрою
сказывай	сказывай
ревнуйте	ревнуйте
будем	будем
отделили	отделили
матерь	матерь
аспид	аспид
возвратили	возвратили
платите	платите
сладкое	сладкое
пребывайте	пребывайте
вытащи	вытащи
госпожи	госпожи
Хвалите	Хвалите
отправили	отправили
били	били
било	било
раздирайте	раздирайте
имевшие	имевшие
разделила	разделила
подняла	подняла
собирайте	собирайте
попускаешь	попускаешь
отвратили	отвратили
мучился	мучился
родословные	родословные
Аду	Аду
лукавые	лукавые
хотим	хотим
венцом	венцом
дорогой	дорогой
давить	давить
переносят	переносят
изнеженную	изнеженную
захватили	захватили
восклицали	восклицали
пернатые	пернатые
пронзили	пронзили
заключили	заключили
протоках	протоках
блаженный	блаженный
тельцами	тельцами
порти	порти
главного	главного
овладели	овладели
золото	золото
садите	садите
Рабы	Рабы
повторили	повторили
века	века
смертного	смертного
можете	можете
выходила	выходила
познает	познает
будет	будет
исходили	исходили
кропить	кропить
пил	пил
пар	пар
преследуй	преследуй
красный	красный
немой	немой
превозносить	превозносить
спаси	спаси
отпустим	отпустим
спорите	спорите
заменили	заменили
язвах	язвах
посетить	посетить
освяти	освяти
пиши	пиши
завладели	завладели
заплатить	заплатить
покрывали	покрывали
спросили	спросили
языком	языком
подтвердить	подтвердить
ударить	ударить
водить	водить
проклинали	проклинали
проклятою	проклятою
вороные	вороные
запрудили	запрудили
нечистой	нечистой
устранили	устранили
возложили	возложили
охраняй	охраняй
запрудите	запрудите
воздала	воздала
уменьши	уменьши
животным	животным
томился	томился
осмолила	осмолила
жребием	жребием
голубого	голубого
уверить	уверить
окропи	окропи
передвигают	передвигают
предавали	предавали
скрывайте	скрывайте
траве	траве
голодного	голодного
сходи	сходи
находила	находила
отсекли	отсекли
последовать	последовать
попросите	попросите
Можешь	Можешь
жилища	жилища
святою	святою
поцелую	поцелую
поднимите	поднимите
левши	левши
пожалело	пожалело
искало	искало
внимать	внимать
находят	находят
благую	благую
бесноватый	бесноватый
возносили	возносили
мужчинах	мужчинах
доставляла	доставляла
удалить	удалить
стража	стража
сохраняйте	сохраняйте
убийстве	убийстве
силе	силе
признает	признает
Дину	Дину
искупить	искупить
проводит	проводит
вносить	вносить
управляющий	управляющий
одетым	одетым
пьяные	пьяные
фараоном	фараоном
перехватили	перехватили
выступить	выступить
Приветствуют	Приветствуют
укрепи	укрепи
последовали	последовали
блаженных	блаженных
жемчугом	жемчугом
желали	желали
завещал	завещал
причинить	причинить
громом	громом
серебром	серебром
искушай	искушай
отделен	отделен
начинали	начинали
захватила	захватила
станом	станом
положи	положи
хромых	хромых
спросила	спросила
наполни	наполни
хулите	хулите
просить	просить
сторожу	сторожу
богатого	богатого
постигла	постигла
моем	моем
пророчествуйте	пророчествуйте
подходить	подходить
благо	благо
возлюбили	возлюбили
слышим	слышим
смертный	смертный
молодая	молодая
вдовы	вдовы
похули	похули
чудное	чудное
пьяным	пьяным
приходили	приходили
птенцов	птенцов
доходила	доходила
возлегло	возлегло
требуйте	требуйте
почитать	почитать
раздражить	раздражить
живых	живых
вы	вы
управляли	управляли
отвалят	отвалят
люди	люди
правых	правых
выбросили	выбросили
злодействе	злодействе
уповали	уповали
белы	белы
знаком	знаком
спросить	спросить
вступили	вступили
порядку	порядку
поникли	поникли
река	река
разрешить	разрешить
начинайте	начинайте
утру	утру
меньшая	меньшая
затворить	затворить
опустошили	опустошили
дозволяйте	дозволяйте
заговорит	заговорит
выпали	выпали
совершили	совершили
бич	бич
духа	духа
наставить	наставить
семействе	семействе
отпустила	отпустила
рассмотри	рассмотри
блудить	блудить
столе	столе
развалинах	развалинах
научить	научить
терпите	терпите
ехидны	ехидны
преследуйте	преследуйте
поручен	поручен
выпало	выпало
купить	купить
кричали	кричали
погубить	погубить
живом	живом
разводите	разводите
спешит	спешит
цвет	цвет
вносите	вносите
собранный	собранный
простертою	простертою
предавай	предавай
святым	святым
обложила	обложила
наушника	наушника
имевшая	имевшая
голодных	голодных
нашем	нашем
считать	считать
сберегите	сберегите
развалинам	развалинам
страшить	страшить
наполнить	наполнить
духовных	духовных
мертвого	мертвого
разграбить	разграбить
блаженным	блаженным
торгу	торгу
Духе	Духе
стоим	стоим
выдайте	выдайте
преступите	преступите
обитаем	обитаем
тысяч	тысяч
тень	тень
живого	живого
растила	растила
страдали	страдали
поместила	поместила
известить	известить
носила	носила
поглотили	поглотили
служанкою	служанкою
ослабеть	ослабеть
проповедуй	проповедуй
известила	известила
взывайте	взывайте
избавили	избавили
воспоминайте	воспоминайте
истреби	истреби
простертым	простертым
похитить	похитить
принадлежащие	принадлежащие
отпустите	отпустите
выходили	выходили
дворах	дворах
спустила	спустила
воздухе	воздухе
наполнила	наполнила
жертва	жертва
молоти	молоти
сокрыт	сокрыт
вредили	вредили
заменим	заменим
накормить	накормить
Моя	Моя
Сене	Сене
тельцов	тельцов
зеленых	зеленых
стану	стану
дополните	дополните
образу	образу
постыдить	постыдить
Боге	Боге
воспитывайте	воспитывайте
жернова	жернова
благе	благе
гусеница	гусеница
градом	градом
побили	побили
навык	навык
молодого	молодого
откормленных	откормленных
Соляной	Соляной
заколи	заколи
жилами	жилами
сердечной	сердечной
печь	печь
ступите	ступите
жилы	жилы
одолело	одолело
Дине	Дине
ворону	ворону
выстрелили	выстрелили
сходишь	сходишь
испортите	испортите
богах	богах
славословить	славословить
Начала	Начала
сироты	сироты
Будь	Будь
царя	царя
