Male	Male
Fetten	Fetten
strecken	strecken
werdet	werdet
Knechten	Knechten
gießest	gießest
Schenke	Schenke
jammerte	jammerte
Diese	Diese
verzehrst	verzehrst
Riese	Riese
kehrte	kehrte
ratschlaget	ratschlaget
stellte	stellte
schreckt	schreckt
steinigest	steinigest
Werde	Werde
glaubest	glaubest
Ihr	Ihr
aufmacht	aufmacht
haderte	haderte
krank	krank
folget	folget
wälzt	wälzt
erfreuest	erfreuest
predigst	predigst
absagen	absagen
Geliebten	Geliebten
machte	machte
gebieten	gebieten
Zäunen	Zäunen
zeugen	zeugen
zeigst	zeigst
gesellt	gesellt
Mäuse	Mäuse
ruhe	ruhe
kehren	kehren
Tier	Tier
Hebe	Hebe
abzieht	abzieht
Biene	Biene
batet	batet
drängten	drängten
bricht	bricht
verderben	verderben
linke	linke
Sei	Sei
trotze	trotze
wünschet	wünschet
springen	springen
weine	weine
stehst	stehst
Armen	Armen
wärst	wärst
Sucht	Sucht
frage	frage
Elf	Elf
Bund	Bund
steinigst	steinigst
Kohlen	Kohlen
bestellte	bestellte
pflanzte	pflanzte
ritt	ritt
blasen	blasen
Büschen	Büschen
gelang	gelang
Skorpionen	Skorpionen
anrührte	anrührte
lade	lade
hattet	hattet
Gehör	Gehör
enge	enge
Älteste	Älteste
bedürfet	bedürfet
vertrage	vertrage
möchte	möchte
Wachen	Wachen
sollt	sollt
Kreuz	Kreuz
standet	standet
lobet	lobet
Früchten	Früchten
Predigten	Predigten
Bergen	Bergen
lehnte	lehnte
verdammten	verdammten
teil	teil
bleibst	bleibst
harret	harret
recke	recke
gehest	gehest
ehre	ehre
wehret	wehret
verwahrt	verwahrt
bestimmte	bestimmte
gewinne	gewinne
trage	trage
angehöret	angehöret
überführt	überführt
Dinge	Dinge
verbirgt	verbirgt
Falle	Falle
tragen	tragen
Könnet	Könnet
halben	halben
trauten	trauten
spielet	spielet
anderen	anderen
fetten	fetten
säumen	säumen
zerstreuten	zerstreuten
befragt	befragt
verzieht	verzieht
raubte	raubte
war	war
suchet	suchet
ringe	ringe
gewöhnte	gewöhnte
füllen	füllen
nächsten	nächsten
Steinen	Steinen
Den	Den
verkündigst	verkündigst
stellst	stellst
Klauen	Klauen
beweiset	beweiset
fällst	fällst
feiern	feiern
Hirsche	Hirsche
vermögen	vermögen
meines	meines
austilgest	austilgest
Herr	Herr
heiß	heiß
bekannte	bekannte
ehrst	ehrst
gut	gut
säume	säume
betrüge	betrüge
Merket	Merket
zudeckt	zudeckt
löste	löste
Narren	Narren
Recht	Recht
Weinet	Weinet
Leiche	Leiche
verdeckt	verdeckt
werde	werde
flehst	flehst
Binde	Binde
suchen	suchen
Sprüchen	Sprüchen
bracht	bracht
Buchen	Buchen
verwirfst	verwirfst
Werken	Werken
Glaubet	Glaubet
Hast	Hast
brechet	brechet
Tiefen	Tiefen
gebest	gebest
banden	banden
Trübsalen	Trübsalen
Weichet	Weichet
Füßen	Füßen
Höret	Höret
geratest	geratest
Strafe	Strafe
verschont	verschont
denket	denket
schenkte	schenkte
Herren	Herren
halte	halte
Hunde	Hunde
lebest	lebest
schöpfest	schöpfest
liege	liege
wälzte	wälzte
würze	würze
hassest	hassest
Schmieden	Schmieden
brause	brause
löst	löst
ruhest	ruhest
setzte	setzte
Klüften	Klüften
Zerstreuten	Zerstreuten
speise	speise
Stricken	Stricken
versteckt	versteckt
Narr	Narr
säst	säst
fastetet	fastetet
Rufen	Rufen
Aussätzigen	Aussätzigen
pflanzen	pflanzen
decken	decken
nützt	nützt
verstopft	verstopft
gebäre	gebäre
hinausgeht	hinausgeht
Felsen	Felsen
Beine	Beine
weg	weg
Klüfte	Klüfte
zerstreuest	zerstreuest
erkanntet	erkanntet
Erben	Erben
Abtrünnigen	Abtrünnigen
Dank	Dank
Geschäfte	Geschäfte
erhörest	erhörest
stoßt	stoßt
Flöten	Flöten
gelobst	gelobst
Schläge	Schläge
Eile	Eile
haue	haue
strafte	strafte
Junge	Junge
bestanden	bestanden
nahte	nahte
beschuldigt	beschuldigt
Türkis	Türkis
ihres	ihres
am	am
habet	habet
brennen	brennen
sehest	sehest
tretet	tretet
eurer	eurer
Broten	Broten
zerbrichst	zerbrichst
frisch	frisch
gehörst	gehörst
fallt	fallt
zeiget	zeiget
ausführte	ausführte
erfahrt	erfahrt
schämte	schämte
urteile	urteile
ihr	ihr
Einheimische	Einheimische
gebiete	gebiete
vereinigte	vereinigte
verzehrt	verzehrt
bauest	bauest
holte	holte
Stricke	Stricke
Tut	Tut
Wehret	Wehret
Schilde	Schilde
unterrichte	unterrichte
besät	besät
verdammte	verdammte
Decken	Decken
Morde	Morde
hasse	hasse
konnten	konnten
geboten	geboten
Grieche	Grieche
solle	solle
lehrte	lehrte
vergebet	vergebet
ärgere	ärgere
wälzet	wälzet
schwebte	schwebte
Sagen	Sagen
verziehst	verziehst
schenken	schenken
Einen	Einen
Klage	Klage
harrte	harrte
kennest	kennest
sterbt	sterbt
höhnte	höhnte
Ring	Ring
Söhnen	Söhnen
hatte	hatte
wurdet	wurdet
wachsen	wachsen
Jude	Jude
messet	messet
Name	Name
leuchtete	leuchtete
trotzest	trotzest
sollten	sollten
reif	reif
Grab	Grab
binden	binden
Am	Am
laden	laden
weichest	weichest
Gefängnissen	Gefängnissen
Strafen	Strafen
schwelle	schwelle
spiele	spiele
führet	führet
habest	habest
ziere	ziere
treibest	treibest
Gründen	Gründen
reden	reden
weist	weist
pflügen	pflügen
frommen	frommen
bezahlest	bezahlest
Ringen	Ringen
sitzen	sitzen
ehret	ehret
Weh	Weh
vertraut	vertraut
Verheißungen	Verheißungen
irre	irre
Schaffet	Schaffet
ausrichtest	ausrichtest
Kreise	Kreise
Satzungen	Satzungen
befehlen	befehlen
Werdet	Werdet
Für	Für
amen	amen
Heuschrecken	Heuschrecken
backen	backen
gelobet	gelobet
laut	laut
Regenten	Regenten
Gänge	Gänge
taufen	taufen
schießt	schießt
inneren	inneren
taufte	taufte
mögest	mögest
Funken	Funken
bleibe	bleibe
unterrichten	unterrichten
Reihen	Reihen
arbeit	arbeit
laufet	laufet
fremde	fremde
Fragen	Fragen
zürnet	zürnet
gebäret	gebäret
spaltete	spaltete
Forsche	Forsche
ausziehst	ausziehst
hieben	hieben
Verheißung	Verheißung
bezahlst	bezahlst
bestellt	bestellt
dienst	dienst
Kommst	Kommst
Köpfe	Köpfe
fälle	fälle
heben	heben
Sabbatjahr	Sabbatjahr
erhebest	erhebest
hieltet	hieltet
zankte	zankte
Perle	Perle
Ellen	Ellen
erschreckte	erschreckte
auszieht	auszieht
zwölften	zwölften
wirkst	wirkst
schmelzt	schmelzt
herrschet	herrschet
batest	batest
Regieren	Regieren
Kriege	Kriege
entsündigen	entsündigen
wehklage	wehklage
Schaden	Schaden
fette	fette
heulte	heulte
rufest	rufest
lache	lache
meine	meine
schlaf	schlaf
Setzet	Setzet
Führe	Führe
Räten	Räten
tief	tief
seufzest	seufzest
stimmte	stimmte
teilte	teilte
Knechte	Knechte
umkommt	umkommt
Wunde	Wunde
Sehet	Sehet
mein	mein
tut	tut
deinem	deinem
Heißt	Heißt
Fett	Fett
erlösest	erlösest
verkriechet	verkriechet
übest	übest
Wäre	Wäre
Zweigen	Zweigen
frevles	frevles
Festen	Festen
Deutungen	Deutungen
Regent	Regent
grün	grün
kennst	kennst
ungeistlichen	ungeistlichen
entsetzet	entsetzet
Tiere	Tiere
Gebet	Gebet
alle	alle
anhangen	anhangen
Saget	Saget
Juden	Juden
verkürzest	verkürzest
Nehmt	Nehmt
Verwundete	Verwundete
heftetest	heftetest
Zeugen	Zeugen
besitzt	besitzt
Dienst	Dienst
fehlet	fehlet
Höfe	Höfe
einsammelte	einsammelte
Mache	Mache
den	den
zürnst	zürnst
gebot	gebot
unseres	unseres
Kohle	Kohle
schwebe	schwebe
einführen	einführen
maßen	maßen
teilen	teilen
lügst	lügst
Christen	Christen
Schwänzen	Schwänzen
Aufsätze	Aufsätze
Mal	Mal
Reif	Reif
decket	decket
wiederkommst	wiederkommst
erlassen	erlassen
Blitze	Blitze
wachse	wachse
dürfest	dürfest
Tragt	Tragt
betrübten	betrübten
stärket	stärket
Altären	Altären
Kriegsknechten	Kriegsknechten
Einem	Einem
Kommet	Kommet
Zehen	Zehen
murmelte	murmelte
eilet	eilet
Zehe	Zehe
lobte	lobte
erkennst	erkennst
Ratsherr	Ratsherr
verkehrt	verkehrt
Skorpione	Skorpione
Weinbergen	Weinbergen
scheue	scheue
konnte	konnte
scheu	scheu
werft	werft
abweichest	abweichest
werte	werte
Fliege	Fliege
gebären	gebären
verbannet	verbannet
entsündigte	entsündigte
Wogen	Wogen
Als	Als
baue	baue
lösest	lösest
Röcken	Röcken
nächste	nächste
ringst	ringst
schonte	schonte
griechischen	griechischen
gebraucht	gebraucht
schreibst	schreibst
erweckt	erweckt
möchten	möchten
besäest	besäest
füllte	füllte
fallen	fallen
fragst	fragst
berührt	berührt
sorgen	sorgen
lassest	lassest
leuchten	leuchten
hineingehst	hineingehst
Lobe	Lobe
bemühst	bemühst
gießt	gießt
Denen	Denen
siehst	siehst
Aas	Aas
Schafen	Schafen
besitze	besitze
Gevierte	Gevierte
fange	fange
Arme	Arme
Heere	Heere
tragt	tragt
bis	bis
Gebot	Gebot
fünften	fünften
erwerben	erwerben
Decke	Decke
pflüget	pflüget
Eingeweide	Eingeweide
Unrechten	Unrechten
losen	losen
absagt	absagt
Dienet	Dienet
gebt	gebt
Reizen	Reizen
reife	reife
lange	lange
Gefilde	Gefilde
Schau	Schau
ermahnet	ermahnet
Wehr	Wehr
wissest	wissest
kurz	kurz
gehört	gehört
machest	machest
Reihe	Reihe
werden	werden
gewöhnt	gewöhnt
mehret	mehret
sitze	sitze
Feinde	Feinde
Winden	Winden
vergleichen	vergleichen
Stühle	Stühle
Vorhäuten	Vorhäuten
nehmet	nehmet
eins	eins
blitzen	blitzen
Quelle	Quelle
ernten	ernten
untergehst	untergehst
Reizt	Reizt
trinkest	trinkest
lesen	lesen
gelobten	gelobten
wert	wert
umkehret	umkehret
halten	halten
gereicht	gereicht
decke	decke
Feiertagen	Feiertagen
anbetest	anbetest
hängte	hängte
stürzte	stürzte
Ärzten	Ärzten
Meinst	Meinst
Forschet	Forschet
wollt	wollt
wisset	wisset
erwerbe	erwerbe
reizte	reizte
Bitten	Bitten
geraten	geraten
stahlen	stahlen
Heiße	Heiße
schmiert	schmiert
nahest	nahest
jeder	jeder
währet	währet
Kleinode	Kleinode
vermagst	vermagst
bestimmt	bestimmt
Leiden	Leiden
Frieden	Frieden
machet	machet
lang	lang
aufstand	aufstand
austilgen	austilgen
sorge	sorge
haben	haben
sieht	sieht
Laufen	Laufen
stimmen	stimmen
schmückte	schmückte
entgegenkamst	entgegenkamst
leihet	leihet
keinen	keinen
vierten	vierten
jemand	jemand
umkehrt	umkehrt
Äxten	Äxten
erlaubte	erlaubte
soll	soll
neigest	neigest
Orten	Orten
schaffte	schaffte
traut	traut
weinest	weinest
strafe	strafe
Stärket	Stärket
schlafet	schlafet
schreien	schreien
erfüllst	erfüllst
Solch	Solch
Solchen	Solchen
still	still
mal	mal
kosten	kosten
baust	baust
kaufest	kaufest
erzeigten	erzeigten
betrügen	betrügen
ausgereckte	ausgereckte
zerstreute	zerstreute
ratschlagten	ratschlagten
predigten	predigten
zuhörte	zuhörte
Laien	Laien
suchten	suchten
Merke	Merke
Frösche	Frösche
strecke	strecke
deine	deine
Ordnung	Ordnung
erbauet	erbauet
suchte	suchte
Ängsten	Ängsten
Kriegen	Kriegen
vergleiche	vergleiche
krähte	krähte
träge	träge
Höhlen	Höhlen
bemüht	bemüht
vergibt	vergibt
Geviert	Geviert
Seilen	Seilen
Schätze	Schätze
Wehre	Wehre
rittest	rittest
Stücken	Stücken
würdest	würdest
unserer	unserer
Helme	Helme
Tannen	Tannen
speisen	speisen
Ärgernissen	Ärgernissen
Schade	Schade
trotzt	trotzt
zeugst	zeugst
höret	höret
hinaufgeht	hinaufgeht
Gefäße	Gefäße
höhnest	höhnest
lernst	lernst
sehet	sehet
gibst	gibst
Zweige	Zweige
Anschlägen	Anschlägen
Scharen	Scharen
anrichte	anrichte
stoßet	stoßet
behaltet	behaltet
erschreckten	erschreckten
hause	hause
Maß	Maß
Gefängnisse	Gefängnisse
fällte	fällte
meinte	meinte
Pfunden	Pfunden
Erste	Erste
Habe	Habe
meinst	meinst
trüb	trüb
bange	bange
ausbreitet	ausbreitet
Büsche	Büsche
Schuld	Schuld
Fittiche	Fittiche
scheiden	scheiden
Sorget	Sorget
rühmest	rühmest
begehrten	begehrten
Suche	Suche
spielte	spielte
trinkst	trinkst
gelobte	gelobte
leide	leide
streute	streute
lebst	lebst
erzeigte	erzeigte
säumet	säumet
Eines	Eines
Sieb	Sieb
ausgeht	ausgeht
Morden	Morden
meinen	meinen
pflügte	pflügte
wog	wog
taufst	taufst
bleiben	bleiben
gelobt	gelobt
Malen	Malen
erbaut	erbaut
fällen	fällen
verdeckten	verdeckten
Friede	Friede
kranken	kranken
Seht	Seht
lieben	lieben
stelle	stelle
Säcken	Säcken
preisen	preisen
Zeug	Zeug
Ochs	Ochs
müßten	müßten
Gehorcht	Gehorcht
täuschte	täuschte
Wert	Wert
fünfte	fünfte
plagen	plagen
warnte	warnte
verziehen	verziehen
Taufe	Taufe
Lobgesänge	Lobgesänge
Herrn	Herrn
kaufte	kaufte
heil	heil
Schauen	Schauen
nahe	nahe
auflegst	auflegst
Stolze	Stolze
schöpfe	schöpfe
heulet	heulet
Spitze	Spitze
trieb	trieb
wehrte	wehrte
werdest	werdest
regen	regen
einer	einer
schlage	schlage
Ratsherren	Ratsherren
Schuhen	Schuhen
Türmen	Türmen
stille	stille
ehrest	ehrest
Mein	Mein
Aufsätzen	Aufsätzen
sterbest	sterbest
Habt	Habt
versöhnet	versöhnet
Gebirgen	Gebirgen
haut	haut
grüßte	grüßte
Gut	Gut
trinken	trinken
verliere	verliere
trägt	trägt
feiert	feiert
Städte	Städte
Könige	Könige
Gebirge	Gebirge
einen	einen
Kräfte	Kräfte
wurdest	wurdest
Taten	Taten
solch	solch
verfolgt	verfolgt
blende	blende
folgte	folgte
reichet	reichet
beharret	beharret
gefällt	gefällt
webte	webte
jungen	jungen
leset	leset
nötig	nötig
verklärt	verklärt
Feinden	Feinden
Gästen	Gästen
habt	habt
pflanzest	pflanzest
gehorchten	gehorchten
Lichte	Lichte
Tritt	Tritt
hadere	hadere
schreist	schreist
Welche	Welche
gehören	gehören
Keile	Keile
bringest	bringest
währte	währte
leere	leere
elfte	elfte
wogen	wogen
sagest	sagest
legest	legest
Weihen	Weihen
drängst	drängst
Türkise	Türkise
fluchte	fluchte
ziehst	ziehst
befestigten	befestigten
wachet	wachet
Rühmet	Rühmet
Plagen	Plagen
Fremde	Fremde
gerne	gerne
ab	ab
verkündigten	verkündigten
Wege	Wege
hieltest	hieltest
erschrickst	erschrickst
schnelle	schnelle
aufwachst	aufwachst
Weg	Weg
lehret	lehret
kämpfte	kämpfte
verzieh	verzieh
erlöst	erlöst
glaubte	glaubte
Bären	Bären
Reife	Reife
brauste	brauste
brauchte	brauchte
unsrer	unsrer
erhebet	erhebet
schöpfte	schöpfte
Träume	Träume
lüge	lüge
säte	säte
Pfeile	Pfeile
schaffst	schaffst
fertig	fertig
vermöget	vermöget
jammern	jammern
erhaltet	erhaltet
erzürnst	erzürnst
keines	keines
hasset	hasset
Pfeilen	Pfeilen
zerstreut	zerstreut
räumet	räumet
aufrichtest	aufrichtest
lieget	lieget
schießen	schießen
predigt	predigt
Alle	Alle
suche	suche
Füchsen	Füchsen
wohnst	wohnst
Edelsteine	Edelsteine
fluchet	fluchet
zerstreuet	zerstreuet
ausrichtet	ausrichtet
leite	leite
gehst	gehst
Maße	Maße
zieren	zieren
sage	sage
schaffet	schaffet
anrührt	anrührt
lachte	lachte
zählte	zählte
stiege	stiege
seien	seien
Rehe	Rehe
Klaue	Klaue
kühle	kühle
Sehe	Sehe
predigte	predigte
scheinest	scheinest
Tritte	Tritte
dürft	dürft
sagst	sagst
verlaßt	verlaßt
Seil	Seil
pflanzt	pflanzt
Pferde	Pferde
Fische	Fische
fehlte	fehlte
eilte	eilte
stäupt	stäupt
allen	allen
Brote	Brote
Füchse	Füchse
weisest	weisest
Befehle	Befehle
nähret	nähret
log	log
erfüllt	erfüllt
könnest	könnest
besehet	besehet
demütig	demütig
gebietet	gebietet
weichen	weichen
Lüste	Lüste
beweisen	beweisen
zierte	zierte
urteilen	urteilen
fliegen	fliegen
würzen	würzen
ungefälschtem	ungefälschtem
griff	griff
begrabest	begrabest
beißet	beißet
feierte	feierte
hieb	hieb
Gefäßen	Gefäßen
Riesen	Riesen
Acht	Acht
links	links
Tausend	Tausend
entsetzen	entsetzen
handhaben	handhaben
Gefangene	Gefangene
Staube	Staube
leider	leider
merket	merket
Anklage	Anklage
bekehrten	bekehrten
Leid	Leid
bleibest	bleibest
grüßen	grüßen
steige	steige
streuen	streuen
Ordnungen	Ordnungen
verdeckte	verdeckte
abtrünnige	abtrünnige
haust	haust
Augen	Augen
klagte	klagte
ausführe	ausführe
Gäste	Gäste
Kosten	Kosten
zuschließt	zuschließt
frische	frische
Fels	Fels
wundere	wundere
folge	folge
schnitten	schnitten
behaltest	behaltest
ausrufest	ausrufest
beider	beider
Gras	Gras
trübe	trübe
Band	Band
gehorchte	gehorchte
Arm	Arm
Quellen	Quellen
besorgt	besorgt
erfahret	erfahret
Töpfen	Töpfen
vor	vor
Strömen	Strömen
steigen	steigen
beschädigte	beschädigte
bekehrt	bekehrt
hausen	hausen
saget	saget
triebe	triebe
heiligte	heiligte
murmeln	murmeln
Schauet	Schauet
Rufe	Rufe
Lehne	Lehne
scheinen	scheinen
messe	messe
aufnahmen	aufnahmen
Briefen	Briefen
Tanne	Tanne
Predigt	Predigt
offenbart	offenbart
fragest	fragest
Alles	Alles
Kleinod	Kleinod
speiest	speiest
kostet	kostet
wehte	wehte
beugte	beugte
gehorchet	gehorchet
Fröschen	Fröschen
wisse	wisse
Tat	Tat
wiederkommt	wiederkommt
ungehorsame	ungehorsame
weichst	weichst
Prophet	Prophet
feierten	feierten
wirket	wirket
legte	legte
Bette	Bette
verstörte	verstörte
Jünglinge	Jünglinge
vereinigt	vereinigt
bist	bist
machst	machst
hauen	hauen
Buchstaben	Buchstaben
befestigt	befestigt
zweifel	zweifel
Letzten	Letzten
Joche	Joche
trieben	trieben
Teil	Teil
Betten	Betten
erbaust	erbaust
könnte	könnte
siegen	siegen
Kühen	Kühen
grüße	grüße
Schenken	Schenken
brechen	brechen
wachen	wachen
Knabe	Knabe
beiden	beiden
Leide	Leide
wehklagen	wehklagen
Winde	Winde
neige	neige
verhalten	verhalten
Felle	Felle
Aller	Aller
Gewürzen	Gewürzen
seinem	seinem
lose	lose
müssest	müssest
gelangen	gelangen
Stimme	Stimme
Zäume	Zäume
schrecke	schrecke
Basilisk	Basilisk
erhörst	erhörst
bekehrte	bekehrte
mahlen	mahlen
Obrigkeiten	Obrigkeiten
Kriegsknechte	Kriegsknechte
besuchen	besuchen
redetet	redetet
Kost	Kost
Schlangen	Schlangen
bitte	bitte
keine	keine
bang	bang
schöpfen	schöpfen
Spaltung	Spaltung
schau	schau
Fülle	Fülle
Leisten	Leisten
heiligest	heiligest
glänzte	glänzte
erweckst	erweckst
baute	baute
irrte	irrte
Jahren	Jahren
berühret	berühret
küsse	küsse
vergebt	vergebt
grüne	grüne
treibst	treibst
bekennst	bekennst
Schulden	Schulden
Jünger	Jünger
Eine	Eine
zweifelte	zweifelte
Schar	Schar
pflege	pflege
Ringe	Ringe
Eins	Eins
kommest	kommest
Zäumen	Zäumen
vergesset	vergesset
stärkte	stärkte
Worte	Worte
vertraute	vertraute
klaget	klaget
sprechet	sprechet
eurem	eurem
heißest	heißest
mangeln	mangeln
Tieren	Tieren
erweckest	erweckest
Wegen	Wegen
los	los
eingehet	eingehet
ausfuhren	ausfuhren
möge	möge
zerreißest	zerreißest
rufet	rufet
griffe	griffe
erzürnet	erzürnet
verunreinigst	verunreinigst
glaubet	glaubet
armen	armen
wiederkamt	wiederkamt
entsetzt	entsetzt
fresse	fresse
Ästen	Ästen
Teppiche	Teppiche
tiefe	tiefe
drücken	drücken
Weiche	Weiche
zerbrechest	zerbrechest
waren	waren
elften	elften
Helmen	Helmen
tatet	tatet
kämpfet	kämpfet
Macht	Macht
Ha	Ha
offenbar	offenbar
besitzest	besitzest
beschwören	beschwören
erschrecket	erschrecket
setzt	setzt
kommet	kommet
Verwundeten	Verwundeten
fließt	fließt
Wollt	Wollt
reizen	reizen
taufe	taufe
hilfst	hilfst
ältesten	ältesten
Stücke	Stücke
Tausenden	Tausenden
Jünglingen	Jünglingen
Taufen	Taufen
rächte	rächte
Ställe	Ställe
Steige	Steige
esset	esset
drängte	drängte
flucht	flucht
folgen	folgen
bekannten	bekannten
schläft	schläft
wünschte	wünschte
Leset	Leset
hure	hure
verhalte	verhalte
unserem	unserem
tragest	tragest
Eiche	Eiche
fahret	fahret
Grase	Grase
Heuschrecke	Heuschrecke
Früchte	Früchte
wild	wild
wache	wache
solche	solche
würden	würden
urteilte	urteilte
anrichten	anrichten
Wirte	Wirte
Weile	Weile
grünen	grünen
hebst	hebst
gießet	gießet
weide	weide
stillte	stillte
forschet	forschet
gleich	gleich
verlaß	verlaß
Aussätzige	Aussätzige
Solcher	Solcher
begehret	begehret
empfange	empfange
aufheben	aufheben
Gerät	Gerät
weiten	weiten
bewahrst	bewahrst
dein	dein
einsammelst	einsammelst
zuhört	zuhört
gewinnet	gewinnet
Weil	Weil
zuhöret	zuhöret
vorn	vorn
verstecke	verstecke
wohnest	wohnest
Spießen	Spießen
solchen	solchen
morden	morden
Deine	Deine
Teilen	Teilen
hingehst	hingehst
nehmest	nehmest
Würzen	Würzen
dürfte	dürfte
hätte	hätte
Gängen	Gängen
Sinne	Sinne
hörest	hörest
messen	messen
Buben	Buben
schaffen	schaffen
räumen	räumen
Bande	Bande
gehorchest	gehorchest
erzeigen	erzeigen
bereite	bereite
reckte	reckte
hingeht	hingeht
stehest	stehest
glänzt	glänzt
möget	möget
lobe	lobe
seufzt	seufzt
ratschlagte	ratschlagte
nähre	nähre
Anfechtungen	Anfechtungen
Gebärden	Gebärden
Säcke	Säcke
sagen	sagen
holst	holst
Fäuste	Fäuste
haltet	haltet
allem	allem
klagen	klagen
verwahret	verwahret
Blitzen	Blitzen
bekennet	bekennet
kommst	kommst
stürze	stürze
Tauben	Tauben
verdeckst	verdeckst
frevler	frevler
dankte	dankte
verstand	verstand
eingehst	eingehst
Bete	Bete
schaffest	schaffest
Leiste	Leiste
Schuhe	Schuhe
älteste	älteste
umkäme	umkäme
verkaufst	verkaufst
wohnet	wohnet
erlasset	erlasset
verliert	verliert
Ställen	Ställen
gleiche	gleiche
jaget	jaget
umkehrte	umkehrte
greifet	greifet
aßet	aßet
Füße	Füße
Empörung	Empörung
Tore	Tore
weiche	weiche
fallet	fallet
dritte	dritte
bedeckt	bedeckt
führest	führest
sollst	sollst
hauest	hauest
Heben	Heben
dürfe	dürfe
übrigbleibet	übrigbleibet
reizet	reizet
leid	leid
anzeigte	anzeigte
müsset	müsset
Erde	Erde
merken	merken
Ältesten	Ältesten
zerstörst	zerstörst
Stämmen	Stämmen
mögt	mögt
Fittichen	Fittichen
fastetest	fastetest
heiligem	heiligem
verstehst	verstehst
Fällt	Fällt
gebührt	gebührt
Ende	Ende
anbetet	anbetet
sorget	sorget
Bienen	Bienen
erlaubt	erlaubt
Stimmen	Stimmen
Krieg	Krieg
scheide	scheide
Soll	Soll
heftete	heftete
blitzt	blitzt
grünte	grünte
Bleibe	Bleibe
Herz	Herz
erkennest	erkennest
Sagte	Sagte
zerbricht	zerbricht
sitzest	sitzest
beweisest	beweisest
Namen	Namen
wegen	wegen
hell	hell
Pflanzungen	Pflanzungen
tobst	tobst
pflanze	pflanze
stiften	stiften
Schneiden	Schneiden
gewinnen	gewinnen
sondern	sondern
bekennt	bekennt
aber	aber
unser	unser
Binden	Binden
einführte	einführte
Köpfen	Köpfen
Vorstädten	Vorstädten
begrabet	begrabet
Last	Last
betrübte	betrübte
zerreißt	zerreißt
Spaltungen	Spaltungen
stiftete	stiftete
fastete	fastete
Wären	Wären
regieren	regieren
Gedanken	Gedanken
erhöht	erhöht
widerstand	widerstand
befragte	befragte
nötige	nötige
hinausgehst	hinausgehst
Speise	Speise
Geschäften	Geschäften
scheinet	scheinet
jauchzte	jauchzte
Rechte	Rechte
regte	regte
vertraget	vertraget
demütigst	demütigst
junge	junge
Gefangenen	Gefangenen
geselle	geselle
Hirschen	Hirschen
einführt	einführt
hängen	hängen
versucht	versucht
schämet	schämet
fahrest	fahrest
Ebene	Ebene
empfanget	empfanget
Paläste	Paläste
Jochen	Jochen
laute	laute
Mensch	Mensch
Trinkgefäßen	Trinkgefäßen
weise	weise
zerbrecht	zerbrecht
beschwöre	beschwöre
Trage	Trage
streckst	streckst
zweifeln	zweifeln
stäupte	stäupte
solchem	solchem
preiset	preiset
Schiffen	Schiffen
aufrichte	aufrichte
gehet	gehet
arm	arm
Woge	Woge
brach	brach
beschädigt	beschädigt
Lobgesängen	Lobgesängen
wurden	wurden
Herden	Herden
schließt	schließt
bauet	bauet
Schiffe	Schiffe
Zeugnissen	Zeugnissen
beschädigten	beschädigten
regieret	regieret
Helden	Helden
Stufen	Stufen
Ränke	Ränke
verführe	verführe
müsse	müsse
seinen	seinen
Weinstöcke	Weinstöcke
reizest	reizest
Rudern	Rudern
vertrauten	vertrauten
mußte	mußte
Mäusen	Mäusen
trüge	trüge
schnell	schnell
ratschlagen	ratschlagen
sterbet	sterbet
stürzest	stürzest
brachen	brachen
aufwacht	aufwacht
aufhebest	aufhebest
Sollten	Sollten
lehre	lehre
mühte	mühte
Höhle	Höhle
schmierte	schmierte
seines	seines
Werte	Werte
Testamente	Testamente
wehe	wehe
Königreiche	Königreiche
liebet	liebet
verklärest	verklärest
glaubst	glaubst
lebte	lebte
Raube	Raube
führst	führst
hebräischen	hebräischen
beides	beides
Schlange	Schlange
Brüste	Brüste
auflöst	auflöst
stirbst	stirbst
ach	ach
Tyrann	Tyrann
erbest	erbest
Ängste	Ängste
Elfen	Elfen
Stolz	Stolz
streite	streite
scheute	scheute
erlöset	erlöset
Wehen	Wehen
Stämme	Stämme
Flammen	Flammen
schenket	schenket
Götzen	Götzen
Enden	Enden
Kristalle	Kristalle
Trübsal	Trübsal
führen	führen
gehörten	gehörten
liebst	liebst
Seile	Seile
einnehmet	einnehmet
wilde	wilde
warst	warst
Wache	Wache
außer	außer
jemanden	jemanden
rufen	rufen
schließe	schließe
hüten	hüten
Auge	Auge
demütiget	demütiget
Heide	Heide
rede	rede
erlösen	erlösen
fressen	fressen
Urteil	Urteil
sollte	sollte
suchest	suchest
logen	logen
Gebeten	Gebeten
eingeht	eingeht
Steiget	Steiget
Streiten	Streiten
ausrufen	ausrufen
Beten	Beten
Speisen	Speisen
schwellen	schwellen
Geboten	Geboten
kaufe	kaufe
morde	morde
beharrt	beharrt
aufstanden	aufstanden
möchtet	möchtet
Gläubige	Gläubige
verkriechst	verkriechst
bewahret	bewahret
versuche	versuche
aufhebt	aufhebt
fluche	fluche
weh	weh
Danket	Danket
spannt	spannt
versuchet	versuchet
Bäche	Bäche
liegen	liegen
schreiet	schreiet
Leichen	Leichen
nachwandelt	nachwandelt
bedeckst	bedeckst
Gesetze	Gesetze
breche	breche
eines	eines
Menschen	Menschen
durchbohrte	durchbohrte
erfreut	erfreut
Sehne	Sehne
erst	erst
Zeuge	Zeuge
Bürden	Bürden
Worten	Worten
ausrottest	ausrottest
Teile	Teile
langte	langte
linken	linken
streckte	streckte
taten	taten
fangt	fangt
weinet	weinet
Hunden	Hunden
entgegenkamen	entgegenkamen
Königreichen	Königreichen
Sprüche	Sprüche
Wehklagen	Wehklagen
danke	danke
Warten	Warten
betrübst	betrübst
Edelsteinen	Edelsteinen
ihrem	ihrem
begehrst	begehrst
Pfunde	Pfunde
Kehret	Kehret
keiner	keiner
handhabest	handhabest
bringst	bringst
reichte	reichte
erforschet	erforschet
Trübsale	Trübsale
ernte	ernte
mehr	mehr
abtrünnigen	abtrünnigen
gelangte	gelangte
Kristallen	Kristallen
jedes	jedes
Glauben	Glauben
unsres	unsres
begehrte	begehrte
stürzt	stürzt
wenden	wenden
bewahrt	bewahrt
erfüllet	erfüllet
kaufst	kaufst
hatten	hatten
Röcke	Röcke
verstehet	verstehet
würdet	würdet
Rehen	Rehen
Lehre	Lehre
Hundert	Hundert
Speeren	Speeren
entsetzten	entsetzten
Schaffe	Schaffe
Sorge	Sorge
plagte	plagte
Machet	Machet
verwahrst	verwahrst
Wachet	Wachet
zuschließet	zuschließet
regierest	regierest
Freunden	Freunden
Steine	Steine
Wollte	Wollte
irren	irren
verführen	verführen
schenkst	schenkst
Ding	Ding
umkämen	umkämen
Klagen	Klagen
einem	einem
schauen	schauen
Zöpfe	Zöpfe
Sabbate	Sabbate
wohnte	wohnte
erfahrest	erfahrest
unseren	unseren
liebte	liebte
verlieren	verlieren
schmelzen	schmelzen
zudeckte	zudeckte
einnehmest	einnehmest
redetest	redetest
Reichen	Reichen
Meine	Meine
keinem	keinem
begrabt	begrabt
Grenze	Grenze
sonderte	sonderte
stirbt	stirbt
Fliegen	Fliegen
erhöhet	erhöhet
wärmte	wärmte
fromme	fromme
Schlägen	Schlägen
fertige	fertige
wollte	wollte
bestellten	bestellten
Säuen	Säuen
solcher	solcher
Städten	Städten
Rechten	Rechten
ehrte	ehrte
Hure	Hure
Äxte	Äxte
jauchzt	jauchzt
vier	vier
hurst	hurst
hörst	hörst
rührte	rührte
wach	wach
jedem	jedem
spannen	spannen
erniedrigst	erniedrigst
gedenket	gedenket
Heiden	Heiden
brecht	brecht
befestigte	befestigte
zeigte	zeigte
seht	seht
fallest	fallest
Regiert	Regiert
verfolgst	verfolgst
bekehret	bekehret
ansehet	ansehet
loben	loben
gehörte	gehörte
leget	leget
Esset	Esset
verkehrte	verkehrte
wäre	wäre
aufhört	aufhört
schon	schon
all	all
Deinen	Deinen
kaufet	kaufet
Held	Held
hinaufgehst	hinaufgehst
Gelobet	Gelobet
schreiben	schreiben
vergibst	vergibst
verkaufe	verkaufe
schlag	schlag
verdammt	verdammt
Werke	Werke
knüpfst	knüpfst
Seiten	Seiten
erhebst	erhebst
Maultier	Maultier
Setzt	Setzt
Meinem	Meinem
heile	heile
begehrt	begehrt
Gebärde	Gebärde
beißt	beißt
ausführen	ausführen
reifen	reifen
fehlen	fehlen
Seit	Seit
Erstlinge	Erstlinge
Lobet	Lobet
spricht	spricht
wechselte	wechselte
Unrecht	Unrecht
stoßest	stoßest
stellen	stellen
glaube	glaube
zeuge	zeuge
stiegen	stiegen
Schneide	Schneide
Weinen	Weinen
weinte	weinte
konntest	konntest
verstopften	verstopften
auflöste	auflöste
ziehest	ziehest
Ihre	Ihre
Drachen	Drachen
besucht	besucht
Fäusten	Fäusten
hattest	hattest
Weinberge	Weinberge
Löwe	Löwe
fluchten	fluchten
säet	säet
entsetzte	entsetzte
Schafe	Schafe
er	er
Hecke	Hecke
Gewürze	Gewürze
weichet	weichet
springst	springst
wallet	wallet
naht	naht
mußten	mußten
rechten	rechten
jagte	jagte
Fallt	Fallt
beweist	beweist
Decket	Decket
glauben	glauben
verkürzt	verkürzt
reiche	reiche
Sollst	Sollst
Anklagen	Anklagen
Pflanzung	Pflanzung
zerrüttete	zerrüttete
bekannt	bekannt
Sehnen	Sehnen
lachen	lachen
Königen	Königen
teilet	teilet
weiden	weiden
Fallen	Fallen
griffen	griffen
aufrichtet	aufrichtet
Zerstreut	Zerstreut
Loben	Loben
Söhne	Söhne
schämst	schämst
bestimmst	bestimmst
ansehen	ansehen
Essen	Essen
füllst	füllst
Gründe	Gründe
Kehre	Kehre
Gerichten	Gerichten
Wer	Wer
Könnt	Könnt
Alte	Alte
helfet	helfet
Herzen	Herzen
Einer	Einer
fließen	fließen
Spanne	Spanne
Werk	Werk
meinet	meinet
Schilden	Schilden
eile	eile
dienest	dienest
Flamme	Flamme
lehnen	lehnen
fahrt	fahrt
helle	helle
Träumen	Träumen
gibt	gibt
malen	malen
demütigte	demütigte
begehre	begehre
Spitzen	Spitzen
Reiche	Reiche
weinst	weinst
befehle	befehle
ladest	ladest
schlafest	schlafest
halt	halt
Lüsten	Lüsten
schätze	schätze
verboten	verboten
Dein	Dein
Schleifen	Schleifen
möchtest	möchtest
könne	könne
aufstehet	aufstehet
Ersten	Ersten
Monden	Monden
Fürst	Fürst
Abtrünnige	Abtrünnige
streiten	streiten
ermahnt	ermahnt
raubest	raubest
euren	euren
offenbare	offenbare
vertrauet	vertrauet
ringet	ringet
Amen	Amen
weite	weite
Bahnen	Bahnen
bekehrst	bekehrst
hebräische	hebräische
Laie	Laie
Welchen	Welchen
stellet	stellet
Pfeife	Pfeife
teile	teile
brausen	brausen
lachet	lachet
preise	preise
Waren	Waren
Flöte	Flöte
erzürnt	erzürnt
Ochse	Ochse
ziert	ziert
erwürgt	erwürgt
mangelte	mangelte
blaset	blaset
maß	maß
aufnahmt	aufnahmt
handhabt	handhabt
solches	solches
Märkten	Märkten
zweite	zweite
könnten	könnten
Füllen	Füllen
verkauften	verkauften
grüßt	grüßt
Eilet	Eilet
zeuget	zeuget
untergeht	untergeht
nachwandelte	nachwandelte
prüfet	prüfet
verkehrten	verkehrten
mehrte	mehrte
lernet	lernet
hoffte	hoffte
wollten	wollten
wahr	wahr
verstanden	verstanden
beschuldiget	beschuldiget
Gebeinen	Gebeinen
trotzet	trotzet
Sinnen	Sinnen
bedenket	bedenket
neigte	neigte
führte	führte
kurze	kurze
vermöge	vermöge
Schätzen	Schätzen
schneide	schneide
verstecken	verstecken
Altäre	Altäre
warten	warten
pflanzet	pflanzet
bringet	bringet
borgte	borgte
Geräte	Geräte
erzeigt	erzeigt
wachset	wachset
bauten	bauten
unsere	unsere
Zöpfen	Zöpfen
backe	backe
Taube	Taube
Sabbaten	Sabbaten
Ebenen	Ebenen
Teppichen	Teppichen
Löwen	Löwen
seist	seist
hingehet	hingehet
Märkte	Märkte
gedenkest	gedenkest
Buche	Buche
sprichst	sprichst
beugst	beugst
umbringt	umbringt
Sieben	Sieben
übrigbleiben	übrigbleiben
vermag	vermag
Aase	Aase
werfet	werfet
gute	gute
tote	tote
seit	seit
stehet	stehet
besorgte	besorgte
wärmet	wärmet
schmückst	schmückst
Deutung	Deutung
Stäben	Stäben
vergießest	vergießest
Lehren	Lehren
Huren	Huren
Gerichte	Gerichte
Wunden	Wunden
Tyrannen	Tyrannen
könnt	könnt
labe	labe
erbte	erbte
holet	holet
versuchst	versuchst
wehen	wehen
befragten	befragten
Schalen	Schalen
regiere	regiere
reichen	reichen
rührst	rührst
gefällst	gefällst
anzeigen	anzeigen
kennet	kennet
weinen	weinen
Deinem	Deinem
Halle	Halle
wart	wart
Fischen	Fischen
Spieße	Spieße
Grüße	Grüße
Monate	Monate
Wehklage	Wehklage
verlasset	verlasset
vertilgst	vertilgst
wiederkamen	wiederkamen
gehorchst	gehorchst
beschwert	beschwert
Gebete	Gebete
wallte	wallte
Maultieren	Maultieren
Hälsen	Hälsen
Ströme	Ströme
Gehörst	Gehörst
lernte	lernte
Jungen	Jungen
versuchen	versuchen
nimmt	nimmt
kriegte	kriegte
schwimmst	schwimmst
Graben	Graben
Säge	Säge
erkannten	erkannten
erschrickt	erschrickt
binde	binde
Sekte	Sekte
zählst	zählst
greife	greife
schwimmen	schwimmen
lehren	lehren
schätzte	schätzte
wünsche	wünsche
tobte	tobte
demütige	demütige
Rauben	Rauben
Tiefe	Tiefe
bedeckest	bedeckest
flehte	flehte
beben	beben
fragte	fragte
schätzen	schätzen
freute	freute
Pauken	Pauken
leiten	leiten
verlasse	verlasse
verführt	verführt
sucht	sucht
Vorhäute	Vorhäute
baten	baten
erlöse	erlöse
Einheimischen	Einheimischen
Westen	Westen
hebräisch	hebräisch
raubet	raubet
ausgehst	ausgehst
gern	gern
denkst	denkst
Jahr	Jahr
bat	bat
Zeugnisse	Zeugnisse
Seinen	Seinen
verlähmte	verlähmte
pflegte	pflegte
Kreisen	Kreisen
beweise	beweise
schauet	schauet
lasset	lasset
behalte	behalte
krähen	krähen
Solche	Solche
grüßet	grüßet
Pferden	Pferden
raten	raten
Sekten	Sekten
Elle	Elle
forschte	forschte
Gehorchet	Gehorchet
schickte	schickte
schaute	schaute
schlafe	schlafe
spannte	spannte
aufrichten	aufrichten
Raten	Raten
liebest	liebest
Stäbe	Stäbe
Ruder	Ruder
Götze	Götze
Hälse	Hälse
sprachen	sprachen
prüfst	prüfst
Basilisken	Basilisken
lauf	lauf
anrichtet	anrichtet
Plage	Plage
Toren	Toren
Unglauben	Unglauben
anhangt	anhangt
preist	preist
versagen	versagen
sagte	sagte
Führet	Führet
Kaufleuten	Kaufleuten
lebet	lebet
schläfst	schläfst
Fette	Fette
aufmachte	aufmachte
Wolle	Wolle
innere	innere
Hat	Hat
huren	huren
prediget	prediget
Fremden	Fremden
haltest	haltest
hänget	hänget
weisen	weisen
esse	esse
auflegt	auflegt
aufwachte	aufwachte
erhalte	erhalte
schauest	schauest
Gelobt	Gelobt
fasset	fasset
schweigst	schweigst
wolle	wolle
beseht	beseht
lehrest	lehrest
Satzung	Satzung
Zäune	Zäune
besuche	besuche
ausfuhr	ausfuhr
Frage	Frage
Stühlen	Stühlen
seufzte	seufzte
verderbest	verderbest
leben	leben
griechisch	griechisch
küssen	küssen
War	War
hörte	hörte
empörten	empörten
ersten	ersten
schließen	schließen
betrübt	betrübt
Röhre	Röhre
aufsteht	aufsteht
Keilen	Keilen
Staub	Staub
rate	rate
Sabbatjahre	Sabbatjahre
blitzte	blitzte
aufhörte	aufhörte
bezahlt	bezahlt
Folget	Folget
Neumonden	Neumonden
versagt	versagt
helfest	helfest
verbot	verbot
verziehe	verziehe
blenden	blenden
rühmst	rühmst
abziehen	abziehen
Befehlen	Befehlen
Geliebte	Geliebte
verwirrt	verwirrt
Maßen	Maßen
leer	leer
täuschet	täuschet
ärger	ärger
abweichet	abweichet
Wesen	Wesen
wärme	wärme
Steigen	Steigen
Brüsten	Brüsten
reizt	reizt
fällt	fällt
fremden	fremden
würde	würde
schlaget	schlaget
müßte	müßte
wer	wer
entsündigten	entsündigten
eingehest	eingehest
aufstehst	aufstehst
Wille	Wille
führe	führe
kämpfe	kämpfe
toten	toten
Fahret	Fahret
laben	laben
Sollte	Sollte
helft	helft
Ochsen	Ochsen
übet	übet
wünschen	wünschen
deines	deines
setzest	setzest
sei	sei
hättest	hättest
Bärte	Bärte
dienet	dienet
verdammst	verdammst
Diebe	Diebe
rufst	rufst
Sorgen	Sorgen
Buch	Buch
Neumonde	Neumonde
Erstlingen	Erstlingen
laufe	laufe
warte	warte
außen	außen
fliege	fliege
vertilgest	vertilgest
Dingen	Dingen
fresset	fresset
schweigen	schweigen
wahre	wahre
Grabe	Grabe
freuet	freuet
Sage	Sage
Monde	Monde
einst	einst
diente	diente
fasse	fasse
ein	ein
Rabe	Rabe
Fahrt	Fahrt
salz	salz
bestimmten	bestimmten
anrufen	anrufen
erben	erben
Meeren	Meeren
essest	essest
tat	tat
spanne	spanne
Haue	Haue
Gemeinden	Gemeinden
salzen	salzen
Gebeine	Gebeine
zerschlagt	zerschlagt
Kühe	Kühe
schreie	schreie
Gesellen	Gesellen
leiden	leiden
Obrigkeit	Obrigkeit
Schwelle	Schwelle
schaffe	schaffe
Lasten	Lasten
Reich	Reich
Leuchten	Leuchten
Ihren	Ihren
Töpfe	Töpfe
verkaufte	verkaufte
macht	macht
Stärke	Stärke
Drache	Drache
Samen	Samen
sitzt	sitzt
knüpfte	knüpfte
Christ	Christ
Bächen	Bächen
stürzen	stürzen
gedenkst	gedenkst
Hörst	Hörst
erforscht	erforscht
Urteile	Urteile
Freunde	Freunde
hebet	hebet
anders	anders
lehrst	lehrst
lest	lest
heißt	heißt
sprecht	sprecht
backt	backt
beschwerst	beschwerst
schlaft	schlaft
tust	tust
prüfest	prüfest
Ratet	Ratet
Streite	Streite
eure	eure
Schale	Schale
Feste	Feste
gereichte	gereichte
heiße	heiße
aßest	aßest
vergießt	vergießt
berufen	berufen
Gefilden	Gefilden
Same	Same
Wehe	Wehe
Tagen	Tagen
spalten	spalten
Bürde	Bürde
strafen	strafen
Füllet	Füllet
schenke	schenke
verwirft	verwirft
stäupten	stäupten
ungeistlich	ungeistlich
Gebote	Gebote
gelangt	gelangt
fassest	fassest
Stufe	Stufe
strafet	strafet
rühmte	rühmte
drängest	drängest
ehren	ehren
verbergest	verbergest
deckst	deckst
warnst	warnst
heißet	heißet
jeden	jeden
erhört	erhört
umkommst	umkommst
hätten	hätten
Jahre	Jahre
Räte	Räte
Diesen	Diesen
danket	danket
versöhnst	versöhnst
steckte	steckte
versteckst	versteckst
Unsere	Unsere
webet	webet
habe	habe
Schild	Schild
Dieben	Dieben
mußt	mußt
verbannt	verbannt
ungehorsam	ungehorsam
verwirren	verwirren
vierte	vierte
plagest	plagest
erniedrigt	erniedrigt
traget	traget
mühe	mühe
essen	essen
Spannt	Spannt
wilden	wilden
fülle	fülle
anrufe	anrufe
verschonet	verschonet
hineingeht	hineingeht
beide	beide
Banden	Banden
hilft	hilft
kochte	kochte
redete	redete
erhöhst	erhöhst
herrschest	herrschest
Palästen	Palästen
bleibet	bleibet
klage	klage
Hecken	Hecken
Beinen	Beinen
Schwellen	Schwellen
eures	eures
male	male
Tage	Tage
Ärzte	Ärzte
Fällen	Fällen
verunreinigt	verunreinigt
zweiten	zweiten
mache	mache
nütze	nütze
umbringet	umbringet
Haben	Haben
Ach	Ach
ausführt	ausführt
ritten	ritten
wollest	wollest
stand	stand
erkannte	erkannte
rühmet	rühmet
Würze	Würze
Monaten	Monaten
Meinen	Meinen
Röhren	Röhren
verkauft	verkauft
kämpfen	kämpfen
Majestät	Majestät
fertigte	fertigte
kehrst	kehrst
zürnte	zürnte
untertretet	untertretet
Suchet	Suchet
meinem	meinem
Maultiere	Maultiere
Grenzen	Grenzen
Werden	Werden
tuest	tuest
verbergt	verbergt
Eichen	Eichen
Feiertage	Feiertage
arme	arme
alles	alles
dritten	dritten
Funke	Funke
ringen	ringen
Vorstädte	Vorstädte
empörte	empörte
Erbe	Erbe
Rühmst	Rühmst
arbeiten	arbeiten
versöhnt	versöhnt
koste	koste
heilet	heilet
Glaubst	Glaubst
Anfechtung	Anfechtung
Fallet	Fallet
befehlt	befehlt
Bäume	Bäume
Gedanke	Gedanke
Leuchte	Leuchte
strafst	strafst
Heeren	Heeren
Ehren	Ehren
Herde	Herde
Nehmet	Nehmet
zuteilte	zuteilte
stillest	stillest
fragen	fragen
Gemeinde	Gemeinde
Schreiet	Schreiet
stärke	stärke
Weißt	Weißt
Bleche	Bleche
Unserer	Unserer
Pauke	Pauke
Warte	Warte
erhöhest	erhöhest
Jüngern	Jüngern
kühlen	kühlen
speiet	speiet
Wirst	Wirst
Meere	Meere
Seines	Seines
jagst	jagst
rufe	rufe
Perlen	Perlen
empört	empört
konntet	konntet
steinigte	steinigte
steckst	steckst
merkte	merkte
könnet	könnet
verbirgst	verbirgst
Testamenten	Testamenten
eine	eine
Letzte	Letzte
schicke	schicke
nehmt	nehmt
verkündiget	verkündiget
Kaufleute	Kaufleute
anzeigt	anzeigt
leihst	leihst
trinket	trinket
löset	löset
verkehre	verkehre
merke	merke
anzeige	anzeige
Orte	Orte
steig	steig
ungefälschter	ungefälschter
sitzet	sitzet
tretest	tretest
legst	legst
ratet	ratet
regiert	regiert
fließe	fließe
Speere	Speere
lauft	lauft
Schreien	Schreien
steiget	steiget
ziehet	ziehet
deckte	deckte
bitten	bitten
rauschte	rauschte
zerschlaget	zerschlaget
Blechen	Blechen
setzet	setzet
Bitte	Bitte
anzeigest	anzeigest
kehret	kehret
krieget	krieget
Fellen	Fellen
spielen	spielen
verderbet	verderbet
gebrauchte	gebrauchte
reich	reich
Gebt	Gebt
ausbreitete	ausbreitete
schlagt	schlagt
Meinet	Meinet
zerstört	zerstört
Kreuze	Kreuze
weich	weich
unterrichtet	unterrichtet
auflegte	auflegte
drücke	drücke
hebe	hebe
Ärgernisse	Ärgernisse
spracht	spracht
zerrütteten	zerrütteten
widerstanden	widerstanden
Türme	Türme
wunderte	wunderte
koche	koche
Entsetzen	Entsetzen
Lob	Lob
Säue	Säue
müßt	müßt
rauschen	rauschen
Bunde	Bunde
Alten	Alten
schweiget	schweiget
Schleife	Schleife
blase	blase
sündiget	sündiget
verständige	verständige
Weinstöcken	Weinstöcken
durchbohrt	durchbohrt
verlobte	verlobte
Bäumen	Bäumen
erbet	erbet
braust	braust
wirkte	wirkte
erkennet	erkennet
fehle	fehle
zanket	zanket
Erden	Erden
erzeigest	erzeigest
brauchst	brauchst
zwölfte	zwölfte
Raben	Raben
Grüßet	Grüßet
bebte	bebte
Propheten	Propheten
Gesell	Gesell
verstört	verstört
Kräften	Kräften
Kleinoden	Kleinoden
sorgte	sorgte
zuteil	zuteil
Bahn	Bahn
Laufet	Laufet
fraget	fraget
taufet	taufet
Eingeweiden	Eingeweiden
zeugest	zeugest
Solches	Solches
suchst	suchst
Weiß	Weiß
drückte	drückte
brauche	brauche
bedenken	bedenken
angehört	angehört
Bleibet	Bleibet
betrübet	betrübet
Majestäten	Majestäten
halbe	halbe
zählet	zählet
Meines	Meines
ihre	ihre
wacht	wacht
erntete	erntete
erschreckt	erschreckt
stärken	stärken
herrschte	herrschte
trügen	trügen
Ränken	Ränken
wechseln	wechseln
Willen	Willen
wachte	wachte
gehorcht	gehorcht
Anschläge	Anschläge
Griechen	Griechen
wehren	wehren
Wir	Wir
lügen	lügen
erforschest	erforschest
rauben	rauben
denn	denn
Rufet	Rufet
greifen	greifen
überführen	überführen
schenkest	schenkest
bedürft	bedürft
forschen	forschen
Lesen	Lesen
steigest	steigest
siegte	siegte
band	band
schätzt	schätzt
schnitt	schnitt
Unglaube	Unglaube
blast	blast
Tun	Tun
Briefe	Briefe
Hebet	Hebet
Höfen	Höfen
sündigt	sündigt
anruft	anruft
Gläubigen	Gläubigen
borgst	borgst
liegst	liegst
wehre	wehre
Trinkgefäße	Trinkgefäße
verlähmt	verlähmt
Hallen	Hallen
schmücket	schmücket
zeugte	zeugte
Äste	Äste
speist	speist
liebe	liebe
Entsetzt	Entsetzt
brichst	brichst
aller	aller
Haut	Haut
bewahrest	bewahrest
nährte	nährte
gebühren	gebühren
nötigte	nötigte
heilte	heilte
Knaben	Knaben
pflegst	pflegst
Empörungen	Empörungen
erste	erste
kehre	kehre
hänge	hänge
unsre	unsre
Ehre	Ehre
rechte	rechte
Weihe	Weihe
verstörten	verstörten
Bär	Bär
berufe	berufe
Pfeifen	Pfeifen
Bube	Bube
Gute	Gute
kriegen	kriegen
zerstreust	zerstreust
Buchstabe	Buchstabe
schneiden	schneiden
trägst	trägst
Entsetzet	Entsetzet
mahle	mahle
kühl	kühl
gehöre	gehöre
gebet	gebet
Sägen	Sägen
nimmst	nimmst
stoße	stoße
vergessest	vergessest
schrecken	schrecken
übte	übte
Hauen	Hauen
Hunderten	Hunderten
erwürget	erwürget
eng	eng
wurde	wurde
Schmiede	Schmiede
hoffet	hoffet
verkündigest	verkündigest
hüte	hüte
achten	achten
lauten	lauten
jede	jede
zürnest	zürnest
ausgereckten	ausgereckten
Weine	Weine
wende	wende
verzehre	verzehre
rächest	rächest
besitzet	besitzet
Gesetzen	Gesetzen
Feind	Feind
Licht	Licht
Berge	Berge
bestand	bestand
Tust	Tust
stahl	stahl
schlagest	schlagest
verlobt	verlobt
Lehnen	Lehnen
falle	falle
brenne	brenne
bereitet	bereitet
Schwänze	Schwänze
verständig	verständig
kein	kein
Folge	Folge
lieb	lieb
ruhte	ruhte
speisest	speisest
ausrottet	ausrottet
untertreten	untertreten
verstehest	verstehest
