Entsetzen	Entsetzen
bewahrest	bewahrest
Rufe	Rufe
brechen	brechen
Wehret	Wehret
leben	leben
erzürnt	erzürnt
Vorstädte	Vorstädte
besitze	besitze
predigten	predigten
sucht	sucht
Märkten	Märkten
heil	heil
rührte	rührte
Perle	Perle
tief	tief
kaufet	kaufet
raubte	raubte
lasset	lasset
Mein	Mein
Winden	Winden
fangt	fangt
trefft	trefft
Ebene	Ebene
verfolgt	verfolgt
schenkest	schenkest
Binden	Binden
verkehrt	verkehrt
streute	streute
Gebot	Gebot
Predigten	Predigten
Weinet	Weinet
Dieben	Dieben
Sternen	Sternen
verkauften	verkauften
Elf	Elf
Geschäfte	Geschäfte
Wehklagen	Wehklagen
Falle	Falle
schenken	schenken
erzürnst	erzürnst
Königreiche	Königreiche
Tust	Tust
sitzt	sitzt
hauen	hauen
Arme	Arme
verbergest	verbergest
fasse	fasse
Sabbaten	Sabbaten
Prophet	Prophet
sitzest	sitzest
Helden	Helden
tragen	tragen
untergeht	untergeht
scheute	scheute
versöhnst	versöhnst
banden	banden
laben	laben
Brüsten	Brüsten
vergleichen	vergleichen
Pferde	Pferde
gedenkst	gedenkst
schaffe	schaffe
Haut	Haut
Hast	Hast
bekennet	bekennet
hineingeht	hineingeht
Unrecht	Unrecht
Gehorchet	Gehorchet
unschuldige	unschuldige
kämpfen	kämpfen
halt	halt
trüb	trüb
bemüht	bemüht
predigst	predigst
begrabet	begrabet
steinigte	steinigte
liege	liege
löst	löst
absagt	absagt
schenkte	schenkte
rede	rede
schmücket	schmücket
Gründe	Gründe
Bächen	Bächen
hause	hause
schreie	schreie
geboten	geboten
Graben	Graben
ärgere	ärgere
schweigst	schweigst
Trinken	Trinken
spalten	spalten
lose	lose
ausgeht	ausgeht
Ästen	Ästen
blitzt	blitzt
Ratsherr	Ratsherr
Morde	Morde
arm	arm
Buche	Buche
weh	weh
wollt	wollt
wehret	wehret
zeugest	zeugest
beweisen	beweisen
Reichen	Reichen
abziehen	abziehen
Schenken	Schenken
werdet	werdet
verstehet	verstehet
Jahr	Jahr
opfern	opfern
besitzet	besitzet
gedenkest	gedenkest
kaufe	kaufe
leite	leite
blasen	blasen
nehmet	nehmet
erkennet	erkennet
verführen	verführen
Königen	Königen
Glauben	Glauben
Bürden	Bürden
schreiet	schreiet
verkriechst	verkriechst
glaubte	glaubte
umkommt	umkommt
Kohlen	Kohlen
lebet	lebet
erforschest	erforschest
Gebirgen	Gebirgen
werfet	werfet
Sucht	Sucht
beugte	beugte
schlaf	schlaf
Feind	Feind
empfange	empfange
Zäumen	Zäumen
Spieße	Spieße
Mal	Mal
Narren	Narren
Reihe	Reihe
erlaubte	erlaubte
Schafe	Schafe
Höhle	Höhle
Sinnen	Sinnen
wahre	wahre
aufkommt	aufkommt
wirket	wirket
macht	macht
heiß	heiß
Krieg	Krieg
Folge	Folge
erlöse	erlöse
leiden	leiden
tragest	tragest
forschen	forschen
Spaltungen	Spaltungen
brauche	brauche
suchst	suchst
predigte	predigte
verwirrt	verwirrt
verkriechet	verkriechet
vertraute	vertraute
spiele	spiele
machte	machte
Held	Held
stoßet	stoßet
vergebt	vergebt
Jünglinge	Jünglinge
fertigte	fertigte
vermag	vermag
erhöht	erhöht
fallest	fallest
Perlen	Perlen
fließt	fließt
bezahlt	bezahlt
gehorchet	gehorchet
spielen	spielen
messet	messet
morden	morden
Schätzen	Schätzen
lügen	lügen
reife	reife
ehren	ehren
verderbest	verderbest
bekannten	bekannten
kühlen	kühlen
bauten	bauten
verlaß	verlaß
unterrichtet	unterrichtet
helft	helft
Gebärde	Gebärde
rühmte	rühmte
täuschet	täuschet
Flamme	Flamme
strecke	strecke
gehest	gehest
Gemeinde	Gemeinde
Gerichte	Gerichte
anrührte	anrührte
aufstanden	aufstanden
lobe	lobe
Trage	Trage
stehest	stehest
gereichte	gereichte
Werde	Werde
führte	führte
folgen	folgen
lehnte	lehnte
höhnte	höhnte
traget	traget
hingeht	hingeht
wünschet	wünschet
trüge	trüge
Wänden	Wänden
Gedanken	Gedanken
mühte	mühte
Reizen	Reizen
grünen	grünen
stille	stille
zweifelte	zweifelte
würzen	würzen
Gehorcht	Gehorcht
Fahrt	Fahrt
Kleinoden	Kleinoden
könnet	könnet
Leide	Leide
gleiche	gleiche
urteile	urteile
dürfe	dürfe
pflege	pflege
Stricken	Stricken
berufen	berufen
schämst	schämst
Unrechten	Unrechten
Fröschen	Fröschen
ermahnet	ermahnet
aufwacht	aufwacht
Rufen	Rufen
blase	blase
werde	werde
tragt	tragt
dürfte	dürfte
Pfunde	Pfunde
Schneiden	Schneiden
grüne	grüne
liegen	liegen
Gebeinen	Gebeinen
besucht	besucht
rauschte	rauschte
vergießt	vergießt
bezahlst	bezahlst
Maultiere	Maultiere
Haben	Haben
Jünglingen	Jünglingen
meinet	meinet
Biene	Biene
scheinen	scheinen
gehörst	gehörst
Junge	Junge
Zehe	Zehe
Kohle	Kohle
Schiffe	Schiffe
fülle	fülle
Merke	Merke
gleich	gleich
gedenket	gedenket
schmiert	schmiert
gründen	gründen
stürzest	stürzest
Speeren	Speeren
nimmt	nimmt
springst	springst
Toren	Toren
heulte	heulte
lest	lest
lache	lache
Hunden	Hunden
Sieben	Sieben
logen	logen
bereite	bereite
lobte	lobte
versuchet	versuchet
Schreien	Schreien
Bäume	Bäume
zerbrechest	zerbrechest
wachte	wachte
holte	holte
Schleife	Schleife
umbringet	umbringet
Raube	Raube
bedenken	bedenken
frommen	frommen
bleibest	bleibest
ungehorsame	ungehorsame
einnehmest	einnehmest
gebäre	gebäre
nährte	nährte
Hat	Hat
Schreiet	Schreiet
Drachen	Drachen
steinigst	steinigst
Freunden	Freunden
Heißt	Heißt
Eingeweide	Eingeweide
bemühst	bemühst
Elle	Elle
Frieden	Frieden
Lichte	Lichte
Fliegen	Fliegen
borgst	borgst
pflügte	pflügte
kommst	kommst
Male	Male
Äxten	Äxten
gebären	gebären
Führet	Führet
Weichet	Weichet
durchbohrt	durchbohrt
Hälsen	Hälsen
aufhebest	aufhebest
schlaget	schlaget
Träume	Träume
regieret	regieret
wärme	wärme
hell	hell
solle	solle
Spaltung	Spaltung
binden	binden
erwürget	erwürget
erschrickst	erschrickst
scheue	scheue
linken	linken
wachet	wachet
befestigte	befestigte
demütige	demütige
kaufte	kaufte
stirbst	stirbst
denkst	denkst
schießt	schießt
versuche	versuche
erfreut	erfreut
gehörten	gehörten
ausbreitet	ausbreitet
sollt	sollt
Samen	Samen
flehst	flehst
wiederkommt	wiederkommt
gehorcht	gehorcht
offenbart	offenbart
weinest	weinest
trinken	trinken
träumte	träumte
Augen	Augen
Ding	Ding
bleiben	bleiben
greifet	greifet
Wegen	Wegen
Strafe	Strafe
steiget	steiget
verständige	verständige
leset	leset
heile	heile
Wachen	Wachen
Buchstaben	Buchstaben
hassest	hassest
mal	mal
vermögen	vermögen
begehrt	begehrt
aufrichten	aufrichten
Steige	Steige
herrschte	herrschte
Christen	Christen
Rehe	Rehe
lehnen	lehnen
stellen	stellen
werden	werden
decket	decket
Kaufleuten	Kaufleuten
speist	speist
Meere	Meere
stolze	stolze
zanket	zanket
hänge	hänge
erbest	erbest
wenden	wenden
schämet	schämet
Pauken	Pauken
Kaufleute	Kaufleute
Maultieren	Maultieren
schaute	schaute
Gebet	Gebet
jagte	jagte
haltet	haltet
vergibt	vergibt
Gefilde	Gefilde
Brüste	Brüste
wundere	wundere
Weißt	Weißt
ausfuhr	ausfuhr
erhaltet	erhaltet
eng	eng
schmierte	schmierte
bekennt	bekennt
Geschäften	Geschäften
Türmen	Türmen
säte	säte
Befehlen	Befehlen
weg	weg
schwebe	schwebe
Zähne	Zähne
folget	folget
herrschest	herrschest
merket	merket
Morden	Morden
Röhren	Röhren
aufstehet	aufstehet
wärmte	wärmte
kaufst	kaufst
sagest	sagest
behaltet	behaltet
Leuchte	Leuchte
Lehre	Lehre
Christ	Christ
trotzet	trotzet
denket	denket
gehören	gehören
Tiere	Tiere
esset	esset
leihst	leihst
Decket	Decket
Soll	Soll
fallen	fallen
Stühlen	Stühlen
male	male
wünschen	wünschen
Decke	Decke
fehlte	fehlte
verwahrst	verwahrst
verzehrt	verzehrt
seufzest	seufzest
laufet	laufet
beschwören	beschwören
vergesset	vergesset
verunreinigt	verunreinigt
Vorhäute	Vorhäute
Stufen	Stufen
eile	eile
leuchtete	leuchtete
weisen	weisen
armen	armen
verdeckt	verdeckt
weide	weide
anbetet	anbetet
Herren	Herren
lehrest	lehrest
weinet	weinet
erhebest	erhebest
erhörst	erhörst
Hauen	Hauen
Schade	Schade
Taten	Taten
wisset	wisset
füllte	füllte
aufnahmen	aufnahmen
schreckt	schreckt
währte	währte
verlasse	verlasse
Hirschen	Hirschen
beschädigte	beschädigte
preiset	preiset
blitzen	blitzen
Lehne	Lehne
weisest	weisest
Türkise	Türkise
wissest	wissest
Kommet	Kommet
Erbe	Erbe
zerstreuest	zerstreuest
Knabe	Knabe
wehre	wehre
auszieht	auszieht
lachte	lachte
vertraget	vertraget
traut	traut
verwirft	verwirft
flehte	flehte
Klüften	Klüften
Sekten	Sekten
prüfst	prüfst
ausrichtest	ausrichtest
fromme	fromme
Setzet	Setzet
erbauet	erbauet
Brote	Brote
Rufet	Rufet
wohnte	wohnte
Pauke	Pauke
Wunden	Wunden
glaubet	glaubet
Hure	Hure
Kosten	Kosten
stürzen	stürzen
Fels	Fels
Zäunen	Zäunen
dankte	dankte
habt	habt
Erstlingen	Erstlingen
neigte	neigte
vertrage	vertrage
wachset	wachset
nähre	nähre
Fett	Fett
Ochs	Ochs
tust	tust
Rubine	Rubine
Höhen	Höhen
Meine	Meine
bedeckest	bedeckest
umkehret	umkehret
behaltest	behaltest
verklärt	verklärt
Bienen	Bienen
Gäste	Gäste
Monden	Monden
gelobst	gelobst
rühmst	rühmst
liebst	liebst
Schaffet	Schaffet
Trübsal	Trübsal
Mensch	Mensch
Drache	Drache
anbetest	anbetest
wärmet	wärmet
brecht	brecht
setzet	setzet
Schwänzen	Schwänzen
grüßt	grüßt
mehr	mehr
harrte	harrte
deckst	deckst
lernst	lernst
Weinstöcken	Weinstöcken
baute	baute
Fällt	Fällt
wart	wart
neige	neige
verbirgst	verbirgst
Gesetzen	Gesetzen
Aas	Aas
recke	recke
wohnest	wohnest
müssest	müssest
Gefangenen	Gefangenen
Weinstöcke	Weinstöcke
grüßen	grüßen
springen	springen
Gras	Gras
Eichen	Eichen
Kriegsknechte	Kriegsknechte
fällte	fällte
wilde	wilde
Spanne	Spanne
Gibt	Gibt
verwirfst	verwirfst
Schauen	Schauen
gießet	gießet
strafen	strafen
Testamenten	Testamenten
regte	regte
hasset	hasset
habet	habet
dienet	dienet
Entsetzet	Entsetzet
spannt	spannt
anzeigt	anzeigt
haut	haut
selbst	selbst
lernte	lernte
behalte	behalte
Vorstädten	Vorstädten
Lesen	Lesen
griffen	griffen
Boten	Boten
ausbreitete	ausbreitete
Ebenen	Ebenen
binde	binde
küssen	küssen
Dingen	Dingen
Leiche	Leiche
Sehe	Sehe
halte	halte
Söhne	Söhne
Herr	Herr
decken	decken
Gefängnissen	Gefängnissen
Kräfte	Kräfte
lieb	lieb
Gehör	Gehör
gebäret	gebäret
schließe	schließe
schweiget	schweiget
Werkzeugen	Werkzeugen
grabe	grabe
Städten	Städten
Erde	Erde
Spitze	Spitze
Wehen	Wehen
schaffst	schaffst
treibst	treibst
bitte	bitte
versöhnt	versöhnt
ältesten	ältesten
einführen	einführen
Köpfen	Köpfen
täuschte	täuschte
hingehst	hingehst
fresset	fresset
verdeckst	verdeckst
drücke	drücke
erschreckte	erschreckte
Tiefe	Tiefe
leide	leide
ziehst	ziehst
Wollt	Wollt
Lüsten	Lüsten
braust	braust
Gebete	Gebete
speiet	speiet
stiege	stiege
setzte	setzte
zerbricht	zerbricht
betrüge	betrüge
zeuget	zeuget
versucht	versucht
Zerstreut	Zerstreut
stimmen	stimmen
könnest	könnest
feierte	feierte
begehret	begehret
Jungen	Jungen
schau	schau
wehrte	wehrte
schlafe	schlafe
wehen	wehen
Pflanzungen	Pflanzungen
los	los
glaubst	glaubst
Füßen	Füßen
eilet	eilet
naht	naht
salzen	salzen
Tyrann	Tyrann
schöpfen	schöpfen
Sage	Sage
Hecke	Hecke
Gute	Gute
ziehet	ziehet
sollte	sollte
legst	legst
Zehen	Zehen
Fäuste	Fäuste
teil	teil
hineingehst	hineingehst
führest	führest
Träumen	Träumen
siegte	siegte
hasse	hasse
bestimmte	bestimmte
Äste	Äste
Gevierte	Gevierte
Skorpione	Skorpione
haben	haben
sagst	sagst
bringst	bringst
gehorchest	gehorchest
Sehet	Sehet
gehörte	gehörte
geselle	geselle
hure	hure
Briefe	Briefe
anrichte	anrichte
kommet	kommet
reden	reden
fragte	fragte
Skorpionen	Skorpionen
löset	löset
Taube	Taube
säumen	säumen
Reif	Reif
verstand	verstand
Blechen	Blechen
wohnet	wohnet
faule	faule
Grüße	Grüße
Höfe	Höfe
zuhörte	zuhörte
älteste	älteste
Gefängnisse	Gefängnisse
Anschlägen	Anschlägen
Schleifen	Schleifen
seufzte	seufzte
wohnst	wohnst
glaubest	glaubest
verbirgt	verbirgt
Bleibe	Bleibe
Fette	Fette
essen	essen
Klaue	Klaue
spielet	spielet
plagest	plagest
nahe	nahe
schlagt	schlagt
hebräische	hebräische
speiest	speiest
Tausenden	Tausenden
kranken	kranken
Blitze	Blitze
ringst	ringst
schlagest	schlagest
empört	empört
Verheißung	Verheißung
Maßen	Maßen
Setzt	Setzt
bekehrst	bekehrst
bestand	bestand
schaffen	schaffen
Banden	Banden
erschreckten	erschreckten
mein	mein
Stäben	Stäben
verzieht	verzieht
verdammt	verdammt
drückte	drückte
lesen	lesen
Lehren	Lehren
wahr	wahr
Röcken	Röcken
jungen	jungen
machet	machet
Trinkgefäßen	Trinkgefäßen
sterbest	sterbest
anrichtet	anrichtet
vermöget	vermöget
nötig	nötig
hoffte	hoffte
griff	griff
hörte	hörte
Schuhen	Schuhen
Gemeinden	Gemeinden
krähen	krähen
aufstehst	aufstehst
Hörst	Hörst
zudeckte	zudeckte
Leuchten	Leuchten
beben	beben
gehst	gehst
morde	morde
regiere	regiere
beharret	beharret
Heere	Heere
Dienet	Dienet
wild	wild
Tische	Tische
Zäune	Zäune
Gut	Gut
verstanden	verstanden
strafte	strafte
sehet	sehet
reichen	reichen
Nehmet	Nehmet
küsse	küsse
stimmte	stimmte
Weinberge	Weinberge
Fremden	Fremden
arbeit	arbeit
ehre	ehre
verstecken	verstecken
Gehörst	Gehörst
Rehen	Rehen
füllen	füllen
schnelle	schnelle
wachen	wachen
Raten	Raten
pflanzet	pflanzet
meinen	meinen
klaget	klaget
Erstlinge	Erstlinge
kennet	kennet
lehrte	lehrte
Hundert	Hundert
fließe	fließe
müsset	müsset
Reizt	Reizt
Wollte	Wollte
Werkzeuge	Werkzeuge
zerstörst	zerstörst
pflegte	pflegte
trauten	trauten
Winde	Winde
vergleiche	vergleiche
erhöhest	erhöhest
Staube	Staube
schaffet	schaffet
Sagen	Sagen
abtrünnige	abtrünnige
Tut	Tut
besorgt	besorgt
gebietet	gebietet
Grab	Grab
messe	messe
taufte	taufte
Ärzte	Ärzte
suchet	suchet
stillest	stillest
erfahrest	erfahrest
Bahnen	Bahnen
hebräischen	hebräischen
taufst	taufst
Bund	Bund
zürnest	zürnest
dürft	dürft
ausrufen	ausrufen
bestimmten	bestimmten
pflegst	pflegst
befragt	befragt
Ängsten	Ängsten
handhabest	handhabest
Riesen	Riesen
fresse	fresse
gehorchte	gehorchte
sterbet	sterbet
preise	preise
bestimmst	bestimmst
Jünger	Jünger
kühle	kühle
erhebet	erhebet
rächte	rächte
befehlen	befehlen
Saget	Saget
zeigst	zeigst
Pfeilen	Pfeilen
Buch	Buch
brennen	brennen
schwimmen	schwimmen
tretest	tretest
säet	säet
Ratet	Ratet
wiederkommst	wiederkommst
vergessest	vergessest
hinaufgeht	hinaufgeht
schaffest	schaffest
offenbar	offenbar
sitze	sitze
standet	standet
Name	Name
hinausgeht	hinausgeht
übet	übet
Teile	Teile
frisch	frisch
aufrichtest	aufrichtest
Joche	Joche
Frommen	Frommen
plagen	plagen
bekehret	bekehret
zeiget	zeiget
jagst	jagst
erlöst	erlöst
danket	danket
kehrte	kehrte
Berge	Berge
Schaden	Schaden
bitten	bitten
verdammten	verdammten
demütig	demütig
prediget	prediget
Gefilden	Gefilden
lügst	lügst
Aussätzige	Aussätzige
Binde	Binde
Tieren	Tieren
berühret	berühret
Kehret	Kehret
ausführe	ausführe
Leichname	Leichname
vertrauten	vertrauten
Helmen	Helmen
lernet	lernet
führet	führet
Lehnen	Lehnen
fallet	fallet
Unglaube	Unglaube
Gewürzen	Gewürzen
freiwilligen	freiwilligen
erfüllet	erfüllet
Buben	Buben
sorgen	sorgen
weinen	weinen
verstopft	verstopft
wachsen	wachsen
reiche	reiche
dienest	dienest
heißet	heißet
schmelzt	schmelzt
inneren	inneren
grünte	grünte
verwirren	verwirren
gefällst	gefällst
Schwänze	Schwänze
gewinnet	gewinnet
Fallet	Fallet
toten	toten
anzeigte	anzeigte
höret	höret
auflegst	auflegst
Ruder	Ruder
Majestäten	Majestäten
verstörten	verstörten
verfolgst	verfolgst
Röhre	Röhre
bauet	bauet
bleibe	bleibe
Worte	Worte
war	war
lieben	lieben
Edelsteinen	Edelsteinen
schneiden	schneiden
führen	führen
Rühmst	Rühmst
Tausend	Tausend
Lobgesänge	Lobgesänge
Befehle	Befehle
erniedrigst	erniedrigst
steckte	steckte
Bote	Bote
zerstreust	zerstreust
sagte	sagte
hieb	hieb
hoffet	hoffet
verkaufst	verkaufst
fluchet	fluchet
schrecke	schrecke
danke	danke
Türkis	Türkis
Bete	Bete
leid	leid
Knechten	Knechten
Gerichten	Gerichten
erweckst	erweckst
Reihen	Reihen
versuchen	versuchen
gewöhnt	gewöhnt
Laie	Laie
Hirsche	Hirsche
Schaffe	Schaffe
schmelzen	schmelzen
Sabbatjahre	Sabbatjahre
nützt	nützt
Forsche	Forsche
Bitte	Bitte
Deutung	Deutung
Klauen	Klauen
Spießen	Spießen
Stühle	Stühle
Leichen	Leichen
Riese	Riese
brauchst	brauchst
Füße	Füße
Schlange	Schlange
griffe	griffe
sollst	sollst
Scharen	Scharen
bedürfet	bedürfet
schauen	schauen
wallet	wallet
Leichnamen	Leichnamen
zählst	zählst
hilft	hilft
wollten	wollten
Keile	Keile
Wesen	Wesen
waren	waren
Feinde	Feinde
Meinst	Meinst
bedenket	bedenket
Füchse	Füchse
schreist	schreist
hörest	hörest
messen	messen
sehest	sehest
dienst	dienst
Keilen	Keilen
lauft	lauft
erhörest	erhörest
kennst	kennst
Klagen	Klagen
Tier	Tier
hebet	hebet
fliegen	fliegen
zerschlagt	zerschlagt
Werken	Werken
baust	baust
Lobe	Lobe
frische	frische
kehre	kehre
vertrieb	vertrieb
könnten	könnten
sorge	sorge
trägt	trägt
begrabest	begrabest
Ärzten	Ärzten
Suche	Suche
gebet	gebet
zerbrichst	zerbrichst
Sieb	Sieb
Juden	Juden
nötige	nötige
Gelobt	Gelobt
führst	führst
Stäbe	Stäbe
halbe	halbe
Heide	Heide
Rubinen	Rubinen
erniedrigt	erniedrigt
berufe	berufe
lade	lade
fällst	fällst
einführte	einführte
essest	essest
verzehre	verzehre
reizest	reizest
speise	speise
kämpfe	kämpfe
anrufen	anrufen
wollest	wollest
verdammst	verdammst
Sabbatjahr	Sabbatjahr
Weinbergen	Weinbergen
wacht	wacht
esse	esse
Ende	Ende
Kräften	Kräften
Speise	Speise
brachen	brachen
Zerstreuten	Zerstreuten
ruhte	ruhte
stürzte	stürzte
deckte	deckte
taufe	taufe
Maultier	Maultier
erweckest	erweckest
treibest	treibest
Hunderten	Hunderten
drängten	drängten
rufe	rufe
betrübt	betrübt
Ellen	Ellen
weinte	weinte
Beinen	Beinen
Sorget	Sorget
Grenzen	Grenzen
Gerät	Gerät
merkte	merkte
Bergen	Bergen
nahte	nahte
schießen	schießen
demütigst	demütigst
Freunde	Freunde
bebte	bebte
beschwert	beschwert
Räte	Räte
regieren	regieren
Sprüchen	Sprüchen
Predigt	Predigt
zudeckt	zudeckt
Monde	Monde
verstört	verstört
Schale	Schale
brechet	brechet
reizet	reizet
lebte	lebte
löste	löste
Schauet	Schauet
fremden	fremden
Eingeweiden	Eingeweiden
lauf	lauf
Gar	Gar
kennest	kennest
stehet	stehet
taufet	taufet
laufe	laufe
Ecken	Ecken
Woge	Woge
Wogen	Wogen
reif	reif
enge	enge
Dinge	Dinge
Schuhe	Schuhe
Tat	Tat
prüfet	prüfet
rächest	rächest
Ängste	Ängste
heilte	heilte
Herden	Herden
ringen	ringen
Quellen	Quellen
kühl	kühl
Gebote	Gebote
Sollst	Sollst
junge	junge
sage	sage
fluchten	fluchten
blende	blende
sprechet	sprechet
erforschet	erforschet
vermöge	vermöge
anruft	anruft
schnitten	schnitten
Kreise	Kreise
erhalte	erhalte
Steine	Steine
Monaten	Monaten
reizt	reizt
weiten	weiten
Friede	Friede
laden	laden
weiden	weiden
wach	wach
liebet	liebet
stellst	stellst
siehst	siehst
fetten	fetten
Fragen	Fragen
beweisest	beweisest
Eilet	Eilet
Klüfte	Klüfte
kämpfet	kämpfet
tatet	tatet
Pfeife	Pfeife
trübe	trübe
bekehrten	bekehrten
Forschet	Forschet
schätzen	schätzen
gelangt	gelangt
Hände	Hände
zerstört	zerstört
anzeigen	anzeigen
verlaßt	verlaßt
siegen	siegen
stärkte	stärkte
trägst	trägst
klagte	klagte
Huren	Huren
bessere	bessere
Tischen	Tischen
schwelle	schwelle
bang	bang
fertig	fertig
gute	gute
jammerte	jammerte
Staub	Staub
verbergt	verbergt
mache	mache
vergebet	vergebet
Reife	Reife
Jahren	Jahren
Weile	Weile
Rudern	Rudern
Abtrünnigen	Abtrünnigen
liebest	liebest
tobte	tobte
trieb	trieb
leider	leider
zerschlaget	zerschlaget
freuet	freuet
weine	weine
gelobten	gelobten
decke	decke
schenke	schenke
Büschen	Büschen
lehren	lehren
kosten	kosten
gießest	gießest
gibst	gibst
erschrickt	erschrickt
brach	brach
hängte	hängte
Geliebte	Geliebte
Früchten	Früchten
knüpfst	knüpfst
lösest	lösest
aufhört	aufhört
feiern	feiern
empörten	empörten
Halle	Halle
aufstand	aufstand
vertrauet	vertrauet
Gebirge	Gebirge
Ehren	Ehren
heißt	heißt
Gebärden	Gebärden
verständig	verständig
preisen	preisen
brenne	brenne
beugst	beugst
Streiten	Streiten
ausrottest	ausrottest
regierest	regierest
pflügen	pflügen
schreibst	schreibst
trage	trage
hängen	hängen
Machet	Machet
Nehmt	Nehmt
verziehe	verziehe
Garten	Garten
bracht	bracht
ungehorsam	ungehorsam
Ärgernisse	Ärgernisse
schenket	schenket
trotzt	trotzt
spielte	spielte
weichet	weichet
Schneide	Schneide
bleibst	bleibst
widerstanden	widerstanden
Abhängen	Abhängen
kriegen	kriegen
mühe	mühe
habe	habe
zuhöret	zuhöret
strafet	strafet
erntete	erntete
verschont	verschont
trügen	trügen
Einheimische	Einheimische
verkürzest	verkürzest
Ratsherren	Ratsherren
Stämme	Stämme
ausziehst	ausziehst
Satzung	Satzung
Türme	Türme
erwerben	erwerben
Weine	Weine
Meinet	Meinet
kehret	kehret
anrichten	anrichten
Kreisen	Kreisen
zeugst	zeugst
Merket	Merket
beißt	beißt
mögest	mögest
erhöhet	erhöhet
predigt	predigt
frage	frage
Weil	Weil
Anklagen	Anklagen
Ochsen	Ochsen
lachen	lachen
Bunde	Bunde
Kristallen	Kristallen
Stücke	Stücke
Macht	Macht
Auge	Auge
bestimmt	bestimmt
weinst	weinst
Würzen	Würzen
fallt	fallt
zweifeln	zweifeln
Pfeile	Pfeile
würze	würze
betrübten	betrübten
prüfest	prüfest
Götzen	Götzen
Kehre	Kehre
Beine	Beine
vergießest	vergießest
säume	säume
beweiset	beweiset
hebräisch	hebräisch
setzest	setzest
umbringt	umbringt
rechten	rechten
spricht	spricht
Erben	Erben
erkennst	erkennst
lobet	lobet
leiten	leiten
spracht	spracht
Briefen	Briefen
brichst	brichst
geratest	geratest
heben	heben
blenden	blenden
besuche	besuche
Herzen	Herzen
demütiget	demütiget
wünsche	wünsche
ausrufest	ausrufest
aufwachte	aufwachte
Danket	Danket
jaget	jaget
beharrt	beharrt
Hälse	Hälse
rühmest	rühmest
bewähret	bewähret
fraget	fraget
Märkte	Märkte
nehmt	nehmt
murmelte	murmelte
stolz	stolz
säst	säst
erlaubt	erlaubt
schaffte	schaffte
habest	habest
Ränke	Ränke
zierte	zierte
eingehet	eingehet
Pfeifen	Pfeifen
erhöhst	erhöhst
verkehrte	verkehrte
erbte	erbte
verziehen	verziehen
ziere	ziere
beschwöre	beschwöre
schlaft	schlaft
zürnst	zürnst
Ställe	Ställe
kehrst	kehrst
Gelobet	Gelobet
ziehest	ziehest
Löwen	Löwen
übest	übest
Glaubet	Glaubet
Ärgernissen	Ärgernissen
tut	tut
log	log
zürnet	zürnet
Könige	Könige
Strömen	Strömen
Blitzen	Blitzen
raubet	raubet
wogen	wogen
gefällt	gefällt
unterrichte	unterrichte
Suchet	Suchet
drängst	drängst
reizen	reizen
Grüßet	Grüßet
Weiß	Weiß
versteckt	versteckt
Trübsalen	Trübsalen
aufmachte	aufmachte
stiftete	stiftete
Lüste	Lüste
warnst	warnst
erlöset	erlöset
meine	meine
speisest	speisest
Anfechtungen	Anfechtungen
zerbrecht	zerbrecht
Beten	Beten
Dank	Dank
Heben	Heben
Schenke	Schenke
lassest	lassest
erbet	erbet
Gibst	Gibst
reichet	reichet
erfahrt	erfahrt
müsse	müsse
bezahlest	bezahlest
hüten	hüten
Schilden	Schilden
Kriegen	Kriegen
pflanzte	pflanzte
Kristalle	Kristalle
Decken	Decken
wollte	wollte
Kommst	Kommst
tuest	tuest
Säge	Säge
kehren	kehren
schicke	schicke
Götze	Götze
Herde	Herde
verführe	verführe
scheide	scheide
blast	blast
beseht	beseht
klagen	klagen
reckte	reckte
wache	wache
Diebe	Diebe
betrübet	betrübet
Werk	Werk
feiert	feiert
fasset	fasset
Säcken	Säcken
schöpfte	schöpfte
einsammelst	einsammelst
verziehst	verziehst
Glaubst	Glaubst
erlösest	erlösest
Broten	Broten
Ringe	Ringe
Geboten	Geboten
sagen	sagen
aufsteht	aufsteht
verdeckte	verdeckte
ruhe	ruhe
versöhnet	versöhnet
Sekte	Sekte
spannen	spannen
Same	Same
gründe	gründe
folge	folge
schöpfest	schöpfest
besitzest	besitzest
bekannte	bekannte
Höfen	Höfen
Schiffen	Schiffen
maß	maß
Wege	Wege
spanne	spanne
hebst	hebst
nötigte	nötigte
Ringen	Ringen
schlafet	schlafet
aufmacht	aufmacht
Fetten	Fetten
Herz	Herz
Waren	Waren
verlieren	verlieren
Fromme	Fromme
haue	haue
aufrichtet	aufrichtet
Zweige	Zweige
vermagst	vermagst
Fällen	Fällen
Teil	Teil
Könnet	Könnet
heißest	heißest
labe	labe
Stücken	Stücken
Narr	Narr
rührst	rührst
glänzte	glänzte
Bahn	Bahn
Reiche	Reiche
brauste	brauste
Weiche	Weiche
bewahrt	bewahrt
erfahret	erfahret
Tyrannen	Tyrannen
schreiben	schreiben
Westen	Westen
Regiert	Regiert
Bleibet	Bleibet
verliert	verliert
verkehrten	verkehrten
Tragt	Tragt
tote	tote
nehmest	nehmest
arbeiten	arbeiten
Lob	Lob
arme	arme
wälzte	wälzte
entsetzte	entsetzte
Armen	Armen
hurst	hurst
Füllen	Füllen
nähret	nähret
gebieten	gebieten
befestigt	befestigt
Säuen	Säuen
wehklage	wehklage
lehret	lehret
steigen	steigen
Tanne	Tanne
verschonet	verschonet
gebest	gebest
bekehrt	bekehrt
sprachen	sprachen
Jüngern	Jüngern
spaltete	spaltete
durchbohrte	durchbohrte
Laien	Laien
pflanzen	pflanzen
suchten	suchten
fassest	fassest
lang	lang
krieget	krieget
ziert	ziert
weichst	weichst
Taufen	Taufen
gesellt	gesellt
Tage	Tage
gehöre	gehöre
gelobte	gelobte
ansehet	ansehet
Schuld	Schuld
befragten	befragten
bedeckt	bedeckt
fragest	fragest
verlasset	verlasset
gebot	gebot
unterrichten	unterrichten
Tun	Tun
schauet	schauet
Flöte	Flöte
untergehst	untergehst
gelangte	gelangte
Sagte	Sagte
brauchte	brauchte
überführt	überführt
auflöst	auflöst
Weihe	Weihe
schon	schon
würdest	würdest
suche	suche
aufheben	aufheben
Unglauben	Unglauben
herrschet	herrschet
zankte	zankte
mangelte	mangelte
beschwerst	beschwerst
stellet	stellet
freute	freute
erkennest	erkennest
flucht	flucht
ärger	ärger
backt	backt
weise	weise
folgte	folgte
Maße	Maße
Zäume	Zäume
webte	webte
Anklage	Anklage
wehe	wehe
diente	diente
haust	haust
Trübsale	Trübsale
schwellen	schwellen
stoßest	stoßest
Urteile	Urteile
irren	irren
Ältesten	Ältesten
reich	reich
Bitten	Bitten
Plage	Plage
neigest	neigest
Höhlen	Höhlen
seht	seht
müßt	müßt
beweist	beweist
Last	Last
verbot	verbot
lange	lange
umkehrt	umkehrt
Bäumen	Bäumen
gelobet	gelobet
Meinen	Meinen
rufst	rufst
bringest	bringest
vergibst	vergibst
verstehest	verstehest
Geräte	Geräte
verklärest	verklärest
Pferden	Pferden
Jude	Jude
Wille	Wille
Stimme	Stimme
Rauben	Rauben
abtrünnigen	abtrünnigen
Neumonde	Neumonde
versagt	versagt
reizte	reizte
ausführen	ausführen
helfest	helfest
schläfst	schläfst
Leisten	Leisten
Rühmet	Rühmet
ratet	ratet
wunderte	wunderte
bedürft	bedürft
Sorgen	Sorgen
faul	faul
speisen	speisen
greife	greife
stoßt	stoßt
schätzte	schätzte
lehrst	lehrst
Leiden	Leiden
Schilde	Schilde
baue	baue
Basilisk	Basilisk
Trinkgefäße	Trinkgefäße
beschädigten	beschädigten
Laufen	Laufen
Gefäße	Gefäße
Leid	Leid
ritten	ritten
Geviert	Geviert
pflüget	pflüget
ausführte	ausführte
Gehilfen	Gehilfen
Sägen	Sägen
schickte	schickte
suchest	suchest
müßten	müßten
Höhe	Höhe
Wüste	Wüste
Sehnen	Sehnen
schauest	schauest
verunreinigst	verunreinigst
Plagen	Plagen
zerstreuten	zerstreuten
Fischen	Fischen
Leset	Leset
halten	halten
werdest	werdest
Grieche	Grieche
bereitet	bereitet
gereicht	gereicht
besorgte	besorgte
sprichst	sprichst
Spitzen	Spitzen
Kühe	Kühe
vertraut	vertraut
Hecken	Hecken
stiften	stiften
leer	leer
Töpfe	Töpfe
Gesetze	Gesetze
Eile	Eile
schließen	schließen
Fallen	Fallen
hüte	hüte
Hunde	Hunde
wälzt	wälzt
Essen	Essen
zählte	zählte
zuschließet	zuschließet
Ränken	Ränken
gehorchten	gehorchten
stahl	stahl
Grenze	Grenze
Obrigkeiten	Obrigkeiten
brausen	brausen
hänget	hänget
verderbet	verderbet
schreien	schreien
still	still
Ring	Ring
Söhnen	Söhnen
schwebte	schwebte
zerstreuet	zerstreuet
Gläubigen	Gläubigen
Feinden	Feinden
räumen	räumen
urteilen	urteilen
steigest	steigest
stürze	stürze
Altären	Altären
aufhörte	aufhörte
brause	brause
pflanzt	pflanzt
stärken	stärken
schätze	schätze
innere	innere
einführt	einführt
Fäusten	Fäusten
entsetzen	entsetzen
würde	würde
träumen	träumen
umkommst	umkommst
verstopften	verstopften
Linken	Linken
Quelle	Quelle
Helme	Helme
strafst	strafst
ritt	ritt
ausrottet	ausrottet
erwerbe	erwerbe
ehrte	ehrte
besitzt	besitzt
Städte	Städte
Gehilfe	Gehilfe
Gängen	Gängen
greifen	greifen
gebraucht	gebraucht
würden	würden
griechisch	griechisch
Stämmen	Stämmen
Weinen	Weinen
heiße	heiße
Säcke	Säcke
hingehet	hingehet
höhnest	höhnest
Lasten	Lasten
wegen	wegen
tretet	tretet
rate	rate
möget	möget
Griechen	Griechen
Pfunden	Pfunden
wirkst	wirkst
erschrecket	erschrecket
sitzen	sitzen
erfüllt	erfüllt
stürzt	stürzt
erfreuest	erfreuest
eingehest	eingehest
mangeln	mangeln
verbannt	verbannt
Buchstabe	Buchstabe
geraten	geraten
plagte	plagte
begehre	begehre
Kost	Kost
erhört	erhört
lachet	lachet
Licht	Licht
falle	falle
gehorchst	gehorchst
Füllet	Füllet
erweckt	erweckt
steig	steig
Kreuze	Kreuze
hadere	hadere
Büsche	Büsche
scheu	scheu
handhabt	handhabt
Erden	Erden
Paläste	Paläste
schläft	schläft
glauben	glauben
aufkommen	aufkommen
langte	langte
weich	weich
Fittiche	Fittiche
forschet	forschet
schneide	schneide
irrte	irrte
verzehrst	verzehrst
gelangen	gelangen
weichest	weichest
Schmieden	Schmieden
liebe	liebe
Zeuge	Zeuge
verführt	verführt
Reich	Reich
Speere	Speere
vereinigte	vereinigte
Willen	Willen
gebühren	gebühren
Stolz	Stolz
feierten	feierten
teilen	teilen
trotze	trotze
Enden	Enden
gehört	gehört
Funke	Funke
kriegte	kriegte
weiche	weiche
Ehre	Ehre
wilden	wilden
gebt	gebt
lieget	lieget
Empörung	Empörung
bestellten	bestellten
Weh	Weh
heilet	heilet
Stolze	Stolze
Sterne	Sterne
drängest	drängest
Seilen	Seilen
aufwachst	aufwachst
Testamente	Testamente
währet	währet
fette	fette
pflanze	pflanze
fange	fange
fällen	fällen
Kriegsknechten	Kriegsknechten
webet	webet
Heiße	Heiße
drängte	drängte
krähte	krähte
säumet	säumet
Sabbate	Sabbate
Laufet	Laufet
Werke	Werke
blaset	blaset
Gebt	Gebt
helfet	helfet
spannte	spannte
Stricke	Stricke
wechseln	wechseln
Feiertagen	Feiertagen
rauben	rauben
erforscht	erforscht
backe	backe
stärke	stärke
könne	könne
weichen	weichen
fremde	fremde
schlag	schlag
verderben	verderben
warnte	warnte
machest	machest
streckst	streckst
Dienst	Dienst
Ecke	Ecke
Steigen	Steigen
würdet	würdet
Wehr	Wehr
Zöpfen	Zöpfen
Lobet	Lobet
befehlt	befehlt
verwahret	verwahret
widerstand	widerstand
legte	legte
unschuldigen	unschuldigen
schwimmst	schwimmst
Aase	Aase
Gesell	Gesell
ausführt	ausführt
suchte	suchte
entsetzt	entsetzt
Sprüche	Sprüche
stehst	stehst
Anschläge	Anschläge
treffen	treffen
Menschen	Menschen
rühmet	rühmet
wirft	wirft
Röcke	Röcke
Wolle	Wolle
Urteil	Urteil
erlösen	erlösen
gewinnen	gewinnen
leihet	leihet
schnell	schnell
ermahnt	ermahnt
Abhänge	Abhänge
steckst	steckst
Kleinode	Kleinode
lehre	lehre
Schafen	Schafen
erfüllst	erfüllst
Sorge	Sorge
aufhebt	aufhebt
machst	machst
teile	teile
bricht	bricht
Loben	Loben
Worten	Worten
wallte	wallte
schmückst	schmückst
wälzet	wälzet
hinausgehst	hinausgehst
Früchte	Früchte
Namen	Namen
merken	merken
selber	selber
rufen	rufen
Aufsätze	Aufsätze
überführen	überführen
rechte	rechte
raten	raten
schließt	schließt
ausfuhren	ausfuhren
Maß	Maß
empörte	empörte
leere	leere
zeigte	zeigte
bestellt	bestellt
Zweigen	Zweigen
könnt	könnt
verkauft	verkauft
gewöhnte	gewöhnte
möge	möge
gebührt	gebührt
Bürde	Bürde
Taufe	Taufe
Gebeine	Gebeine
Stärket	Stärket
Sollten	Sollten
wehklagen	wehklagen
Verheißungen	Verheißungen
erlassen	erlassen
scheiden	scheiden
irre	irre
vertrieben	vertrieben
mehrte	mehrte
Speisen	Speisen
Räten	Räten
Knechte	Knechte
Löwe	Löwe
Habe	Habe
kämpfte	kämpfte
schätzt	schätzt
wisse	wisse
Heeren	Heeren
Festen	Festen
sitzet	sitzet
beschuldigt	beschuldigt
halben	halben
Habt	Habt
fehlet	fehlet
Band	Band
fehlen	fehlen
zeugen	zeugen
Gefangene	Gefangene
Höret	Höret
hausen	hausen
fahrest	fahrest
Tauben	Tauben
forschte	forschte
stillte	stillte
fahret	fahret
zerreißest	zerreißest
krank	krank
regen	regen
Schlangen	Schlangen
betrübte	betrübte
grüßet	grüßet
sollten	sollten
nütze	nütze
warst	warst
Zeug	Zeug
Empörungen	Empörungen
streite	streite
bewährt	bewährt
Gänge	Gänge
grüße	grüße
Gästen	Gästen
Buchen	Buchen
fragst	fragst
bekehrte	bekehrte
bestanden	bestanden
verhalten	verhalten
Geliebten	Geliebten
Entsetzt	Entsetzt
Neumonden	Neumonden
Führe	Führe
haderte	haderte
Töpfen	Töpfen
Kreuz	Kreuz
befehle	befehle
Zöpfe	Zöpfe
leuchten	leuchten
Königreichen	Königreichen
Frösche	Frösche
schlage	schlage
Felsen	Felsen
suchen	suchen
umkehrte	umkehrte
meinte	meinte
wünschte	wünschte
helle	helle
lebest	lebest
kostet	kostet
wende	wende
nimmst	nimmst
wehte	wehte
ehret	ehret
hilfst	hilfst
grüßte	grüßte
Haue	Haue
bewahret	bewahret
koche	koche
rauschen	rauschen
gut	gut
urteilte	urteilte
Wände	Wände
Funken	Funken
entsetzet	entsetzet
zieren	zieren
Hebe	Hebe
müßte	müßte
verstehst	verstehst
Fellen	Fellen
Wüsten	Wüsten
Ströme	Ströme
anzeige	anzeige
Bären	Bären
empfanget	empfanget
Schalen	Schalen
beschuldiget	beschuldiget
Spannt	Spannt
Meeren	Meeren
Schild	Schild
einnehmet	einnehmet
zählet	zählet
grün	grün
Gewürze	Gewürze
verboten	verboten
erschreckt	erschreckt
zürnte	zürnte
strafe	strafe
tobst	tobst
versteckst	versteckst
wolle	wolle
streckte	streckte
stahlen	stahlen
entsetzten	entsetzten
Raben	Raben
fluche	fluche
Felle	Felle
Heuschrecke	Heuschrecke
anzeigest	anzeigest
handhaben	handhaben
trinket	trinket
Arm	Arm
berührt	berührt
auflöste	auflöste
vierten	vierten
verkehre	verkehre
Regieren	Regieren
Mache	Mache
Seil	Seil
Schau	Schau
murmeln	murmeln
erhebst	erhebst
blitzte	blitzte
stärket	stärket
trieben	trieben
betrügen	betrügen
lüge	lüge
Kriege	Kriege
trotzest	trotzest
besuchen	besuchen
absagen	absagen
verstörte	verstörte
Weihen	Weihen
scheinet	scheinet
loben	loben
nahest	nahest
schnitt	schnitt
stiegen	stiegen
verkaufe	verkaufe
bedeckst	bedeckst
Teppiche	Teppiche
tiefe	tiefe
räumet	räumet
bringet	bringet
War	War
Satzungen	Satzungen
Schar	Schar
stirbt	stirbt
Zeugen	Zeugen
fahrt	fahrt
Aussätzigen	Aussätzigen
glaube	glaube
Wehe	Wehe
Gründen	Gründen
reichte	reichte
trinkest	trinkest
band	band
Wunde	Wunde
übte	übte
huren	huren
Frage	Frage
erlasset	erlasset
graben	graben
Flammen	Flammen
eingeht	eingeht
sondern	sondern
fällt	fällt
opferte	opferte
wehren	wehren
verzieh	verzieh
streiten	streiten
ringe	ringe
sorget	sorget
borgte	borgte
Fische	Fische
mehret	mehret
Schmiede	Schmiede
Bande	Bande
linke	linke
Teppichen	Teppichen
streuen	streuen
Knaben	Knaben
meinst	meinst
fälle	fälle
begehrte	begehrte
Feste	Feste
Zähnen	Zähnen
maßen	maßen
begehrst	begehrst
Pflanzung	Pflanzung
haltest	haltest
kochte	kochte
erwürgt	erwürgt
zuschließt	zuschließt
verkürzt	verkürzt
preist	preist
Schläge	Schläge
sterbt	sterbt
pflanzest	pflanzest
Trinket	Trinket
koste	koste
schlafest	schlafest
gerne	gerne
tat	tat
Abtrünnige	Abtrünnige
weite	weite
gebiete	gebiete
wirfst	wirfst
auflegt	auflegt
Klage	Klage
führe	führe
steige	steige
ernten	ernten
rittest	rittest
Linke	Linke
hebe	hebe
gewinne	gewinne
verlobt	verlobt
Grase	Grase
Bleche	Bleche
mahlen	mahlen
wechselte	wechselte
Füchsen	Füchsen
Ochse	Ochse
zerstreut	zerstreut
gebrauchte	gebrauchte
raubest	raubest
verdeckten	verdeckten
Stärke	Stärke
gern	gern
regiert	regiert
ruhest	ruhest
Esset	Esset
beweise	beweise
Altäre	Altäre
Gesellen	Gesellen
fressen	fressen
salz	salz
Steinen	Steinen
merke	merke
vier	vier
abzieht	abzieht
beschädigt	beschädigt
Leiste	Leiste
Eiche	Eiche
heulet	heulet
sieht	sieht
scheinest	scheinest
versagen	versagen
strecken	strecken
ehrest	ehrest
Wehklage	Wehklage
ansehen	ansehen
verwahrt	verwahrt
hörst	hörst
anrührt	anrührt
Ställen	Ställen
verlobte	verlobte
Schulden	Schulden
aufrichte	aufrichte
anrufe	anrufe
liebte	liebte
Tagen	Tagen
begrabt	begrabt
trinkst	trinkst
Schätze	Schätze
Lobgesängen	Lobgesängen
Weg	Weg
freiwillige	freiwillige
setzt	setzt
Majestät	Majestät
schweigen	schweigen
Händen	Händen
leget	leget
holst	holst
zerreißt	zerreißt
jammern	jammern
Gebeten	Gebeten
Gedanke	Gedanke
Köpfe	Köpfe
Deutungen	Deutungen
ernte	ernte
Teilen	Teilen
betrübst	betrübst
besehet	besehet
triebe	triebe
teilet	teilet
erben	erben
Zeugnisse	Zeugnisse
soll	soll
ausgehst	ausgehst
Mäuse	Mäuse
gelang	gelang
saget	saget
zuhört	zuhört
Fülle	Fülle
fehle	fehle
lebst	lebst
Bube	Bube
liegst	liegst
Stufe	Stufe
sorgte	sorgte
bleibet	bleibet
glänzt	glänzt
wog	wog
schämte	schämte
Werdet	Werdet
backen	backen
Bäche	Bäche
Vorhäuten	Vorhäuten
zeuge	zeuge
fliege	fliege
besser	besser
bauest	bauest
erbaust	erbaust
ladest	ladest
dürfest	dürfest
schrecken	schrecken
Streite	Streite
fließen	fließen
fertige	fertige
Stimmen	Stimmen
Malen	Malen
Tiefen	Tiefen
Obrigkeit	Obrigkeit
Älteste	Älteste
stoße	stoße
Jahre	Jahre
fluchte	fluchte
beißet	beißet
Propheten	Propheten
Ordnungen	Ordnungen
Flöten	Flöten
verdammte	verdammte
Fremde	Fremde
schenkst	schenkst
Gefäßen	Gefäßen
demütigte	demütigte
Tannen	Tannen
Kühen	Kühen
Monate	Monate
schmückte	schmückte
Könnt	Könnt
eingehst	eingehst
aufnahmt	aufnahmt
losen	losen
Seht	Seht
Schwellen	Schwellen
könnte	könnte
Fliege	Fliege
Seile	Seile
Folget	Folget
Fahret	Fahret
Elfen	Elfen
bange	bange
kaufest	kaufest
steinigest	steinigest
Wehre	Wehre
Rabe	Rabe
Säue	Säue
holet	holet
zeugte	zeugte
schöpfe	schöpfe
Hebet	Hebet
Sinne	Sinne
Äxte	Äxte
kommest	kommest
gießt	gießt
Schwelle	Schwelle
Hallen	Hallen
Mäusen	Mäusen
knüpfte	knüpfte
teilte	teilte
Fallt	Fallt
offenbare	offenbare
Wachet	Wachet
fragen	fragen
verstecke	verstecke
ringet	ringet
eilte	eilte
breche	breche
zweifel	zweifel
gibt	gibt
Strafen	Strafen
Zeugnissen	Zeugnissen
harret	harret
ausrichtet	ausrichtet
verhalte	verhalte
hauest	hauest
seufzt	seufzt
werft	werft
Fittichen	Fittichen
sonderte	sonderte
erzürnet	erzürnet
stelle	stelle
verkaufte	verkaufte
Wache	Wache
legest	legest
Bär	Bär
einsammelte	einsammelte
füllst	füllst
stellte	stellte
Steiget	Steiget
Jochen	Jochen
Kleinod	Kleinod
Feiertage	Feiertage
zerstreute	zerstreute
hieben	hieben
Schlägen	Schlägen
mahle	mahle
bekannt	bekannt
schonte	schonte
rufet	rufet
verbannet	verbannet
hinaufgehst	hinaufgehst
malen	malen
Würze	Würze
Grabe	Grabe
gehet	gehet
Anfechtung	Anfechtung
Werden	Werden
begehrten	begehrten
vierte	vierte
befragte	befragte
Sehne	Sehne
Einheimischen	Einheimischen
wirkte	wirkte
auflegte	auflegte
Sollte	Sollte
Ordnung	Ordnung
bekennst	bekennst
Herrn	Herrn
vereinigt	vereinigt
Heiden	Heiden
gelobt	gelobt
stand	stand
versuchst	versuchst
befestigten	befestigten
reifen	reifen
Heuschrecken	Heuschrecken
Palästen	Palästen
rufest	rufest
weist	weist
Basilisken	Basilisken
Aufsätzen	Aufsätzen
bewahrst	bewahrst
taten	taten
sprecht	sprecht
Tore	Tore
Gläubige	Gläubige
bestellte	bestellte
mögt	mögt
taufen	taufen
wachse	wachse
Edelsteine	Edelsteine
griechischen	griechischen
klage	klage
verliere	verliere
ehrst	ehrst
erbaut	erbaut
drücken	drücken
