Früchtchen	Früchtchen
beschuldiget	beschuldiget
emaillieret	emaillieret
ziehst	ziehst
verpuffe	verpuffe
Zapfhahn	Zapfhahn
Neumonde	Neumonde
finanziere	finanziere
ummantelten	ummantelten
pflügen	pflügen
verdammet	verdammet
verludet	verludet
verdeckt	verdeckt
fromme	fromme
Lusitaners	Lusitaners
zerstreut	zerstreut
Geringschätzung	Geringschätzung
könnten	könnten
grüble	grüble
balkanisierten	balkanisierten
Managementsystem	Managementsystem
verforme	verforme
Binde	Binde
Penis	Penis
Ei	Ei
Tische	Tische
Sitzfleisch	Sitzfleisch
Trockendock	Trockendock
Carbiden	Carbiden
schautet	schautet
schleiß	schleiß
Suchanfrage	Suchanfrage
Tust	Tust
mache	mache
sitzest	sitzest
eroberte	eroberte
Wahn	Wahn
schämest	schämest
flöteten	flöteten
Schenken	Schenken
schubset	schubset
Kreise	Kreise
Saget	Saget
baten	baten
Denkmünzen	Denkmünzen
aßest	aßest
egalisiertet	egalisiertet
Rhodochrosite	Rhodochrosite
konnotieret	konnotieret
verbrauchte	verbrauchte
rühmst	rühmst
gesellt	gesellt
pflügest	pflügest
Polyphosphat	Polyphosphat
aufstehet	aufstehet
Schicksen	Schicksen
Strontiumamalgams	Strontiumamalgams
Psi	Psi
Verdacht	Verdacht
schmuggele	schmuggele
teilen	teilen
henken	henken
dich	dich
Jagdhund	Jagdhund
Adlerbussard	Adlerbussard
dritte	dritte
deponiere	deponiere
Alle	Alle
setztest	setztest
Primärenergie	Primärenergie
Ich	Ich
zeug	zeug
tun	tun
Heptamolybdat	Heptamolybdat
nagelest	nagelest
concessionieren	concessionieren
Idolatrien	Idolatrien
gestaltest	gestaltest
Zehnten	Zehnten
narren	narren
haschieret	haschieret
Achseln	Achseln
ringen	ringen
manche	manche
verhalte	verhalte
leistest	leistest
Türkis	Türkis
Altären	Altären
Rotgusses	Rotgusses
Kadavergehorsam	Kadavergehorsam
Liebchen	Liebchen
Gehorsam	Gehorsam
Übertretung	Übertretung
schnüren	schnüren
steinigte	steinigte
Pausbacke	Pausbacke
stolze	stolze
Ebene	Ebene
Sanatoriums	Sanatoriums
Abschiedsbrief	Abschiedsbrief
Schwärmereien	Schwärmereien
schwadroniert	schwadroniert
steckst	steckst
Rücktrittes	Rücktrittes
Verwaltungsakten	Verwaltungsakten
ärgertest	ärgertest
legten	legten
treffen	treffen
unterstützten	unterstützten
beziehen	beziehen
Schnittlauch	Schnittlauch
Euter	Euter
Werden	Werden
ausführe	ausführe
kontaktiere	kontaktiere
Ambiguitäten	Ambiguitäten
schlummerte	schlummerte
Märkten	Märkten
helfest	helfest
Oxalaten	Oxalaten
durchwacht	durchwacht
fluktuiert	fluktuiert
gabelst	gabelst
Kuckucke	Kuckucke
negierest	negierest
reichtet	reichtet
meldeten	meldeten
Marokkaners	Marokkaners
aufrichtet	aufrichtet
reinstitutionalisiert	reinstitutionalisiert
beklage	beklage
versucht	versucht
Minimierungen	Minimierungen
colorierend	colorierend
Ecke	Ecke
Mäppchen	Mäppchen
Testamente	Testamente
schlabberten	schlabberten
Bist	Bist
Kost	Kost
Dezernaten	Dezernaten
Gitarrenspieler	Gitarrenspieler
kreieren	kreieren
Keilen	Keilen
Geheimdienst	Geheimdienst
tabuisierten	tabuisierten
tobet	tobet
Knöllchens	Knöllchens
sinterte	sinterte
vertraget	vertraget
grau	grau
glauben	glauben
waren	waren
Zwergschwanes	Zwergschwanes
Puder	Puder
beäugen	beäugen
Jüngern	Jüngern
warst	warst
auflöst	auflöst
labert	labert
Weste	Weste
vermahnt	vermahnt
Gaschromatographien	Gaschromatographien
dechiffriere	dechiffriere
armen	armen
rüstete	rüstete
beschwöre	beschwöre
merket	merket
verbraucht	verbraucht
Entsetzen	Entsetzen
bereits	bereits
Zähne	Zähne
Pflanzungen	Pflanzungen
Dürre	Dürre
Gebete	Gebete
Herbstwinden	Herbstwinden
trügen	trügen
Plumpse	Plumpse
Zwingburg	Zwingburg
installierten	installierten
benützt	benützt
möchten	möchten
Locken	Locken
Städte	Städte
Noseans	Noseans
schenke	schenke
sitzen	sitzen
pflanze	pflanze
Herde	Herde
fabuliere	fabuliere
Massage	Massage
überqueren	überqueren
Rechnung	Rechnung
Unterseite	Unterseite
fehle	fehle
besäen	besäen
sterilisierten	sterilisierten
umgäben	umgäben
saget	saget
Beschleuniger	Beschleuniger
scheitern	scheitern
Inauguration	Inauguration
verkapselten	verkapselten
erhöhest	erhöhest
scheiterest	scheiterest
brauche	brauche
plaziert	plaziert
Entmachtung	Entmachtung
Lehne	Lehne
bereitet	bereitet
Elstern	Elstern
eure	eure
maßen	maßen
Kommoden	Kommoden
Knüppeln	Knüppeln
Vanadaten	Vanadaten
wollte	wollte
Zeitungsente	Zeitungsente
zwängtet	zwängtet
Sehnen	Sehnen
entwaffneten	entwaffneten
unterrichten	unterrichten
grauten	grauten
hängte	hängte
Gewinnungen	Gewinnungen
generiertet	generiertet
Streich	Streich
lauten	lauten
Klappertöpfen	Klappertöpfen
regierst	regierst
Jahren	Jahren
heiliget	heiliget
vertilge	vertilge
verachtend	verachtend
zeugen	zeugen
Königreichen	Königreichen
Neuigkeiten	Neuigkeiten
Asthenosphäre	Asthenosphäre
Flaschenhälsen	Flaschenhälsen
Provinzen	Provinzen
regen	regen
offenbartest	offenbartest
blondiert	blondiert
Adeliepinguin	Adeliepinguin
Unterschlagung	Unterschlagung
wurdest	wurdest
entsündigen	entsündigen
Ende	Ende
Metallothioneinen	Metallothioneinen
Gebirgen	Gebirgen
Isobars	Isobars
denaturierte	denaturierte
lieb	lieb
heilige	heilige
Chlorats	Chlorats
Pflaume	Pflaume
Kissenschlacht	Kissenschlacht
Kohlrübe	Kohlrübe
Mitwisserschaft	Mitwisserschaft
bildest	bildest
Marjellchen	Marjellchen
lobte	lobte
Beilen	Beilen
folgend	folgend
Autonomien	Autonomien
Atommodelle	Atommodelle
peilst	peilst
mobilisieret	mobilisieret
seit	seit
porträtiere	porträtiere
Spanne	Spanne
deinen	deinen
umgaben	umgaben
implodier	implodier
blasen	blasen
nahest	nahest
Schlüchten	Schlüchten
konstatiertest	konstatiertest
Halbmonden	Halbmonden
vibriere	vibriere
Gammastrahl	Gammastrahl
feire	feire
rächest	rächest
wähnet	wähnet
tastet	tastet
Rinde	Rinde
Schneepflüge	Schneepflüge
krieget	krieget
zwänget	zwänget
späht	späht
schmiert	schmiert
Perlen	Perlen
Asteroid	Asteroid
fahret	fahret
bequemest	bequemest
Kräften	Kräften
bestraft	bestraft
Grabe	Grabe
denen	denen
Kühe	Kühe
injizierest	injizierest
aufrichte	aufrichte
folgt	folgt
Rekursionen	Rekursionen
verscheißerte	verscheißerte
Ausnahme	Ausnahme
Bifurkationen	Bifurkationen
Kürasse	Kürasse
lochten	lochten
assimilierte	assimilierte
warntet	warntet
Füchsen	Füchsen
haderte	haderte
reinige	reinige
trieben	trieben
fremden	fremden
zeuge	zeuge
zentrifugieren	zentrifugieren
gähne	gähne
verführtest	verführtest
steckte	steckte
leider	leider
Spektralbereich	Spektralbereich
zerfielest	zerfielest
Leisten	Leisten
reimte	reimte
predigtest	predigtest
Alkin	Alkin
schöpfe	schöpfe
zupftet	zupftet
sezierte	sezierte
erwärmst	erwärmst
Mikrometer	Mikrometer
schmettern	schmettern
aufnahmen	aufnahmen
bereiteten	bereiteten
rollten	rollten
dürften	dürften
stimme	stimme
Reiseleiter	Reiseleiter
Hadith	Hadith
möchtet	möchtet
UND-Gattern	UND-Gattern
sündigte	sündigte
Weißt	Weißt
fließen	fließen
Bombardierung	Bombardierung
verletzt	verletzt
tragt	tragt
fluppt	fluppt
begehrt	begehrt
spannen	spannen
machet	machet
benähmen	benähmen
Ausgangssperren	Ausgangssperren
blondierten	blondierten
Möbelstoffen	Möbelstoffen
Helme	Helme
ärgernd	ärgernd
springen	springen
besänftigtest	besänftigtest
hegst	hegst
Drachenblut	Drachenblut
Tieren	Tieren
Primärenergien	Primärenergien
beweisest	beweisest
anzeige	anzeige
Beryll	Beryll
Hadithe	Hadithe
spekulieren	spekulieren
Banketten	Banketten
Kupferkiesen	Kupferkiesen
Rabe	Rabe
Halleluja	Halleluja
Fromme	Fromme
Adlerbussarden	Adlerbussarden
Gemeinden	Gemeinden
Samarskit	Samarskit
handhabt	handhabt
drangen	drangen
Sonderbericht	Sonderbericht
Als	Als
Teilnehmerin	Teilnehmerin
verwirren	verwirren
ob	ob
blockierten	blockierten
besicheret	besicheret
warte	warte
krank	krank
Auszüge	Auszüge
Atombombe	Atombombe
Theologie	Theologie
beleidigst	beleidigst
blamierte	blamierte
glaubt	glaubt
Laubholz	Laubholz
süsse	süsse
brauchte	brauchte
gereichte	gereichte
Vogelscheuche	Vogelscheuche
fluppen	fluppen
Traubenlesen	Traubenlesen
Schwarzseherin	Schwarzseherin
bleiben	bleiben
verspätest	verspätest
streiten	streiten
kickend	kickend
äussern	äussern
pensionierten	pensionierten
hinterlege	hinterlege
verformen	verformen
ratschlagte	ratschlagte
sieht	sieht
emailliert	emailliert
Landwirte	Landwirte
Leichenschauhäusern	Leichenschauhäusern
Eutern	Eutern
Handbüchern	Handbüchern
erstehet	erstehet
pflücke	pflücke
Samstagnachmittagen	Samstagnachmittagen
Krume	Krume
gelangen	gelangen
nimmst	nimmst
Stühlen	Stühlen
sehnte	sehnte
Feiertagen	Feiertagen
ertragen	ertragen
vier	vier
massierend	massierend
Kriegsknechten	Kriegsknechten
Tintenklecks	Tintenklecks
anrichtet	anrichtet
kategorisierte	kategorisierte
Emmer	Emmer
Dominicanerinnen	Dominicanerinnen
fistete	fistete
andere	andere
strafst	strafst
Bertrandite	Bertrandite
gepuddelt	gepuddelt
nehmt	nehmt
anzögen	anzögen
dunkelten	dunkelten
Verselbstständigung	Verselbstständigung
Inder	Inder
vermahnten	vermahnten
kehret	kehret
Buntspechte	Buntspechte
Werken	Werken
piesackest	piesackest
concessioniert	concessioniert
lehren	lehren
wog	wog
prostituieret	prostituieret
überreicht	überreicht
Weinstöcke	Weinstöcke
Treppe	Treppe
bündelten	bündelten
Argyroditen	Argyroditen
Fremde	Fremde
meinem	meinem
Farbstoffen	Farbstoffen
zweifeln	zweifeln
vertonten	vertonten
Bertrandit	Bertrandit
stoßest	stoßest
diversifiziert	diversifiziert
wert	wert
Herden	Herden
Attentäter	Attentäter
bummelet	bummelet
Unwahrheiten	Unwahrheiten
gewarnt	gewarnt
entfachet	entfachet
zensierten	zensierten
ziehest	ziehest
frikassiert	frikassiert
verewigt	verewigt
blättertet	blättertet
haarte	haarte
Setzt	Setzt
Kleinod	Kleinod
Schnarchralle	Schnarchralle
Dorsch	Dorsch
Säuen	Säuen
wurdet	wurdet
Gründungsprivilegien	Gründungsprivilegien
brachen	brachen
zeugt	zeugt
verstehest	verstehest
Achatschnecken	Achatschnecken
höhnest	höhnest
winke	winke
Paradiesapfel	Paradiesapfel
Knüppels	Knüppels
bebten	bebten
Myriade	Myriade
Schober	Schober
beunruhige	beunruhige
Pferden	Pferden
bringst	bringst
verderbest	verderbest
formirte	formirte
preiset	preiset
extemporiere	extemporiere
kehren	kehren
zerrüttete	zerrüttete
Sekten	Sekten
mineralisierten	mineralisierten
baggerte	baggerte
untersagtest	untersagtest
Bilderstürmer	Bilderstürmer
Gehirnwelle	Gehirnwelle
erklingt	erklingt
Mähnenwölfen	Mähnenwölfen
Busen	Busen
stäupt	stäupt
vermeße	vermeße
Assimilationen	Assimilationen
hingehst	hingehst
tust	tust
tief	tief
inspirierest	inspirierest
predigte	predigte
Fellachinnen	Fellachinnen
glaubten	glaubten
bekriegtet	bekriegtet
lehrte	lehrte
vergrubt	vergrubt
Fremden	Fremden
zeichnest	zeichnest
wechselwirkte	wechselwirkte
Thioacetalen	Thioacetalen
Bundesgebiet	Bundesgebiet
Muhme	Muhme
erlösest	erlösest
Grabbeltisch	Grabbeltisch
streutet	streutet
auflöste	auflöste
trinkst	trinkst
malten	malten
ringst	ringst
schleim	schleim
explodierten	explodierten
übrigbleibt	übrigbleibt
ehrest	ehrest
tatet	tatet
dekompilierten	dekompilierten
hüpfen	hüpfen
Apportierhunde	Apportierhunde
Zeugen	Zeugen
Negermusik	Negermusik
Weiblein	Weiblein
bilden	bilden
plärrtest	plärrtest
Kernspaltung	Kernspaltung
gibt	gibt
Essigsäurechlorid	Essigsäurechlorid
zuppen	zuppen
äusserst	äusserst
Sagte	Sagte
aufheben	aufheben
Bademantel	Bademantel
Bildschirmfoto	Bildschirmfoto
Erlösungen	Erlösungen
Würzen	Würzen
höhnte	höhnte
Seile	Seile
Mischung	Mischung
dekoriere	dekoriere
Gegenleistung	Gegenleistung
speisest	speisest
dringt	dringt
Sichelzellenanämien	Sichelzellenanämien
raubet	raubet
verurteile	verurteile
Abbild	Abbild
könnet	könnet
Brüder	Brüder
schummelst	schummelst
Älteste	Älteste
verkürzte	verkürzte
grünet	grünet
oxidierst	oxidierst
vernehmen	vernehmen
Omnibus	Omnibus
Geschreis	Geschreis
urbanisiert	urbanisiert
Laib	Laib
Aggressor	Aggressor
Atomphysiker	Atomphysiker
Forschung	Forschung
Pi	Pi
Scherzen	Scherzen
älteste	älteste
besucht	besucht
verzehrt	verzehrt
spaltetest	spaltetest
zuppe	zuppe
thematisierten	thematisierten
wegführe	wegführe
beförderet	beförderet
Anhängseln	Anhängseln
Chemikerinnen	Chemikerinnen
nütze	nütze
eiterte	eiterte
Gleitzeit	Gleitzeit
erbrütet	erbrütet
Linguist	Linguist
begrubt	begrubt
Silberdrähten	Silberdrähten
jeden	jeden
bemühten	bemühten
verselbstständigest	verselbstständigest
dürfe	dürfe
wohnst	wohnst
faltest	faltest
boß	boß
preise	preise
Nachteile	Nachteile
geboten	geboten
Leiden	Leiden
überreichen	überreichen
geleitet	geleitet
lobe	lobe
keinem	keinem
Abkürzungsverzeichnisse	Abkürzungsverzeichnisse
legte	legte
fragmentierst	fragmentierst
Kannst	Kannst
Brieföffner	Brieföffner
Urologe	Urologe
Laie	Laie
ernte	ernte
fasse	fasse
Holzquirl	Holzquirl
fällt	fällt
Verbrechen	Verbrechen
Orgeln	Orgeln
tote	tote
überschnitten	überschnitten
ander	ander
hattest	hattest
heilte	heilte
reagierte	reagierte
Ionen	Ionen
Tanne	Tanne
löste	löste
querest	querest
Stall	Stall
Seelöwen	Seelöwen
reanimierten	reanimierten
lockerte	lockerte
schaffest	schaffest
lachte	lachte
er	er
flenstet	flenstet
Backpflaumen	Backpflaumen
bekehret	bekehret
Heiratsgütern	Heiratsgütern
zwang	zwang
greifet	greifet
wehrte	wehrte
wogen	wogen
Carbids	Carbids
Gehirnwellen	Gehirnwellen
taufst	taufst
Krankenschein	Krankenschein
belohnte	belohnte
Waren	Waren
Licht	Licht
jaule	jaule
Totenglocke	Totenglocke
übersehest	übersehest
Kassiterits	Kassiterits
ihn	ihn
Firnisse	Firnisse
Atommodellen	Atommodellen
erschütterte	erschütterte
Essen	Essen
gedachte	gedachte
verzeichnete	verzeichnete
gelegt	gelegt
Gewalttätern	Gewalttätern
Bedeutung	Bedeutung
immunisiere	immunisiere
sponsertest	sponsertest
frohlockte	frohlockte
Sollst	Sollst
gründen	gründen
Freunde	Freunde
stiften	stiften
liebtet	liebtet
wähnt	wähnt
backt	backt
downloadete	downloadete
Stufe	Stufe
austilgen	austilgen
gezählt	gezählt
wallfahrest	wallfahrest
redetest	redetest
fehlen	fehlen
Magiern	Magiern
regiertest	regiertest
fragst	fragst
verführest	verführest
stoppten	stoppten
rufe	rufe
angehört	angehört
kappet	kappet
Philerast	Philerast
Rußen	Rußen
Molybdite	Molybdite
zentriert	zentriert
Nachweisreagenzien	Nachweisreagenzien
Landstreichereien	Landstreichereien
schmelzt	schmelzt
schreiben	schreiben
besorg	besorg
Primatologen	Primatologen
fertigte	fertigte
möge	möge
eurem	eurem
schmelzen	schmelzen
anderen	anderen
verschont	verschont
werten	werten
Teile	Teile
kranken	kranken
Vorstoß	Vorstoß
gähnten	gähnten
Androiden	Androiden
binde	binde
seht	seht
ernten	ernten
beläufst	beläufst
Flamingo	Flamingo
herrschest	herrschest
entzögen	entzögen
Schläge	Schläge
wechselte	wechselte
versüße	versüße
Schnittlauche	Schnittlauche
schwirrt	schwirrt
verselbstständige	verselbstständige
lispelten	lispelten
gehört	gehört
Dampfschiffen	Dampfschiffen
härtet	härtet
Juden	Juden
Kirchhof	Kirchhof
Schwirrvogel	Schwirrvogel
murmelst	murmelst
Helmen	Helmen
Schreiber	Schreiber
Drohkulisse	Drohkulisse
prangte	prangte
geloben	geloben
vierte	vierte
Nervenzellen	Nervenzellen
Falz	Falz
Fallt	Fallt
Gehör	Gehör
sicherst	sicherst
Seelöwe	Seelöwe
Brettspiele	Brettspiele
toten	toten
sezierst	sezierst
außen	außen
vibrierend	vibrierend
demütiget	demütiget
reiche	reiche
verklagt	verklagt
Hochhäuser	Hochhäuser
stigmatisierest	stigmatisierest
strecken	strecken
dingt	dingt
Türkin	Türkin
Wüsten	Wüsten
Fußmatte	Fußmatte
lohnt	lohnt
vereinbarten	vereinbarten
Früchte	Früchte
Bauwerke	Bauwerke
reformierten	reformierten
mikrominiaturisiere	mikrominiaturisiere
willen	willen
drücken	drücken
veranstaltest	veranstaltest
Kälber	Kälber
Streichen	Streichen
kitzele	kitzele
betrügen	betrügen
Gepäckträgern	Gepäckträgern
Bote	Bote
flambiert	flambiert
babbelst	babbelst
Leiste	Leiste
konsumiere	konsumiere
hupen	hupen
blase	blase
strandend	strandend
schneidet	schneidet
webet	webet
Gnaden	Gnaden
vertagt	vertagt
bauet	bauet
sondern	sondern
Kohlenstoffgehalten	Kohlenstoffgehalten
beneidete	beneidete
Bruchstrich	Bruchstrich
Erdboden	Erdboden
meines	meines
pensionierest	pensionierest
absagen	absagen
vertilgen	vertilgen
Trioxid	Trioxid
Anhänge	Anhänge
Pfahl	Pfahl
gleite	gleite
überschatteten	überschatteten
sündigst	sündigst
Monate	Monate
erwärmten	erwärmten
Aas	Aas
Nahrungsbestandteil	Nahrungsbestandteil
wenden	wenden
bewürben	bewürben
erwärmet	erwärmet
funkelet	funkelet
werdest	werdest
Gefangene	Gefangene
vereinigt	vereinigt
Steuerwagens	Steuerwagens
absolviertet	absolviertet
Bienenzüchter	Bienenzüchter
überwiese	überwiese
Schlüchte	Schlüchte
habe	habe
erhebest	erhebest
Kassettenrekorder	Kassettenrekorder
fülle	fülle
versteckend	versteckend
hineinbrächte	hineinbrächte
knufften	knufften
trage	trage
Unrechten	Unrechten
Maß	Maß
protestierst	protestierst
Antimusters	Antimusters
gebt	gebt
Laufringen	Laufringen
verringeret	verringeret
schäumtest	schäumtest
ab	ab
vorn	vorn
beichteten	beichteten
Stücke	Stücke
loben	loben
beschwindele	beschwindele
Weinberge	Weinberge
Samstagnachmittag	Samstagnachmittag
taten	taten
bewahrheitete	bewahrheitete
Hebet	Hebet
willst	willst
bedurftest	bedurftest
Milz	Milz
begehr	begehr
versagen	versagen
anfingst	anfingst
arrivierst	arrivierst
hinterfragten	hinterfragten
Scheck	Scheck
verhungert	verhungert
Taschenwörterbuches	Taschenwörterbuches
raubest	raubest
harmoniere	harmoniere
gekröst	gekröst
grabe	grabe
diente	diente
Nährmediums	Nährmediums
planschest	planschest
bewässertet	bewässertet
jungen	jungen
gelobe	gelobe
Aderhaut	Aderhaut
Substanz	Substanz
Untier	Untier
hievst	hievst
bringet	bringet
schöpfte	schöpfte
Kreisen	Kreisen
austilgest	austilgest
Pfandgeld	Pfandgeld
verallgemeinerst	verallgemeinerst
Pfunden	Pfunden
veranstalten	veranstalten
durfte	durfte
entzweit	entzweit
kugele	kugele
Hinterwäldlern	Hinterwäldlern
Remis	Remis
Pfleglinge	Pfleglinge
Maultier	Maultier
Rückumlauten	Rückumlauten
Trickbetrügern	Trickbetrügern
lodertet	lodertet
kichern	kichern
schwadronierten	schwadronierten
Playlist	Playlist
Eselsohren	Eselsohren
emigriert	emigriert
ermahnet	ermahnet
Kehret	Kehret
rebelliertet	rebelliertet
bewahret	bewahret
viele	viele
Brote	Brote
Notstand	Notstand
Stoffwechselweg	Stoffwechselweg
enterten	enterten
Laubbläsern	Laubbläsern
ernteten	ernteten
pendelt	pendelt
entwendete	entwendete
verbirgt	verbirgt
lügt	lügt
notlandet	notlandet
knitterte	knitterte
Ansteckers	Ansteckers
Hornunges	Hornunges
versagt	versagt
pfänden	pfänden
Blitze	Blitze
appellierte	appellierte
Deckenzapfen	Deckenzapfen
Lärchen	Lärchen
funzt	funzt
Funktionalität	Funktionalität
folget	folget
erkälteten	erkälteten
Adeliepinguins	Adeliepinguins
Töpfe	Töpfe
Sphären	Sphären
suchen	suchen
Meldezettel	Meldezettel
Tretlager	Tretlager
wehen	wehen
Euphemismen	Euphemismen
filzen	filzen
Eingeweiden	Eingeweiden
Abfertigungsgebäuden	Abfertigungsgebäuden
Pläsier	Pläsier
foppst	foppst
radierte	radierte
verteidigt	verteidigt
ausführen	ausführen
Kaufkraft	Kaufkraft
Klärungen	Klärungen
gewärtigten	gewärtigten
überreichend	überreichend
billige	billige
Malaysierinnen	Malaysierinnen
weg	weg
Welteninseln	Welteninseln
schätzen	schätzen
bitten	bitten
Aktienkurs	Aktienkurs
speise	speise
Worte	Worte
Feierabende	Feierabende
trinken	trinken
Gedanken	Gedanken
Steigen	Steigen
rauschte	rauschte
unserer	unserer
bereitend	bereitend
führe	führe
begnadigte	begnadigte
stapelten	stapelten
Dödeln	Dödeln
konvertieren	konvertieren
Sorget	Sorget
Versorgungen	Versorgungen
schluchzte	schluchzte
wollt	wollt
Gasgemischen	Gasgemischen
verspielte	verspielte
Otavit	Otavit
Biene	Biene
zerschlagt	zerschlagt
Malaysierin	Malaysierin
Leichenschauhäuser	Leichenschauhäuser
erinnre	erinnre
Gerät	Gerät
erzwangt	erzwangt
Päckchen	Päckchen
mehr	mehr
bekennst	bekennst
verlautete	verlautete
Flenser	Flenser
maximierten	maximierten
Laufet	Laufet
Zeithorizonte	Zeithorizonte
schnelle	schnelle
Anhängsel	Anhängsel
verführt	verführt
klingt	klingt
erlöset	erlöset
verknüpfet	verknüpfet
Normdatum	Normdatum
Deutungen	Deutungen
Geckos	Geckos
klagte	klagte
trüb	trüb
Atommassen	Atommassen
Halbgott	Halbgott
zerbrechest	zerbrechest
rechten	rechten
Einrad	Einrad
lesen	lesen
Schlaraffenlandes	Schlaraffenlandes
Linie	Linie
Butike	Butike
Dochte	Dochte
schwimmst	schwimmst
Solches	Solches
Pater	Pater
solchem	solchem
ausziehst	ausziehst
erratet	erratet
jemanden	jemanden
ackerst	ackerst
fresse	fresse
begrub	begrub
vierten	vierten
Spitzen	Spitzen
Buchfinken	Buchfinken
verwirklicht	verwirklicht
merke	merke
Gemüt	Gemüt
wünschst	wünschst
Premieren	Premieren
punktetest	punktetest
Dingen	Dingen
Trümmersprachen	Trümmersprachen
dümpelest	dümpelest
gestikulierst	gestikulierst
geschlummert	geschlummert
Automatikgetrieben	Automatikgetrieben
Domäne	Domäne
sabbelten	sabbelten
Kaufleute	Kaufleute
Rasterkraftmikroskop	Rasterkraftmikroskop
hydrogentartrat	hydrogentartrat
privilegierst	privilegierst
Futtermitteln	Futtermitteln
gründe	gründe
nächste	nächste
besänne	besänne
ziere	ziere
tage	tage
Reichweite	Reichweite
gelobst	gelobst
einführte	einführte
dolmetschst	dolmetschst
schließen	schließen
scheute	scheute
Wühltischen	Wühltischen
besprächen	besprächen
Gehorchet	Gehorchet
watete	watete
erstehen	erstehen
Wären	Wären
Borkenkäfer	Borkenkäfer
gedenkt	gedenkt
wallet	wallet
beschottre	beschottre
stürzest	stürzest
schweigen	schweigen
läute	läute
Notizen	Notizen
stellst	stellst
Wiederauferstehung	Wiederauferstehung
füllte	füllte
sabbere	sabbere
Schnipseln	Schnipseln
gebären	gebären
unsre	unsre
lieben	lieben
harmonierest	harmonierest
Alibi	Alibi
hantiert	hantiert
zerbräche	zerbräche
trüge	trüge
Stärke	Stärke
Erzeugungen	Erzeugungen
jedes	jedes
babbelten	babbelten
ritze	ritze
verbüßest	verbüßest
War	War
pflanzt	pflanzt
strafte	strafte
Zementen	Zementen
Drang	Drang
plazierest	plazierest
Ypecaharalle	Ypecaharalle
füllst	füllst
Fischen	Fischen
beschottert	beschottert
opferte	opferte
habest	habest
widerrufe	widerrufe
Spannt	Spannt
liebe	liebe
hoben	hoben
schämst	schämst
Schotten	Schotten
Shortcuts	Shortcuts
Habe	Habe
Gipfeltreffen	Gipfeltreffen
Orten	Orten
verstehet	verstehet
Nadelbäume	Nadelbäume
vertilgst	vertilgst
optimiert	optimiert
Asylrechte	Asylrechte
Agoraphobien	Agoraphobien
Sinnen	Sinnen
weh	weh
Fragen	Fragen
werfet	werfet
versuchten	versuchten
Gasen	Gasen
Gemüseläden	Gemüseläden
berücksichtigt	berücksichtigt
verdamm	verdamm
stiegen	stiegen
trieb	trieb
Einheimischen	Einheimischen
Kaufhäusern	Kaufhäusern
Antimustern	Antimustern
Steinen	Steinen
Nanosatellit	Nanosatellit
Dewargefäße	Dewargefäße
Eissteinen	Eissteinen
erscheinest	erscheinest
Somiten	Somiten
ihren	ihren
erbauet	erbauet
verdammend	verdammend
besuchen	besuchen
Aha-Erlebnisse	Aha-Erlebnisse
Silbergeschirr	Silbergeschirr
strandeten	strandeten
forschen	forschen
bespracht	bespracht
Ringeltaube	Ringeltaube
verziehst	verziehst
Petersfischen	Petersfischen
schau	schau
stäupten	stäupten
verbluten	verbluten
grüne	grüne
ratschlaget	ratschlaget
rinnt	rinnt
planschtest	planschtest
Tatsachenbeschöniger	Tatsachenbeschöniger
Suchanfragen	Suchanfragen
Nanokondensatoren	Nanokondensatoren
Bilderstürmers	Bilderstürmers
all	all
Böse	Böse
heiße	heiße
stehest	stehest
revoltierte	revoltierte
Abschreckung	Abschreckung
beißt	beißt
Anachronismus	Anachronismus
lade	lade
ehret	ehret
träumen	träumen
Schwänze	Schwänze
bedenket	bedenket
Efeu	Efeu
Linken	Linken
vergaset	vergaset
predigten	predigten
euren	euren
sehet	sehet
Rekursion	Rekursion
imkeret	imkeret
verkündigt	verkündigt
gefällst	gefällst
halben	halben
Fusseln	Fusseln
erkennet	erkennet
Wärt	Wärt
tappten	tappten
begrübe	begrübe
Schuhe	Schuhe
ungefälschter	ungefälschter
Gigapascal	Gigapascal
Pedanten	Pedanten
unschuldigen	unschuldigen
inhalierest	inhalierest
Halsabschneider	Halsabschneider
dein	dein
bewässerst	bewässerst
Kakaos	Kakaos
Tiefschutzen	Tiefschutzen
hauen	hauen
wehe	wehe
tätowierest	tätowierest
abzieht	abzieht
anhangt	anhangt
Girls	Girls
neigest	neigest
Einsätzen	Einsätzen
Kerzenlichtern	Kerzenlichtern
reizest	reizest
besichert	besichert
verdammtet	verdammtet
faschierst	faschierst
Nagellackentferner	Nagellackentferner
Iberer	Iberer
Stämmen	Stämmen
Elementen	Elementen
reizen	reizen
Hälse	Hälse
Früchten	Früchten
verseift	verseift
einem	einem
Peptids	Peptids
einführt	einführt
entkörperlichte	entkörperlichte
Lenkstange	Lenkstange
Paragraphenreitern	Paragraphenreitern
gedachten	gedachten
flupptest	flupptest
Astat	Astat
verschmelze	verschmelze
Eingeweide	Eingeweide
kämpfte	kämpfte
streiften	streiften
prediget	prediget
hattet	hattet
Rooibos	Rooibos
Schlagzeugern	Schlagzeugern
Gammastrahlen	Gammastrahlen
beschwören	beschwören
erwachend	erwachend
Höret	Höret
hüte	hüte
spiele	spiele
gravierten	gravierten
irrte	irrte
Atommasse	Atommasse
Welchen	Welchen
Epiker	Epiker
Kohlen	Kohlen
rede	rede
schwelle	schwelle
plagen	plagen
naschst	naschst
schlachtet	schlachtet
zerrüttet	zerrüttet
lösend	lösend
schauen	schauen
Edelsteinen	Edelsteinen
Rücktritt	Rücktritt
abalieniertest	abalieniertest
Tischen	Tischen
gewinnen	gewinnen
Wespen	Wespen
Affenbrotbaum	Affenbrotbaum
simulierst	simulierst
losest	losest
Wadenbeines	Wadenbeines
gereicht	gereicht
verringerten	verringerten
Erstarren	Erstarren
umkäme	umkäme
Banknoten	Banknoten
höbe	höbe
heißt	heißt
erziehst	erziehst
liste	liste
Gemurmel	Gemurmel
behauptete	behauptete
kürzten	kürzten
stoppte	stoppte
Schwänzchen	Schwänzchen
Tintenfisch	Tintenfisch
Fluorgehalte	Fluorgehalte
Flensern	Flensern
Schneider	Schneider
Unternehmung	Unternehmung
Sitz	Sitz
Gefängnissen	Gefängnissen
löst	löst
schimmerst	schimmerst
verjährest	verjährest
bist	bist
wünsche	wünsche
betrübt	betrübt
gelobtest	gelobtest
Republikflucht	Republikflucht
Überschüssen	Überschüssen
Helden	Helden
Selbstversuche	Selbstversuche
Zipfelmütze	Zipfelmütze
Maultieren	Maultieren
Polarisation	Polarisation
Somite	Somite
Zeitschlitzen	Zeitschlitzen
Telefonverkäufer	Telefonverkäufer
frottierten	frottierten
übrigbleiben	übrigbleiben
entmineralisieret	entmineralisieret
Fettes	Fettes
verlasset	verlasset
überbewerte	überbewerte
gräbst	gräbst
machte	machte
Löwen	Löwen
Teekesseln	Teekesseln
Präservativen	Präservativen
zweifel	zweifel
Finanzministern	Finanzministern
mögest	mögest
knutschst	knutschst
Leitkegeln	Leitkegeln
ruckeln	ruckeln
verlautet	verlautet
Kurkuma	Kurkuma
Rechenbrettern	Rechenbrettern
bemühet	bemühet
Freeganer	Freeganer
Tritte	Tritte
leite	leite
Smaragdkehlkolibris	Smaragdkehlkolibris
köderte	köderte
plumpsten	plumpsten
Stechpalmen	Stechpalmen
erwähnten	erwähnten
Kaufhäuser	Kaufhäuser
Animation	Animation
Acht	Acht
Deuteriums	Deuteriums
liebte	liebte
gehorchten	gehorchten
obfuskieren	obfuskieren
bekannt	bekannt
linken	linken
Lautschrift	Lautschrift
suchst	suchst
herrschet	herrschet
Managementsystemen	Managementsystemen
Lautwandel	Lautwandel
Weile	Weile
klone	klone
demütigte	demütigte
Ehren	Ehren
Bittersüß	Bittersüß
Schafe	Schafe
Protonen	Protonen
filtern	filtern
Kannen	Kannen
Anker	Anker
ritten	ritten
Arsch	Arsch
Recitativ	Recitativ
wer	wer
Werk	Werk
grübelte	grübelte
folge	folge
lauft	lauft
halbierest	halbierest
Pflanzenwachstum	Pflanzenwachstum
Steuerborden	Steuerborden
legen	legen
Fetten	Fetten
Aachener	Aachener
Plüschtier	Plüschtier
Kleinodien	Kleinodien
nähe	nähe
Temperaturanstieg	Temperaturanstieg
Deutung	Deutung
Haarverlust	Haarverlust
respektiere	respektiere
opfern	opfern
bromiertet	bromiertet
tagen	tagen
vertilgest	vertilgest
sagten	sagten
stelle	stelle
Maße	Maße
fokussierten	fokussierten
schämte	schämte
Bleiglanz	Bleiglanz
geleiteten	geleiteten
Fischotter	Fischotter
Wanderfalken	Wanderfalken
Feuerteufels	Feuerteufels
lanciertet	lanciertet
ermutigt	ermutigt
instanziier	instanziier
fritierten	fritierten
fritierst	fritierst
Amputierte	Amputierte
gedenkest	gedenkest
steigerten	steigerten
suche	suche
seines	seines
Ausbeuter	Ausbeuter
betrübe	betrübe
Renegaten	Renegaten
Atemluft	Atemluft
frikassierend	frikassierend
Linien	Linien
inneren	inneren
Berber	Berber
warnt	warnt
demoralisiere	demoralisiere
stärket	stärket
Diagnostik	Diagnostik
speist	speist
Beine	Beine
bröckelten	bröckelten
verbot	verbot
Agoraphobie	Agoraphobie
weine	weine
substituierend	substituierend
Bundesgebieten	Bundesgebieten
erstürmt	erstürmt
repräsentieret	repräsentieret
verpufftest	verpufftest
vertraute	vertraute
hämmerst	hämmerst
verlassen	verlassen
impfte	impfte
Schwestern	Schwestern
Zwangsarbeiterin	Zwangsarbeiterin
reizet	reizet
Hälsen	Hälsen
Augen	Augen
werdet	werdet
Lüste	Lüste
würdest	würdest
urbanisier	urbanisier
Abartigkeiten	Abartigkeiten
zeugten	zeugten
Küchenmaschinen	Küchenmaschinen
taufet	taufet
Introjektion	Introjektion
optimierte	optimierte
bescheißt	bescheißt
liehen	liehen
verschärftet	verschärftet
beschotteret	beschotteret
Tübinger	Tübinger
Schenke	Schenke
beansprucht	beansprucht
motivierten	motivierten
Isobar	Isobar
Lehrbücher	Lehrbücher
egalisierten	egalisierten
vandaliere	vandaliere
schimmerest	schimmerest
Kanzlei	Kanzlei
säte	säte
Einöden	Einöden
ärgere	ärgere
gedächten	gedächten
Klauen	Klauen
Schamentzündung	Schamentzündung
schreie	schreie
fritieret	fritieret
Radsatzes	Radsatzes
griffe	griffe
Datentypen	Datentypen
Reststoffen	Reststoffen
vergliche	vergliche
zerschlaget	zerschlaget
Pfunde	Pfunde
Reststoff	Reststoff
allen	allen
Grüßet	Grüßet
Ärzten	Ärzten
Ochsen	Ochsen
designiertet	designiertet
Konifere	Konifere
anrührt	anrührt
Radfahrer	Radfahrer
verwirkliche	verwirkliche
deckst	deckst
Panzerschrecke	Panzerschrecke
fladern	fladern
trotzt	trotzt
erstarrten	erstarrten
plumpse	plumpse
schlaft	schlaft
pflegte	pflegte
überlebest	überlebest
Zapfhähnen	Zapfhähnen
bekennet	bekennet
Wirst	Wirst
Sabbate	Sabbate
niemand	niemand
Kanzlerinnen	Kanzlerinnen
trödele	trödele
Kraftfahrzeuges	Kraftfahrzeuges
verbleibet	verbleibet
klaget	klaget
Einem	Einem
einigte	einigte
sannen	sannen
rufst	rufst
Weinstöcken	Weinstöcken
entgegenkamen	entgegenkamen
Soge	Soge
gewähret	gewähret
Wiederauferstehungen	Wiederauferstehungen
alarmiere	alarmiere
entfolgte	entfolgte
wässerten	wässerten
Meeren	Meeren
aufsteht	aufsteht
Zinkat	Zinkat
Ärschen	Ärschen
überweist	überweist
Begünstigung	Begünstigung
bewies	bewies
besitze	besitze
Staatsführungen	Staatsführungen
rühmte	rühmte
Chinakohl	Chinakohl
verdeckte	verdeckte
Wäre	Wäre
Fahlflanken-Ameisenwürgern	Fahlflanken-Ameisenwürgern
bekehrte	bekehrte
verbrauchten	verbrauchten
Lebenskräften	Lebenskräften
stiege	stiege
enträtselst	enträtselst
schluchze	schluchze
beanspruchest	beanspruchest
bölket	bölket
Komponistinnen	Komponistinnen
säumen	säumen
Darlehen	Darlehen
Kerzenlichter	Kerzenlichter
vermöget	vermöget
Berufen	Berufen
plissierten	plissierten
wohnte	wohnte
verkleidete	verkleidete
Besprechungen	Besprechungen
konnotierst	konnotierst
schöben	schöben
verstörte	verstörte
schaffet	schaffet
klage	klage
Dachdeckerin	Dachdeckerin
Rhabarbern	Rhabarbern
Märkte	Märkte
seinem	seinem
übersiehst	übersiehst
erlasset	erlasset
Komponistin	Komponistin
Pflanzenstoff	Pflanzenstoff
verführten	verführten
Fahlflanken-Ameisenwürger	Fahlflanken-Ameisenwürger
wehre	wehre
Lümmeltüte	Lümmeltüte
verwirrest	verwirrest
Einzelgänger	Einzelgänger
posiert	posiert
beschuldigt	beschuldigt
Diäresen	Diäresen
Nullpunktes	Nullpunktes
laben	laben
hingeht	hingeht
Höhlen	Höhlen
privatisierest	privatisierest
zerfielen	zerfielen
Anschlägen	Anschlägen
verzweigst	verzweigst
schließe	schließe
Käsereiben	Käsereiben
entheilige	entheilige
jauchzte	jauchzte
Knöllchen	Knöllchen
Bazziten	Bazziten
Begrenzungen	Begrenzungen
Tausch	Tausch
verunziere	verunziere
Kerf	Kerf
fastete	fastete
Alte	Alte
unterwerfest	unterwerfest
bewässern	bewässern
murmeln	murmeln
fassest	fassest
verbesserten	verbesserten
Dominicanerin	Dominicanerin
malochet	malochet
Donoren	Donoren
schenkest	schenkest
Deckenfarbe	Deckenfarbe
bedient	bedient
Basiliken	Basiliken
Barschaften	Barschaften
gönnest	gönnest
ermordeten	ermordeten
parlieren	parlieren
Floß	Floß
föhnest	föhnest
Scherzes	Scherzes
Unterschlagungen	Unterschlagungen
unterschieden	unterschieden
stäupte	stäupte
Oberlippe	Oberlippe
plagte	plagte
lauf	lauf
Ösophagospasmen	Ösophagospasmen
erfreute	erfreute
Zeitplanes	Zeitplanes
grien	grien
schwebe	schwebe
verglichest	verglichest
lehre	lehre
mißversteht	mißversteht
Felsboden	Felsboden
denaturierten	denaturierten
moppen	moppen
Aktivisten	Aktivisten
widmest	widmest
angehöre	angehöre
Provinz	Provinz
Gehorcht	Gehorcht
Gegebenheiten	Gegebenheiten
wachsen	wachsen
aufhobt	aufhobt
spaltest	spaltest
wehrtest	wehrtest
Mäuse	Mäuse
lange	lange
stimmet	stimmet
hinterzöge	hinterzöge
erwache	erwache
heißet	heißet
ahnten	ahnten
Kalb	Kalb
besprengen	besprengen
vermag	vermag
dressierten	dressierten
Stiefvater	Stiefvater
arm	arm
Rhabarber	Rhabarber
Ästen	Ästen
Ionenaustauscher	Ionenaustauscher
Berylle	Berylle
Kalifeldspate	Kalifeldspate
Zäumen	Zäumen
langte	langte
Last	Last
inhalier	inhalier
Leitkegel	Leitkegel
quantisierte	quantisierte
halltet	halltet
regiert	regiert
Beobachtungen	Beobachtungen
Pumpellyiten	Pumpellyiten
Unglaube	Unglaube
brechen	brechen
Videoaufzeichnungen	Videoaufzeichnungen
Zähnen	Zähnen
versteckst	versteckst
führen	führen
explodierst	explodierst
begehrtest	begehrtest
Gedächtnissen	Gedächtnissen
verdrängt	verdrängt
fasset	fasset
anhanget	anhanget
verzweifelten	verzweifelten
verflog	verflog
Nährmedien	Nährmedien
Stätte	Stätte
Meinet	Meinet
brillierest	brillierest
Skorpione	Skorpione
Apostel	Apostel
Sauberfrau	Sauberfrau
blende	blende
Fellachin	Fellachin
Durchbruch	Durchbruch
Dezernat	Dezernat
versklavt	versklavt
Eine	Eine
Spießen	Spießen
leihe	leihe
besitzest	besitzest
schreist	schreist
befürchtet	befürchtet
sündigt	sündigt
Donnerstagabenden	Donnerstagabenden
Alltag	Alltag
Mäusen	Mäusen
auflegt	auflegt
raten	raten
schaffen	schaffen
räumet	räumet
blitzet	blitzet
Einer	Einer
Gasflaschen	Gasflaschen
generiert	generiert
Greyerzern	Greyerzern
Abschirmungen	Abschirmungen
Kindergeldern	Kindergeldern
Füchsinnen	Füchsinnen
entsetzen	entsetzen
anrufen	anrufen
glänzte	glänzte
gebührt	gebührt
unsrer	unsrer
Dudelsäcken	Dudelsäcken
vergiften	vergiften
wachet	wachet
keines	keines
offenbarten	offenbarten
Krieg	Krieg
Funkfeuern	Funkfeuern
naschten	naschten
spannt	spannt
wehr	wehr
losten	losten
Gegenleistungen	Gegenleistungen
Adhäsionen	Adhäsionen
Nanoteslan	Nanoteslan
Eingaben	Eingaben
WebHook	WebHook
schnappet	schnappet
redete	redete
Solche	Solche
erntet	erntet
gedolmetscht	gedolmetscht
backen	backen
revoltiert	revoltiert
denaturieret	denaturieret
Volltreffer	Volltreffer
ehrte	ehrte
bestellt	bestellt
schmuste	schmuste
Wehre	Wehre
Eisenkraut	Eisenkraut
reichen	reichen
Ihr	Ihr
abweichest	abweichest
Unsere	Unsere
moppte	moppte
Sprödmetall	Sprödmetall
verkleinern	verkleinern
auszogen	auszogen
Tausche	Tausche
Denen	Denen
vergrabest	vergrabest
wurde	wurde
Gebäck	Gebäck
formirend	formirend
benütztest	benütztest
verunglimpfen	verunglimpfen
Lob	Lob
Klüften	Klüften
Spektroskopie	Spektroskopie
flambierest	flambierest
löge	löge
fluktuierte	fluktuierte
Rubine	Rubine
hinterzögen	hinterzögen
prahlet	prahlet
schießen	schießen
ehrst	ehrst
gedachtest	gedachtest
chloroformieret	chloroformieret
scheucht	scheucht
tut	tut
Staatsanleihe	Staatsanleihe
Reisebüros	Reisebüros
Finanzminister	Finanzminister
Lümmeltüten	Lümmeltüten
emittierte	emittierte
Märtyrer	Märtyrer
erstaunst	erstaunst
Firnis	Firnis
aber	aber
Blicksilber	Blicksilber
Geschwindigkeitsmesser	Geschwindigkeitsmesser
entkäme	entkäme
Heuschrecken	Heuschrecken
posierst	posierst
Herabsetzung	Herabsetzung
aufwachte	aufwachte
sticke	sticke
Füllfeder	Füllfeder
zuhört	zuhört
Röcken	Röcken
Sabotagen	Sabotagen
grüntet	grüntet
Trümmersprache	Trümmersprache
Gute	Gute
Stäben	Stäben
austilge	austilge
evakuieret	evakuieret
Werkzeugen	Werkzeugen
begebe	begebe
annektierten	annektierten
Wadenbein	Wadenbein
Kosten	Kosten
dotierst	dotierst
lösen	lösen
Lobet	Lobet
könne	könne
Mein	Mein
kommst	kommst
Amputierten	Amputierten
quantisiere	quantisiere
ummantle	ummantle
Kriegsenden	Kriegsenden
entmineralisierst	entmineralisierst
zürnst	zürnst
Chasar	Chasar
spielet	spielet
formulierst	formulierst
Homodimere	Homodimere
stapften	stapften
vielen	vielen
sinke	sinke
flitzte	flitzte
Rutheniumisotop	Rutheniumisotop
verwirft	verwirft
kabeln	kabeln
gabelt	gabelt
putzt	putzt
Augenglases	Augenglases
erkaltest	erkaltest
besäet	besäet
zählet	zählet
Dorsche	Dorsche
Zöpfen	Zöpfen
brauste	brauste
Gelobet	Gelobet
Pianos	Pianos
transportierten	transportierten
heiligten	heiligten
Excimerlaser	Excimerlaser
addieret	addieret
Tasten	Tasten
regieren	regieren
jaulst	jaulst
Wachet	Wachet
fehlet	fehlet
Jude	Jude
anzeigen	anzeigen
sedimentiert	sedimentiert
privatisiert	privatisiert
gedenken	gedenken
kritzeln	kritzeln
vernickele	vernickele
fingieret	fingieret
Iberers	Iberers
Bärenfelle	Bärenfelle
dürft	dürft
Saiblinge	Saiblinge
kennet	kennet
bürsteten	bürsteten
Für	Für
googelest	googelest
evakuierte	evakuierte
fressen	fressen
Seine	Seine
auszöge	auszöge
griechisch	griechisch
Seiten	Seiten
Malaysiers	Malaysiers
reformieren	reformieren
schnell	schnell
betonierte	betonierte
argumentierten	argumentierten
verzehre	verzehre
bereitete	bereitete
lehrst	lehrst
Abfertigungsgebäude	Abfertigungsgebäude
Sinne	Sinne
tendierst	tendierst
Lautschriften	Lautschriften
überführt	überführt
pflegst	pflegst
Normdaten	Normdaten
Sage	Sage
Adler	Adler
zanket	zanket
segmentierten	segmentierten
verschaffte	verschaffte
Afrikaner	Afrikaner
streite	streite
diskutiere	diskutiere
Hörspiel	Hörspiel
überwachten	überwachten
Ställe	Ställe
Gesetze	Gesetze
Rauten	Rauten
Begünstigungen	Begünstigungen
Gewürzen	Gewürzen
malet	malet
idealisierten	idealisierten
Gründungsprivileg	Gründungsprivileg
fragen	fragen
drifte	drifte
Stämme	Stämme
gebieten	gebieten
setzte	setzte
kostet	kostet
Domänen	Domänen
Bedenken	Bedenken
gezügelt	gezügelt
Krokus	Krokus
Öfchens	Öfchens
blaset	blaset
Sprichwörtern	Sprichwörtern
zürntet	zürntet
bekehrst	bekehrst
Unserer	Unserer
attestiertet	attestiertet
zerbricht	zerbricht
verzieret	verzieret
erzürnet	erzürnet
klingest	klingest
Hochzeitstorten	Hochzeitstorten
Ein	Ein
hegten	hegten
Falltürme	Falltürme
pharyngalisierten	pharyngalisierten
Roben	Roben
erbringst	erbringst
Ypecaharallen	Ypecaharallen
Jagdhunden	Jagdhunden
sponseret	sponseret
ermordet	ermordet
gefällt	gefällt
betätigest	betätigest
jede	jede
Genie	Genie
nachwandelt	nachwandelt
achten	achten
Bleigehalt	Bleigehalt
steuerte	steuerte
herrschen	herrschen
Barbareien	Barbareien
murmelte	murmelte
behalte	behalte
suchten	suchten
Genkinits	Genkinits
beider	beider
replizieret	replizieret
Heiratsgut	Heiratsgut
verkriechst	verkriechst
keiner	keiner
Gläubigern	Gläubigern
Fußmatten	Fußmatten
verewiget	verewiget
erntest	erntest
Einsatz	Einsatz
streuen	streuen
Rumänin	Rumänin
zürnten	zürnten
Märchenbüchern	Märchenbüchern
NAND-Gatter	NAND-Gatter
Wüste	Wüste
Bademäntel	Bademäntel
impfst	impfst
verkürzten	verkürzten
hydrolysierend	hydrolysierend
quasselten	quasselten
Büchereien	Büchereien
höret	höret
Haben	Haben
gestatteten	gestatteten
drillest	drillest
ungeistlich	ungeistlich
beweise	beweise
Abfertigungsschalters	Abfertigungsschalters
Pferde	Pferde
segelte	segelte
strömte	strömte
befestigten	befestigten
fluppst	fluppst
niemanden	niemanden
eurer	eurer
bracht	bracht
Zeitbomben	Zeitbomben
füsilierte	füsilierte
verjährte	verjährte
erste	erste
Heide	Heide
sehnst	sehnst
Kacke	Kacke
schämten	schämten
Verehrer	Verehrer
Komponisten	Komponisten
Adamsapfel	Adamsapfel
Apportierhund	Apportierhund
schnatternd	schnatternd
Kaufleuten	Kaufleuten
meinen	meinen
illustriere	illustriere
messen	messen
Urbaren	Urbaren
Drachen	Drachen
Grizzlybären	Grizzlybären
feierten	feierten
lögen	lögen
Blutgefäß	Blutgefäß
leid	leid
Nullpunkt	Nullpunkt
Hunden	Hunden
Herd	Herd
schweiget	schweiget
Zitronensäften	Zitronensäften
Selbstsicherheit	Selbstsicherheit
verkürztet	verkürztet
Lopariten	Lopariten
Raucherinnen	Raucherinnen
Mischelementen	Mischelementen
Antitranspiranten	Antitranspiranten
Anrufbeantworter	Anrufbeantworter
leide	leide
Brieftaubenzüchter	Brieftaubenzüchter
gehetzt	gehetzt
zählte	zählte
geherrscht	geherrscht
Hanse	Hanse
Mensch	Mensch
Wisset	Wisset
versteckt	versteckt
eggte	eggte
Heiden	Heiden
Anliegen	Anliegen
Graben	Graben
Fäusten	Fäusten
knüpfen	knüpfen
Langzeichen	Langzeichen
Leichname	Leichname
gebet	gebet
begräbt	begräbt
mogelten	mogelten
raffiniere	raffiniere
Kommet	Kommet
schlagt	schlagt
Pailletten	Pailletten
Hinkelstein	Hinkelstein
heiligte	heiligte
Gerichte	Gerichte
blitze	blitze
Küstenwache	Küstenwache
Schwester	Schwester
legest	legest
Leuchtstoff	Leuchtstoff
betrübte	betrübte
vereinbaren	vereinbaren
Briefen	Briefen
tobend	tobend
Bären	Bären
deutete	deutete
extemporieret	extemporieret
Hie	Hie
erlabet	erlabet
duschten	duschten
bekannte	bekannte
Türklingeln	Türklingeln
recycele	recycele
abziehen	abziehen
schlafest	schlafest
Fingerspitze	Fingerspitze
Gebirge	Gebirge
Garten	Garten
wehrten	wehrten
Gefängnisse	Gefängnisse
Epoxide	Epoxide
Werdet	Werdet
Dünungen	Dünungen
schnattert	schnattert
würden	würden
Woge	Woge
zerrütteten	zerrütteten
sprechet	sprechet
liege	liege
Saiblingen	Saiblingen
Sagen	Sagen
verkleide	verkleide
Prophet	Prophet
Gehorsams	Gehorsams
Beten	Beten
Ruße	Ruße
Marjellchens	Marjellchens
lispelt	lispelt
knurrt	knurrt
Gram	Gram
anrichten	anrichten
Blässe	Blässe
querte	querte
rundet	rundet
verstand	verstand
wirfst	wirfst
müssest	müssest
unseren	unseren
heulte	heulte
Eisstein	Eisstein
Hälmchen	Hälmchen
Genkinit	Genkinit
mögt	mögt
Halbzeit	Halbzeit
Noseanen	Noseanen
anrichte	anrichte
decket	decket
schlachten	schlachten
Chasaren	Chasaren
verarbeite	verarbeite
Kerls	Kerls
Türkenbund	Türkenbund
verschicket	verschicket
verweise	verweise
Sprüche	Sprüche
Schönredner	Schönredner
mischst	mischst
ausgereckte	ausgereckte
Weinbergen	Weinbergen
still	still
zagest	zagest
Abbindebeschleunigern	Abbindebeschleunigern
pflüget	pflüget
Seetaucher	Seetaucher
Laien	Laien
irgendeine	irgendeine
Pest	Pest
Steuerwagen	Steuerwagen
evaluiert	evaluiert
Brauhaus	Brauhaus
Möbelstoff	Möbelstoff
ruhte	ruhte
lebst	lebst
gratuliere	gratuliere
Atemgasen	Atemgasen
Keile	Keile
fertig	fertig
Samen	Samen
redetet	redetet
Tübingern	Tübingern
Haltepunkten	Haltepunkten
unser	unser
destabilisierst	destabilisierst
flötete	flötete
entgehe	entgehe
gehst	gehst
mangelte	mangelte
Lärche	Lärche
kooperierst	kooperierst
funkeln	funkeln
Zeugnissen	Zeugnissen
verfehle	verfehle
stützen	stützen
parfümierst	parfümierst
Berufe	Berufe
Ingredienzen	Ingredienzen
ermordetest	ermordetest
Technetaten	Technetaten
junge	junge
Geboten	Geboten
strullerte	strullerte
Drache	Drache
drängest	drängest
Danket	Danket
konnte	konnte
dritten	dritten
versuchte	versuchte
verabschiedetet	verabschiedetet
Kriegsschauplätze	Kriegsschauplätze
weichen	weichen
Fallturm	Fallturm
sagst	sagst
bekennt	bekennt
Gehilfen	Gehilfen
verseucht	verseucht
Ansichtskarte	Ansichtskarte
narret	narret
Sucht	Sucht
Gigapascaln	Gigapascaln
Fett	Fett
interpretiert	interpretiert
forschet	forschet
zagt	zagt
Kriegsknechte	Kriegsknechte
Altbau	Altbau
Buchhalterin	Buchhalterin
Bande	Bande
erlabe	erlabe
verseifet	verseifet
Flöte	Flöte
Industrienation	Industrienation
überreichst	überreichst
meuterest	meuterest
gestalten	gestalten
transportierte	transportierte
versteckten	versteckten
widerriefe	widerriefe
observiertest	observiertest
ortete	ortete
moppst	moppst
erfreuen	erfreuen
bewieset	bewieset
Drillinge	Drillinge
hasse	hasse
Weichseln	Weichseln
Büstenhaltern	Büstenhaltern
Rechtsruck	Rechtsruck
Dödel	Dödel
hüten	hüten
Suffix	Suffix
verseuchen	verseuchen
lehnte	lehnte
Flitzer	Flitzer
funktioniertest	funktioniertest
Ehre	Ehre
Fledermaus	Fledermaus
Anfechtung	Anfechtung
Brikette	Brikette
seist	seist
rundest	rundest
werte	werte
Schlangen	Schlangen
vermischten	vermischten
Mutagenen	Mutagenen
Untiefe	Untiefe
dienest	dienest
erkannten	erkannten
Substanzen	Substanzen
schwenkt	schwenkt
zeuget	zeuget
Kopfverletzungen	Kopfverletzungen
blamierest	blamierest
Dann	Dann
Quellflüssen	Quellflüssen
restaurierten	restaurierten
pflügte	pflügte
Amnestie	Amnestie
Asiatin	Asiatin
Shortcut	Shortcut
Grenzwert	Grenzwert
Kruste	Kruste
Kopfsalat	Kopfsalat
Laufen	Laufen
halbe	halbe
Städten	Städten
steig	steig
changieren	changieren
Klassenzimmer	Klassenzimmer
ungefälschtem	ungefälschtem
möpperst	möpperst
Trinkgefäßen	Trinkgefäßen
Taufen	Taufen
Rast	Rast
teile	teile
Wänden	Wänden
Zwergschwan	Zwergschwan
fladerest	fladerest
scheitertet	scheitertet
reglementiert	reglementiert
Organistin	Organistin
Teufel	Teufel
kriegen	kriegen
hintertreibt	hintertreibt
liegen	liegen
Gauner	Gauner
unterscheide	unterscheide
schummelten	schummelten
kupiert	kupiert
Retter	Retter
teilte	teilte
blast	blast
analysiert	analysiert
stoße	stoße
möppertet	möppertet
Genies	Genies
Ausbeutern	Ausbeutern
zeichnet	zeichnet
Aderhäuten	Aderhäuten
Störe	Störe
designierst	designierst
wetzte	wetzte
bewahrt	bewahrt
Dattel	Dattel
Bienenstöcke	Bienenstöcke
neiden	neiden
Hobbys	Hobbys
Gelobt	Gelobt
funzen	funzen
hupet	hupet
entschleieret	entschleieret
kennst	kennst
seien	seien
betrübst	betrübst
rodete	rodete
labe	labe
ein	ein
verspielest	verspielest
Planern	Planern
regierten	regierten
brennen	brennen
regelet	regelet
Reliquiare	Reliquiare
Anfänger	Anfänger
zürnte	zürnte
Besprechung	Besprechung
Seetauchers	Seetauchers
verschafft	verschafft
entwickelten	entwickelten
konvergierest	konvergierest
ausfuhr	ausfuhr
Raten	Raten
Polizeisprechern	Polizeisprechern
verbirgst	verbirgst
All	All
Streife	Streife
Bildschirmfotos	Bildschirmfotos
Grönländer	Grönländer
Abschußringe	Abschußringe
Äquatoren	Äquatoren
beweiset	beweiset
spaltete	spaltete
Suchet	Suchet
Bärte	Bärte
Herzchen	Herzchen
Schiffen	Schiffen
mühte	mühte
glaubet	glaubet
ausgereckt	ausgereckt
Vergrößerungen	Vergrößerungen
Mönchen	Mönchen
besäest	besäest
stand	stand
Wehklagen	Wehklagen
Tumult	Tumult
mißverstehet	mißverstehet
verantwortet	verantwortet
behütetest	behütetest
entsündigten	entsündigten
amenagieren	amenagieren
Bevölkerungsdichte	Bevölkerungsdichte
Uterus	Uterus
widerstand	widerstand
schaust	schaust
inszeniere	inszeniere
verschickte	verschickte
fügt	fügt
tagten	tagten
Kleinoden	Kleinoden
gebühren	gebühren
unsres	unsres
aßet	aßet
sollt	sollt
bimmelte	bimmelte
touchierte	touchierte
Wachen	Wachen
Angaben	Angaben
tagest	tagest
Leuchtkäfer	Leuchtkäfer
schenken	schenken
Sprödmetallen	Sprödmetallen
schenkst	schenkst
wichsten	wichsten
widerstanden	widerstanden
schmeichelest	schmeichelest
Spielen	Spielen
weiche	weiche
substituierest	substituierest
Trichter	Trichter
machest	machest
glaubend	glaubend
käbbelte	käbbelte
auflegst	auflegst
zerreißt	zerreißt
hättest	hättest
erobern	erobern
Freizeitzentrum	Freizeitzentrum
Vorhäute	Vorhäute
Stierkämpfe	Stierkämpfe
Lehrkörpers	Lehrkörpers
Nanosatelliten	Nanosatelliten
kramten	kramten
gewünscht	gewünscht
übrigbleibet	übrigbleibet
maximiere	maximiere
fabulierte	fabulierte
dresche	dresche
vermahnte	vermahnte
Krusten	Krusten
Arreste	Arreste
lockerst	lockerst
vergaste	vergaste
kämpfen	kämpfen
Theistinnen	Theistinnen
Ausstiegstüren	Ausstiegstüren
schichteten	schichteten
Gurten	Gurten
linsten	linsten
durchzuckest	durchzuckest
Scheißkerl	Scheißkerl
stammelest	stammelest
soll	soll
gewurstelt	gewurstelt
fertige	fertige
Geschwindigkeitsmessern	Geschwindigkeitsmessern
Einrädern	Einrädern
grausten	grausten
neidest	neidest
verleumdetest	verleumdetest
Aktenkoffer	Aktenkoffer
besetzest	besetzest
Reizen	Reizen
zerfetzt	zerfetzt
Gummibäumen	Gummibäumen
emendierte	emendierte
Elf	Elf
Worten	Worten
seufzt	seufzt
Zäunen	Zäunen
würde	würde
ungeistlichen	ungeistlichen
Schlägen	Schlägen
schlaf	schlaf
partitionierten	partitionierten
einführen	einführen
griff	griff
Bettlers	Bettlers
Klaue	Klaue
ausführte	ausführte
zentrierest	zentrierest
keine	keine
Pforten	Pforten
Röcke	Röcke
Atemlüfte	Atemlüfte
skypet	skypet
grabble	grabble
verziehe	verziehe
rekonstruieret	rekonstruieret
genehmigt	genehmigt
glänzen	glänzen
Erdbirnen	Erdbirnen
verschonet	verschonet
knusperst	knusperst
Futur	Futur
stärken	stärken
solche	solche
peiltest	peiltest
produzierte	produzierte
weinet	weinet
Mopp	Mopp
Wembley-Tore	Wembley-Tore
verdreht	verdreht
Notärztin	Notärztin
Schade	Schade
Feiertage	Feiertage
verirrt	verirrt
Ahnen	Ahnen
schlage	schlage
nahe	nahe
Krustentier	Krustentier
sabbre	sabbre
vertuest	vertuest
substituieren	substituieren
bemüht	bemüht
Ihren	Ihren
parametrisierst	parametrisierst
unterrichtet	unterrichtet
Träumers	Träumers
bollerest	bollerest
verkündigten	verkündigten
fladerst	fladerst
erwürgten	erwürgten
gehorchte	gehorchte
Magier	Magier
Erstlingen	Erstlingen
Linguisten	Linguisten
berühret	berühret
Lammfellhandschuhen	Lammfellhandschuhen
Sigle	Sigle
konsolidierend	konsolidierend
Frettchen	Frettchen
interagiert	interagiert
Bonzen	Bonzen
Herkünften	Herkünften
einernten	einernten
vertäte	vertäte
Ektoplasmen	Ektoplasmen
Hüftgelenken	Hüftgelenken
schweigst	schweigst
nahte	nahte
Schwächung	Schwächung
Steuerberatern	Steuerberatern
tappst	tappst
helfet	helfet
lehret	lehret
Tintenklecksen	Tintenklecksen
Asteroide	Asteroide
stillest	stillest
Blitzen	Blitzen
Erzherzogshüten	Erzherzogshüten
lösten	lösten
Blitzableiter	Blitzableiter
Male	Male
Weiß	Weiß
Ass	Ass
Rhodochrositen	Rhodochrositen
Geschrei	Geschrei
oxidierte	oxidierte
Dreieinigkeit	Dreieinigkeit
entflieht	entflieht
erniedrigt	erniedrigt
gleiche	gleiche
stellte	stellte
gewährtest	gewährtest
Blockflöte	Blockflöte
Einöde	Einöde
unterforderten	unterforderten
Körpergeruch	Körpergeruch
Collagen	Collagen
Pinguinen	Pinguinen
Honigbären	Honigbären
ausgereckter	ausgereckter
scheu	scheu
Stiefmütterchen	Stiefmütterchen
Spiralen	Spiralen
hydrogentartrate	hydrogentartrate
Gänge	Gänge
bang	bang
überfallen	überfallen
Schanktisch	Schanktisch
überschattete	überschattete
Politologen	Politologen
taufen	taufen
Stühle	Stühle
Weißflügelpinguin	Weißflügelpinguin
beben	beben
Steiget	Steiget
Milchflasche	Milchflasche
Eiszapfen	Eiszapfen
klemmt	klemmt
zeugest	zeugest
Galopps	Galopps
Affenbrotbäumen	Affenbrotbäumen
schnitten	schnitten
aufnahmt	aufnahmt
Generation	Generation
Welteninsel	Welteninsel
desensibilisierte	desensibilisierte
Ringeltauben	Ringeltauben
behaltest	behaltest
prophezeiet	prophezeiet
Einbrecher	Einbrecher
zeugst	zeugst
deine	deine
gehörst	gehörst
sich	sich
Futtermittel	Futtermittel
türmt	türmt
wollest	wollest
trödeltest	trödeltest
erfüllst	erfüllst
leuchten	leuchten
vor	vor
verwirrt	verwirrt
Preisen	Preisen
referenziere	referenziere
Gasgemisch	Gasgemisch
flehte	flehte
verkriechet	verkriechet
kühlen	kühlen
Beschuldigung	Beschuldigung
kabelten	kabelten
kosten	kosten
Aggressoren	Aggressoren
Gefügen	Gefügen
entschädiget	entschädiget
Händen	Händen
tobte	tobte
Stärket	Stärket
parametrisierten	parametrisierten
Päckchens	Päckchens
auszieht	auszieht
spielte	spielte
verließen	verließen
Notständen	Notständen
lobet	lobet
Darlegung	Darlegung
Biokraftstoff	Biokraftstoff
Autokraten	Autokraten
kategorisierst	kategorisierst
herrschst	herrschst
sponsert	sponsert
Sekte	Sekte
Karern	Karern
abtrünnigen	abtrünnigen
verprügelet	verprügelet
Urbare	Urbare
Kanzleien	Kanzleien
folterte	folterte
überweise	überweise
Kandidaturen	Kandidaturen
Volkslehren	Volkslehren
hilft	hilft
unterbrächest	unterbrächest
bemerken	bemerken
treibest	treibest
brechet	brechet
Fischzucht	Fischzucht
Abbindebeschleuniger	Abbindebeschleuniger
Artischocken	Artischocken
Reinstoffen	Reinstoffen
bessere	bessere
schauet	schauet
Gibst	Gibst
filteret	filteret
jauchzt	jauchzt
weich	weich
speisend	speisend
Prüfbericht	Prüfbericht
Ausländern	Ausländern
Satzung	Satzung
vernickelte	vernickelte
Leitungsweg	Leitungsweg
schmeicheln	schmeicheln
schlabbere	schlabbere
Begrenzung	Begrenzung
fehlte	fehlte
zwölften	zwölften
verbitterest	verbitterest
Kardinal	Kardinal
verzögerten	verzögerten
deponierte	deponierte
Abfahrtslisten	Abfahrtslisten
Rutheniumkomplex	Rutheniumkomplex
entständen	entständen
verkapselt	verkapselt
Generationen	Generationen
löstet	löstet
begrabt	begrabt
bedenken	bedenken
spielen	spielen
Almanache	Almanache
Abkömmling	Abkömmling
verklagst	verklagst
linke	linke
erschrickt	erschrickt
haste	haste
Ratet	Ratet
Handbuch	Handbuch
Schickse	Schickse
Kleptokratien	Kleptokratien
Reliquiar	Reliquiar
massierst	massierst
liebest	liebest
verwechselst	verwechselst
Fokus	Fokus
Eines	Eines
Fingerhüten	Fingerhüten
gelobest	gelobest
Götze	Götze
Subspezies	Subspezies
protokollieren	protokollieren
Milchflaschen	Milchflaschen
Brechnuss	Brechnuss
Monden	Monden
Willen	Willen
rüstetest	rüstetest
rauschen	rauschen
tendiertet	tendiertet
Musters	Musters
Päderast	Päderast
emittiert	emittiert
Hinkelsteine	Hinkelsteine
kühl	kühl
konntet	konntet
lehnen	lehnen
lostet	lostet
verkündiget	verkündiget
zürn	zürn
überweiset	überweiset
boßte	boßte
Empörung	Empörung
wehrt	wehrt
Epoxiden	Epoxiden
Korrosionsschutzen	Korrosionsschutzen
gedenk	gedenk
hicksest	hicksest
ausgeht	ausgeht
weinst	weinst
Bushaltestelle	Bushaltestelle
Verbindungsdrähten	Verbindungsdrähten
zierte	zierte
predigen	predigen
griechischen	griechischen
wärme	wärme
Schuldner	Schuldner
gleitest	gleitest
Däumlingen	Däumlingen
Landwirt	Landwirt
Paragraphenreiter	Paragraphenreiter
frottier	frottier
schaut	schaut
feierst	feierst
schäumt	schäumt
Nukleinsäure	Nukleinsäure
exmatrikulierte	exmatrikulierte
dienet	dienet
sedimentiere	sedimentiere
Fellhandschuhen	Fellhandschuhen
torpediert	torpediert
baust	baust
Prozedur	Prozedur
Aase	Aase
regeln	regeln
begehre	begehre
harren	harren
Höhle	Höhle
gedächte	gedächte
Schläfchen	Schläfchen
leer	leer
kichert	kichert
erlassen	erlassen
vertiefet	vertiefet
Stadtbezirken	Stadtbezirken
Bunde	Bunde
Briefwechsel	Briefwechsel
verschlingt	verschlingt
Augur	Augur
bummeltet	bummeltet
trauerten	trauerten
zeigst	zeigst
fallt	fallt
Gemeinde	Gemeinde
Kühen	Kühen
Sprichwort	Sprichwort
Schau	Schau
sehn	sehn
helft	helft
begehrtet	begehrtet
Klotz	Klotz
stolz	stolz
Proton	Proton
verfolgst	verfolgst
Taufe	Taufe
Werte	Werte
Kautschuke	Kautschuke
sehnet	sehnet
Sportlerinnen	Sportlerinnen
Mikrowellenfilter	Mikrowellenfilter
fünften	fünften
Betainen	Betainen
verbündest	verbündest
Stearat	Stearat
Reinigungsschritten	Reinigungsschritten
nachwandelst	nachwandelst
kollidierte	kollidierte
Füßen	Füßen
Gesetzen	Gesetzen
Petersfisch	Petersfisch
besorgest	besorgest
Buchstabe	Buchstabe
Vorstädten	Vorstädten
driftete	driftete
stäupen	stäupen
amenagiere	amenagiere
fotzte	fotzte
haschiert	haschiert
kollidierten	kollidierten
haltet	haltet
kremieren	kremieren
Dessous	Dessous
Abkömmlingen	Abkömmlingen
Zeile	Zeile
wach	wach
Verbindungsdraht	Verbindungsdraht
Geflecktheiten	Geflecktheiten
widmend	widmend
erschüttere	erschüttere
Kupferkiese	Kupferkiese
erzeige	erzeige
nähernd	nähernd
Auguren	Auguren
sagt	sagt
verhungerte	verhungerte
stapfst	stapfst
Sabbatjahre	Sabbatjahre
stimmte	stimmte
funktionalisierte	funktionalisierte
Sprecher	Sprecher
einen	einen
Würze	Würze
verkauften	verkauften
Abschreckungen	Abschreckungen
merken	merken
Bluffs	Bluffs
Hirschen	Hirschen
verzierten	verzierten
feiertest	feiertest
begrabet	begrabet
feiert	feiert
fließt	fließt
appellierst	appellierst
Konfitüren	Konfitüren
Kristallen	Kristallen
erbringen	erbringen
süsst	süsst
Katamarane	Katamarane
Bestecken	Bestecken
Android	Android
Orgel	Orgel
Spektralbereichen	Spektralbereichen
Wasserbädern	Wasserbädern
Rotzinkerz	Rotzinkerz
herrschten	herrschten
sprichst	sprichst
Molybdit	Molybdit
Schaffe	Schaffe
Türkinnen	Türkinnen
stigmatisierst	stigmatisierst
bekannten	bekannten
legst	legst
Chelatkomplex	Chelatkomplex
umarbeiten	umarbeiten
Rehen	Rehen
Ablösung	Ablösung
formulieren	formulieren
brichst	brichst
Erfahrungen	Erfahrungen
trotzest	trotzest
versuchet	versuchet
seinen	seinen
Klassenzimmern	Klassenzimmern
Pudern	Pudern
Bällchen	Bällchen
fastetest	fastetest
verschränkest	verschränkest
Fellen	Fellen
hadertet	hadertet
kräuselten	kräuselten
Anfechtungen	Anfechtungen
faul	faul
Schnute	Schnute
Halt	Halt
Basilikum	Basilikum
Fäuste	Fäuste
Eiszapfens	Eiszapfens
Reichweiten	Reichweiten
surre	surre
vermutest	vermutest
umkämen	umkämen
erhebst	erhebst
Bete	Bete
ermächtige	ermächtige
Dewargefäß	Dewargefäß
schonte	schonte
Ausbeuterei	Ausbeuterei
neige	neige
Basilisk	Basilisk
Portal	Portal
Silbererze	Silbererze
holet	holet
Landesverräterinnen	Landesverräterinnen
replizierten	replizierten
Serverzugriffe	Serverzugriffe
Unternehmensanwendungsintegrationen	Unternehmensanwendungsintegrationen
entmineralisieren	entmineralisieren
scheiterst	scheiterst
lügst	lügst
schauspielert	schauspielert
Hallen	Hallen
Carbid	Carbid
Dienstgrade	Dienstgrade
Melanteriten	Melanteriten
Buchstaben	Buchstaben
unehret	unehret
Wände	Wände
heischten	heischten
besinnen	besinnen
Reißnagel	Reißnagel
prostituierte	prostituierte
stärke	stärke
Premierministerinnen	Premierministerinnen
erkannte	erkannte
Monarchie	Monarchie
Hände	Hände
reinigst	reinigst
Zitronensaft	Zitronensaft
nähre	nähre
leget	leget
sedimentieret	sedimentieret
Türkenbünden	Türkenbünden
Referenz	Referenz
schläft	schläft
Testamenten	Testamenten
kochte	kochte
Safran	Safran
keulte	keulte
Akkadierinnen	Akkadierinnen
segeln	segeln
Inkarnationen	Inkarnationen
Ärztinnen	Ärztinnen
piesacken	piesacken
transportiere	transportiere
gehorchst	gehorchst
Gewicht	Gewicht
Nigger	Nigger
Hummer	Hummer
verstrahlten	verstrahlten
produzierest	produzierest
Effekten	Effekten
bombardiere	bombardiere
verreisest	verreisest
anzeigt	anzeigt
schubse	schubse
trinket	trinket
attestierten	attestierten
säume	säume
Sehne	Sehne
ersparen	ersparen
konstatiere	konstatiere
bestellte	bestellte
Reizt	Reizt
Taube	Taube
Wurzelwachstum	Wurzelwachstum
Teppichen	Teppichen
Schleppern	Schleppern
Gase	Gase
Weil	Weil
Denkmünze	Denkmünze
Harpunen	Harpunen
Räten	Räten
entsetzten	entsetzten
verunglimpfte	verunglimpfte
Zeitschlitze	Zeitschlitze
schwängen	schwängen
Kernladungszahlen	Kernladungszahlen
zweiten	zweiten
Klotzes	Klotzes
Öfchen	Öfchen
schlafe	schlafe
kautest	kautest
Gibt	Gibt
gehet	gehet
Kardinäle	Kardinäle
Fiebermittel	Fiebermittel
fahrt	fahrt
vergibst	vergibst
Meere	Meere
Türmen	Türmen
Jünglingen	Jünglingen
regte	regte
konnten	konnten
Kakao	Kakao
entfolgst	entfolgst
jaget	jaget
betrübten	betrübten
dümpelst	dümpelst
erlaubest	erlaubest
Bausch	Bausch
trägst	trägst
rodet	rodet
ruhest	ruhest
Fischotters	Fischotters
koexistierte	koexistierte
sortierte	sortierte
offenbarest	offenbarest
Koniferen	Koniferen
flieh	flieh
Wir	Wir
tat	tat
hätte	hätte
Massenanteil	Massenanteil
Exilanten	Exilanten
Galeeren	Galeeren
berührt	berührt
sahet	sahet
initiierten	initiierten
dirigieret	dirigieret
Mageninhalten	Mageninhalten
Dithiolane	Dithiolane
initiieret	initiieret
Monarchien	Monarchien
Gangster	Gangster
Krankenscheinen	Krankenscheinen
hantierte	hantierte
Silbererzen	Silbererzen
erinnerest	erinnerest
zirpen	zirpen
ausfuhren	ausfuhren
Wehe	Wehe
hauest	hauest
Fluoratom	Fluoratom
klicket	klicket
berücksichtiget	berücksichtiget
Zäune	Zäune
beeindruckt	beeindruckt
Laubbaum	Laubbaum
Bube	Bube
Effekt	Effekt
beschlaget	beschlaget
knistert	knistert
wälzt	wälzt
gedenke	gedenke
Minimierung	Minimierung
wart	wart
Mops	Mops
bleibest	bleibest
Ringen	Ringen
Lesen	Lesen
kickst	kickst
Mauten	Mauten
faschieren	faschieren
harmonierte	harmonierte
Arsenit	Arsenit
Coventrisierungen	Coventrisierungen
Benzol	Benzol
gefügt	gefügt
Version	Version
panaschieret	panaschieret
Gebeten	Gebeten
zappen	zappen
Metonymie	Metonymie
härten	härten
Schalen	Schalen
Brettspielen	Brettspielen
Bis	Bis
schaffe	schaffe
musizieret	musizieret
fragmentiert	fragmentiert
Kristalle	Kristalle
beleuchte	beleuchte
Argentits	Argentits
Rehe	Rehe
murmelten	murmelten
gut	gut
Bevölkerungsdichten	Bevölkerungsdichten
pressiert	pressiert
entfachten	entfachten
geselle	geselle
orgelt	orgelt
Fußballweltmeisterschaftsqualifikationsspielen	Fußballweltmeisterschaftsqualifikationsspielen
erhörest	erhörest
entgegenkamst	entgegenkamst
frevle	frevle
entkämen	entkämen
fistet	fistet
Höfe	Höfe
jappen	jappen
Preisanstieg	Preisanstieg
einigst	einigst
Stör	Stör
dramatisieren	dramatisieren
entwickele	entwickele
Tollkirschen	Tollkirschen
Seehechten	Seehechten
Speere	Speere
Aktivist	Aktivist
Hahnenkämme	Hahnenkämme
ladest	ladest
Rückumschlages	Rückumschlages
Schilde	Schilde
geräuchert	geräuchert
unterdrückte	unterdrückte
Ring	Ring
grünend	grünend
Minischweine	Minischweine
predigt	predigt
bewässerest	bewässerest
posiertet	posiertet
defragmentierten	defragmentierten
wässerst	wässerst
Huren	Huren
Höhen	Höhen
Keine	Keine
arme	arme
vergleichet	vergleichet
konvergiere	konvergiere
Grieße	Grieße
Hallelujas	Hallelujas
Schlaraffenländern	Schlaraffenländern
Schlange	Schlange
greinet	greinet
sprecht	sprecht
grünst	grünst
schlafet	schlafet
grübelten	grübelten
Höschens	Höschens
schießt	schießt
Portale	Portale
Gedicht	Gedicht
Homodimeren	Homodimeren
grüßet	grüßet
solch	solch
nehmest	nehmest
Halbzeiten	Halbzeiten
maß	maß
Schlägst	Schlägst
kristallisiertest	kristallisiertest
trefft	trefft
Beile	Beile
diese	diese
dichten	dichten
wünschet	wünschet
bekehrten	bekehrten
Blattgeweben	Blattgeweben
legend	legend
zittere	zittere
nötigte	nötigte
Banden	Banden
Fehden	Fehden
stammeln	stammeln
trompetete	trompetete
leere	leere
überlieferten	überlieferten
Leichtmetallen	Leichtmetallen
koche	koche
befördert	befördert
pflanzet	pflanzet
Halle	Halle
erzeigest	erzeigest
Wachteln	Wachteln
Transportwegen	Transportwegen
versteigernd	versteigernd
speichertest	speichertest
spähet	spähet
Trotzkist	Trotzkist
schmuggelest	schmuggelest
begleicht	begleicht
erhört	erhört
Flamme	Flamme
Präservativs	Präservativs
harrest	harrest
downloadet	downloadet
wilden	wilden
fünfte	fünfte
Epidemien	Epidemien
gewärtigt	gewärtigt
spricht	spricht
wünschest	wünschest
steuerst	steuerst
Technetiumatom	Technetiumatom
pulsiert	pulsiert
Lotterien	Lotterien
drescht	drescht
leiden	leiden
schätze	schätze
Hainbuche	Hainbuche
sündigten	sündigten
gelangte	gelangte
Treibhausgasen	Treibhausgasen
Mop	Mop
Anwendungsgebiete	Anwendungsgebiete
Lazarette	Lazarette
produziert	produziert
Schätze	Schätze
konsolidierest	konsolidierest
deaktiviere	deaktiviere
zerstreute	zerstreute
Ha	Ha
Falle	Falle
angehören	angehören
Händedrücken	Händedrücken
knacktest	knacktest
betrüben	betrüben
schöpfen	schöpfen
bezahlt	bezahlt
Beziehungen	Beziehungen
wärst	wärst
sonderte	sonderte
schreien	schreien
verscheißert	verscheißert
Kronsbeere	Kronsbeere
sedimentierte	sedimentierte
überschneidet	überschneidet
foppte	foppte
lüge	lüge
zensiere	zensiere
haare	haare
wünschtest	wünschtest
freiwilligen	freiwilligen
Sanatorien	Sanatorien
erhöht	erhöht
stürzte	stürzte
pharyngalisierst	pharyngalisierst
Maximierung	Maximierung
stärkte	stärkte
Aromastoffen	Aromastoffen
entsündigte	entsündigte
malträtiere	malträtiere
schwebte	schwebte
entsetzet	entsetzet
Wissen	Wissen
Ärzteblatt	Ärzteblatt
Haue	Haue
verunglimpfest	verunglimpfest
ackerest	ackerest
erlauben	erlauben
umhüllend	umhüllend
brauchst	brauchst
scheuchen	scheuchen
Trinker	Trinker
Kommst	Kommst
mußten	mußten
streckte	streckte
Abartigkeit	Abartigkeit
Fluoratome	Fluoratome
den	den
reparierten	reparierten
Butzemänner	Butzemänner
durchzuck	durchzuck
Hehler	Hehler
Braunralle	Braunralle
fegst	fegst
manchen	manchen
Werke	Werke
Dinge	Dinge
kupieren	kupieren
geahnt	geahnt
Ratsherr	Ratsherr
überführen	überführen
Briketten	Briketten
blitz	blitz
Zainen	Zainen
gewährte	gewährte
illustriertet	illustriertet
Aufprall	Aufprall
grüßte	grüßte
Generatoren	Generatoren
angehöret	angehöret
räucheret	räucheret
Grenze	Grenze
Tannen	Tannen
amputiere	amputiere
Fokusse	Fokusse
hüpfest	hüpfest
Wiedergutmachung	Wiedergutmachung
ärgerte	ärgerte
Verdachtes	Verdachtes
bestimmt	bestimmt
Büstenhalters	Büstenhalters
Graphem	Graphem
duckmäuseret	duckmäuseret
Milzen	Milzen
Preis	Preis
Zehen	Zehen
wild	wild
Muster	Muster
grüßest	grüßest
gewöhnt	gewöhnt
Butzemann	Butzemann
gafften	gafften
klappst	klappst
Zeitüberschreitung	Zeitüberschreitung
aufwacht	aufwacht
entdecket	entdecket
reif	reif
Sexten	Sexten
täuschte	täuschte
widmet	widmet
aufhebt	aufhebt
dringst	dringst
Mittelaltermarkt	Mittelaltermarkt
Entsetzt	Entsetzt
applizirte	applizirte
setzt	setzt
verachtet	verachtet
Volkslehre	Volkslehre
Jochen	Jochen
zupfte	zupfte
Pforte	Pforte
Uranerzen	Uranerzen
Abkürzungsverzeichnis	Abkürzungsverzeichnis
hebräischen	hebräischen
wichste	wichste
fetten	fetten
Bazzit	Bazzit
Schneidern	Schneidern
puddelst	puddelst
Bushaltestellen	Bushaltestellen
pflücktet	pflücktet
Stätten	Stätten
Remisen	Remisen
Lobgesängen	Lobgesängen
schnürest	schnürest
Gebern	Gebern
verlaß	verlaß
benachrichtiget	benachrichtiget
Sonnenfinsternis	Sonnenfinsternis
linstest	linstest
leertet	leertet
Schätzen	Schätzen
verleumdete	verleumdete
bemerket	bemerket
verführen	verführen
Strahlentierchens	Strahlentierchens
wisperten	wisperten
meinst	meinst
verurteilen	verurteilen
halt	halt
Halogenatom	Halogenatom
Rheumatismus	Rheumatismus
Lobe	Lobe
addierte	addierte
Auge	Auge
letzten	letzten
Augengläsern	Augengläsern
gelang	gelang
betrübest	betrübest
fastetet	fastetet
Charakteristika	Charakteristika
liebst	liebst
erfahret	erfahret
glaube	glaube
Meinem	Meinem
überstehst	überstehst
verdinglichtest	verdinglichtest
sterbt	sterbt
Isolatoren	Isolatoren
würdet	würdet
vertiefe	vertiefe
wolle	wolle
Europium	Europium
Pfählen	Pfählen
gelobend	gelobend
wallte	wallte
Gäste	Gäste
Ochs	Ochs
Tyrannen	Tyrannen
radiertest	radiertest
klappten	klappten
Teilen	Teilen
beantrage	beantrage
solcher	solcher
repräsentierten	repräsentierten
vertonet	vertonet
Anfängern	Anfängern
sterilisiert	sterilisiert
stoßet	stoßet
leben	leben
hobt	hobt
belohnten	belohnten
Kronsbeeren	Kronsbeeren
wilde	wilde
Beziehung	Beziehung
Überweisung	Überweisung
scheue	scheue
herrschte	herrschte
Fahrt	Fahrt
eigene	eigene
liehe	liehe
Plumpsen	Plumpsen
gewitterest	gewitterest
verringert	verringert
Mageninhalt	Mageninhalt
verlieren	verlieren
Hinterwäldler	Hinterwäldler
Tumulten	Tumulten
Sonnenfinsternissen	Sonnenfinsternissen
durchläutert	durchläutert
Geschäfte	Geschäfte
nähert	nähert
Taschenwörterbuch	Taschenwörterbuch
Adventskalender	Adventskalender
zankte	zankte
sortiert	sortiert
Forschungen	Forschungen
erwachte	erwachte
Trägergas	Trägergas
untertretet	untertretet
krähen	krähen
Wiederbelebung	Wiederbelebung
setztet	setztet
Entmachtungen	Entmachtungen
folgen	folgen
prophezeie	prophezeie
Weg	Weg
Funkfeuer	Funkfeuer
fritiert	fritiert
Wolfesgrube	Wolfesgrube
platz	platz
Hörst	Hörst
unterdrücke	unterdrücke
Organisation	Organisation
zwölfte	zwölfte
Amen	Amen
Habt	Habt
Sizilianer	Sizilianer
Sollten	Sollten
analysiere	analysiere
Peptid	Peptid
hänget	hänget
Ebenen	Ebenen
gewinne	gewinne
Keiner	Keiner
Jahr	Jahr
Aprikosen	Aprikosen
blondieren	blondieren
unsere	unsere
überquerst	überquerst
träge	träge
Desserts	Desserts
beschlug	beschlug
Membranen	Membranen
borgte	borgte
erst	erst
Raben	Raben
wegen	wegen
Letzten	Letzten
zertifizierst	zertifizierst
bereuest	bereuest
sortierest	sortierest
Rücktrittbremsen	Rücktrittbremsen
deute	deute
löstest	löstest
zieren	zieren
finanziert	finanziert
Boten	Boten
platzt	platzt
Libelle	Libelle
Hummel	Hummel
Messiassen	Messiassen
köderet	köderet
geraten	geraten
Kunstgeschichte	Kunstgeschichte
ehre	ehre
bücktest	bücktest
Rundbriefen	Rundbriefen
aufkommt	aufkommt
Dunkelkammern	Dunkelkammern
Zeitplan	Zeitplan
Kaliumdichromat	Kaliumdichromat
Ältesten	Ältesten
sorgen	sorgen
Ranzigkeit	Ranzigkeit
erwürgtest	erwürgtest
wiederholte	wiederholte
Radiergummis	Radiergummis
Wachtel	Wachtel
verhören	verhören
bemühst	bemühst
knackt	knackt
klettert	klettert
Jünger	Jünger
Flosse	Flosse
Auszügen	Auszügen
verzweifelt	verzweifelt
besehet	besehet
Waldbränden	Waldbränden
Schreien	Schreien
hinterfragst	hinterfragst
dingte	dingte
Erfahrung	Erfahrung
Einheimische	Einheimische
genieret	genieret
erfreu	erfreu
Prostylos	Prostylos
Sei	Sei
erstaunte	erstaunte
lausche	lausche
Arsenbergwerk	Arsenbergwerk
Schafen	Schafen
Ärzteblättern	Ärzteblättern
duschte	duschte
hatte	hatte
Buben	Buben
Bromidquellen	Bromidquellen
einst	einst
blenden	blenden
Regierung	Regierung
zerstreuten	zerstreuten
Erstlinge	Erstlinge
Rufen	Rufen
Alkalien	Alkalien
jeder	jeder
sündiget	sündiget
gestatte	gestatte
entschädigte	entschädigte
baggerst	baggerst
stehet	stehet
verfinstert	verfinstert
Regenwald	Regenwald
Energiespeicher	Energiespeicher
Lehnen	Lehnen
blitzen	blitzen
Trübsale	Trübsale
Euren	Euren
Spende	Spende
Küstenwachen	Küstenwachen
Einen	Einen
empört	empört
Gruftis	Gruftis
raffinier	raffinier
eggt	eggt
gebot	gebot
vertreiben	vertreiben
widerlegte	widerlegte
Arbeitsleistung	Arbeitsleistung
WebHooks	WebHooks
zersetzte	zersetzte
bescheiße	bescheiße
nächsten	nächsten
Alterität	Alterität
Ecken	Ecken
Schilden	Schilden
beäugst	beäugst
gehörte	gehörte
ansehen	ansehen
Hirt	Hirt
eines	eines
Gepäckträger	Gepäckträger
Beschuldigungen	Beschuldigungen
Geigerzähler	Geigerzähler
Bärenfellen	Bärenfellen
weise	weise
verkündigest	verkündigest
verlobte	verlobte
Den	Den
Laubbläser	Laubbläser
fragest	fragest
sinnst	sinnst
übet	übet
schabst	schabst
nimmt	nimmt
filzte	filzte
bat	bat
Dorngesträuchen	Dorngesträuchen
errötest	errötest
Halogenatomen	Halogenatomen
Anhang	Anhang
innere	innere
begehrest	begehrest
Schrei	Schrei
ausführt	ausführt
More	More
Treppen	Treppen
alarmieren	alarmieren
Oberlandesgericht	Oberlandesgericht
lodert	lodert
erziehen	erziehen
argumentierest	argumentierest
Talisman	Talisman
lavierend	lavierend
tragest	tragest
vermöge	vermöge
Sprachraum	Sprachraum
stützet	stützet
gleich	gleich
Besteck	Besteck
Räte	Räte
Schlot	Schlot
zweite	zweite
blitzte	blitzte
Schwänzen	Schwänzen
verknüpft	verknüpft
erfahrt	erfahrt
Einfältigkeit	Einfältigkeit
bitte	bitte
vertilgt	vertilgt
schaben	schaben
Rückumlaute	Rückumlaute
Meines	Meines
schaue	schaue
bedürftet	bedürftet
zähle	zähle
ahne	ahne
malträtiert	malträtiert
Großstädter	Großstädter
verführte	verführte
kritzelet	kritzelet
verifizierten	verifizierten
dingten	dingten
Edelsteine	Edelsteine
Freibrief	Freibrief
besprenget	besprenget
Fieberanfall	Fieberanfall
lösest	lösest
Linke	Linke
Reiterschwertern	Reiterschwertern
verfange	verfange
Arbeitsunfähigkeit	Arbeitsunfähigkeit
Sexte	Sexte
entflöhen	entflöhen
reifte	reifte
Markise	Markise
Mobilfunknetzen	Mobilfunknetzen
Gespenstern	Gespenstern
Fiesling	Fiesling
handhabest	handhabest
Ion	Ion
tiefe	tiefe
Mischelement	Mischelement
zerstückte	zerstückte
Großfürsten	Großfürsten
benehme	benehme
Teekessel	Teekessel
aase	aase
googelten	googelten
fabuliert	fabuliert
listeten	listeten
wirst	wirst
Apfelbäume	Apfelbäume
Trägerwellen	Trägerwellen
müsse	müsse
eskaliert	eskaliert
begründest	begründest
Zuschauer	Zuschauer
Eins	Eins
Münzsammlung	Münzsammlung
föchte	föchte
Geldautomaten	Geldautomaten
Mutagen	Mutagen
präsentier	präsentier
zuteilte	zuteilte
missversteht	missversteht
Autoklaven	Autoklaven
erzeigte	erzeigte
gelangt	gelangt
sterbest	sterbest
Kernladungszahl	Kernladungszahl
betrete	betrete
begehrend	begehrend
reglementierte	reglementierte
Berge	Berge
Würfen	Würfen
fluchten	fluchten
straftet	straftet
Kairiner	Kairiner
Grießen	Grießen
imitiertet	imitiertet
kurz	kurz
umhüll	umhüll
grünest	grünest
Kompassen	Kompassen
hastete	hastete
Abschirmung	Abschirmung
prostete	prostete
schauspieleren	schauspieleren
zerstreuest	zerstreuest
anrührte	anrührte
aller	aller
Gemütes	Gemütes
Griechen	Griechen
glaubst	glaubst
Korrosionsschutz	Korrosionsschutz
frohlockest	frohlockest
ersparte	ersparte
Radiergummi	Radiergummi
Vesper	Vesper
referenzierte	referenzierte
Apotheose	Apotheose
wirft	wirft
habt	habt
Freizeitzentren	Freizeitzentren
haust	haust
Lötzinn	Lötzinn
verkehrten	verkehrten
wahre	wahre
heilet	heilet
kabbelet	kabbelet
jammerte	jammerte
Bildpunkten	Bildpunkten
Besuchen	Besuchen
schämet	schämet
bewerbet	bewerbet
Tyrann	Tyrann
duckmäusere	duckmäusere
Wühltische	Wühltische
verrostet	verrostet
Tore	Tore
Paralipse	Paralipse
Suffixen	Suffixen
Kapitalverkehr	Kapitalverkehr
Solch	Solch
Europameistern	Europameistern
scherze	scherze
Mönche	Mönche
war	war
erniedrigst	erniedrigst
ruhe	ruhe
läuten	läuten
Hure	Hure
verstehst	verstehst
feierte	feierte
gebäre	gebäre
welche	welche
fluppten	fluppten
bebte	bebte
Irrtumes	Irrtumes
widerlegest	widerlegest
Einfältigkeiten	Einfältigkeiten
karikieret	karikieret
Borhydrid	Borhydrid
anzöge	anzöge
befehle	befehle
Zeithorizonten	Zeithorizonten
ducktest	ducktest
dampfte	dampfte
Brüdern	Brüdern
zuhörte	zuhörte
erlaube	erlaube
Strohhälmchen	Strohhälmchen
Exzentriker	Exzentriker
unterstützet	unterstützet
beleuchteten	beleuchteten
wechselwirkt	wechselwirkt
Töpfen	Töpfen
gedurft	gedurft
Arresten	Arresten
bequemte	bequemte
Bildpunkt	Bildpunkt
ihnen	ihnen
Atmosphäre	Atmosphäre
verberge	verberge
Unter	Unter
Durchbruches	Durchbruches
Dachdecker	Dachdecker
diversifiziere	diversifiziere
Dank	Dank
brausen	brausen
verwahret	verwahret
Dudelsack	Dudelsack
verdeckst	verdeckst
Excimerlasern	Excimerlasern
spritzet	spritzet
Pflichten	Pflichten
Gewinnung	Gewinnung
deaktivierst	deaktivierst
Hansen	Hansen
Aacheners	Aacheners
mikrominiaturisierten	mikrominiaturisierten
analysierest	analysierest
Steuerbord	Steuerbord
Finanzministerium	Finanzministerium
Gefilden	Gefilden
hebet	hebet
gelost	gelost
Germanist	Germanist
Pausbacken	Pausbacken
tätowiertet	tätowiertet
Blockflöten	Blockflöten
jagst	jagst
kritzelst	kritzelst
sagtet	sagtet
Entrées	Entrées
mopst	mopst
kein	kein
babbeltet	babbeltet
gönnst	gönnst
Hirnstämme	Hirnstämme
Geräte	Geräte
hättet	hättet
schnappt	schnappt
wiederkamt	wiederkamt
quietsche	quietsche
Diesen	Diesen
Grüße	Grüße
gratuliert	gratuliert
Riesen	Riesen
verbrauchet	verbrauchet
geniertest	geniertest
klappest	klappest
räumen	räumen
Äxte	Äxte
Kontrollkästchen	Kontrollkästchen
Ding	Ding
reichte	reichte
vertilgte	vertilgte
halte	halte
suchest	suchest
Katalanen	Katalanen
velarisiert	velarisiert
assimilieret	assimilieret
strecke	strecke
Freibergit	Freibergit
fahrest	fahrest
Arbeitsbereichen	Arbeitsbereichen
Arme	Arme
ermahnt	ermahnt
eiterten	eiterten
anzeigest	anzeigest
Hehlern	Hehlern
bimmelten	bimmelten
Karikaturistinnen	Karikaturistinnen
kram	kram
Vollkornbrot	Vollkornbrot
erwürgest	erwürgest
streute	streute
Zankapfels	Zankapfels
harrten	harrten
Anzeichens	Anzeichens
unschuldige	unschuldige
entsetzte	entsetzte
Vordenkern	Vordenkern
oben	oben
freuet	freuet
vermögen	vermögen
ältesten	ältesten
abalienierest	abalienierest
holst	holst
Regent	Regent
Haltepunkt	Haltepunkt
verlasse	verlasse
demütig	demütig
Irrtümern	Irrtümern
lögest	lögest
fotzt	fotzt
analysieret	analysieret
Großfürst	Großfürst
Stellen	Stellen
zeltest	zeltest
protestiere	protestiere
Maut	Maut
ankerst	ankerst
manövrierte	manövrierte
Klüfte	Klüfte
Plüschtiere	Plüschtiere
Hypochlorite	Hypochlorite
erweckst	erweckst
Trotzkisten	Trotzkisten
leistete	leistete
verdammen	verdammen
zwingst	zwingst
Gallan	Gallan
Kräfte	Kräfte
Stimmen	Stimmen
verwerten	verwerten
verbündeten	verbündeten
Zunge	Zunge
Briefköpfen	Briefköpfen
Anmelder	Anmelder
denaturiert	denaturiert
eggten	eggten
ratschlagt	ratschlagt
erpress	erpress
Prostyloi	Prostyloi
Grieche	Grieche
mehret	mehret
verschlimmerte	verschlimmerte
Bürzeln	Bürzeln
Überziehen	Überziehen
Urheimaten	Urheimaten
Crescendo	Crescendo
Eisenkräutern	Eisenkräutern
Bienenstock	Bienenstock
pulsiere	pulsiere
aufhebest	aufhebest
schwellen	schwellen
kehre	kehre
breche	breche
entrümpelest	entrümpelest
überdächte	überdächte
erzeigt	erzeigt
Buntwaschmittel	Buntwaschmittel
bestanden	bestanden
mästest	mästest
besuche	besuche
dramatisiert	dramatisiert
Ångström	Ångström
Gefäße	Gefäße
graben	graben
Schwächungen	Schwächungen
UND-Gatter	UND-Gatter
Färsen	Färsen
Meinen	Meinen
meldet	meldet
christianisiere	christianisiere
verspäte	verspäte
borgst	borgst
Heteroatom	Heteroatom
verstrahlet	verstrahlet
tattert	tattert
kürze	kürze
eingehest	eingehest
Meine	Meine
schwöllen	schwöllen
vollendest	vollendest
kaufe	kaufe
Hubschrauber	Hubschrauber
Ochse	Ochse
verschärfst	verschärfst
sage	sage
schütze	schütze
scheinest	scheinest
Heuhaufen	Heuhaufen
Steuerberater	Steuerberater
entheiligten	entheiligten
misstrauen	misstrauen
Nadelbäumen	Nadelbäumen
schreckt	schreckt
Wandergewerbe	Wandergewerbe
speiste	speiste
lautete	lautete
Schaffnerinnen	Schaffnerinnen
vernichtest	vernichtest
kommet	kommet
Heben	Heben
höbest	höbest
Arbeitskreis	Arbeitskreis
assimiliertest	assimiliertest
gedenket	gedenket
Äste	Äste
Füllfedern	Füllfedern
Blaumeise	Blaumeise
bewähret	bewähret
Ärztin	Ärztin
Totgeburten	Totgeburten
bejubelte	bejubelte
überwachest	überwachest
Schiffe	Schiffe
imitiert	imitiert
halbierte	halbierte
flirre	flirre
gute	gute
Abnahmen	Abnahmen
verfügten	verfügten
folg	folg
kehrst	kehrst
erfahrest	erfahrest
schreibst	schreibst
dirigieren	dirigieren
glawbten	glawbten
Toten	Toten
Nussknackern	Nussknackern
träumte	träumte
Möbiusbändern	Möbiusbändern
zertifiziertest	zertifiziertest
verliert	verliert
schreiet	schreiet
Kirgisinnen	Kirgisinnen
Fröschen	Fröschen
Maultiere	Maultiere
Wache	Wache
dissentierten	dissentierten
Genetikerin	Genetikerin
lest	lest
mußte	mußte
Brite	Brite
erhörst	erhörst
Schneepflug	Schneepflug
Katz-und-Maus-Spielen	Katz-und-Maus-Spielen
Weichloten	Weichloten
Rufet	Rufet
Fahrzeugkatalysatoren	Fahrzeugkatalysatoren
evaluierten	evaluierten
implodiere	implodiere
erlösen	erlösen
Reisebüro	Reisebüro
trägt	trägt
Schuhen	Schuhen
klumpe	klumpe
untertreten	untertreten
kaufst	kaufst
hineinbrächten	hineinbrächten
boykottierten	boykottierten
Gebeine	Gebeine
beteuerest	beteuerest
Propheten	Propheten
Glauben	Glauben
Massagen	Massagen
Lusitaner	Lusitaner
Luftschiff	Luftschiff
gehören	gehören
reagiert	reagiert
verdrehet	verdrehet
Ausländer	Ausländer
sinkest	sinkest
Wechselstube	Wechselstube
bezahlst	bezahlst
Mobilfunknetze	Mobilfunknetze
rebellieret	rebellieret
Aha-Erlebnis	Aha-Erlebnis
föhnten	föhnten
Numerus	Numerus
Einstufung	Einstufung
Weihen	Weihen
Metallquirlen	Metallquirlen
massakrierten	massakrierten
eures	eures
Palme	Palme
erhebet	erhebet
außer	außer
Meter	Meter
kehrte	kehrte
Meerschweinchen	Meerschweinchen
initiierst	initiierst
ringe	ringe
Fluorkohlenwasserstoff	Fluorkohlenwasserstoff
lüftet	lüftet
Sportlerin	Sportlerin
Brötchen	Brötchen
reichet	reichet
interpretierten	interpretierten
unterbewertete	unterbewertete
kriegte	kriegte
elften	elften
fluche	fluche
Acetat	Acetat
Bajonetten	Bajonetten
Metallspiegeln	Metallspiegeln
Schwebfliegen	Schwebfliegen
lege	lege
Körpergeruches	Körpergeruches
Klärung	Klärung
bange	bange
colorierten	colorierten
feiern	feiern
hingehet	hingehet
verwirfst	verwirfst
Ente	Ente
Senkung	Senkung
trompete	trompete
Campingplätzen	Campingplätzen
überdenkst	überdenkst
beschrifteten	beschrifteten
seine	seine
hänge	hänge
erstarre	erstarre
Maßen	Maßen
bedeckest	bedeckest
Pfeile	Pfeile
Flammen	Flammen
Brieföffners	Brieföffners
ihre	ihre
Heeren	Heeren
konvertiere	konvertiere
setzten	setzten
Soll	Soll
endlagern	endlagern
stille	stille
beiden	beiden
schwächend	schwächend
bestimmst	bestimmst
scheltet	scheltet
Kaffeelöffel	Kaffeelöffel
Erbse	Erbse
Klappertopf	Klappertopf
Naturen	Naturen
Sabbatjahr	Sabbatjahr
bedeckst	bedeckst
verzeichne	verzeichne
Arsenbergwerken	Arsenbergwerken
Panzerschreck	Panzerschreck
tatteret	tatteret
Zubrötchen	Zubrötchen
mühe	mühe
Blattgewebe	Blattgewebe
scherzt	scherzt
übrigbleibe	übrigbleibe
verdinglichest	verdinglichest
Herbstwinde	Herbstwinde
zerfetzte	zerfetzte
flirtete	flirtete
kämpfet	kämpfet
Arbeitsbereich	Arbeitsbereich
Leugnung	Leugnung
Backenbärten	Backenbärten
Trinken	Trinken
schauest	schauest
batet	batet
tragen	tragen
zerbrichst	zerbrichst
überschattet	überschattet
Flöten	Flöten
respektiert	respektiert
verwertete	verwertete
bündelet	bündelet
Schauen	Schauen
Talismanen	Talismanen
Apfelbäumen	Apfelbäumen
spracht	spracht
streue	streue
sollten	sollten
Fittiche	Fittiche
Marokkanern	Marokkanern
lebet	lebet
Bettler	Bettler
Freitagnachmittagen	Freitagnachmittagen
Teufeln	Teufeln
jappte	jappte
kritzele	kritzele
sei	sei
zuppte	zuppte
Wehklage	Wehklage
Bagger	Bagger
duckt	duckt
Abfertigungsschalter	Abfertigungsschalter
Reinigungsschrittes	Reinigungsschrittes
gelobet	gelobet
blamierten	blamierten
Alkine	Alkine
Chlorat	Chlorat
wachset	wachset
Hat	Hat
Fittichen	Fittichen
Rückweg	Rückweg
lohnten	lohnten
klönen	klönen
Literaturen	Literaturen
letzte	letzte
Haarshampoos	Haarshampoos
entstände	entstände
Schwirrvögel	Schwirrvögel
schmuggelte	schmuggelte
Putschisten	Putschisten
kurbelte	kurbelte
Extrems	Extrems
infizieret	infizieret
Aspartamen	Aspartamen
weinte	weinte
Golfplätzen	Golfplätzen
begliche	begliche
Californium	Californium
produzierten	produzierten
finanzierest	finanzierest
generalisiere	generalisiere
esset	esset
Schanktischen	Schanktischen
drosselt	drosselt
gehörten	gehörten
kürzt	kürzt
führte	führte
Safrane	Safrane
steinigst	steinigst
Anführern	Anführern
Buntspechten	Buntspechten
plissieren	plissieren
simuliertet	simuliertet
Friesen	Friesen
sprüht	sprüht
reichst	reichst
drängst	drängst
Nachruf	Nachruf
lachen	lachen
drosselten	drosselten
Hochsommer	Hochsommer
Schnitzeljagd	Schnitzeljagd
merkte	merkte
heiligem	heiligem
stürze	stürze
Gicht	Gicht
Wunde	Wunde
Nukleinsäuren	Nukleinsäuren
prosteten	prosteten
nähte	nähte
erfüllet	erfüllet
besprichst	besprichst
Rotzinkerzen	Rotzinkerzen
verklärest	verklärest
Feldbett	Feldbett
rufet	rufet
fremde	fremde
Traggasen	Traggasen
gestattest	gestattest
schmuggle	schmuggle
changiere	changiere
liebet	liebet
ziehet	ziehet
Tiefschutz	Tiefschutz
Betten	Betten
demütige	demütige
entwendet	entwendet
Galeere	Galeere
Bächen	Bächen
Besuch	Besuch
Denunziationen	Denunziationen
zerstreuet	zerstreuet
musizierte	musizierte
Argentit	Argentit
verachte	verachte
grüßend	grüßend
Trioxiden	Trioxiden
Dienstgrad	Dienstgrad
wechseln	wechseln
höbet	höbet
Gesamtmengen	Gesamtmengen
Hüllenelektronen	Hüllenelektronen
verkürztest	verkürztest
Samarskite	Samarskite
Jahre	Jahre
inspirierten	inspirierten
baute	baute
Weinet	Weinet
hieltest	hieltest
Anarchisten	Anarchisten
bemächtigest	bemächtigest
Pardelkatze	Pardelkatze
Unrecht	Unrecht
Sternen	Sternen
Gässchen	Gässchen
missverstände	missverstände
beschrifte	beschrifte
Pfarrerinnen	Pfarrerinnen
laut	laut
Wehr	Wehr
Küsserei	Küsserei
Wasserquelle	Wasserquelle
Aktienkursen	Aktienkursen
hinterlegt	hinterlegt
erwachet	erwachet
Schild	Schild
Enden	Enden
Programmiererinnen	Programmiererinnen
verwechsele	verwechsele
dunkelt	dunkelt
verschlungen	verschlungen
Taschendieb	Taschendieb
Rechenbrett	Rechenbrett
Theistin	Theistin
Regiert	Regiert
Verwundete	Verwundete
Flossen	Flossen
heben	heben
knusperten	knusperten
vermeßest	vermeßest
log	log
protestieret	protestieret
Rosinenkuchenmodell	Rosinenkuchenmodell
beschlügen	beschlügen
brecht	brecht
Tintenfische	Tintenfische
beliefen	beliefen
Rotscheitelreiher	Rotscheitelreiher
Citrat	Citrat
weisest	weisest
Erbsen	Erbsen
dürfen	dürfen
verlobt	verlobt
Galoppen	Galoppen
feiere	feiere
weissagten	weissagten
Angabe	Angabe
Lehrbüchern	Lehrbüchern
bereite	bereite
wünschen	wünschen
Fallen	Fallen
Pläsieren	Pläsieren
schleißt	schleißt
reich	reich
Transportweg	Transportweg
inszenierst	inszenierst
weichst	weichst
Großstädtern	Großstädtern
bete	bete
dissentierte	dissentierte
globalisier	globalisier
Sauberfrauen	Sauberfrauen
ratet	ratet
fraget	fraget
verunreinigt	verunreinigt
überfischte	überfischte
zerstückt	zerstückt
Ränke	Ränke
idealisierest	idealisierest
suchte	suchte
begehrst	begehrst
Wert	Wert
fladerten	fladerten
zittertest	zittertest
weichest	weichest
Hektare	Hektare
achte	achte
saht	saht
erzeigten	erzeigten
Junge	Junge
Tiefen	Tiefen
vermahne	vermahne
ersparet	ersparet
überprüfte	überprüfte
bestellten	bestellten
ertraget	ertraget
verifizieret	verifizieret
begrabe	begrabe
Germanisten	Germanisten
stimmen	stimmen
ermutigte	ermutigte
taufe	taufe
heile	heile
Kleinode	Kleinode
Schlössern	Schlössern
verblieben	verblieben
Amtsträger	Amtsträger
thematisierte	thematisierte
kapiert	kapiert
Fluorgehalt	Fluorgehalt
knistern	knistern
Mammut	Mammut
Füllfederhalter	Füllfederhalter
velarisierend	velarisierend
Riegel	Riegel
Überschüsse	Überschüsse
schlabberte	schlabberte
ölt	ölt
tabuisiert	tabuisiert
Ängsten	Ängsten
Glühwürmchen	Glühwürmchen
fallen	fallen
freiwillige	freiwillige
Hektaren	Hektaren
Fusselbart	Fusselbart
rolltet	rolltet
weinen	weinen
dürftet	dürftet
referenzierst	referenzierst
begehrten	begehrten
fluchte	fluchte
tränkten	tränkten
Maxima	Maxima
schnorrtet	schnorrtet
bölkte	bölkte
ermordetet	ermordetet
Werde	Werde
strafend	strafend
gelobt	gelobt
wachte	wachte
Trägergasen	Trägergasen
Monaten	Monaten
moppet	moppet
grün	grün
verprügelte	verprügelte
blondieret	blondieret
Fetzens	Fetzens
messet	messet
rebelliere	rebelliere
verantwortetest	verantwortetest
verdunstet	verdunstet
folterst	folterst
glaubest	glaubest
Schönrednern	Schönrednern
sagtest	sagtest
installiert	installiert
Technetate	Technetate
reden	reden
Leichen	Leichen
Zement	Zement
Baisers	Baisers
Feind	Feind
punktest	punktest
irre	irre
Geschichtsbüchern	Geschichtsbüchern
Mähnenwolf	Mähnenwolf
Campingplatzes	Campingplatzes
liebt	liebt
quatschest	quatschest
Abschußring	Abschußring
Spieße	Spieße
bedeckt	bedeckt
beunruhigte	beunruhigte
Insulaner	Insulaner
Freunden	Freunden
erkalten	erkalten
Tetraiodiden	Tetraiodiden
bedingst	bedingst
Fortsetzungen	Fortsetzungen
beteuerten	beteuerten
aufrichtest	aufrichtest
Reinstoff	Reinstoff
deklarierten	deklarierten
Kuckucken	Kuckucken
urteilte	urteilte
protestierest	protestierest
Ackerschachtelhalme	Ackerschachtelhalme
Händedruck	Händedruck
Dürren	Dürren
verunglimpftet	verunglimpftet
meißeltest	meißeltest
Badezimmer	Badezimmer
deinem	deinem
bandagierte	bandagierte
Antitranspirante	Antitranspirante
verblute	verblute
ausrufen	ausrufen
Laken	Laken
lüftetet	lüftetet
malt	malt
kürzest	kürzest
Wasserbades	Wasserbades
begehren	begehren
Abarten	Abarten
Höfen	Höfen
bemächtigte	bemächtigte
Katamaranen	Katamaranen
Alten	Alten
Platte	Platte
Otaviten	Otaviten
Enthärtungen	Enthärtungen
Aspartame	Aspartame
sollst	sollst
surrst	surrst
belüftet	belüftet
kräusle	kräusle
Gefangenen	Gefangenen
überweisend	überweisend
unehrt	unehrt
malen	malen
Assistentinnen	Assistentinnen
Kuttern	Kuttern
Adelung	Adelung
Broten	Broten
Pentaboraten	Pentaboraten
Deuterium	Deuterium
wehte	wehte
Bluff	Bluff
Zeitbombe	Zeitbombe
Katz-und-Maus-Spiele	Katz-und-Maus-Spiele
notlande	notlande
Bombardierungen	Bombardierungen
Konfitüre	Konfitüre
Tut	Tut
Oxonium	Oxonium
Werkzeuge	Werkzeuge
türmen	türmen
Preisanstiegen	Preisanstiegen
Kautschuken	Kautschuken
parkierst	parkierst
ankern	ankern
buddeln	buddeln
Namen	Namen
beweist	beweist
Löwe	Löwe
Am	Am
mobilisierten	mobilisierten
kauerten	kauerten
Aerosole	Aerosole
kreierten	kreierten
Eingabe	Eingabe
imprägniere	imprägniere
Aufsätzen	Aufsätzen
Schreibtischtäter	Schreibtischtäter
behütet	behütet
reizte	reizte
Jungen	Jungen
versuchen	versuchen
speicherten	speicherten
Vorhäuten	Vorhäuten
Kürass	Kürass
Fürst	Fürst
rechte	rechte
infiziertet	infiziertet
Säue	Säue
bröckeln	bröckeln
verkürzt	verkürzt
kommest	kommest
schlaget	schlaget
kugelten	kugelten
warnet	warnet
löse	löse
greifen	greifen
Selbstversuch	Selbstversuch
Weihe	Weihe
entgehst	entgehst
Blaumeisen	Blaumeisen
plissiere	plissiere
wisperest	wisperest
nehmet	nehmet
steigeret	steigeret
Achsel	Achsel
Zensus	Zensus
Äthern	Äthern
bewiest	bewiest
Düften	Düften
fingiere	fingiere
Weinen	Weinen
erlöse	erlöse
Gefäßen	Gefäßen
charakterisierend	charakterisierend
Kontraindikation	Kontraindikation
hadere	hadere
säusele	säusele
Hochsommern	Hochsommern
lang	lang
verglühte	verglühte
welchen	welchen
injiziert	injiziert
eingehst	eingehst
jedem	jedem
bediene	bediene
Decket	Decket
bauest	bauest
Düfte	Düfte
standet	standet
Aphasien	Aphasien
begehret	begehret
alles	alles
dümpelte	dümpelte
Abschiedsbriefe	Abschiedsbriefe
koordinierte	koordinierte
heftete	heftete
laden	laden
verklärt	verklärt
übersteht	übersteht
unterschiede	unterschiede
Tritt	Tritt
erzürnt	erzürnt
Weichlote	Weichlote
Pflaumen	Pflaumen
Führet	Führet
Eiland	Eiland
speiset	speiset
verletzte	verletzte
gehorchest	gehorchest
beseht	beseht
bewiesen	bewiesen
spanne	spanne
Deinen	Deinen
Tatsachenbeschönigern	Tatsachenbeschönigern
verschreibt	verschreibt
Coventrisierung	Coventrisierung
Recitativen	Recitativen
entwaffnest	entwaffnest
flitzen	flitzen
ihres	ihres
unseres	unseres
henket	henket
verziehen	verziehen
nötig	nötig
verbärgen	verbärgen
zeugtest	zeugtest
torpedieret	torpedieret
verunreinigst	verunreinigst
winkt	winkt
Lüsten	Lüsten
verglühest	verglühest
Lammfellhandschuhs	Lammfellhandschuhs
Knaben	Knaben
forschte	forschte
balkanisierte	balkanisierte
Wolle	Wolle
berufen	berufen
klonet	klonet
Elektronenschale	Elektronenschale
Bankettes	Bankettes
eins	eins
Kurkumen	Kurkumen
Telefonnummern	Telefonnummern
Katamaran	Katamaran
am	am
verkaufst	verkaufst
frevler	frevler
misstrauet	misstrauet
Zipfelmützen	Zipfelmützen
geschämt	geschämt
steigen	steigen
diesen	diesen
frisch	frisch
Gebot	Gebot
respektierten	respektierten
Grab	Grab
umhüllst	umhüllst
Kornnattern	Kornnattern
erforschet	erforschet
Wer	Wer
Grabbeltischen	Grabbeltischen
Rutheniumkomplexen	Rutheniumkomplexen
Rückumschlägen	Rückumschlägen
Steige	Steige
streifte	streifte
dehydrierte	dehydrierte
verwahrt	verwahrt
Frieden	Frieden
verführe	verführe
Döner	Döner
endlagerten	endlagerten
koordinieret	koordinieret
Frösche	Frösche
heftetest	heftetest
regieret	regieret
teilet	teilet
Golfplatz	Golfplatz
blätteret	blätteret
hebräisch	hebräisch
reanimiere	reanimiere
langweilst	langweilst
Zöpfe	Zöpfe
Bestechungsgelder	Bestechungsgelder
Schnipsel	Schnipsel
glühenden	glühenden
pressiere	pressiere
offenbart	offenbart
verdrängen	verdrängen
verwahrst	verwahrst
wallfahrten	wallfahrten
Büsche	Büsche
verspäteten	verspäteten
instanziiere	instanziiere
verzeigt	verzeigt
scheuchten	scheuchten
Kernspaltungen	Kernspaltungen
Ersten	Ersten
pustet	pustet
Signalen	Signalen
wegführen	wegführen
heulet	heulet
reicht	reicht
Buche	Buche
verkündigst	verkündigst
straften	straften
darfst	darfst
Mäusespeck	Mäusespeck
Indianer	Indianer
Zankapfel	Zankapfel
spannte	spannte
erliegst	erliegst
protokollierst	protokollierst
besät	besät
Crescendos	Crescendos
Charakteristikan	Charakteristikan
hassest	hassest
Heuschrecke	Heuschrecke
Komplexionen	Komplexionen
heiligest	heiligest
Würfelspiele	Würfelspiele
kauten	kauten
Flame	Flame
Andrologie	Andrologie
hörest	hörest
wehret	wehret
Gedächtnisse	Gedächtnisse
Strahlentierchen	Strahlentierchen
sollte	sollte
werden	werden
löset	löset
kappten	kappten
kasernierte	kasernierte
verfinstere	verfinstere
Dithiolan	Dithiolan
Elfen	Elfen
Wimpertierchen	Wimpertierchen
anhangen	anhangen
Kriegen	Kriegen
besser	besser
Geflecktheit	Geflecktheit
wurden	wurden
Euphemismus	Euphemismus
verabschiedeten	verabschiedeten
Binden	Binden
exmatrikuliertet	exmatrikuliertet
Badezimmers	Badezimmers
schätzte	schätzte
offenbare	offenbare
reifst	reifst
verdammt	verdammt
Sorge	Sorge
dürfte	dürfte
begebet	begebet
bequemen	bequemen
Entree	Entree
Zehnt	Zehnt
aufstand	aufstand
Hackern	Hackern
falle	falle
liebtest	liebtest
eigenen	eigenen
besichtigt	besichtigt
Götzen	Götzen
eskalieret	eskalieret
überstehend	überstehend
Elementarzelle	Elementarzelle
lancierst	lancierst
Laufringe	Laufringe
verdunsten	verdunsten
verbasele	verbasele
Thioester	Thioester
Finanzministerien	Finanzministerien
Strontiumamalgamen	Strontiumamalgamen
holte	holte
nähret	nähret
Abfahrtsliste	Abfahrtsliste
gewähr	gewähr
Armband	Armband
bewahrest	bewahrest
desertierst	desertierst
putzte	putzte
Panamaer	Panamaer
Münzsammlungen	Münzsammlungen
Huflattich	Huflattich
beeinflusste	beeinflusste
schließt	schließt
bollerte	bollerte
stillte	stillte
Welche	Welche
schichtet	schichtet
Königen	Königen
Atombomben	Atombomben
Lazarett	Lazarett
Vordenker	Vordenker
bedrückest	bedrückest
schauten	schauten
schwangt	schwangt
versteckte	versteckte
gravierst	gravierst
vollendete	vollendete
rächte	rächte
Freibergits	Freibergits
knurrtet	knurrtet
Frommen	Frommen
gewöhnte	gewöhnte
Diethylether	Diethylether
schiebest	schiebest
erbrüte	erbrüte
Metallquirle	Metallquirle
anfinge	anfinge
verschlimmere	verschlimmere
Kochfeldern	Kochfeldern
hintertrieben	hintertrieben
Stärkungsmittel	Stärkungsmittel
ansehet	ansehet
eng	eng
Trichtern	Trichtern
Automatikgetriebe	Automatikgetriebe
Unwahrheit	Unwahrheit
sagest	sagest
parliere	parliere
hievten	hievten
ringet	ringet
fluppe	fluppe
geratest	geratest
watet	watet
pflügten	pflügten
wachen	wachen
Sitzfleisches	Sitzfleisches
glawbte	glawbte
erscheine	erscheine
eine	eine
Verwaltungsakte	Verwaltungsakte
Planer	Planer
gehorcht	gehorcht
antworte	antworte
dampfst	dampfst
warten	warten
Greyerzer	Greyerzer
Diamantringen	Diamantringen
kontaktieret	kontaktieret
schläfst	schläfst
hurst	hurst
solchen	solchen
irren	irren
Herabsetzungen	Herabsetzungen
Atemgas	Atemgas
rittest	rittest
rangieret	rangieret
meinet	meinet
Blumensträußen	Blumensträußen
einerntest	einerntest
Zahnfleischentzündungen	Zahnfleischentzündungen
Amt	Amt
Sündern	Sündern
begeben	begeben
begnügt	begnügt
amenagier	amenagier
solches	solches
Massenanteilen	Massenanteilen
Kavalier	Kavalier
streckst	streckst
wischt	wischt
verwechseltet	verwechseltet
bestimmten	bestimmten
Geliebte	Geliebte
frappiere	frappiere
vertrieben	vertrieben
liegst	liegst
ehren	ehren
betreten	betreten
Gebäcken	Gebäcken
Zeitungsenten	Zeitungsenten
Reinelemente	Reinelemente
begruben	begruben
Kerzenfische	Kerzenfische
defragmentierest	defragmentierest
Zwingburgen	Zwingburgen
härte	härte
Füllet	Füllet
bewährt	bewährt
blockiert	blockiert
drillte	drillte
Geschichtsbücher	Geschichtsbücher
Deine	Deine
wärt	wärt
Elle	Elle
Zwetschge	Zwetschge
Heringe	Heringe
beeindrucket	beeindrucket
grienest	grienest
Mittelaltermarktes	Mittelaltermarktes
Malen	Malen
nähet	nähet
malträtierte	malträtierte
Wege	Wege
Wirtschaftswissenschaft	Wirtschaftswissenschaft
sintertest	sintertest
enttäuschet	enttäuschet
webte	webte
verständige	verständige
Obszönität	Obszönität
erwähnet	erwähnet
parametrisierte	parametrisierte
Glatteis	Glatteis
versuche	versuche
kramst	kramst
wohnest	wohnest
verhalten	verhalten
knüpfte	knüpfte
Tiere	Tiere
nippst	nippst
Gefilde	Gefilde
klickte	klickte
Sonderberichte	Sonderberichte
Fermium	Fermium
Trinket	Trinket
Fetzen	Fetzen
Adelungen	Adelungen
näht	näht
Gläubiger	Gläubiger
vertagest	vertagest
frappierte	frappierte
lostest	lostest
offenbar	offenbar
beichten	beichten
spekuliere	spekuliere
verunzierte	verunzierte
koexistierten	koexistierten
massakrierte	massakrierte
gedenkst	gedenkst
entsetzt	entsetzt
erstehst	erstehst
schlagest	schlagest
entschleiert	entschleiert
Feldzug	Feldzug
Held	Held
Ludwigsburger	Ludwigsburger
Warten	Warten
Leitungswegs	Leitungswegs
Linguistinnen	Linguistinnen
speisen	speisen
Basilisken	Basilisken
vertreibt	vertreibt
griffen	griffen
erforschest	erforschest
häuftet	häuftet
erliegest	erliegest
spezialisierst	spezialisierst
Dichten	Dichten
dekorieren	dekorieren
eingehet	eingehet
Garben	Garben
käbbelnd	käbbelnd
Grufti	Grufti
Fallet	Fallet
Eistaucher	Eistaucher
transportierst	transportierst
brillieret	brillieret
Flussbett	Flussbett
konjugiere	konjugiere
stickt	stickt
Gurt	Gurt
zürnet	zürnet
Kontrollboxen	Kontrollboxen
füllen	füllen
auszogst	auszogst
verfanget	verfanget
versüßtet	versüßtet
verkaufte	verkaufte
Vergeltungen	Vergeltungen
Riese	Riese
verladet	verladet
vertrauten	vertrauten
Cola	Cola
glaubte	glaubte
strafest	strafest
verallgemeinerest	verallgemeinerest
lüg	lüg
verderbet	verderbet
überbewertet	überbewertet
Botokuden	Botokuden
Ihre	Ihre
Schreiet	Schreiet
unterfordern	unterfordern
Breiten	Breiten
brandet	brandet
entsündigt	entsündigt
Rotgüssen	Rotgüssen
traget	traget
Knabe	Knabe
Blättchen	Blättchen
Hüfte	Hüfte
Vipernatter	Vipernatter
einer	einer
Abhänge	Abhänge
Ach	Ach
Pimmel	Pimmel
quietschest	quietschest
erbaust	erbaust
Zehe	Zehe
Friedensforscherinnen	Friedensforscherinnen
kühle	kühle
Heteroatome	Heteroatome
verwaiset	verwaiset
grüßen	grüßen
Abnahme	Abnahme
solle	solle
Drehtüren	Drehtüren
erliegen	erliegen
häufte	häufte
Streite	Streite
verkündige	verkündige
durchläuterte	durchläuterte
verbarg	verbarg
addieren	addieren
Nehmet	Nehmet
enge	enge
Glaubst	Glaubst
Ackerschachtelhalm	Ackerschachtelhalm
Gallanen	Gallanen
verdränge	verdränge
weist	weist
behauptest	behauptest
schautest	schautest
verbaselte	verbaselte
wahr	wahr
Organisationen	Organisationen
sitzet	sitzet
zeugte	zeugte
urteilen	urteilen
Markisen	Markisen
emendieret	emendieret
Trockendocks	Trockendocks
beeinflusst	beeinflusst
filzst	filzst
kurze	kurze
steiget	steiget
sitzt	sitzt
Drohkulissen	Drohkulissen
binden	binden
sehest	sehest
gaffest	gaffest
punkten	punkten
erstände	erstände
Solchen	Solchen
glühten	glühten
bauten	bauten
enttäuschtest	enttäuschtest
Rechte	Rechte
Sachen	Sachen
folgtet	folgtet
Weh	Weh
erzürnst	erzürnst
frische	frische
pendele	pendele
Langeweile	Langeweile
bräunst	bräunst
desensibilisierten	desensibilisierten
gebäret	gebäret
quatschen	quatschen
hängen	hängen
folgst	folgst
wache	wache
babbelt	babbelt
beleidige	beleidige
Schlöte	Schlöte
sabbelt	sabbelt
rekrutierest	rekrutierest
helle	helle
zerstücken	zerstücken
Gar	Gar
Pfleglingen	Pfleglingen
Aussätzige	Aussätzige
Epidemie	Epidemie
essest	essest
Kassiteriten	Kassiteriten
erweckest	erweckest
Name	Name
Schale	Schale
Geldautomat	Geldautomat
belüftete	belüftete
nippend	nippend
heparinisierten	heparinisierten
mampfte	mampfte
vergibt	vergibt
assimilierten	assimilierten
anders	anders
Feste	Feste
Kompass	Kompass
verfliegest	verfliegest
braust	braust
Kerl	Kerl
Tier	Tier
salz	salz
lärmte	lärmte
Metapher	Metapher
polymerisier	polymerisier
chloroformiere	chloroformiere
Äxten	Äxten
Flöße	Flöße
interagierte	interagierte
lebte	lebte
handhaben	handhaben
schauend	schauend
begrübest	begrübest
Dolde	Dolde
Ärzte	Ärzte
Arsenolithen	Arsenolithen
attackieret	attackieret
verstecke	verstecke
Ächselchen	Ächselchen
Membran	Membran
danke	danke
Fülle	Fülle
deklarierte	deklarierte
schicke	schicke
Wiedergutmachungen	Wiedergutmachungen
fresset	fresset
Hochhäusern	Hochhäusern
Wegen	Wegen
vertrieb	vertrieb
spritzt	spritzt
verdammte	verdammte
Fremdwörter	Fremdwörter
Extremen	Extremen
besorgt	besorgt
wälzet	wälzet
bleibst	bleibst
schaffst	schaffst
Arsenite	Arsenite
Dieben	Dieben
Lebenskraft	Lebenskraft
Freitagnachmittage	Freitagnachmittage
Wahnen	Wahnen
pilgert	pilgert
hintertriebe	hintertriebe
Filzläusen	Filzläusen
arbeit	arbeit
Wandergesellen	Wandergesellen
Aphasie	Aphasie
Wille	Wille
dürfest	dürfest
Kassettenrekordern	Kassettenrekordern
Abtrünnige	Abtrünnige
rännen	rännen
obfuskierten	obfuskierten
Band	Band
Säcken	Säcken
Aufsätze	Aufsätze
annektierst	annektierst
Thioestere	Thioestere
billigte	billigte
zuteil	zuteil
Hirte	Hirte
schlängelest	schlängelest
lieget	lieget
schon	schon
Rechnungen	Rechnungen
globalisieret	globalisieret
Ratsherren	Ratsherren
Bäusche	Bäusche
Polizeisprecher	Polizeisprecher
pressierten	pressierten
hickste	hickste
gelobtet	gelobtet
attackieren	attackieren
Polierstählen	Polierstählen
zähltet	zähltet
schenket	schenket
verdränget	verdränget
rekonstruieren	rekonstruieren
harmoniert	harmoniert
Decken	Decken
Bette	Bette
verselbständigt	verselbständigt
kennest	kennest
funktionierte	funktionierte
entdeckst	entdeckst
setze	setze
verlaßt	verlaßt
Seil	Seil
Notärztinnen	Notärztinnen
selbst	selbst
Rechten	Rechten
Aluminaten	Aluminaten
Chlorwasserstoffmolekül	Chlorwasserstoffmolekül
Fällt	Fällt
Hertz	Hertz
Wollte	Wollte
drückte	drückte
Grizzlybär	Grizzlybär
Politologe	Politologe
stationierten	stationierten
charakterisiert	charakterisiert
amputierten	amputierten
besetzen	besetzen
belauere	belauere
umhüllt	umhüllt
verbitterte	verbitterte
Skorpionen	Skorpionen
rekrutiere	rekrutiere
erhöhet	erhöhet
Fingerhüte	Fingerhüte
Herkunft	Herkunft
Trickbetrüger	Trickbetrüger
dehydrierten	dehydrierten
entwischtet	entwischtet
Druckfehlern	Druckfehlern
säuselest	säuselest
Westen	Westen
grünten	grünten
siegte	siegte
scheinet	scheinet
Aussätzigen	Aussätzigen
treibst	treibst
predig	predig
Denn	Denn
Montagmittagen	Montagmittagen
vermahnet	vermahnet
Abszisse	Abszisse
sprachen	sprachen
geleite	geleite
hydrolysierest	hydrolysierest
Leiche	Leiche
Vetter	Vetter
lügen	lügen
Reflexionen	Reflexionen
lös	lös
Fällen	Fällen
aufrichten	aufrichten
begnügte	begnügte
auflegte	auflegte
pflanzte	pflanzte
schaffte	schaffte
Brieftaubenzüchters	Brieftaubenzüchters
klappen	klappen
jammern	jammern
Puffersystemen	Puffersystemen
Kohlenstoffgehalt	Kohlenstoffgehalt
ihr	ihr
fragte	fragte
jene	jene
schrecken	schrecken
verbitterten	verbitterten
widmeten	widmeten
hell	hell
rote	rote
Dein	Dein
Sprachräumen	Sprachräumen
Kirgisin	Kirgisin
kaserniert	kaserniert
arrivieren	arrivieren
verspätete	verspätete
Däumlings	Däumlings
Honigbär	Honigbär
bejubelst	bejubelst
entzogen	entzogen
beides	beides
hätten	hätten
ramme	ramme
Gewichten	Gewichten
gedacht	gedacht
beschotterten	beschotterten
kabelte	kabelte
Türkise	Türkise
sedimentiertet	sedimentiertet
Geburtsnamen	Geburtsnamen
Bleche	Bleche
überweis	überweis
Fluorkohlenwasserstoffe	Fluorkohlenwasserstoffe
erweckt	erweckt
laufet	laufet
separieret	separieret
verzehrst	verzehrst
Toren	Toren
Selbstversuchen	Selbstversuchen
erbte	erbte
posierten	posierten
erkennest	erkennest
überfällst	überfällst
Schreibtischtätern	Schreibtischtätern
bückest	bückest
Überfamilie	Überfamilie
Baiser	Baiser
Unterseiten	Unterseiten
umarmet	umarmet
Schwan	Schwan
Bürzel	Bürzel
Quellfluss	Quellfluss
rufen	rufen
Würfelspiel	Würfelspiel
panaschieren	panaschieren
Füllfederhalters	Füllfederhalters
Trübsalen	Trübsalen
glaubtet	glaubtet
Thioacetal	Thioacetal
Schwermetallionen	Schwermetallionen
sterbet	sterbet
Außenministerien	Außenministerien
dividiere	dividiere
Brotkästen	Brotkästen
trübe	trübe
Martyrologium	Martyrologium
Renegat	Renegat
drücke	drücke
Füllen	Füllen
Abtrünnigen	Abtrünnigen
klumpt	klumpt
sterilisierte	sterilisierte
respektieren	respektieren
Azubi	Azubi
Äther	Äther
sorget	sorget
Alles	Alles
Elastomer	Elastomer
grüßt	grüßt
Kleptokratie	Kleptokratie
verringertet	verringertet
Jünglinge	Jünglinge
buddelten	buddelten
Zebrahaies	Zebrahaies
Schaffnerin	Schaffnerin
Bromidquelle	Bromidquelle
springst	springst
wurstelten	wurstelten
berufe	berufe
mischt	mischt
Fanatiker	Fanatiker
finanzieret	finanzieret
erdacht	erdacht
flirtest	flirtest
idealisieret	idealisieret
konsumieren	konsumieren
Pfeilen	Pfeilen
versuchtet	versuchtet
möchte	möchte
Anmeldern	Anmeldern
Gewürze	Gewürze
Zur-Schau-Stellen	Zur-Schau-Stellen
Decks	Decks
Anachronismen	Anachronismen
Deck	Deck
verkehrte	verkehrte
Unglauben	Unglauben
Dans	Dans
stutzt	stutzt
fluchet	fluchet
Stempeluhren	Stempeluhren
gedächtet	gedächtet
erlöst	erlöst
verdamme	verdamme
revoltieren	revoltieren
deren	deren
krähte	krähte
diskutierst	diskutierst
Bäche	Bäche
Ausnahmen	Ausnahmen
malochte	malochte
Scheißkerlen	Scheißkerlen
Hardwareentwicklerin	Hardwareentwicklerin
lochtest	lochtest
substituierten	substituierten
Seinen	Seinen
Hin	Hin
Speeren	Speeren
Sippe	Sippe
schmetterst	schmetterst
übte	übte
bebet	bebet
lavierte	lavierte
Höschen	Höschen
verbaseln	verbaseln
keulst	keulst
rufest	rufest
Strafraum	Strafraum
Nadel	Nadel
heißest	heißest
Physikerinnen	Physikerinnen
Fremdwort	Fremdwort
polymerisierte	polymerisierte
erbet	erbet
Wembley-Toren	Wembley-Toren
Tukanen	Tukanen
Setzet	Setzet
vermischen	vermischen
Esset	Esset
porträtiert	porträtiert
Diese	Diese
Montagmittag	Montagmittag
Paillette	Paillette
grünen	grünen
verlähmte	verlähmte
scheinen	scheinen
Gebote	Gebote
Möbiusbänder	Möbiusbänder
reifen	reifen
zuppst	zuppst
Taschendiebe	Taschendiebe
Zirkelbeweis	Zirkelbeweis
Mitschuld	Mitschuld
unterwirft	unterwirft
preisen	preisen
aufhoben	aufhoben
bereiten	bereiten
Spurensicherung	Spurensicherung
umarmen	umarmen
Letzte	Letzte
wollten	wollten
knuffend	knuffend
Willst	Willst
verzieht	verzieht
links	links
Fussel	Fussel
könnt	könnt
preist	preist
Halte	Halte
ritt	ritt
tunet	tunet
Buchfink	Buchfink
steige	steige
bricht	bricht
Bajonette	Bajonette
Puffersystem	Puffersystem
erzwinget	erzwinget
Telefonnummer	Telefonnummer
begäben	begäben
verstört	verstört
erdachten	erdachten
anruft	anruft
Physikerin	Physikerin
zweifelte	zweifelte
Konzentrat	Konzentrat
skypst	skypst
Serverzugriffen	Serverzugriffen
überliefere	überliefere
Wollt	Wollt
Armen	Armen
schwirret	schwirret
Vorstädte	Vorstädte
legt	legt
besitzet	besitzet
Halter	Halter
Rückwege	Rückwege
beherrschest	beherrschest
wünscht	wünscht
verließet	verließet
benachrichtige	benachrichtige
amen	amen
Ringe	Ringe
Fahrzeugkatalysator	Fahrzeugkatalysator
Mähnenwolfes	Mähnenwolfes
Spirale	Spirale
besänftiget	besänftiget
strafet	strafet
Innenministerien	Innenministerien
vermagst	vermagst
bekotete	bekotete
gebietet	gebietet
observierst	observierst
Rehböcken	Rehböcken
Lehrkörpern	Lehrkörpern
Ichs	Ichs
Hummern	Hummern
kapiertet	kapiertet
Druckfehler	Druckfehler
Brandbeschleuniger	Brandbeschleuniger
Gedränge	Gedränge
halten	halten
hetzte	hetzte
Operationssaal	Operationssaal
erwärmte	erwärmte
Nanotesla	Nanotesla
Pflicht	Pflicht
Aerosolen	Aerosolen
Strafräume	Strafräume
bescherten	bescherten
strömt	strömt
Schaffet	Schaffet
Entsetzet	Entsetzet
duzen	duzen
vermahnen	vermahnen
Anlässe	Anlässe
recycelten	recycelten
verwechselet	verwechselet
fälle	fälle
hebe	hebe
ratschlagten	ratschlagten
Prozeduren	Prozeduren
Technikerinnen	Technikerinnen
ratschlagen	ratschlagen
verderben	verderben
Joche	Joche
vernehmest	vernehmest
schälte	schälte
Nahrungsbestandteilen	Nahrungsbestandteilen
verkündigte	verkündigte
begehrte	begehrte
Quatsch	Quatsch
Gehörst	Gehörst
elfte	elfte
Beteiligte	Beteiligte
alle	alle
wende	wende
betrübtest	betrübtest
ihrem	ihrem
Ösophagospasmus	Ösophagospasmus
Knechte	Knechte
verkürzest	verkürzest
Theologien	Theologien
Moren	Moren
nagelte	nagelte
Judenräte	Judenräte
strullerst	strullerst
Hornung	Hornung
bandagiert	bandagiert
Langschwanzpinguin	Langschwanzpinguin
Beiblätter	Beiblätter
Cyanat	Cyanat
strafe	strafe
zürnest	zürnest
beanspruchte	beanspruchte
punkteten	punkteten
Gedrängen	Gedrängen
Deinem	Deinem
Uranerz	Uranerz
misstrauest	misstrauest
tattre	tattre
Dachdeckerinnen	Dachdeckerinnen
sagte	sagte
verlöteten	verlöteten
entrümpelst	entrümpelst
imkernd	imkernd
dechiffrierend	dechiffrierend
Macht	Macht
Solcher	Solcher
Einwirkungen	Einwirkungen
weichet	weichet
Untern	Untern
eher	eher
denn	denn
kauern	kauern
Tukans	Tukans
nachwandeln	nachwandeln
deines	deines
Türklingel	Türklingel
schnitt	schnitt
greinen	greinen
bezahlest	bezahlest
Pis	Pis
wiederholten	wiederholten
Glaubet	Glaubet
predigend	predigend
reinstitutionalisierten	reinstitutionalisierten
gequasselt	gequasselt
Quelle	Quelle
deckte	deckte
betätigtet	betätigtet
erpresst	erpresst
aufkämen	aufkämen
Hacker	Hacker
huren	huren
Elektrophil	Elektrophil
beklagte	beklagte
Monde	Monde
Leichtmetalle	Leichtmetalle
Schlager	Schlager
Quellen	Quellen
hegt	hegt
Referenzen	Referenzen
durchwachen	durchwachen
liebten	liebten
Gedanke	Gedanke
Anspielungen	Anspielungen
meine	meine
bereue	bereue
Oxalate	Oxalate
Stufen	Stufen
negierte	negierte
halle	halle
Senkungen	Senkungen
meißelt	meißelt
Anlass	Anlass
Aufträgen	Aufträgen
versklavte	versklavte
Höhe	Höhe
bombardiert	bombardiert
Unterwerfungen	Unterwerfungen
aufstanden	aufstanden
Erste	Erste
Böreks	Böreks
Fusselbärten	Fusselbärten
Acetaten	Acetaten
tyrannisierte	tyrannisierte
knüpfet	knüpfet
Wasserquellen	Wasserquellen
verstanden	verstanden
Fiasko	Fiasko
Drillingen	Drillingen
Küchenmaschine	Küchenmaschine
langweiltest	langweiltest
irgendein	irgendein
verrosteten	verrosteten
rammte	rammte
Gespenst	Gespenst
suchet	suchet
gern	gern
Hubschraubern	Hubschraubern
schlängelt	schlängelt
Indianern	Indianern
Langschwanzpinguinen	Langschwanzpinguinen
wacht	wacht
Alteritäten	Alteritäten
Ränken	Ränken
Laiben	Laiben
Toypudel	Toypudel
Landstreicher	Landstreicher
Sprechers	Sprechers
erlagst	erlagst
Kerzenfischen	Kerzenfischen
Patres	Patres
unterbewerte	unterbewerte
Tetraiodide	Tetraiodide
Menschen	Menschen
empörte	empörte
formiret	formiret
Schlagern	Schlagern
weinest	weinest
Piratensender	Piratensender
reim	reim
meinte	meinte
Massenarbeitslosigkeit	Massenarbeitslosigkeit
egge	egge
Alkali	Alkali
Reiterschwert	Reiterschwert
verbaselt	verbaselt
Stimme	Stimme
Mache	Mache
fette	fette
Vogelscheuchen	Vogelscheuchen
beschert	beschert
Judenrat	Judenrat
zuppt	zuppt
befehlt	befehlt
regierte	regierte
Berichterstattungen	Berichterstattungen
pflanzest	pflanzest
spukte	spukte
Fußballweltmeisterschaftsqualifikationsspiel	Fußballweltmeisterschaftsqualifikationsspiel
Tiefe	Tiefe
schmierte	schmierte
Rundbriefe	Rundbriefe
Sogen	Sogen
gebündelt	gebündelt
führst	führst
ärger	ärger
Schwermetallion	Schwermetallion
spurtest	spurtest
Impedanz	Impedanz
leerst	leerst
karikierten	karikierten
eingeht	eingeht
Feierabend	Feierabend
ausgerecktem	ausgerecktem
bezieht	bezieht
Fahret	Fahret
restaurieret	restaurieret
verwirrte	verwirrte
Friede	Friede
Indern	Indern
liebend	liebend
glühende	glühende
umbrächten	umbrächten
regelten	regelten
Herr	Herr
fokussieret	fokussieret
ritzten	ritzten
Ruß	Ruß
Chlorid	Chlorid
Führe	Führe
begnadigst	begnadigst
erriet	erriet
spalten	spalten
Dilettanten	Dilettanten
Männlein	Männlein
haben	haben
Sekretärinnen	Sekretärinnen
puste	puste
betrübet	betrübet
Stolze	Stolze
Briten	Briten
befestigte	befestigte
bewahrheitetet	bewahrheitetet
grause	grause
predige	predige
Signal	Signal
reparieret	reparieret
Tun	Tun
arbeiten	arbeiten
säst	säst
Kompromissen	Kompromissen
flense	flense
begrabest	begrabest
Sünders	Sünders
ballaste	ballaste
gesagt	gesagt
Arbeitsgruppen	Arbeitsgruppen
Adenosin	Adenosin
erben	erben
entmineralisierten	entmineralisierten
Gummibaumes	Gummibaumes
Kriegsschauplatz	Kriegsschauplatz
Blumenstrauß	Blumenstrauß
weissagst	weissagst
siehst	siehst
Nachteilen	Nachteilen
Verwundeten	Verwundeten
Zerfällen	Zerfällen
Aprikose	Aprikose
Radsätzen	Radsätzen
Playlists	Playlists
schneide	schneide
glänzt	glänzt
Kompromiss	Kompromiss
bekriegt	bekriegt
zählend	zählend
erforscht	erforscht
Festen	Festen
grabbelten	grabbelten
möchtest	möchtest
Zebrahai	Zebrahai
Machet	Machet
verstörten	verstörten
Geber	Geber
Trinkgefäße	Trinkgefäße
Randbemerkung	Randbemerkung
reiftet	reiftet
läutetet	läutetet
vereinigte	vereinigte
Gasflasche	Gasflasche
Metallspiegel	Metallspiegel
siegen	siegen
Autonomie	Autonomie
brenne	brenne
besorgten	besorgten
Halsabschneidern	Halsabschneidern
Schläfchens	Schläfchens
Harpune	Harpune
beißet	beißet
touchiere	touchiere
salzen	salzen
präsentiere	präsentiere
geliebt	geliebt
verblutete	verblutete
Steine	Steine
kramen	kramen
Knechten	Knechten
vergast	vergast
besprachen	besprachen
reichtest	reichtest
ferne	ferne
sorge	sorge
Seehechte	Seehechte
Privatsachen	Privatsachen
Malaysier	Malaysier
nützt	nützt
Braunrallen	Braunrallen
Kerfe	Kerfe
schleimte	schleimte
Verkehrsflugzeug	Verkehrsflugzeug
schwöret	schwöret
Reiseleitern	Reiseleitern
klemmen	klemmen
verlötest	verlötest
säet	säet
reizt	reizt
Brechnüssen	Brechnüssen
lachet	lachet
Abgaskatalysatoren	Abgaskatalysatoren
laute	laute
Gläubigen	Gläubigen
Paradiesäpfeln	Paradiesäpfeln
möget	möget
glänzten	glänzten
ziert	ziert
Satzungen	Satzungen
Fußbodens	Fußbodens
Ölfasses	Ölfasses
hieltet	hieltet
Abbildern	Abbildern
föchten	föchten
enträtselten	enträtselten
Ölfässern	Ölfässern
allem	allem
Zeug	Zeug
flambierten	flambierten
erkundigte	erkundigte
schwöre	schwöre
Festons	Festons
gehöre	gehöre
hintertreiben	hintertreiben
Seit	Seit
Gästen	Gästen
Buchhalterinnen	Buchhalterinnen
untersagest	untersagest
Außenministerium	Außenministerium
Leugnungen	Leugnungen
schlag	schlag
lose	lose
beherrscht	beherrscht
seufzest	seufzest
ermächtigest	ermächtigest
schneidend	schneidend
überdenkest	überdenkest
Wucher	Wucher
Fische	Fische
bedrücktest	bedrücktest
Leide	Leide
zelte	zelte
sucht	sucht
Raucherin	Raucherin
unterwerfe	unterwerfe
Cholesterin	Cholesterin
Bebauungsplänen	Bebauungsplänen
grünte	grünte
Bleiglanzes	Bleiglanzes
wäre	wäre
Fiebermitteln	Fiebermitteln
Hobby	Hobby
entzweiest	entzweiest
besorgend	besorgend
verkleinerest	verkleinerest
stapele	stapele
Pflanzung	Pflanzung
krösest	krösest
frommen	frommen
faule	faule
Lunisolarkalender	Lunisolarkalender
fliehe	fliehe
pipettierten	pipettierten
schnorrest	schnorrest
umarbeitest	umarbeitest
Fettsack	Fettsack
unterwerft	unterwerft
bündelest	bündelest
kämmtet	kämmtet
pfände	pfände
Feuerteufel	Feuerteufel
stirbst	stirbst
Kortholt	Kortholt
wären	wären
Teppiche	Teppiche
neigte	neigte
Zeilen	Zeilen
unserem	unserem
fallest	fallest
Essigsäurechloriden	Essigsäurechloriden
motivieren	motivieren
Fehlen	Fehlen
verliere	verliere
folgte	folgte
heil	heil
verboten	verboten
Erzherzogshüte	Erzherzogshüte
Hahnenkämmen	Hahnenkämmen
beauftragt	beauftragt
erzeigen	erzeigen
Fischer	Fischer
Mopps	Mopps
keinen	keinen
Zwetschgen	Zwetschgen
verstecken	verstecken
unterbrächen	unterbrächen
bezichtigten	bezichtigten
Grenzen	Grenzen
Schlepper	Schlepper
Zerfall	Zerfall
geleitest	geleitest
Anschläge	Anschläge
jenen	jenen
selber	selber
aasend	aasend
ringele	ringele
Gläubige	Gläubige
stifte	stifte
jappten	jappten
Zapfen	Zapfen
weisen	weisen
dankte	dankte
prostet	prostet
vertreibe	vertreibe
Dorngesträuch	Dorngesträuch
greife	greife
bräunen	bräunen
steigest	steigest
Bruchstriches	Bruchstriches
schmusen	schmusen
Sterne	Sterne
Empörungen	Empörungen
schätzt	schätzt
Lichte	Lichte
Geliebten	Geliebten
Nehmt	Nehmt
ärgerst	ärgerst
kooperierte	kooperierte
verteidigte	verteidigte
verschmelzen	verschmelzen
blitztet	blitztet
zirpe	zirpe
Schaden	Schaden
Säcke	Säcke
betreibet	betreibet
falteten	falteten
klagen	klagen
Messies	Messies
Bergen	Bergen
parfümierte	parfümierte
leset	leset
Büschen	Büschen
häufen	häufen
spezialisiere	spezialisiere
mampfen	mampfen
Spitze	Spitze
kaufet	kaufet
tyrannisiertest	tyrannisiertest
versteigerest	versteigerest
Kettenraucher	Kettenraucher
triebe	triebe
Gewalttäter	Gewalttäter
Jagdbomber	Jagdbomber
baue	baue
addierest	addierest
zählten	zählten
generalisiert	generalisiert
frohlocke	frohlocke
Kutter	Kutter
könnest	könnest
aktualisiere	aktualisiere
koste	koste
Treibhausgase	Treibhausgase
erkältete	erkältete
Füchse	Füchse
verfehlten	verfehlten
manövrieret	manövrieret
stiftest	stiftest
Mikrometern	Mikrometern
Wunden	Wunden
Hunde	Hunde
sagen	sagen
warne	warne
lackieren	lackieren
kristallisierest	kristallisierest
beide	beide
leiste	leiste
wünschte	wünschte
Geschäften	Geschäften
Siglen	Siglen
regiere	regiere
Türme	Türme
Traubenlese	Traubenlese
Raute	Raute
öle	öle
applizirst	applizirst
ersten	ersten
Trübsal	Trübsal
decken	decken
Ansteckern	Ansteckern
Meinst	Meinst
Amokläuferinnen	Amokläuferinnen
Leid	Leid
Zahnfleischentzündung	Zahnfleischentzündung
grünt	grünt
bewiese	bewiese
frohlockten	frohlockten
kitzeln	kitzeln
Jungfernflug	Jungfernflug
Kehre	Kehre
rangierst	rangierst
mehrte	mehrte
Farbstoffe	Farbstoffe
Neumonden	Neumonden
Merkel-Rauten	Merkel-Rauten
gespeist	gespeist
privilegiere	privilegiere
flehst	flehst
Asylrechten	Asylrechten
Flussbetten	Flussbetten
Welpen	Welpen
speiest	speiest
erschrickst	erschrickst
Schlagzeuger	Schlagzeuger
zürne	zürne
verselbständigst	verselbständigst
erbest	erbest
Felle	Felle
Eutektikum	Eutektikum
Bär	Bär
segmentiere	segmentiere
Königreiche	Königreiche
Altäre	Altäre
verbündet	verbündet
zerrisset	zerrisset
bleibet	bleibet
jemand	jemand
vertilgten	vertilgten
abtrünnige	abtrünnige
Leset	Leset
Wirte	Wirte
vernichtete	vernichtete
machst	machst
bürsten	bürsten
vertrage	vertrage
Omnibusse	Omnibusse
Wehret	Wehret
strafen	strafen
Vaginen	Vaginen
Schatten	Schatten
versuchst	versuchst
Beobachtung	Beobachtung
wärmet	wärmet
zerstreust	zerstreust
mopsend	mopsend
Kraftfahrzeugen	Kraftfahrzeugen
setzet	setzet
Warte	Warte
dotiere	dotiere
sichten	sichten
separieren	separieren
Recht	Recht
Anführer	Anführer
gestikuliere	gestikuliere
Pinguin	Pinguin
grübelt	grübelt
filzten	filzten
Fluoratomen	Fluoratomen
stirbt	stirbt
Blütenachse	Blütenachse
entkörperlichten	entkörperlichten
Kakadu	Kakadu
gewinnet	gewinnet
Gerücht	Gerücht
vandalieren	vandalieren
Toypudeln	Toypudeln
Könige	Könige
Sabbaten	Sabbaten
Oheim	Oheim
verkröchet	verkröchet
wispern	wispern
Fußboden	Fußboden
Aufpralle	Aufpralle
haarten	haarten
Gesamtmenge	Gesamtmenge
füsilierten	füsilierten
ausgereckten	ausgereckten
führet	führet
flucht	flucht
ungehorsam	ungehorsam
prahlte	prahlte
warntest	warntest
schützt	schützt
Cyclodextrinen	Cyclodextrinen
Palästen	Palästen
Frage	Frage
Fanmeile	Fanmeile
Gerichten	Gerichten
taufte	taufte
hatten	hatten
Gegebenheit	Gegebenheit
Prügelstrafen	Prügelstrafen
gibst	gibst
Gebeinen	Gebeinen
verzweigt	verzweigt
trinkest	trinkest
werde	werde
überprüftest	überprüftest
Pedant	Pedant
Uteri	Uteri
dirigiert	dirigiert
Polierstahl	Polierstahl
häufe	häufe
werft	werft
Menschenhandel	Menschenhandel
abweichet	abweichet
Buch	Buch
dressieret	dressieret
Blechen	Blechen
Fellhandschuh	Fellhandschuh
bedürft	bedürft
verbündend	verbündend
blitzt	blitzt
Ölspuren	Ölspuren
Leuchtkäfern	Leuchtkäfern
konntest	konntest
zerbrechen	zerbrechen
Aller	Aller
Bund	Bund
Schote	Schote
knautsche	knautsche
durften	durften
Kindergeld	Kindergeld
setzen	setzen
Radfahrern	Radfahrern
plärrt	plärrt
loste	loste
Borhydride	Borhydride
Sphäre	Sphäre
Streiten	Streiten
Schulleiterin	Schulleiterin
drängten	drängten
freute	freute
heiligt	heiligt
vergiftet	vergiftet
Assistentin	Assistentin
Elementarzellen	Elementarzellen
Ängste	Ängste
Schamentzündungen	Schamentzündungen
beanspruchet	beanspruchet
betrübend	betrübend
fegte	fegte
gewitterte	gewitterte
Anzeichen	Anzeichen
Europameisters	Europameisters
Märchenbuches	Märchenbuches
Hirnstämmen	Hirnstämmen
Bienen	Bienen
bekehrt	bekehrt
grüßten	grüßten
Wogen	Wogen
bedingten	bedingten
zappten	zappten
rühmet	rühmet
meuternd	meuternd
Wechselstuben	Wechselstuben
verfolgt	verfolgt
Stiefvätern	Stiefvätern
täuschet	täuschet
kletteret	kletteret
leuchtete	leuchtete
stiftete	stiftete
Astats	Astats
Stäbe	Stäbe
parkierten	parkierten
Sorgen	Sorgen
Kein	Kein
heiß	heiß
plagest	plagest
anzeigte	anzeigte
entert	entert
Kontraindikationen	Kontraindikationen
rotten	rotten
frevles	frevles
Neuigkeit	Neuigkeit
verbündete	verbündete
fällte	fällte
hebräische	hebräische
stoßt	stoßt
heparinisiere	heparinisiere
boykottierst	boykottierst
Chlorwasserstoffmoleküls	Chlorwasserstoffmoleküls
bestrafe	bestrafe
pilgerte	pilgerte
Paläste	Paläste
Robe	Robe
Zäume	Zäume
Halbmond	Halbmond
bestand	bestand
Suche	Suche
emigrieret	emigrieret
stellen	stellen
Stücken	Stücken
bequemtet	bequemtet
verbluteten	verbluteten
duzet	duzet
beantragt	beantragt
Zinkionen	Zinkionen
Chronisten	Chronisten
sichere	sichere
Same	Same
hasset	hasset
Ambiguität	Ambiguität
Ellen	Ellen
bis	bis
Gängen	Gängen
Eure	Eure
zürntest	zürntest
funktionalisiertest	funktionalisiertest
umbrächte	umbrächte
Oberbegriff	Oberbegriff
dümpelt	dümpelt
setzest	setzest
stürzen	stürzen
Übelkeit	Übelkeit
könnte	könnte
Kriege	Kriege
mangeln	mangeln
Loben	Loben
Tauben	Tauben
stellet	stellet
bewahrst	bewahrst
bromiert	bromiert
lebest	lebest
mästet	mästet
Schneepflügen	Schneepflügen
trotze	trotze
Konzentrate	Konzentrate
Stadtbezirke	Stadtbezirke
stürzt	stürzt
schäme	schäme
Eilande	Eilande
Hast	Hast
stickten	stickten
Kontaktierungen	Kontaktierungen
Stilllegungen	Stilllegungen
lackiere	lackiere
Haarverlusten	Haarverlusten
drängte	drängte
amenagierst	amenagierst
verdeckten	verdeckten
Hirten	Hirten
Metallothionein	Metallothionein
Dobermännern	Dobermännern
Schreibern	Schreibern
beten	beten
Dich	Dich
Imperialismen	Imperialismen
grabest	grabest
Zeugnisse	Zeugnisse
brause	brause
Martyrologien	Martyrologien
Lautwandeln	Lautwandeln
Bergsteiger	Bergsteiger
Alibis	Alibis
Lobgesänge	Lobgesänge
Flamen	Flamen
absolviere	absolviere
Füchsin	Füchsin
rebellieren	rebellieren
Zain	Zain
Füße	Füße
verkaufe	verkaufe
Gymnasien	Gymnasien
traueret	traueret
Briefe	Briefe
Silbersulfidbelag	Silbersulfidbelag
fallet	fallet
rauben	rauben
aufkäme	aufkäme
reife	reife
Seines	Seines
Herrn	Herrn
Träumer	Träumer
Kryostat	Kryostat
begraben	begraben
führest	führest
erklinge	erklinge
Bezeugungen	Bezeugungen
Kalifeldspat	Kalifeldspat
losen	losen
Innenschau	Innenschau
teil	teil
Argyrodite	Argyrodite
höben	höben
Arm	Arm
hure	hure
Verkehrsflugzeuge	Verkehrsflugzeuge
Erzeugung	Erzeugung
leiten	leiten
Jungfernflüge	Jungfernflüge
bombardiertet	bombardiertet
Tiegel	Tiegel
schwächst	schwächst
kabbelnd	kabbelnd
fern	fern
imprägnieret	imprägnieret
Rehbock	Rehbock
ruckelst	ruckelst
gelobten	gelobten
Silberdrahts	Silberdrahts
ungehorsame	ungehorsame
motivierte	motivierte
mogelest	mogelest
verdammst	verdammst
brillieren	brillieren
Stoffwechselwegen	Stoffwechselwegen
Videoaufzeichnung	Videoaufzeichnung
Hirsche	Hirsche
betrüge	betrüge
nötige	nötige
ausgehst	ausgehst
brach	brach
Autoklav	Autoklav
erntete	erntete
Abhängen	Abhängen
verlähmt	verlähmt
Pentaborat	Pentaborat
belauerten	belauerten
Ställen	Ställen
wallfahrteten	wallfahrteten
Darlegungen	Darlegungen
Perle	Perle
zügelten	zügelten
Narkotikum	Narkotikum
Beinen	Beinen
verhörest	verhörest
Biokraftstoffes	Biokraftstoffes
ach	ach
dekompiliertest	dekompiliertest
Fette	Fette
auszögen	auszögen
gehorchet	gehorchet
Schal	Schal
überdenkend	überdenkend
Regieren	Regieren
wiederkamen	wiederkamen
Fadenlauf	Fadenlauf
verkauft	verkauft
Anwendungsgebiet	Anwendungsgebiet
Stilllegung	Stilllegung
verständig	verständig
wehren	wehren
grüße	grüße
decke	decke
Sollte	Sollte
Dochten	Dochten
Optimisten	Optimisten
Laufring	Laufring
schöpfest	schöpfest
zeiget	zeiget
absagt	absagt
laufe	laufe
Prüfberichten	Prüfberichten
Gut	Gut
erstürmet	erstürmet
läutet	läutet
Beteiligten	Beteiligten
kaufest	kaufest
bezichtigt	bezichtigt
klöne	klöne
Stolz	Stolz
Palisade	Palisade
tanzen	tanzen
Piratensendern	Piratensendern
billigen	billigen
zerrissen	zerrissen
desertiertet	desertiertet
Atomphysikern	Atomphysikern
rüste	rüste
ehe	ehe
Bilderstürmereien	Bilderstürmereien
Almanachen	Almanachen
lehrest	lehrest
wir	wir
Karer	Karer
verfängt	verfängt
Libellen	Libellen
demütigst	demütigst
schenkte	schenkte
Fettsäcken	Fettsäcken
tränke	tränke
Ärgernisse	Ärgernisse
enttäusche	enttäusche
entwischten	entwischten
pflanzen	pflanzen
Empfängnisverhütungen	Empfängnisverhütungen
der	der
nachwandelte	nachwandelte
Qualifikationen	Qualifikationen
sprühend	sprühend
befestigt	befestigt
Feinde	Feinde
verzögerte	verzögerte
beweisen	beweisen
Sprüchen	Sprüchen
vermutet	vermutet
Nussknacker	Nussknacker
Schauet	Schauet
Zirkelschlüssen	Zirkelschlüssen
wehrend	wehrend
haltest	haltest
kaufte	kaufte
markiere	markiere
versuchest	versuchest
ringelten	ringelten
Zirkelschluss	Zirkelschluss
besichtiget	besichtiget
Reinelementen	Reinelementen
Kopfsalaten	Kopfsalaten
schaute	schaute
Falzen	Falzen
hilfst	hilfst
raubte	raubte
verzieh	verzieh
verkündet	verkündet
wohnet	wohnet
regierest	regierest
verwaisten	verwaisten
beneidest	beneidest
Kohle	Kohle
Donor	Donor
geknautscht	geknautscht
Hurriter	Hurriter
Gaunern	Gaunern
kremierten	kremierten
Ölspur	Ölspur
Aromastoffe	Aromastoffe
Hypochlorit	Hypochlorit
dringen	dringen
rüstetet	rüstetet
harrtest	harrtest
scheuchtest	scheuchtest
wachse	wachse
aufkommen	aufkommen
Schnallen	Schnallen
prangest	prangest
Orte	Orte
macht	macht
schickte	schickte
Loparite	Loparite
Fotosynthese	Fotosynthese
kabelst	kabelst
Abflug	Abflug
kämmt	kämmt
Fanmeilen	Fanmeilen
Bleigehalten	Bleigehalten
Bauwerken	Bauwerken
spukest	spukest
Adamsäpfeln	Adamsäpfeln
Gaschromatographie	Gaschromatographie
Temperaturanstiege	Temperaturanstiege
verwiesen	verwiesen
Leichnamen	Leichnamen
destabilisierte	destabilisierte
Rücktrittbremse	Rücktrittbremse
Gichten	Gichten
batest	batest
Seilen	Seilen
erwischten	erwischten
instrumentalisierest	instrumentalisierest
danket	danket
Regenten	Regenten
erfüllt	erfüllt
hebst	hebst
verstecktet	verstecktet
Leuchtstoffen	Leuchtstoffen
säumet	säumet
Schreiben	Schreiben
schwimmen	schwimmen
ertönst	ertönst
Diebe	Diebe
zersetzet	zersetzet
zentrifugierst	zentrifugierst
verschränken	verschränken
Gehilfe	Gehilfe
sorgte	sorgte
Apostels	Apostels
Minischwein	Minischwein
verkürze	verkürze
fabulierest	fabulierest
tanze	tanze
faschieret	faschieret
Pfründe	Pfründe
verdammten	verdammten
Ärgernissen	Ärgernissen
ausrufest	ausrufest
schiesst	schiesst
gare	gare
Märtyrern	Märtyrern
Beiblättern	Beiblättern
Heringen	Heringen
begründetest	begründetest
mein	mein
Schobern	Schobern
Ankern	Ankern
habet	habet
foppten	foppten
brandeten	brandeten
Operationssälen	Operationssälen
lauschte	lauschte
mußt	mußt
Lasten	Lasten
Käsereibe	Käsereibe
essen	essen
Krumen	Krumen
Kaktusfeige	Kaktusfeige
Stierkämpfen	Stierkämpfen
knutschest	knutschest
fällen	fällen
befehlen	befehlen
erkanntet	erkanntet
Rutheniumisotopen	Rutheniumisotopen
Metaphern	Metaphern
gelobte	gelobte
gerne	gerne
producieret	producieret
hämmerte	hämmerte
Überziehens	Überziehens
Rubinen	Rubinen
fällst	fällst
überfischt	überfischt
Heere	Heere
Tollkirsche	Tollkirsche
Gleitzeiten	Gleitzeiten
Tote	Tote
tasteten	tasteten
dividiert	dividiert
betrieben	betrieben
Erdkruste	Erdkruste
ersparten	ersparten
betrübtet	betrübtet
Hode	Hode
dringest	dringest
