gallín	gallín
stærir	stærir
lifðu	lifðu
eiturlyfjanotendum	eiturlyfjanotendum
krossfest	krossfest
fjóla	fjóla
aðdáendurna	aðdáendurna
spektu	spektu
þarfir	þarfir
kalkspati	kalkspati
skrifað	skrifað
rakið	rakið
lífstykkjanna	lífstykkjanna
setta	setta
karsi	karsi
múslimarnir	múslimarnir
æðarblikans	æðarblikans
krossfesta	krossfesta
hug	hug
stökkið	stökkið
fisksins	fisksins
keyptu	keyptu
garðyrkjufræðin	garðyrkjufræðin
stoðunum	stoðunum
langöfunum	langöfunum
sellerí	sellerí
áfrýjuðu	áfrýjuðu
hljóðfærið	hljóðfærið
eyjarnar	eyjarnar
kvöldunum	kvöldunum
Fyrsti	Fyrsti
vísindamönnunum	vísindamönnunum
hneyktuð	hneyktuð
ættfeðurna	ættfeðurna
múkka	múkka
græði	græði
tignað	tignað
Send	Send
peninginn	peninginn
slútta	slútta
Sendu	Sendu
hrap	hrap
þrengingum	þrengingum
gerast	gerast
hafanna	hafanna
synjaði	synjaði
minnt	minnt
fagurfræðina	fagurfræðina
klæddi	klæddi
flotaforingjann	flotaforingjann
vissa	vissa
virtuð	virtuð
ungum	ungum
sent	sent
portum	portum
ilmjurtunum	ilmjurtunum
hengdi	hengdi
þremur	þremur
birtir	birtir
ríkdómur	ríkdómur
ættuð	ættuð
lúkka	lúkka
langöfum	langöfum
bærum	bærum
hvílíkum	hvílíkum
kjafta	kjafta
fjölmiðlasögur	fjölmiðlasögur
hóll	hóll
hneigðuð	hneigðuð
prentuðuð	prentuðuð
drýgði	drýgði
fyrstur	fyrstur
þurrís	þurrís
brekkusniglunum	brekkusniglunum
leysir	leysir
alur	alur
fórnum	fórnum
réttur	réttur
reiðir	reiðir
væskill	væskill
gefinn	gefinn
véið	véið
aukaspyrnu	aukaspyrnu
þjónustuna	þjónustuna
sveikst	sveikst
líka	líka
þínar	þínar
hafði	hafði
heyrðir	heyrðir
túrista	túrista
feta	feta
smalahundana	smalahundana
flokkurinn	flokkurinn
þökkum	þökkum
svaraði	svaraði
gátum	gátum
bíóið	bíóið
ljúkast	ljúkast
hjartarins	hjartarins
efi	efi
rótfestu	rótfestu
áttunda	áttunda
gætt	gætt
fiskum	fiskum
fyrstum	fyrstum
hæðir	hæðir
vekti	vekti
jötunuxa	jötunuxa
Komu	Komu
japönskunni	japönskunni
flæmskuna	flæmskuna
tindur	tindur
farsímanna	farsímanna
þolinu	þolinu
denara	denara
sjötti	sjötti
safnið	safnið
íþyngir	íþyngir
enn	enn
hólminn	hólminn
nærmyndin	nærmyndin
eign	eign
raustar	raustar
heitir	heitir
skýt	skýt
brytar	brytar
allur	allur
ræddu	ræddu
Dauði	Dauði
sleðum	sleðum
diskur	diskur
gefast	gefast
skreyta	skreyta
viðskiptavinarins	viðskiptavinarins
rændi	rændi
klippti	klippti
jafnast	jafnast
fjórir	fjórir
rifrildi	rifrildi
treystu	treystu
hafna	hafna
komast	komast
bestu	bestu
þinna	þinna
þrengingin	þrengingin
þönkum	þönkum
ax	ax
musteranna	musteranna
rífist	rífist
pokir	pokir
freistaði	freistaði
pipars	pipars
sendur	sendur
fljótið	fljótið
brauðin	brauðin
fé	fé
kúturinn	kúturinn
sparkar	sparkar
læra	læra
drukkið	drukkið
keypti	keypti
flæmingja	flæmingja
ytra	ytra
slíku	slíku
verslaði	verslaði
gólfa	gólfa
samboðna	samboðna
fýri	fýri
Leita	Leita
nokkurs	nokkurs
skírðuð	skírðuð
svengdin	svengdin
spörfugl	spörfugl
blikunum	blikunum
sakargift	sakargift
meti	meti
fyllandi	fyllandi
skerið	skerið
félögin	félögin
skelfisksins	skelfisksins
væla	væla
búist	búist
stundir	stundir
kvíða	kvíða
hrææta	hrææta
bifa	bifa
dýralækni	dýralækni
formaðurinn	formaðurinn
hnerruðu	hnerruðu
bruna	bruna
máluðu	máluðu
Æðstu	Æðstu
súrefnisskorturinn	súrefnisskorturinn
vambirnar	vambirnar
vinátta	vinátta
drýgðu	drýgðu
svengd	svengd
sín	sín
flettu	flettu
síðasta	síðasta
grísku	grísku
faldi	faldi
slík	slík
minningin	minningin
Enginn	Enginn
spörkum	spörkum
hvílist	hvílist
afleiðingunum	afleiðingunum
hræðum	hræðum
Orð	Orð
fórintum	fórintum
þótti	þótti
værum	værum
rottuna	rottuna
hringar	hringar
bagall	bagall
krossfesti	krossfesti
almættið	almættið
Hvern	Hvern
straumarnir	straumarnir
ruslinu	ruslinu
skírlífar	skírlífar
hagnaðarins	hagnaðarins
lausnin	lausnin
ríbónúkleösunum	ríbónúkleösunum
tísku	tísku
guðina	guðina
uggum	uggum
yfirheita	yfirheita
hatur	hatur
akur	akur
Þessa	Þessa
skipi	skipi
togi	togi
öll	öll
tefldir	tefldir
sala	sala
lagt	lagt
blóðfrumunum	blóðfrumunum
ríkir	ríkir
angann	angann
efla	efla
rasskinna	rasskinna
sin	sin
Naksons	Naksons
stórhertoga	stórhertoga
gómunum	gómunum
náið	náið
sólunum	sólunum
hornsins	hornsins
brjálæðið	brjálæðið
meiðslunum	meiðslunum
söfnuðuð	söfnuðuð
þriðja	þriðja
gjörast	gjörast
borðar	borðar
neinir	neinir
þekktir	þekktir
suma	suma
vísindamanni	vísindamanni
málum	málum
hlýði	hlýði
fæddur	fæddur
höfðum	höfðum
birti	birti
gjóði	gjóði
jarðarberjum	jarðarberjum
ráðunum	ráðunum
guðum	guðum
umfjöllun	umfjöllun
svikanna	svikanna
nú	nú
þvo	þvo
köstuðum	köstuðum
móður	móður
mundum	mundum
Þau	Þau
skrifuðum	skrifuðum
kvakið	kvakið
hyllið	hyllið
hýstuð	hýstuð
hrætt	hrætt
þarfaþing	þarfaþing
óskar	óskar
skipti	skipti
korkum	korkum
hryggði	hryggði
líkt	líkt
láta	láta
æxlun	æxlun
pennavinurinn	pennavinurinn
dæmist	dæmist
köngulóm	köngulóm
minni	minni
samboðin	samboðin
fremur	fremur
svo	svo
vísa	vísa
dæmin	dæmin
öxli	öxli
enga	enga
byggðuð	byggðuð
vömbin	vömbin
sátu	sátu
sónatína	sónatína
hjólhýsunum	hjólhýsunum
ráðsins	ráðsins
drýgi	drýgi
nefnda	nefnda
kúfinn	kúfinn
aukafalla	aukafalla
gaggið	gaggið
reyndu	reyndu
svikarar	svikarar
hátíða	hátíða
næsta	næsta
leyfum	leyfum
Fyrstur	Fyrstur
órétt	órétt
Alla	Alla
frjókorn	frjókorn
leikmönnum	leikmönnum
aldinin	aldinin
áhugamálið	áhugamálið
safni	safni
annast	annast
blessi	blessi
bæru	bæru
þols	þols
mynstur	mynstur
Jótlandið	Jótlandið
Hvor	Hvor
hef	hef
slíkar	slíkar
hráka	hráka
ræddi	ræddi
firði	firði
væskla	væskla
breidd	breidd
Hvaðan	Hvaðan
engir	engir
fjarlægð	fjarlægð
leyfinu	leyfinu
krókusi	krókusi
móðunni	móðunni
einræktað	einræktað
fljótir	fljótir
frumvörpunum	frumvörpunum
tröllkonurnar	tröllkonurnar
enda	enda
hýdratið	hýdratið
kostum	kostum
sinna	sinna
safnast	safnast
kenndina	kenndina
stæra	stæra
sproki	sproki
forsíðurnar	forsíðurnar
síðastur	síðastur
Mannssoninn	Mannssoninn
hópinn	hópinn
Líkt	Líkt
sumt	sumt
fylltur	fylltur
úkraínsku	úkraínsku
kyssið	kyssið
ríkdóms	ríkdóms
sættir	sættir
björkum	björkum
ógleðin	ógleðin
ferming	ferming
jafnir	jafnir
gjaldi	gjaldi
skrifir	skrifir
hatursins	hatursins
labba	labba
fylltum	fylltum
reið	reið
þrengdist	þrengdist
tind	tind
skírin	skírin
afrit	afrit
kryddi	kryddi
gagntakið	gagntakið
reka	reka
hryggjum	hryggjum
brekkusnigill	brekkusnigill
sagt	sagt
skýr	skýr
hrogns	hrogns
umfjöllunin	umfjöllunin
kúfi	kúfi
safnaðir	safnaðir
sérhvern	sérhvern
kalksteininum	kalksteininum
lagður	lagður
efldir	efldir
fiskinn	fiskinn
spikum	spikum
Er	Er
nefndir	nefndir
óhamingju	óhamingju
skammir	skammir
fæla	fæla
skyldufræði	skyldufræði
bæjasvölur	bæjasvölur
æðsta	æðsta
hvíldina	hvíldina
neinu	neinu
búnings	búnings
unglingsins	unglingsins
þau	þau
hrifsuðuð	hrifsuðuð
lok	lok
jónirnar	jónirnar
slúttir	slúttir
grípur	grípur
flass	flass
menguðu	menguðu
jöfnuninni	jöfnuninni
lakkað	lakkað
hreyfi	hreyfi
látum	látum
reyndi	reyndi
nokkru	nokkru
útlisti	útlisti
enginn	enginn
stærum	stærum
jötunuxann	jötunuxann
lykkjuna	lykkjuna
haga	haga
hólmi	hólmi
grasafræði	grasafræði
sleða	sleða
lappa	lappa
skytu	skytu
bólstraskýs	bólstraskýs
talentur	talentur
dauðadóms	dauðadóms
gleði	gleði
kefði	kefði
skipta	skipta
læsti	læsti
hlýst	hlýst
kölluðu	kölluðu
belgi	belgi
skriðsundi	skriðsundi
umkringdum	umkringdum
sygjum	sygjum
sig	sig
óska	óska
kryfði	kryfði
fjölgyðistrúarinnar	fjölgyðistrúarinnar
úthlutum	úthlutum
Kom	Kom
hræddir	hræddir
spikinu	spikinu
mynstrum	mynstrum
klúðraðir	klúðraðir
þessir	þessir
minn	minn
fundunum	fundunum
vafann	vafann
frystinn	frystinn
rekur	rekur
hraða	hraða
skilinn	skilinn
lauk	lauk
fjöl	fjöl
umkringið	umkringið
færeyskuna	færeyskuna
gildi	gildi
brott	brott
þerrar	þerrar
skýrði	skýrði
vátryggðum	vátryggðum
skrifuðuð	skrifuðuð
heddinu	heddinu
annað	annað
velji	velji
bjórvömbunum	bjórvömbunum
ærumeiðinganna	ærumeiðinganna
tilreiknuð	tilreiknuð
meiðsli	meiðsli
aukaspyrnunum	aukaspyrnunum
styrkjum	styrkjum
kvikmyndanna	kvikmyndanna
þerruðum	þerruðum
korkunum	korkunum
mistur	mistur
útisundlaug	útisundlaug
huldu	huldu
tölvupóstfanga	tölvupóstfanga
herpir	herpir
rakaði	rakaði
guðir	guðir
æðahnútarnir	æðahnútarnir
spils	spils
standa	standa
hengduð	hengduð
leynduð	leynduð
fullreyndin	fullreyndin
brekkusóley	brekkusóley
sjússa	sjússa
geimur	geimur
rósemi	rósemi
hirða	hirða
flæmskunni	flæmskunni
girni	girni
lénin	lénin
kalksteinn	kalksteinn
varaliði	varaliði
lastmæli	lastmæli
kom	kom
eyru	eyru
tálvon	tálvon
jörðina	jörðina
annan	annan
aborra	aborra
baginn	baginn
verð	verð
búninginn	búninginn
sjúgi	sjúgi
flokks	flokks
heltir	heltir
jafnað	jafnað
fuglafræðin	fuglafræðin
öfunduðuð	öfunduðuð
skipinu	skipinu
skulu	skulu
síið	síið
gæti	gæti
óhamingjunni	óhamingjunni
kyrki	kyrki
berklar	berklar
straumurinn	straumurinn
úthlutaði	úthlutaði
útlistum	útlistum
undu	undu
nafla	nafla
saurgar	saurgar
hópi	hópi
hugi	hugi
kúrdísku	kúrdísku
talsmannsins	talsmannsins
heilsu	heilsu
legkaka	legkaka
hópum	hópum
græðum	græðum
órétti	órétti
rakað	rakað
dáð	dáð
smókinn	smókinn
syndgað	syndgað
testósteróns	testósteróns
settum	settum
plokka	plokka
kossarnir	kossarnir
löppunum	löppunum
klæð	klæð
voru	voru
gyltuna	gyltuna
sé	sé
leyndarinnar	leyndarinnar
skipaði	skipaði
eigi	eigi
gaggaði	gaggaði
völd	völd
þjálfunin	þjálfunin
stæri	stæri
vés	vés
hænsnunum	hænsnunum
hins	hins
þanka	þanka
hýdrötunum	hýdrötunum
stórhertoginn	stórhertoginn
kinn	kinn
glatt	glatt
minntu	minntu
vetur	vetur
klæinda	klæinda
hvert	hvert
hreinsunareld	hreinsunareld
dauðadómar	dauðadómar
herpi	herpi
raðað	raðað
varalit	varalit
kveikina	kveikina
bismúts	bismúts
spilltum	spilltum
tennisboltann	tennisboltann
rymdi	rymdi
körfubolta	körfubolta
aðvöruðu	aðvöruðu
hvílík	hvílík
uppfærum	uppfærum
egnduð	egnduð
trunturnar	trunturnar
efa	efa
rannana	rannana
vátryggja	vátryggja
æfingu	æfingu
hina	hina
æðikolls	æðikolls
tíðir	tíðir
lofandi	lofandi
nefndur	nefndur
borga	borga
deyðir	deyðir
raustum	raustum
gerist	gerist
höfða	höfða
ráðast	ráðast
reyndur	reyndur
gorminn	gorminn
nasisma	nasisma
fyllt	fyllt
lifnaði	lifnaði
skýrt	skýrt
tilreiknar	tilreiknar
völdunum	völdunum
hagnýtti	hagnýtti
káetan	káetan
borðaði	borðaði
farsími	farsími
hylli	hylli
markgreifa	markgreifa
látna	látna
valið	valið
minna	minna
bændurnir	bændurnir
þurrísum	þurrísum
minnsta	minnsta
drekki	drekki
þvörguðuð	þvörguðuð
iðnunum	iðnunum
Það	Það
voruð	voruð
undantekið	undantekið
tilreiknast	tilreiknast
kallað	kallað
leyfis	leyfis
fundin	fundin
flokkur	flokkur
sjúkdómur	sjúkdómur
hirðana	hirðana
organistum	organistum
granateplunum	granateplunum
skyttur	skyttur
hvorir	hvorir
ein	ein
hætti	hætti
minnisspilið	minnisspilið
rétti	rétti
trúarjátningunni	trúarjátningunni
gítar	gítar
stjórnandi	stjórnandi
leiddu	leiddu
sjálfsmynd	sjálfsmynd
jaka	jaka
vögguvísa	vögguvísa
postuladóms	postuladóms
breiddu	breiddu
tilreiknað	tilreiknað
lastmælt	lastmælt
kysstu	kysstu
eruð	eruð
bifar	bifar
færis	færis
viskíi	viskíi
svertir	svertir
gjörður	gjörður
syndgar	syndgar
klæðinu	klæðinu
toga	toga
sérhljóðum	sérhljóðum
hræddi	hræddi
þakkirnar	þakkirnar
inni	inni
gleðst	gleðst
étum	étum
Hvar	Hvar
lofaðir	lofaðir
fyllti	fyllti
yrðuð	yrðuð
endurnýjum	endurnýjum
svindlurum	svindlurum
ráði	ráði
beði	beði
rita	rita
strika	strika
fjöldanum	fjöldanum
gyldir	gyldir
þínir	þínir
máluðum	máluðum
Þessu	Þessu
betrir	betrir
hliðin	hliðin
öðru	öðru
fjórði	fjórði
uppfærðuð	uppfærðuð
öðlaðist	öðlaðist
norðan	norðan
teiknuðuð	teiknuðuð
ást	ást
varalitanna	varalitanna
klekkir	klekkir
sést	sést
kontrabassinn	kontrabassinn
vænt	vænt
tónfræði	tónfræði
gættir	gættir
ryðöndin	ryðöndin
óskuðu	óskuðu
skulum	skulum
líkaminn	líkaminn
báðar	báðar
áhugamáli	áhugamáli
aftra	aftra
brottfara	brottfara
tunglsjúkur	tunglsjúkur
gjömmum	gjömmum
eigandann	eigandann
krossfestur	krossfestur
klædd	klædd
meir	meir
jarðarberin	jarðarberin
hulda	hulda
flettum	flettum
sérhljóða	sérhljóða
minnist	minnist
maura	maura
eina	eina
skjóla	skjóla
skyldir	skyldir
fimbulvetrunum	fimbulvetrunum
vel	vel
gættum	gættum
eyddist	eyddist
alls	alls
hljóðfæri	hljóðfæri
lessum	lessum
Skyldi	Skyldi
fundið	fundið
stækjunnar	stækjunnar
syndgum	syndgum
hálfleikur	hálfleikur
hafir	hafir
græddi	græddi
spítalarnir	spítalarnir
fyrstir	fyrstir
skepnu	skepnu
sæbjúgu	sæbjúgu
metanna	metanna
pats	pats
lastmælir	lastmælir
hlýddi	hlýddi
lofa	lofa
efuðuð	efuðuð
Hvaða	Hvaða
kok	kok
Alls	Alls
haltri	haltri
engum	engum
húsfrúrnar	húsfrúrnar
skrifa	skrifa
svæfðuð	svæfðuð
krossfestan	krossfestan
málaðir	málaðir
kunnir	kunnir
fjórum	fjórum
dauðinn	dauðinn
ferð	ferð
Sjálfur	Sjálfur
bættist	bættist
strætisvagna	strætisvagna
fylltir	fylltir
Mæli	Mæli
eiturlyfjanotendurnir	eiturlyfjanotendurnir
miðgilda	miðgilda
reyni	reyni
fjallgarðs	fjallgarðs
byggði	byggði
skjalla	skjalla
hryggi	hryggi
mund	mund
krossgátuna	krossgátuna
gætið	gætið
samkundustjóra	samkundustjóra
blóðflögur	blóðflögur
fjarveru	fjarveru
Krists	Krists
hvílíkan	hvílíkan
húsbóndanum	húsbóndanum
lénið	lénið
hórkarl	hórkarl
hneykjandi	hneykjandi
breytti	breytti
hvor	hvor
byggi	byggi
styrktu	styrktu
fiskana	fiskana
sjöunda	sjöunda
burstirnar	burstirnar
skrifaði	skrifaði
indefinite	indefinite
minntir	minntir
vændis	vændis
vara	vara
fjarlægt	fjarlægt
strandlengju	strandlengju
boði	boði
köstum	köstum
minnið	minnið
þolað	þolað
skipt	skipt
metast	metast
tjarnar	tjarnar
hlutum	hlutum
geimar	geimar
liðsins	liðsins
henni	henni
þjáði	þjáði
missis	missis
hryggir	hryggir
minnstu	minnstu
hinu	hinu
varst	varst
afklæddir	afklæddir
syndga	syndga
tjöldunum	tjöldunum
eignarlýður	eignarlýður
notuðum	notuðum
fimmti	fimmti
minnanna	minnanna
átuð	átuð
Annað	Annað
klæðum	klæðum
drekkir	drekkir
Skyldu	Skyldu
pennavinunum	pennavinunum
skírið	skírið
malbiki	malbiki
bætti	bætti
þrýstir	þrýstir
týnda	týnda
skammar	skammar
skjöllum	skjöllum
brúðkaupsgestir	brúðkaupsgestir
samkundustjóri	samkundustjóri
síðu	síðu
nekt	nekt
vald	vald
fjár	fjár
skituna	skituna
hliðið	hliðið
hálsinum	hálsinum
rifi	rifi
ljóðlistin	ljóðlistin
hringaðir	hringaðir
eigist	eigist
skýrið	skýrið
handrit	handrit
getur	getur
raulið	raulið
valdi	valdi
sinarnar	sinarnar
þriðju	þriðju
jóna	jóna
verðin	verðin
veikt	veikt
flokka	flokka
greina	greina
dáðu	dáðu
skiptir	skiptir
gróðavegur	gróðavegur
þerraði	þerraði
tíðum	tíðum
maur	maur
klæðast	klæðast
skaut	skaut
leyst	leyst
múgæsingum	múgæsingum
net	net
starfið	starfið
hrista	hrista
þessu	þessu
hittu	hittu
færðir	færðir
kalkúnum	kalkúnum
skutuð	skutuð
sléttsöng	sléttsöng
rigninga	rigninga
selduð	selduð
missi	missi
þrjósku	þrjósku
Mun	Mun
dráps	dráps
valmyndarinnar	valmyndarinnar
skreytti	skreytti
Mannssonur	Mannssonur
settuð	settuð
skrifum	skrifum
hitamælunum	hitamælunum
markið	markið
náðu	náðu
mun	mun
kvíði	kvíði
söfnuð	söfnuð
yfirheitunum	yfirheitunum
gæja	gæja
vanheilagt	vanheilagt
einhver	einhver
skytir	skytir
guðspjallamenn	guðspjallamenn
leiðslu	leiðslu
æðikollur	æðikollur
strák	strák
mengar	mengar
snúið	snúið
minnisspili	minnisspili
tiggja	tiggja
treysta	treysta
rigni	rigni
hvílíkir	hvílíkir
burst	burst
skjótt	skjótt
svona	svona
formönnunum	formönnunum
hljóma	hljóma
fetinu	fetinu
leiðir	leiðir
gefin	gefin
gafflana	gafflana
minnkaðir	minnkaðir
slíka	slíka
sóla	sóla
Hvað	Hvað
klædda	klædda
varna	varna
æxlanirnar	æxlanirnar
tali	tali
málandi	málandi
leiddur	leiddur
verslið	verslið
anganna	anganna
reyndir	reyndir
völdu	völdu
ofursta	ofursta
skeifum	skeifum
hvítvíni	hvítvíni
krældi	krældi
fylltuð	fylltuð
myndið	myndið
líkunum	líkunum
kokið	kokið
þekkingar	þekkingar
abbadís	abbadís
geðshræringin	geðshræringin
segðu	segðu
hverja	hverja
hugsast	hugsast
framlengt	framlengt
fyrsti	fyrsti
rauluðuð	rauluðuð
kristni	kristni
nokkurt	nokkurt
vínguðinum	vínguðinum
hryggja	hryggja
krossfestir	krossfestir
vekjum	vekjum
sjötta	sjötta
vissum	vissum
glansi	glansi
notum	notum
færi	færi
kvelds	kvelds
hvílast	hvílast
treyst	treyst
meta	meta
hengið	hengið
hugunum	hugunum
minnti	minnti
höndli	höndli
vináttuna	vináttuna
óskaði	óskaði
ýfið	ýfið
porti	porti
köngla	köngla
hættu	hættu
mest	mest
þrýstu	þrýstu
neyddu	neyddu
Jótlandinu	Jótlandinu
orð	orð
hatti	hatti
útibúa	útibúa
flassið	flassið
lögðu	lögðu
hræddum	hræddum
spáðu	spáðu
tæfunum	tæfunum
þvargaði	þvargaði
vök	vök
hátíðina	hátíðina
lastmælin	lastmælin
neytti	neytti
skrifar	skrifar
ráðum	ráðum
komist	komist
hitti	hitti
viskí	viskí
dansinn	dansinn
stigbreytinguna	stigbreytinguna
þreytum	þreytum
prútta	prútta
vörina	vörina
misstum	misstum
lagðir	lagðir
mæðraveldi	mæðraveldi
hreyfir	hreyfir
ríbónúkleasann	ríbónúkleasann
vitrast	vitrast
ökrunum	ökrunum
ættfeðurnir	ættfeðurnir
feðgin	feðgin
lærður	lærður
dögunum	dögunum
kýklóparnir	kýklóparnir
glásum	glásum
dygðarinnar	dygðarinnar
unglingur	unglingur
reynd	reynd
dansa	dansa
gjörðuð	gjörðuð
meira	meira
rifrildisins	rifrildisins
ríki	ríki
boðum	boðum
þrælkaði	þrælkaði
lögð	lögð
fullreyndur	fullreyndur
hneigir	hneigir
notað	notað
opna	opna
kastað	kastað
spjótkastinu	spjótkastinu
kaupunum	kaupunum
skírn	skírn
göfguðu	göfguðu
Hinir	Hinir
opið	opið
slyppu	slyppu
kring	kring
hneigðu	hneigðu
laukst	laukst
höndla	höndla
flokkanna	flokkanna
hafið	hafið
sandinn	sandinn
trompin	trompin
villimanninn	villimanninn
verið	verið
brúðkaupsgestum	brúðkaupsgestum
sléttsöngur	sléttsöngur
sekta	sekta
fýrum	fýrum
siðuðum	siðuðum
fiska	fiska
hitt	hitt
gramúlf	gramúlf
verðinu	verðinu
Enga	Enga
perlunum	perlunum
reynir	reynir
matana	matana
sárasóttina	sárasóttina
næst	næst
grunnla	grunnla
þrenging	þrenging
kanti	kanti
spjarir	spjarir
bols	bols
fæl	fæl
heyrði	heyrði
skinum	skinum
kirsuber	kirsuber
vinkill	vinkill
sendandi	sendandi
syndgið	syndgið
grískuna	grískuna
dæmið	dæmið
kröftugt	kröftugt
myndaði	myndaði
brottfararinnar	brottfararinnar
annir	annir
vífa	vífa
þekkist	þekkist
síðastir	síðastir
heddunum	heddunum
skyti	skyti
vissir	vissir
samboðinn	samboðinn
kæra	kæra
talsmaðurinn	talsmaðurinn
lífvörðurinn	lífvörðurinn
goldið	goldið
mistilteins	mistilteins
rek	rek
hvar	hvar
fræðimönnunum	fræðimönnunum
skipa	skipa
súrefnisskortinum	súrefnisskortinum
kjörfurstar	kjörfurstar
knýði	knýði
fjörðunum	fjörðunum
sigur	sigur
hennar	hennar
eitt	eitt
Hvorn	Hvorn
smaragður	smaragður
gærum	gærum
bílstjórar	bílstjórar
tæfu	tæfu
fyrstu	fyrstu
tálvonin	tálvonin
kosta	kosta
hagnýta	hagnýta
þolið	þolið
skírðum	skírðum
dæmdu	dæmdu
kvikmyndin	kvikmyndin
misgjörða	misgjörða
gjósta	gjósta
reyknum	reyknum
snúi	snúi
fleygi	fleygi
staðalinn	staðalinn
aðgreindu	aðgreindu
neitað	neitað
minnkaði	minnkaði
umskornir	umskornir
skip	skip
gæta	gæta
japanskan	japanskan
saltast	saltast
drift	drift
klæði	klæði
strandlengjum	strandlengjum
langt	langt
lífvarðarins	lífvarðarins
engjum	engjum
horfðu	horfðu
samboðið	samboðið
sigurinn	sigurinn
drottnaðir	drottnaðir
fiskar	fiskar
náttúru	náttúru
felldir	felldir
fáist	fáist
valinn	valinn
sekt	sekt
slöngur	slöngur
yfirheitið	yfirheitið
smaragð	smaragð
sælur	sælur
fremstur	fremstur
siðaði	siðaði
metinu	metinu
núna	núna
ríkdómi	ríkdómi
hörmum	hörmum
stigbreytingu	stigbreytingu
þrengingu	þrengingu
skjótast	skjótast
yrðu	yrðu
missti	missti
almætti	almætti
símaskrána	símaskrána
hórkarla	hórkarla
spilin	spilin
skilaði	skilaði
trúleysið	trúleysið
leyfi	leyfi
styrktum	styrktum
steikunum	steikunum
teiknið	teiknið
afgreiðum	afgreiðum
samfundinn	samfundinn
kontrafagott	kontrafagott
byggðin	byggðin
einu	einu
drottnara	drottnara
skjallið	skjallið
leikmannanna	leikmannanna
þrem	þrem
drekktu	drekktu
mínir	mínir
þéraði	þéraði
úti	úti
styrki	styrki
skipast	skipast
suguð	suguð
báðir	báðir
styrkir	styrkir
sparkið	sparkið
hrekja	hrekja
upplestrar	upplestrar
Réttu	Réttu
rithöfund	rithöfund
búning	búning
sjúkdóm	sjúkdóm
strákar	strákar
Allt	Allt
furu	furu
slúttað	slúttað
kasta	kasta
heiman	heiman
lítið	lítið
æðst	æðst
öslir	öslir
fórnuðu	fórnuðu
málar	málar
jarða	jarða
ýmiss	ýmiss
undantekningum	undantekningum
skíða	skíða
sjálfstraustið	sjálfstraustið
fána	fána
vögguvísunum	vögguvísunum
verðið	verðið
saurgast	saurgast
kúbeinunum	kúbeinunum
greinisins	greinisins
iðnar	iðnar
læsir	læsir
Þessi	Þessi
plastanna	plastanna
undirfylkinganna	undirfylkinganna
lærði	lærði
gjalda	gjalda
stóð	stóð
göfga	göfga
þægindi	þægindi
þjöl	þjöl
leitum	leitum
brekkusnigli	brekkusnigli
öxla	öxla
horna	horna
mestu	mestu
kvænti	kvænti
sölurnar	sölurnar
eyddi	eyddi
krydda	krydda
misstuð	misstuð
steikinni	steikinni
klappað	klappað
hagnaðurinn	hagnaðurinn
fundinn	fundinn
vettling	vettling
þekktu	þekktu
hégómamáls	hégómamáls
sona	sona
hristu	hristu
jarðir	jarðir
guð	guð
stór	stór
en	en
blik	blik
leita	leita
strikin	strikin
rótfestir	rótfestir
minnir	minnir
hafi	hafi
vegasalt	vegasalt
deyða	deyða
elskum	elskum
skrifið	skrifið
búna	búna
Æðst	Æðst
fjóra	fjóra
bifreið	bifreið
vanræk	vanræk
sendu	sendu
veturinn	veturinn
fullnast	fullnast
hjartarsalt	hjartarsalt
hvílu	hvílu
mínar	mínar
liðum	liðum
óskum	óskum
gjaldið	gjaldið
mátti	mátti
spurningarnar	spurningarnar
gripið	gripið
þakka	þakka
Skyldum	Skyldum
Getum	Getum
höndlað	höndlað
minnkið	minnkið
kenni	kenni
galt	galt
hafa	hafa
Innan	Innan
ofurstinn	ofurstinn
spáði	spáði
eðla	eðla
dryn	dryn
koki	koki
borði	borði
hinum	hinum
sums	sums
framar	framar
hreinsunareldurinn	hreinsunareldurinn
köfðu	köfðu
leiddir	leiddir
stöðunum	stöðunum
hætt	hætt
sverði	sverði
hvorum	hvorum
þóttist	þóttist
gætum	gætum
nefnt	nefnt
bullið	bullið
Slíkt	Slíkt
færð	færð
stærið	stærið
met	met
skýrðu	skýrðu
ert	ert
engan	engan
kveldum	kveldum
Allir	Allir
tvennuna	tvennuna
ógleðina	ógleðina
skrifuðu	skrifuðu
gallínið	gallínið
plóg	plóg
lessunum	lessunum
geirfuglsins	geirfuglsins
þrælkuðu	þrælkuðu
skips	skips
lessan	lessan
Hafið	Hafið
lausnarinnar	lausnarinnar
fundanna	fundanna
þenjum	þenjum
endurræstu	endurræstu
vændinu	vændinu
elska	elska
fremsta	fremsta
fiskanna	fiskanna
send	send
neitt	neitt
horfið	horfið
eindar	eindar
fórnuðuð	fórnuðuð
óréttinn	óréttinn
efldu	efldu
hinar	hinar
vökin	vökin
afritunum	afritunum
bikkju	bikkju
slepptu	slepptu
fórnfæra	fórnfæra
smóka	smóka
skán	skán
kysstuð	kysstuð
blinda	blinda
hvílíks	hvílíks
leyndin	leyndin
sósublettanna	sósublettanna
dissið	dissið
ná	ná
skamma	skamma
byggjum	byggjum
blindir	blindir
ríkt	ríkt
aliandarinnar	aliandarinnar
tómlætinu	tómlætinu
árós	árós
hýstum	hýstum
blikum	blikum
lítt	lítt
sokka	sokka
breyttu	breyttu
hefur	hefur
brunann	brunann
tennisboltarnir	tennisboltarnir
köngulónum	köngulónum
vestrar	vestrar
framlengdi	framlengdi
sérhljóð	sérhljóð
mögnum	mögnum
standast	standast
vakirnar	vakirnar
virti	virti
svara	svara
töntu	töntu
malbikið	malbikið
lauguðum	lauguðum
skyldu	skyldu
karakterinn	karakterinn
undan	undan
hórkarlar	hórkarlar
ættkvíslum	ættkvíslum
leyndi	leyndi
stund	stund
fegrið	fegrið
sektir	sektir
saumurinn	saumurinn
Hafi	Hafi
pílu	pílu
hlutunum	hlutunum
ofan	ofan
sérhvert	sérhvert
staðlana	staðlana
staða	staða
góla	góla
gagntekur	gagntekur
munir	munir
drollinu	drollinu
kyssi	kyssi
konu	konu
snúast	snúast
skírir	skírir
tunglsjúka	tunglsjúka
heiðagæs	heiðagæs
stökkum	stökkum
leit	leit
umkringja	umkringja
sparðs	sparðs
tár	tár
glóbrystinginn	glóbrystinginn
hefjir	hefjir
gátuð	gátuð
reynið	reynið
maka	maka
hænsna	hænsna
alla	alla
aliönd	aliönd
vestra	vestra
öðlist	öðlist
meðulunum	meðulunum
sjálfsmyndina	sjálfsmyndina
köstuðu	köstuðu
öllum	öllum
endar	endar
stoppana	stoppana
gaurarnir	gaurarnir
íveru	íveru
markspyrnum	markspyrnum
arga	arga
frjókornanna	frjókornanna
spá	spá
undirættbálkur	undirættbálkur
fæðu	fæðu
saltkjöt	saltkjöt
liðinn	liðinn
rymur	rymur
metið	metið
sérhverja	sérhverja
Fyrir	Fyrir
kameljóns	kameljóns
Engum	Engum
raust	raust
þriðji	þriðji
hvítvín	hvítvín
leynda	leynda
Lík	Lík
frumvörpum	frumvörpum
æðardúni	æðardúni
kjörfurstann	kjörfurstann
fundi	fundi
mínu	mínu
völdum	völdum
vífið	vífið
kantötum	kantötum
oft	oft
frumbyggja	frumbyggja
veikir	veikir
sæbjúga	sæbjúga
ákæru	ákæru
hefjið	hefjið
gyldi	gyldi
búninganna	búninganna
settaug	settaug
væli	væli
greininum	greininum
orðið	orðið
þol	þol
byggir	byggir
notaðir	notaðir
leyfunum	leyfunum
líkinu	líkinu
stundina	stundina
ræða	ræða
endurnýjuðu	endurnýjuðu
smjattið	smjattið
Leitast	Leitast
hálfleikurinn	hálfleikurinn
kryfjið	kryfjið
hillu	hillu
sköpum	sköpum
hlátur	hlátur
mættuð	mættuð
fimmta	fimmta
freigátunnar	freigátunnar
snuði	snuði
hávellunnar	hávellunnar
tengisagna	tengisagna
huldir	huldir
út	út
pókersins	pókersins
helgi	helgi
gess	gess
getum	getum
tökuorð	tökuorð
leysa	leysa
mál	mál
als	als
útlista	útlista
menga	menga
boðaði	boðaði
svæfið	svæfið
agúrkuna	agúrkuna
kunni	kunni
drukkna	drukkna
eyjar	eyjar
borgum	borgum
aukafallsliðinn	aukafallsliðinn
munt	munt
hræðið	hræðið
lofaði	lofaði
flettuð	flettuð
rithöfundum	rithöfundum
tómlæti	tómlæti
hefðu	hefðu
kastir	kastir
átu	átu
þérað	þérað
skýrðir	skýrðir
drottnarans	drottnarans
víkur	víkur
trúa	trúa
skytum	skytum
möluðuð	möluðuð
skyldufræðinni	skyldufræðinni
líkin	líkin
mærin	mærin
árósa	árósa
lofi	lofi
flugvellirnir	flugvellirnir
úkraínskan	úkraínskan
þekkti	þekkti
þrengingar	þrengingar
félag	félag
beini	beini
ættum	ættum
mistilteinum	mistilteinum
skal	skal
hávellunum	hávellunum
flokkana	flokkana
skyttuna	skyttuna
dreifst	dreifst
bóndi	bóndi
skipið	skipið
rigna	rigna
krikkets	krikkets
Hverja	Hverja
rekið	rekið
hin	hin
tignaðir	tignaðir
stýrið	stýrið
undantókum	undantókum
höfnun	höfnun
borðaðir	borðaðir
gefið	gefið
líkamana	líkamana
loft	loft
talentu	talentu
ættu	ættu
þjálfun	þjálfun
vallarmiðju	vallarmiðju
klætt	klætt
myrtu	myrtu
sjálfir	sjálfir
stundu	stundu
skitur	skitur
safna	safna
hvílir	hvílir
báða	báða
naðranna	naðranna
óvirt	óvirt
leyndir	leyndir
gormarnir	gormarnir
fullyrtu	fullyrtu
ranns	ranns
höttum	höttum
heiðagæsum	heiðagæsum
borða	borða
tígrisdýrs	tígrisdýrs
öfunda	öfunda
definite	definite
hylja	hylja
skírðu	skírðu
byggja	byggja
dúksins	dúksins
lík	lík
akademíurnar	akademíurnar
ályktað	ályktað
dæma	dæma
Belgann	Belgann
göfgar	göfgar
dæmanna	dæmanna
rétt	rétt
stóru	stóru
hreyfingum	hreyfingum
gormsins	gormsins
sá	sá
sagna	sagna
aukafallsliðina	aukafallsliðina
rusls	rusls
heyrðu	heyrðu
akademíunum	akademíunum
plasta	plasta
svikurunum	svikurunum
iðnina	iðnina
ráð	ráð
uppfærið	uppfærið
æðarblika	æðarblika
vinkils	vinkils
jötunuxi	jötunuxi
sjálfsmorðs	sjálfsmorðs
seldir	seldir
hersveitirnar	hersveitirnar
meðal	meðal
endaþarmsmökin	endaþarmsmökin
krossfestið	krossfestið
skepnan	skepnan
knýir	knýir
skýra	skýra
karsinn	karsinn
kjörið	kjörið
sjöundi	sjöundi
öðluðumst	öðluðumst
framan	framan
krælandi	krælandi
hvína	hvína
efldi	efldi
jafnt	jafnt
hristi	hristi
gjörist	gjörist
vitru	vitru
saurgað	saurgað
veitti	veitti
hnefanum	hnefanum
grafíts	grafíts
hýdrat	hýdrat
öðrum	öðrum
rigningarnar	rigningarnar
fósturs	fósturs
gjörir	gjörir
krakkið	krakkið
höfðu	höfðu
leysti	leysti
hefjum	hefjum
bullinu	bullinu
teflir	teflir
neins	neins
kalkúnana	kalkúnana
veldu	veldu
aftraði	aftraði
poka	poka
beð	beð
tómstundagamanið	tómstundagamanið
alinn	alinn
Getur	Getur
kaupi	kaupi
Dauðinn	Dauðinn
víka	víka
risa	risa
öslaði	öslaði
skír	skír
stunda	stunda
skírnir	skírnir
hvílt	hvílt
vinkonan	vinkonan
gætu	gætu
kunna	kunna
horn	horn
byggið	byggið
fórnið	fórnið
vísum	vísum
ríkdóminn	ríkdóminn
hýdrötum	hýdrötum
káetu	káetu
gengið	gengið
tómstundagamni	tómstundagamni
frakka	frakka
allar	allar
smíða	smíða
báðum	báðum
aðfaranóttin	aðfaranóttin
kvæn	kvæn
hagi	hagi
Svía	Svía
vitrunum	vitrunum
vík	vík
aborranna	aborranna
aðvöruðuð	aðvöruðuð
boðin	boðin
klæðir	klæðir
sleiksins	sleiksins
hræætu	hræætu
flaga	flaga
bumbubúum	bumbubúum
postuladóm	postuladóm
settir	settir
höfðuð	höfðuð
eignarlýð	eignarlýð
ölum	ölum
leyfa	leyfa
kæru	kæru
byggðu	byggðu
kýklópa	kýklópa
gegn	gegn
móðunum	móðunum
sokk	sokk
býsn	býsn
þess	þess
týndur	týndur
samkomulagið	samkomulagið
gylturnar	gylturnar
reiðhjólunum	reiðhjólunum
skjótandi	skjótandi
svörður	svörður
best	best
anda	anda
syndum	syndum
áhrifi	áhrifi
breyta	breyta
flokkinn	flokkinn
nefnist	nefnist
tröllkonu	tröllkonu
sérhver	sérhver
öfgi	öfgi
vind	vind
ökuleyfi	ökuleyfi
ónáðaði	ónáðaði
minnstur	minnstur
komu	komu
þöggum	þöggum
Sumir	Sumir
kefja	kefja
beinana	beinana
góm	góm
miðnættin	miðnættin
byggjandi	byggjandi
öndun	öndun
furunum	furunum
gervitungls	gervitungls
heita	heita
félagshyggju	félagshyggju
misskilningi	misskilningi
gildið	gildið
rifið	rifið
mín	mín
ungmenni	ungmenni
hefðum	hefðum
hálsum	hálsum
bílstjóra	bílstjóra
fullnuð	fullnuð
prúttuðuð	prúttuðuð
trúleysi	trúleysi
smalahundum	smalahundum
ráðin	ráðin
helgast	helgast
fisk	fisk
hagann	hagann
öskra	öskra
hugsunum	hugsunum
teikna	teikna
aldin	aldin
styrkja	styrkja
dæmi	dæmi
berst	berst
framlengdu	framlengdu
nokkrar	nokkrar
einhverja	einhverja
egnir	egnir
beltum	beltum
ráða	ráða
sinn	sinn
herstígvél	herstígvél
ákæra	ákæra
mynstra	mynstra
heim	heim
pyntuðu	pyntuðu
krossfestuð	krossfestuð
sóttu	sóttu
sinni	sinni
fær	fær
dygðina	dygðina
málið	málið
villimönnunum	villimönnunum
byggist	byggist
hröðlum	hröðlum
græddum	græddum
hýst	hýst
gríska	gríska
eyrað	eyrað
helvíti	helvíti
einstaklingurinn	einstaklingurinn
Þess	Þess
setti	setti
ergið	ergið
settu	settu
albönsku	albönsku
leitt	leitt
sína	sína
kökukeflið	kökukeflið
hafs	hafs
víst	víst
treysti	treysti
reglurnar	reglurnar
hálfendarnir	hálfendarnir
tjull	tjull
dreif	dreif
sendi	sendi
flöguna	flöguna
handboltanum	handboltanum
tárið	tárið
drifta	drifta
Ert	Ert
míns	míns
aldur	aldur
efli	efli
klæddum	klæddum
dáið	dáið
kontrafagottið	kontrafagottið
girninu	girninu
elsku	elsku
leiðin	leiðin
geta	geta
perlanna	perlanna
Munu	Munu
akademíu	akademíu
heflaði	heflaði
vanheilagir	vanheilagir
leitast	leitast
betri	betri
færði	færði
svindlara	svindlara
nokkra	nokkra
sleppt	sleppt
kílóin	kílóin
kylfu	kylfu
kúts	kúts
sumum	sumum
þínum	þínum
valdið	valdið
fyrsta	fyrsta
uppfært	uppfært
aukaföllin	aukaföllin
fórinta	fórinta
líki	líki
ökuleyfið	ökuleyfið
ungmennis	ungmennis
ákveðin	ákveðin
brögðin	brögðin
hnúts	hnúts
mets	mets
Sum	Sum
byggða	byggða
hljómaði	hljómaði
metin	metin
opinberast	opinberast
engi	engi
lungnaberkla	lungnaberkla
tölvupóstföngum	tölvupóstföngum
Eru	Eru
þekktur	þekktur
lokið	lokið
skafls	skafls
laugaði	laugaði
boða	boða
beila	beila
færeysku	færeysku
blóðflögum	blóðflögum
helvítið	helvítið
lokum	lokum
skýrandi	skýrandi
æxlununum	æxlununum
freistað	freistað
éti	éti
koma	koma
greinis	greinis
endurnýjuðuð	endurnýjuðuð
stjórna	stjórna
hnéskel	hnéskel
reyrar	reyrar
stundanna	stundanna
þín	þín
Hinar	Hinar
notar	notar
hjúkrar	hjúkrar
kossinn	kossinn
skjóta	skjóta
skelfisk	skelfisk
birtur	birtur
hverju	hverju
drepur	drepur
trjóna	trjóna
brenna	brenna
hliðum	hliðum
jöfnunin	jöfnunin
stýri	stýri
arfi	arfi
hjólhýsi	hjólhýsi
hrösuðum	hrösuðum
æfingunum	æfingunum
málað	málað
hötuðu	hötuðu
værir	værir
ergir	ergir
sjússunum	sjússunum
tréblásturshljóðfæris	tréblásturshljóðfæris
Orðið	Orðið
slíkt	slíkt
mátt	mátt
prúttandi	prúttandi
tregi	tregi
slíkir	slíkir
vonunum	vonunum
tískurnar	tískurnar
sjálfan	sjálfan
páskaeggja	páskaeggja
allt	allt
þerra	þerra
körfuboltar	körfuboltar
tvennur	tvennur
byggður	byggður
svíkjum	svíkjum
staðinn	staðinn
aðfaranæturnar	aðfaranæturnar
tíð	tíð
rasskinn	rasskinn
Anna	Anna
Belga	Belga
Kristur	Kristur
Hin	Hin
fjallgarð	fjallgarð
mörkin	mörkin
spurninga	spurninga
gröftum	gröftum
sífrar	sífrar
þvoðu	þvoðu
vígvelli	vígvelli
sonur	sonur
þátíðina	þátíðina
æpa	æpa
lofgjörð	lofgjörð
reykjunum	reykjunum
Nakson	Nakson
þreytist	þreytist
fyll	fyll
selleríið	selleríið
folann	folann
leiðsla	leiðsla
verðs	verðs
mistrið	mistrið
leikaranna	leikaranna
upp	upp
skýri	skýri
hljómlist	hljómlist
hóp	hóp
undantekningu	undantekningu
saumi	saumi
færist	færist
útisundlaugar	útisundlaugar
erfir	erfir
stækju	stækju
yrði	yrði
veittuð	veittuð
þjónustu	þjónustu
stýrðu	stýrðu
miðnætta	miðnætta
ber	ber
markspyrnu	markspyrnu
æðstu	æðstu
vafa	vafa
fljótt	fljótt
hreppa	hreppa
leynum	leynum
skipin	skipin
drekktum	drekktum
skapa	skapa
þoli	þoli
rithöfundurinn	rithöfundurinn
aukafalls	aukafalls
Verði	Verði
valmynda	valmynda
læst	læst
kennir	kennir
hverjir	hverjir
velur	velur
flotaforingja	flotaforingja
raðið	raðið
fóðrunum	fóðrunum
sónatínan	sónatínan
heiti	heiti
kirsuberi	kirsuberi
glerhaf	glerhaf
faldanna	faldanna
uxa	uxa
greinirinn	greinirinn
lýsingarorða	lýsingarorða
hryggdýrin	hryggdýrin
skjótir	skjótir
bundna	bundna
viki	viki
keyptir	keyptir
lýsir	lýsir
séu	séu
vanadíns	vanadíns
drolls	drolls
aðgreindir	aðgreindir
yfirheitin	yfirheitin
svæfði	svæfði
félaga	félaga
brjóstbeins	brjóstbeins
vitrir	vitrir
greinum	greinum
prentaði	prentaði
gegnt	gegnt
áhrifið	áhrifið
stoð	stoð
Koma	Koma
skírlífu	skírlífu
skýtur	skýtur
gramúlfinn	gramúlfinn
Rétt	Rétt
skapaði	skapaði
hrapsins	hrapsins
mær	mær
blekbyttu	blekbyttu
flettið	flettið
trúarjátningin	trúarjátningin
samkundustjórunum	samkundustjórunum
eigna	eigna
höfnunum	höfnunum
freista	freista
velþóknanlegur	velþóknanlegur
tappatogara	tappatogara
helt	helt
æðahnúta	æðahnúta
forsælu	forsælu
leysast	leysast
aðdáandann	aðdáandann
þíns	þíns
eyranu	eyranu
ákærðu	ákærðu
þarfaþingið	þarfaþingið
volað	volað
missum	missum
fiskur	fiskur
markmanninn	markmanninn
æðarkónginn	æðarkónginn
afklæðum	afklæðum
magn	magn
fremst	fremst
gjaldir	gjaldir
búið	búið
kastaðir	kastaðir
hinir	hinir
sýnduð	sýnduð
færir	færir
kynkvísla	kynkvísla
brjóstbeinið	brjóstbeinið
bolir	bolir
stundarinnar	stundarinnar
afgreiddi	afgreiddi
bjarkar	bjarkar
fimbulvetur	fimbulvetur
neitaði	neitaði
trompið	trompið
glasi	glasi
kastar	kastar
skarði	skarði
tóninum	tóninum
Haf	Haf
hætta	hætta
tilreiknaði	tilreiknaði
póker	póker
klædduð	klædduð
gætir	gætir
stóra	stóra
gaurs	gaurs
langaði	langaði
þjáist	þjáist
prómetínið	prómetínið
kílói	kílói
minninganna	minninganna
ilmjurtir	ilmjurtir
senda	senda
raula	raula
gerðu	gerðu
færa	færa
Munum	Munum
morgnunum	morgnunum
kostuðu	kostuðu
komna	komna
metum	metum
heyrðuð	heyrðuð
freistið	freistið
hersveitina	hersveitina
markgreifanna	markgreifanna
reiðin	reiðin
smjatti	smjatti
grundarinnar	grundarinnar
skækjum	skækjum
koka	koka
trúna	trúna
ris	ris
hefðarsæti	hefðarsæti
kosti	kosti
hugtak	hugtak
dúkur	dúkur
verðsins	verðsins
fermingu	fermingu
tíða	tíða
talaði	talaði
kapellunni	kapellunni
skiptum	skiptum
mínum	mínum
Verið	Verið
áfrýjuninni	áfrýjuninni
skytuð	skytuð
fjalir	fjalir
dauði	dauði
æxlunum	æxlunum
vísurnar	vísurnar
nei	nei
sinnar	sinnar
vegasalta	vegasalta
öxin	öxin
leyn	leyn
erfðafræðina	erfðafræðina
kvæntist	kvæntist
fóstrunum	fóstrunum
skerma	skerma
ljúka	ljúka
minnunum	minnunum
hvílíkt	hvílíkt
kúbein	kúbein
safnaði	safnaði
eigin	eigin
múslima	múslima
sættið	sættið
kyrkti	kyrkti
frystiskápum	frystiskápum
kenndin	kenndin
sóða	sóða
slepp	slepp
kommúnistinn	kommúnistinn
samkomulag	samkomulag
síðar	síðar
fuglafræðina	fuglafræðina
flokkum	flokkum
endurnýja	endurnýja
kröftugi	kröftugi
farsímar	farsímar
étið	étið
vönduðuð	vönduðuð
heitið	heitið
skottulækni	skottulækni
þökkunum	þökkunum
lifði	lifði
hrek	hrek
síst	síst
einum	einum
greinanna	greinanna
kastið	kastið
gagntaka	gagntaka
belgir	belgir
auka	auka
káeta	káeta
síður	síður
sakna	sakna
skaflinn	skaflinn
haltra	haltra
góluðu	góluðu
tes	tes
spáð	spáð
heyrast	heyrast
ges	ges
skutum	skutum
þínu	þínu
akra	akra
höf	höf
kúrdískan	kúrdískan
misst	misst
viðræða	viðræða
fyllið	fyllið
seldur	seldur
segist	segist
ljóðlista	ljóðlista
skapanna	skapanna
fjöldann	fjöldann
skil	skil
diski	diski
búningana	búningana
geddu	geddu
ferst	ferst
sælunum	sælunum
plógs	plógs
flettir	flettir
skildist	skildist
vörum	vörum
glerhafið	glerhafið
leyfið	leyfið
eigur	eigur
settaugin	settaugin
plokki	plokki
hugsun	hugsun
garðyrkjufræði	garðyrkjufræði
vísu	vísu
kvænir	kvænir
andlang	andlang
teið	teið
etýðu	etýðu
störf	störf
böðullinn	böðullinn
kalkspatið	kalkspatið
það	það
argaðir	argaðir
horfum	horfum
flokksins	flokksins
spillti	spillti
kætin	kætin
geisladiskur	geisladiskur
bifaði	bifaði
lungnaberklarnir	lungnaberklarnir
skækjan	skækjan
saurgi	saurgi
engar	engar
hrekjast	hrekjast
viðbjóðirnir	viðbjóðirnir
starf	starf
trú	trú
fylli	fylli
leynið	leynið
klappandi	klappandi
okkarínurnar	okkarínurnar
gramúlfarnir	gramúlfarnir
kæti	kæti
jafna	jafna
endi	endi
kastaði	kastaði
harmurinn	harmurinn
guði	guði
drekkti	drekkti
vanda	vanda
félagum	félagum
ritaði	ritaði
dissar	dissar
blessuðuð	blessuðuð
slíkan	slíkan
berð	berð
endurræsti	endurræsti
gráða	gráða
handboltaþjálfara	handboltaþjálfara
komst	komst
er	er
óvirti	óvirti
furunni	furunni
herstígvéla	herstígvéla
hjakkið	hjakkið
orðskviður	orðskviður
heróínið	heróínið
minnast	minnast
tárin	tárin
styrkti	styrkti
þandi	þandi
fyllum	fyllum
iðnanna	iðnanna
vestrinn	vestrinn
fást	fást
hitamælinn	hitamælinn
erfði	erfði
nota	nota
sendið	sendið
æptir	æptir
feðginin	feðginin
einhvern	einhvern
hafsins	hafsins
efaði	efaði
fluttu	fluttu
slangan	slangan
laggaðir	laggaðir
bruninn	bruninn
styrktir	styrktir
ræðu	ræðu
siða	siða
mengaði	mengaði
neyðir	neyðir
dramb	dramb
kjarnakorn	kjarnakorn
þeirra	þeirra
vanadínið	vanadínið
legköku	legköku
ali	ali
páskaeggsins	páskaeggsins
tottaði	tottaði
dauða	dauða
agúrku	agúrku
vindill	vindill
fjólu	fjólu
teiknaði	teiknaði
hvíl	hvíl
konuna	konuna
fylla	fylla
þína	þína
vanrækja	vanrækja
klæða	klæða
leynir	leynir
birtast	birtast
hengdir	hengdir
fæddu	fæddu
markmaðurinn	markmaðurinn
græddur	græddur
minnum	minnum
reiði	reiði
bundið	bundið
guðspjallamaðurinn	guðspjallamaðurinn
óperuhúsið	óperuhúsið
djúpt	djúpt
söndunum	söndunum
hryggðuð	hryggðuð
hóllinn	hóllinn
mætti	mætti
fleygt	fleygt
saknir	saknir
yrðum	yrðum
saurga	saurga
organista	organista
borð	borð
djúp	djúp
fylltu	fylltu
sérhljóðs	sérhljóðs
nöðru	nöðru
haginn	haginn
ýfðuð	ýfðuð
skírum	skírum
svíki	svíki
uppi	uppi
kapellu	kapellu
hlutarins	hlutarins
nokkur	nokkur
skapi	skapi
sjálft	sjálft
leyndu	leyndu
verði	verði
boðið	boðið
græðið	græðið
notaði	notaði
mynstrið	mynstrið
lakka	lakka
þinn	þinn
leikara	leikara
kerti	kerti
stundinni	stundinni
maurs	maurs
senduð	senduð
dæmdir	dæmdir
heróíninu	heróíninu
dýralæknar	dýralæknar
óvirtuð	óvirtuð
tjörnum	tjörnum
vissu	vissu
færanna	færanna
reipið	reipið
afætuna	afætuna
félagi	félagi
þakkir	þakkir
sess	sess
samfund	samfund
hryggðir	hryggðir
forsíðu	forsíðu
gorm	gorm
Jason	Jason
munum	munum
okkarínu	okkarínu
flugvalla	flugvalla
varirnar	varirnar
skjólanna	skjólanna
sumu	sumu
fram	fram
þrengdi	þrengdi
húsfrúna	húsfrúna
freigátunum	freigátunum
stikana	stikana
hæsinnar	hæsinnar
grískunni	grískunni
staði	staði
körtum	körtum
ríkdóm	ríkdóm
brögðum	brögðum
sparði	sparði
kviðunum	kviðunum
fæddir	fæddir
verða	verða
umskornu	umskornu
bandstrik	bandstrik
heitt	heitt
ríktu	ríktu
brjálæði	brjálæði
klæðið	klæðið
samvistarfalli	samvistarfalli
samvistarfallinu	samvistarfallinu
liðanna	liðanna
lessa	lessa
bikkjurnar	bikkjurnar
kviðunni	kviðunni
önnunum	önnunum
drápum	drápum
uppvekja	uppvekja
deyðið	deyðið
berast	berast
breytt	breytt
vestranum	vestranum
vitrað	vitrað
stundum	stundum
denar	denar
skeifa	skeifa
handrits	handrits
knattspyrnu	knattspyrnu
spaðarnir	spaðarnir
Eruð	Eruð
þrengingunum	þrengingunum
miða	miða
berklanna	berklanna
granatepli	granatepli
æðardúninn	æðardúninn
skyldi	skyldi
tyrkneskan	tyrkneskan
lúkks	lúkks
hornum	hornum
smalahundur	smalahundur
þérum	þérum
sleik	sleik
eiginmönnum	eiginmönnum
mættum	mættum
tengisagnirnar	tengisagnirnar
fegrað	fegrað
lifanda	lifanda
guðinn	guðinn
borðið	borðið
gengi	gengi
skírði	skírði
hlutirnir	hlutirnir
bjórvömb	bjórvömb
gólfið	gólfið
fældir	fældir
velþóknanleg	velþóknanleg
flesta	flesta
vifta	vifta
löstum	löstum
glataði	glataði
lagði	lagði
slíkur	slíkur
drekkið	drekkið
hnefann	hnefann
þessa	þessa
lengur	lengur
krossfestu	krossfestu
hvað	hvað
kringum	kringum
korpönd	korpönd
blóðfrumu	blóðfrumu
Sjálfir	Sjálfir
engjanna	engjanna
langi	langi
bliku	bliku
Hvort	Hvort
vendir	vendir
legils	legils
eflduð	eflduð
bíóinu	bíóinu
vælið	vælið
sótt	sótt
viðskiptavinunum	viðskiptavinunum
félaganum	félaganum
skýrum	skýrum
kommúnistum	kommúnistum
þátíð	þátíð
sídd	sídd
upplestra	upplestra
sæbjúgna	sæbjúgna
ýmist	ýmist
gerði	gerði
vettlingum	vettlingum
trunta	trunta
frumbyggjann	frumbyggjann
brotið	brotið
gætti	gætti
hefðuð	hefðuð
síðast	síðast
kvarsinu	kvarsinu
spjara	spjara
Hafa	Hafa
snæris	snæris
tréblásturshljóðfærið	tréblásturshljóðfærið
reiðum	reiðum
slíkum	slíkum
minntuð	minntuð
mesta	mesta
vælir	vælir
endaþarmsmökum	endaþarmsmökum
undirfylkingu	undirfylkingu
reglu	reglu
Hefur	Hefur
tala	tala
beilum	beilum
lesandann	lesandann
logni	logni
drepum	drepum
hrasar	hrasar
kostandi	kostandi
sóunin	sóunin
fengin	fengin
horft	horft
hryggið	hryggið
leiddi	leiddi
dána	dána
pípuhatta	pípuhatta
körtunnar	körtunnar
væri	væri
erum	erum
bólstraskýjum	bólstraskýjum
unga	unga
þrassins	þrassins
gyldu	gyldu
skörð	skörð
hljómað	hljómað
kantöturnar	kantöturnar
komum	komum
ráðið	ráðið
vakir	vakir
máli	máli
eitur	eitur
sæbjúgað	sæbjúgað
sjálfu	sjálfu
umskorna	umskorna
hræddur	hræddur
spila	spila
lífstykkið	lífstykkið
ala	ala
spilltur	spilltur
skipunum	skipunum
gættu	gættu
sprokunum	sprokunum
albönskunnar	albönskunnar
samfundi	samfundi
hvílíkar	hvílíkar
stikann	stikann
sátunni	sátunni
vorum	vorum
talast	talast
lifandann	lifandann
dans	dans
aldir	aldir
fluttur	fluttur
glásirnar	glásirnar
skilin	skilin
skrifi	skrifi
heiður	heiður
flokkar	flokkar
þótt	þótt
hvílíka	hvílíka
nærmynda	nærmynda
munduð	munduð
fært	fært
greinarnir	greinarnir
flestir	flestir
hross	hross
munið	munið
íþyngi	íþyngi
gull	gull
skýrir	skýrir
ógleði	ógleði
þinni	þinni
gjöra	gjöra
skjóti	skjóti
svæfi	svæfi
engu	engu
grafítið	grafítið
Mannssonurinn	Mannssonurinn
sjálfstraust	sjálfstraust
prenta	prenta
áttundi	áttundi
hellirinn	hellirinn
eyrunum	eyrunum
sendum	sendum
kysstir	kysstir
opinber	opinber
hvern	hvern
þjást	þjást
hjökkuðuð	hjökkuðuð
denarinn	denarinn
Allan	Allan
sonunum	sonunum
logann	logann
tíi	tíi
tíin	tíin
útibúið	útibúið
drepir	drepir
lýsingarorð	lýsingarorð
loga	loga
færu	færu
samtengingin	samtengingin
glönsum	glönsum
geirfuglinn	geirfuglinn
hjúkruðum	hjúkruðum
fisks	fisks
samfundurinn	samfundurinn
kvæntur	kvæntur
miðgildið	miðgildið
Asía	Asía
kontrabassann	kontrabassann
testósterónið	testósterónið
hvæstuð	hvæstuð
símaskrá	símaskrá
spítalinn	spítalinn
settur	settur
kjaftar	kjaftar
ugga	ugga
svita	svita
geddanna	geddanna
Hef	Hef
tyrkneskunnar	tyrkneskunnar
mundir	mundir
leiða	leiða
herpti	herpti
Þessir	Þessir
greini	greini
sögn	sögn
nasismanum	nasismanum
allan	allan
skyldum	skyldum
snæri	snæri
söfnuðu	söfnuðu
varaliðið	varaliðið
frísparkið	frísparkið
þessar	þessar
söfnum	söfnum
mellum	mellum
nýtir	nýtir
labbið	labbið
heyrðum	heyrðum
mella	mella
fríspark	fríspark
síddum	síddum
öllu	öllu
hlátrinum	hlátrinum
vonin	vonin
raustin	raustin
kveikinn	kveikinn
hengjum	hengjum
vanadíni	vanadíni
meltingar	meltingar
hengdu	hengdu
grundina	grundina
kært	kært
þögguðu	þögguðu
líks	líks
dansaði	dansaði
ákveðið	ákveðið
píla	píla
hengdum	hengdum
þinnar	þinnar
hjakka	hjakka
hnéskelin	hnéskelin
felldu	felldu
norrænu	norrænu
leglinum	leglinum
Hvert	Hvert
gullið	gullið
akursins	akursins
korpöndunum	korpöndunum
trega	trega
áfrýjandi	áfrýjandi
hvaðan	hvaðan
eignina	eignina
fæst	fæst
áfrýjunar	áfrýjunar
þéruðu	þéruðu
sneri	sneri
lýsti	lýsti
gaffallinn	gaffallinn
pípuhöttunum	pípuhöttunum
peningi	peningi
bifreiðirnar	bifreiðirnar
auki	auki
breytum	breytum
folunum	folunum
fórintu	fórintu
næstur	næstur
misskilnings	misskilnings
spektan	spektan
makar	makar
undir	undir
kross	kross
eigið	eigið
þessi	þessi
fældu	fældu
sviti	sviti
treystuð	treystuð
klúðrir	klúðrir
helga	helga
muni	muni
missið	missið
kostaði	kostaði
burt	burt
pókers	pókers
málaði	málaði
kjöltu	kjöltu
lofgjörðin	lofgjörðin
göfguðuð	göfguðuð
þurrísi	þurrísi
mála	mála
lærandi	lærandi
þeirrar	þeirrar
endarnir	endarnir
neyddur	neyddur
móðu	móðu
höfum	höfum
boð	boð
kjörinn	kjörinn
þreytast	þreytast
kafði	kafði
böðla	böðla
totta	totta
lærir	lærir
stýrði	stýrði
liðið	liðið
neyðið	neyðið
gjörðu	gjörðu
vor	vor
uppvekur	uppvekur
hefli	hefli
stoppanirnar	stoppanirnar
hlutanna	hlutanna
safnandi	safnandi
lengi	lengi
róðra	róðra
lið	lið
skylduð	skylduð
klippi	klippi
rökuðuð	rökuðuð
synir	synir
safnar	safnar
ráðanna	ráðanna
dæmdum	dæmdum
fullyrti	fullyrti
hvílíkur	hvílíkur
heimta	heimta
stjórnuðu	stjórnuðu
fundum	fundum
skírðir	skírðir
Jasoni	Jasoni
orðskviða	orðskviða
teiknaðir	teiknaðir
erfðafræði	erfðafræði
rétta	rétta
plokkaði	plokkaði
raustu	raustu
líkur	líkur
lastmæltu	lastmæltu
dæmast	dæmast
velþóknanlegar	velþóknanlegar
fullreynd	fullreynd
líkið	líkið
öðlast	öðlast
félaganna	félaganna
hólanna	hólanna
hvein	hvein
ryðönd	ryðönd
húsbóndi	húsbóndi
færðu	færðu
allir	allir
þakkað	þakkað
misgjörðin	misgjörðin
ritum	ritum
lesanda	lesanda
reki	reki
fleygði	fleygði
tígrisdýrið	tígrisdýrið
líksins	líksins
mestur	mestur
snerist	snerist
fagurfræðin	fagurfræðin
Suma	Suma
réttu	réttu
missirinn	missirinn
skíðaði	skíðaði
leiði	leiði
gilt	gilt
hreyfinganna	hreyfinganna
loka	loka
högum	högum
umkringdi	umkringdi
sparka	sparka
neyttu	neyttu
þvost	þvost
kvaks	kvaks
stært	stært
sápur	sápur
byggt	byggt
óvirtir	óvirtir
þeirri	þeirri
ríkti	ríkti
fóður	fóður
hluta	hluta
skjótum	skjótum
þakkaði	þakkaði
skalt	skalt
máluðuð	máluðuð
hötuðum	hötuðum
mæðraveldis	mæðraveldis
skýrðuð	skýrðuð
geymduð	geymduð
strætisvagninn	strætisvagninn
Erum	Erum
hvíldunum	hvíldunum
misstir	misstir
segir	segir
sjálfstraustsins	sjálfstraustsins
haft	haft
gramúlfunum	gramúlfunum
köngull	köngull
líkum	líkum
sleppir	sleppir
farsíma	farsíma
át	át
heiðurinn	heiðurinn
gjöri	gjöri
hégómamál	hégómamál
líkir	líkir
blóðboga	blóðboga
elskaði	elskaði
fylgdum	fylgdum
hryggðu	hryggðu
andast	andast
sálmur	sálmur
árósinn	árósinn
iðnum	iðnum
sálma	sálma
kristinna	kristinna
brennur	brennur
káetunum	káetunum
aftrar	aftrar
sett	sett
heimtuð	heimtuð
æxlunina	æxlunina
langað	langað
zetu	zetu
fræðimennirnir	fræðimennirnir
leyfðu	leyfðu
tónninn	tónninn
sætti	sætti
hlið	hlið
kennd	kennd
áhugi	áhugi
eiginmanninn	eiginmanninn
Slíkar	Slíkar
veskjunum	veskjunum
kökukeflis	kökukeflis
laxins	laxins
hneigði	hneigði
iðnaður	iðnaður
lakki	lakki
missir	missir
huga	huga
hreim	hreim
Hafði	Hafði
gjörði	gjörði
kallir	kallir
hluti	hluti
fjarðanna	fjarðanna
neytt	neytt
dæmdur	dæmdur
leyni	leyni
styrkjandi	styrkjandi
brekkusóleyjunum	brekkusóleyjunum
drunið	drunið
Kristi	Kristi
samkundustjórinn	samkundustjórinn
kjaltan	kjaltan
sápa	sápa
Asíu	Asíu
sjúkdóma	sjúkdóma
hirðin	hirðin
meðalið	meðalið
skildum	skildum
gæra	gæra
fórnfærði	fórnfærði
hnerri	hnerri
hjartar	hjartar
lögum	lögum
krossfara	krossfara
hvæstu	hvæstu
ærumeiðingum	ærumeiðingum
morgnanna	morgnanna
skapinu	skapinu
prúttar	prúttar
klæðin	klæðin
geðshræringu	geðshræringu
græddir	græddir
kvars	kvars
iðnað	iðnað
kylfurnar	kylfurnar
þarft	þarft
ættkvíslinni	ættkvíslinni
málir	málir
birta	birta
hneykið	hneykið
vindlunum	vindlunum
rífst	rífst
felldur	felldur
Mælir	Mælir
krossgáturnar	krossgáturnar
eigendur	eigendur
seldu	seldu
skýrðum	skýrðum
hlýddu	hlýddu
kjarnakorni	kjarnakorni
bagli	bagli
akurinn	akurinn
sum	sum
klekkti	klekkti
klæindi	klæindi
inn	inn
myrti	myrti
þægindum	þægindum
lofuðum	lofuðum
sakargiftir	sakargiftir
sífra	sífra
spjótkast	spjótkast
gráðu	gráðu
minnst	minnst
var	var
hugtaks	hugtaks
fylgdist	fylgdist
hryggdýrið	hryggdýrið
drekkja	drekkja
eðjan	eðjan
safnað	safnað
mörkunum	mörkunum
lax	lax
fagga	fagga
Fyrst	Fyrst
frystiskápar	frystiskápar
vanheilagur	vanheilagur
vínguðunum	vínguðunum
múgæsingu	múgæsingu
kristinn	kristinn
væru	væru
vísur	vísur
birtist	birtist
þekktuð	þekktuð
staðurinn	staðurinn
Inn	Inn
leikfangs	leikfangs
grunnlinn	grunnlinn
kyssti	kyssti
gervitunglinu	gervitunglinu
munu	munu
sýndu	sýndu
hittum	hittum
drottnið	drottnið
einstaklinginn	einstaklinginn
æxlanir	æxlanir
byggðum	byggðum
heilsa	heilsa
neinn	neinn
séum	séum
aftrið	aftrið
patinu	patinu
ofar	ofar
drepa	drepa
fjórðu	fjórðu
afleiðingar	afleiðingar
minnandi	minnandi
hópa	hópa
nefnast	nefnast
treystir	treystir
skermurinn	skermurinn
hefði	hefði
svik	svik
kvæntir	kvæntir
jörðuðum	jörðuðum
brennu	brennu
bygg	bygg
trúðu	trúðu
krossanna	krossanna
smalahundurinn	smalahundurinn
flett	flett
spörfuglar	spörfuglar
dæmt	dæmt
vola	vola
hugsaði	hugsaði
hópur	hópur
varir	varir
bögum	bögum
hnútinn	hnútinn
heima	heima
liði	liði
eyra	eyra
leikfangi	leikfangi
lýsið	lýsið
kinnaliti	kinnaliti
leitaði	leitaði
breyting	breyting
viðbjóðs	viðbjóðs
látið	látið
sendir	sendir
vakar	vakar
vinkonurnar	vinkonurnar
kærðu	kærðu
hreima	hreima
stær	stær
laggir	laggir
þurríssins	þurríssins
þekkt	þekkt
ýsu	ýsu
færðuð	færðuð
byggð	byggð
máttu	máttu
skírandi	skírandi
akademíanna	akademíanna
spöðum	spöðum
væruð	væruð
nokkrum	nokkrum
felld	felld
hryggt	hryggt
þrasið	þrasið
ónáðuðuð	ónáðuðuð
flokkunum	flokkunum
notið	notið
brauð	brauð
tindana	tindana
nokkrir	nokkrir
kjólföt	kjólföt
vökunum	vökunum
hjartarsaltið	hjartarsaltið
andaði	andaði
afætunum	afætunum
skíri	skíri
bumbubúa	bumbubúa
kær	kær
gagntak	gagntak
höfunum	höfunum
fyllir	fyllir
glóbrystingurinn	glóbrystingurinn
nýtti	nýtti
hellum	hellum
veski	veski
fjölgyðistrúm	fjölgyðistrúm
undirættbálkunum	undirættbálkunum
leyfanna	leyfanna
musterið	musterið
helgum	helgum
brekkusnigla	brekkusnigla
styrkið	styrkið
eru	eru
mína	mína
lýst	lýst
æðikollsins	æðikollsins
kasti	kasti
sást	sást
samtengingum	samtengingum
köstuðuð	köstuðuð
postuladómi	postuladómi
breytist	breytist
vissuð	vissuð
bismútið	bismútið
stoppunar	stoppunar
gjammar	gjammar
eldpipar	eldpipar
áhuga	áhuga
sjúg	sjúg
brytinn	brytinn
sjálfsmorðið	sjálfsmorðið
synið	synið
ríkið	ríkið
kantinn	kantinn
klæddir	klæddir
drambið	drambið
óperuhúsa	óperuhúsa
hvaða	hvaða
skini	skini
standi	standi
jörð	jörð
hraktir	hraktir
hornið	hornið
frostið	frostið
sektuðu	sektuðu
víddunum	víddunum
pyntið	pyntið
kastandi	kastandi
sósubletturinn	sósubletturinn
lastmæla	lastmæla
glatast	glatast
hrifsaðir	hrifsaðir
kalkspats	kalkspats
klæddu	klæddu
salt	salt
hefðarsætin	hefðarsætin
fjarlægir	fjarlægir
drekk	drekk
notuðuð	notuðuð
flokknum	flokknum
Krist	Krist
svertuð	svertuð
prómetín	prómetín
æðarkóngarnir	æðarkóngarnir
ytri	ytri
synda	synda
melting	melting
hálfendum	hálfendum
skipsins	skipsins
þerrir	þerrir
deyðast	deyðast
flokkarnir	flokkarnir
fæddi	fæddi
skildir	skildir
arfur	arfur
borgir	borgir
skuluð	skuluð
Komum	Komum
breiddi	breiddi
breytingar	breytingar
fórnfært	fórnfært
of	of
burtu	burtu
fletti	fletti
horfði	horfði
gróðaveg	gróðaveg
gengist	gengist
leyndum	leyndum
félagsins	félagsins
handbolta	handbolta
lifnaður	lifnaður
fenguð	fenguð
hneigið	hneigið
engin	engin
styrkt	styrkt
norður	norður
skírt	skírt
gegnum	gegnum
stóðuð	stóðuð
spil	spil
kökukefli	kökukefli
flokki	flokki
alda	alda
flokk	flokk
líkist	líkist
gjóstarnir	gjóstarnir
kinnaliturinn	kinnaliturinn
tindurinn	tindurinn
blindum	blindum
háls	háls
geisladiskurinn	geisladiskurinn
etýðunnar	etýðunnar
slúttum	slúttum
hrákann	hrákann
mala	mala
klæðandi	klæðandi
óskir	óskir
birtum	birtum
Allur	Allur
frökkum	frökkum
dagurinn	dagurinn
jakanna	jakanna
leystu	leystu
sumir	sumir
hreyfðum	hreyfðum
eðju	eðju
glas	glas
þessum	þessum
iðn	iðn
höfði	höfði
fá	fá
kalli	kalli
tárum	tárum
minntum	minntum
fjörður	fjörður
vanheilagan	vanheilagan
afklæða	afklæða
þreytst	þreytst
köntunum	köntunum
vindum	vindum
styrktuð	styrktuð
eðlum	eðlum
skottulæknirinn	skottulæknirinn
leyfði	leyfði
hvort	hvort
vonirnar	vonirnar
piparinn	piparinn
sjálfur	sjálfur
lofið	lofið
raulaði	raulaði
ályktaði	ályktaði
belti	belti
fjölmiðlasögu	fjölmiðlasögu
geymdi	geymdi
skækjur	skækjur
skilið	skilið
reyrinn	reyrinn
undur	undur
tappatogarana	tappatogarana
hæsi	hæsi
bæjasvöluna	bæjasvöluna
hlátri	hlátri
sölum	sölum
kærir	kærir
vökina	vökina
færum	færum
tökuorðin	tökuorðin
ræni	ræni
krókus	krókus
lærðuð	lærðuð
leiðast	leiðast
heilsaði	heilsaði
róður	róður
byggðir	byggðir
stjórnið	stjórnið
fryst	fryst
fórnir	fórnir
grasafræðin	grasafræðin
haf	haf
