Господнем	Господнем
входить	входить
втискиваюсь	втискиваюсь
буроватая	буроватая
агломератам	агломератам
голосистая	голосистая
могла	могла
заколите	заколите
явили	явили
предвыборному	предвыборному
льдинах	льдинах
сахариде	сахариде
какие	какие
гувернанток	гувернанток
вари	вари
восемь	восемь
сходных	сходных
набрать	набрать
смирился	смирился
умерщвляйте	умерщвляйте
изготавливаемся	изготавливаемся
известила	известила
спрашивать	спрашивать
субботним	субботним
неправ	неправ
заключите	заключите
вам	вам
квадранты	квадранты
рибонуклеиновым	рибонуклеиновым
постукивав	постукивав
вырезывающий	вырезывающий
выговоры	выговоры
братьями	братьями
митрополитах	митрополитах
никакого	никакого
рабу	рабу
неразговорчивым	неразговорчивым
пожалуй	пожалуй
Оно	Оно
созрели	созрели
Моисеевым	Моисеевым
посули	посули
самостоятельностью	самостоятельностью
перечеркнуть	перечеркнуть
язычески	язычески
возделывать	возделывать
согрешить	согрешить
окутает	окутает
уставляются	уставляются
ронина	ронина
зол	зол
натянуть	натянуть
зеленых	зеленых
напустивший	напустивший
притворился	притворился
сочинений	сочинений
избрать	избрать
искали	искали
обручу	обручу
княгине	княгине
поджигала	поджигала
тысяченачальником	тысяченачальником
нерадите	нерадите
убедит	убедит
добыче	добыче
раздавливай	раздавливай
тестируют	тестируют
предметные	предметные
привозили	привозили
телеведущего	телеведущего
Мою	Мою
удали	удали
непостоянный	непостоянный
оставлять	оставлять
признаешь	признаешь
ослабели	ослабели
причинным	причинным
храните	храните
сжимавшийся	сжимавшийся
вцепляйтесь	вцепляйтесь
осетинки	осетинки
оттай	оттай
клипа	клипа
пиши	пиши
распростерла	распростерла
присоединяюсь	присоединяюсь
актёрской	актёрской
рассеявший	рассеявший
шопингов	шопингов
чужим	чужим
исцелился	исцелился
умышляли	умышляли
послужишь	послужишь
каждая	каждая
клинкеров	клинкеров
легкие	легкие
пойнтер	пойнтер
сантиментов	сантиментов
рождайте	рождайте
варили	варили
нарушали	нарушали
худом	худом
несмысленный	несмысленный
выдавали	выдавали
минует	минует
упоминайте	упоминайте
мои	мои
питай	питай
прибивало	прибивало
рассказывали	рассказывали
разоришь	разоришь
гадолиния	гадолиния
бил	бил
податливом	податливом
служите	служите
ренегатов	ренегатов
неправды	неправды
очистить	очистить
признать	признать
продолжала	продолжала
бериллам	бериллам
спелый	спелый
отягощать	отягощать
второго	второго
жилище	жилище
змей	змей
горд	горд
малом	малом
ввязываетесь	ввязываетесь
ждите	ждите
советчика	советчика
расставляли	расставляли
сверит	сверит
водосточного	водосточного
пищевое	пищевое
молодые	молодые
мережке	мережке
вложишься	вложишься
осложняя	осложняя
спасу	спасу
переложило	переложило
делало	делало
вникающий	вникающий
прибираю	прибираю
Мигу	Мигу
сманеврировавший	сманеврировавший
Иудину	Иудину
амхарский	амхарский
ампутацией	ампутацией
бесперспективное	бесперспективное
укладах	укладах
благодарить	благодарить
избираюсь	избираюсь
учился	учился
хвалили	хвалили
провалу	провалу
обратили	обратили
проводив	проводив
Нему	Нему
помышлять	помышлять
морем	морем
агванцам	агванцам
завтрашнем	завтрашнем
отворачивал	отворачивал
свечу	свечу
благословлять	благословлять
полиций	полиций
чинили	чинили
уцелело	уцелело
забирали	забирали
избрали	избрали
превышением	превышением
встроенная	встроенная
принципиальными	принципиальными
лица	лица
инертна	инертна
зарыдал	зарыдал
завершалась	завершалась
исполнить	исполнить
местом	местом
кетчупах	кетчупах
аннексией	аннексией
уставился	уставился
оргазмам	оргазмам
доставляла	доставляла
тортами	тортами
бактериологов	бактериологов
камнях	камнях
ненадежно	ненадежно
цепной	цепной
затворит	затворит
Возьмет	Возьмет
отложили	отложили
штольне	штольне
засевайте	засевайте
возвысили	возвысили
широкоплечего	широкоплечего
проклятых	проклятых
четвертою	четвертою
каком	каком
отослали	отослали
сатаною	сатаною
почернели	почернели
полированна	полированна
вологодским	вологодским
неверен	неверен
лесоводческими	лесоводческими
открытым	открытым
вели	вели
укладам	укладам
засыпать	засыпать
зачарованный	зачарованный
всяком	всяком
слепых	слепых
погнали	погнали
послужив	послужив
делила	делила
затишья	затишья
точил	точил
воздевала	воздевала
долгого	долгого
почитают	почитают
отними	отними
взглянул	взглянул
взаимодействуй	взаимодействуй
обращённой	обращённой
покрой	покрой
было	было
опалам	опалам
поднят	поднят
противостал	противостал
углублениями	углублениями
обесчестили	обесчестили
заграждай	заграждай
соорудим	соорудим
сухощава	сухощава
слепце	слепце
подкормят	подкормят
полупустых	полупустых
Он	Он
потребило	потребило
поступи	поступи
соорудила	соорудила
великую	великую
хвалю	хвалю
пазниках	пазниках
мобильника	мобильника
заклянет	заклянет
трепетного	трепетного
завещевайте	завещевайте
милашку	милашку
земляку	земляку
другая	другая
щеглёнка	щеглёнка
укрепился	укрепился
аутсайдер	аутсайдер
округляющий	округляющий
прямыми	прямыми
нахмурилась	нахмурилась
грешков	грешков
воплю	воплю
пьющий	пьющий
выдайся	выдайся
списало	списало
низринь	низринь
ожесточи	ожесточи
возлагай	возлагай
нечестии	нечестии
маслобойке	маслобойке
портативного	портативного
впереди	впереди
кропотливым	кропотливым
враждовали	враждовали
минуло	минуло
неотложек	неотложек
Тысяча	Тысяча
возносив	возносив
ванилинов	ванилинов
умножали	умножали
повелений	повелений
зиму	зиму
он	он
устаиваясь	устаиваясь
подаяния	подаяния
мертво	мертво
провокационной	провокационной
началом	началом
известить	известить
дал	дал
томишь	томишь
всходящий	всходящий
обмундированиям	обмундированиям
правою	правою
вострепетал	вострепетал
отлаживать	отлаживать
звездой	звездой
огорчить	огорчить
спутаться	спутаться
считал	считал
благословляйте	благословляйте
полированным	полированным
нужного	нужного
взаимозависимость	взаимозависимость
осквернили	осквернили
тысяченачальники	тысяченачальники
ярлыки	ярлыки
Твои	Твои
оказала	оказала
померкли	померкли
свирели	свирели
претерпели	претерпели
отослать	отослать
автострады	автострады
консульством	консульством
антисоветском	антисоветском
чужую	чужую
соавторствам	соавторствам
стартами	стартами
рукомойников	рукомойников
царствовать	царствовать
золовки	золовки
тряся	тряся
испустит	испустит
вытрешь	вытрешь
запоминания	запоминания
крылышко	крылышко
вещи	вещи
удивятся	удивятся
сычей	сычей
откажет	откажет
закричал	закричал
вывели	вывели
соделал	соделал
выкипит	выкипит
сосчитали	сосчитали
лучинами	лучинами
перейди	перейди
воспроизводила	воспроизводила
прискорбное	прискорбное
вешали	вешали
сажали	сажали
качка	качка
ельчанина	ельчанина
сажен	сажен
вступить	вступить
бризом	бризом
засели	засели
фронтон	фронтон
призывали	призывали
диспутировала	диспутировала
светила	светила
испытанном	испытанном
вишнёвыми	вишнёвыми
перерезал	перерезал
налетели	налетели
предметное	предметное
женевском	женевском
захуярим	захуярим
имбецилам	имбецилам
расплат	расплат
вляпаются	вляпаются
начертай	начертай
алкашом	алкашом
областеначальники	областеначальники
посолите	посолите
привезли	привезли
родословных	родословных
тортам	тортам
провокационные	провокационные
отправился	отправился
вооружаюсь	вооружаюсь
второю	второю
хребтах	хребтах
косилась	косилась
щупы	щупы
присоединяемся	присоединяемся
оползнями	оползнями
террористической	террористической
поспала	поспала
универсам	универсам
выдернете	выдернете
запекались	запекались
белых	белых
избранной	избранной
терминах	терминах
прямые	прямые
пила	пила
сдачи	сдачи
передовыми	передовыми
повисла	повисла
захоронения	захоронения
разорят	разорят
совершусь	совершусь
превозносящий	превозносящий
могу	могу
Моя	Моя
дёргав	дёргав
Дину	Дину
политруки	политруки
изготавливаются	изготавливаются
исполняйте	исполняйте
целом	целом
святого	святого
хрюкавший	хрюкавший
призывать	призывать
доли	доли
лучниц	лучниц
огорчили	огорчили
выи	выи
вопрошающий	вопрошающий
падишахом	падишахом
падите	падите
мифологию	мифологию
снисходительная	снисходительная
стесняющий	стесняющий
сравнить	сравнить
накал	накал
ассоциации	ассоциации
святую	святую
миновать	миновать
Царя	Царя
потаённой	потаённой
семи	семи
иррациональная	иррациональная
животному	животному
нем	нем
печатка	печатка
шапка	шапка
сторожах	сторожах
фронтонами	фронтонами
сказала	сказала
любила	любила
различают	различают
Своем	Своем
маслобойки	маслобойки
сфинксам	сфинксам
собрали	собрали
предали	предали
пересказывать	пересказывать
одолела	одолела
живая	живая
трактаты	трактаты
павильонам	павильонам
дез	дез
священнодействовали	священнодействовали
открыт	открыт
веришь	веришь
лучшей	лучшей
мурлычьте	мурлычьте
возливали	возливали
сладкое	сладкое
возносят	возносят
поражались	поражались
снотворным	снотворным
берет	берет
толкнулось	толкнулось
самокруткой	самокруткой
ввели	ввели
дирижёре	дирижёре
совместны	совместны
смели	смели
панической	панической
лиственной	лиственной
принят	принят
всходили	всходили
сведущего	сведущего
Свою	Свою
жалкий	жалкий
подгруппам	подгруппам
прославили	прославили
щадил	щадил
растаяло	растаяло
нужный	нужный
бритым	бритым
утихнете	утихнете
долгоносике	долгоносике
торжествуй	торжествуй
приклонить	приклонить
шопингами	шопингами
закладываться	закладываться
антикварках	антикварках
проберет	проберет
отсрочивать	отсрочивать
беззащитных	беззащитных
аппаратного	аппаратного
перекаливало	перекаливало
сморкая	сморкая
запоминаюсь	запоминаюсь
ценят	ценят
пристраивав	пристраивав
наполнили	наполнили
Хвали	Хвали
вколов	вколов
промышленностях	промышленностях
четверенькам	четверенькам
уразумели	уразумели
окинуть	окинуть
перекаливать	перекаливать
говорить	говорить
умещаться	умещаться
сомнительном	сомнительном
прямою	прямою
большою	большою
телеведущим	телеведущим
фабрикую	фабрикую
скапливала	скапливала
поселился	поселился
удила	удила
прискорбная	прискорбная
благую	благую
обличились	обличились
одаряешь	одаряешь
замкнутом	замкнутом
отнесла	отнесла
создали	создали
возливать	возливать
грохочущий	грохочущий
хотим	хотим
преодолениями	преодолениями
мотыжу	мотыжу
развеянный	развеянный
апокалипсису	апокалипсису
выпучите	выпучите
изливай	изливай
вылитая	вылитая
смущали	смущали
права	права
образом	образом
пострадать	пострадать
соединить	соединить
Явился	Явился
утерпеть	утерпеть
возвестила	возвестила
ограничениям	ограничениям
калач	калач
различала	различала
сестрою	сестрою
мокрую	мокрую
сытую	сытую
одушевленное	одушевленное
длинно	длинно
заколения	заколения
двоедушным	двоедушным
сокрытый	сокрытый
произнесли	произнесли
учили	учили
целенаправленной	целенаправленной
заклятым	заклятым
сами	сами
вишнёвого	вишнёвого
налагали	налагали
слышали	слышали
заключительный	заключительный
брить	брить
прилагай	прилагай
нахмурьтесь	нахмурьтесь
эпидемиологических	эпидемиологических
снисходить	снисходить
пожирала	пожирала
сведущие	сведущие
лоботрясах	лоботрясах
червонцы	червонцы
летали	летали
выдам	выдам
оболочка	оболочка
расслаблю	расслаблю
награбили	награбили
матерь	матерь
смутить	смутить
пайком	пайком
посттравматическое	посттравматическое
согрешив	согрешив
гей-парада	гей-парада
оборвавшись	оборвавшись
который	который
напечатавший	напечатавший
надавливая	надавливая
условливается	условливается
сожигания	сожигания
обитали	обитали
любите	любите
устроила	устроила
смири	смири
выдай	выдай
Пи	Пи
проклят	проклят
передовых	передовых
приземлишься	приземлишься
Святых	Святых
кормили	кормили
приветствуйте	приветствуйте
звёзды	звёзды
качеством	качеством
труби	труби
выводят	выводят
аншлюсах	аншлюсах
перебрался	перебрался
целаканту	целаканту
увенчиваешь	увенчиваешь
приветствующий	приветствующий
абакумыче	абакумыче
искажай	искажай
признает	признает
известили	известили
разговорчивого	разговорчивого
манны	манны
воссиять	воссиять
занято	занято
расслабишь	расслабишь
расположили	расположили
рентабельному	рентабельному
Мал	Мал
эмигрантский	эмигрантский
легкомыслие	легкомыслие
пьем	пьем
благи	благи
бронепоездом	бронепоездом
подступившийся	подступившийся
подстерегать	подстерегать
неправы	неправы
кетчупы	кетчупы
появлением	появлением
следующем	следующем
хвали	хвали
главу	главу
община	община
раздражали	раздражали
необходимой	необходимой
оврагом	оврагом
высосать	высосать
обмундированиями	обмундированиями
две	две
женщиною	женщиною
почерпнула	почерпнула
стекается	стекается
богатейшим	богатейшим
данников	данников
свесите	свесите
зипуны	зипуны
волнолом	волнолом
горек	горек
мазурок	мазурок
бубновая	бубновая
собранное	собранное
австрийца	австрийца
эпитафии	эпитафии
Самого	Самого
разбросайте	разбросайте
убеждённый	убеждённый
абстрактностям	абстрактностям
повторите	повторите
подкормит	подкормит
выкаливаете	выкаливаете
половине	половине
обе	обе
трава	трава
отыщите	отыщите
домбры	домбры
приклонили	приклонили
чужих	чужих
потонули	потонули
разворачивавшись	разворачивавшись
булавки	булавки
ввела	ввела
напоены	напоены
заграждали	заграждали
уя	уя
беззаконием	беззаконием
потение	потение
австралиек	австралиек
пустыне	пустыне
бедное	бедное
ваша	ваша
увещевай	увещевай
подступаться	подступаться
ласковым	ласковым
изменили	изменили
говорящих	говорящих
забыли	забыли
красные	красные
колбочку	колбочку
согрешу	согрешу
ферм	ферм
перечеркнула	перечеркнула
твоя	твоя
контролируются	контролируются
возненавидела	возненавидела
сторожем	сторожем
ними	ними
мертвые	мертвые
превозносит	превозносит
выкопай	выкопай
гармонике	гармонике
склоняют	склоняют
ортодоксальным	ортодоксальным
непродолжительную	непродолжительную
удивилась	удивилась
надо	надо
сортами	сортами
хребтами	хребтами
прихлёбнутый	прихлёбнутый
сёстрами	сёстрами
водовозным	водовозным
устных	устных
будут	будут
преследуйте	преследуйте
выломать	выломать
булавок	булавок
имущество	имущество
никакой	никакой
поручение	поручение
окрошке	окрошке
передумывав	передумывав
бесславием	бесславием
назидается	назидается
приноси	приноси
устанавливаешься	устанавливаешься
увязываетесь	увязываетесь
толкнувшийся	толкнувшийся
верноподданного	верноподданного
девушки	девушки
большую	большую
сделать	сделать
споры	споры
приступили	приступили
склонили	склонили
оттаивайте	оттаивайте
внутри	внутри
блузка	блузка
кидай	кидай
снабжали	снабжали
разделили	разделили
вколете	вколете
предстал	предстал
никакою	никакою
утапливаем	утапливаем
жилой	жилой
гражданско-правовых	гражданско-правовых
раздолье	раздолье
прельстить	прельстить
затыкает	затыкает
приходите	приходите
выпала	выпала
сонарам	сонарам
надеть	надеть
расистам	расистам
золотою	золотою
посерьезнеешь	посерьезнеешь
целаканта	целаканта
песнопениями	песнопениями
стену	стену
омыли	омыли
огибает	огибает
вспылив	вспылив
животными	животными
отлучить	отлучить
дивившись	дивившись
нарекли	нарекли
закрою	закрою
исправленные	исправленные
запекавшийся	запекавшийся
сидели	сидели
сухую	сухую
пчеле	пчеле
мудоёбе	мудоёбе
выкупить	выкупить
амбициозное	амбициозное
узнает	узнает
легкое	легкое
посох	посох
изгнали	изгнали
теннисные	теннисные
нечистоту	нечистоту
презирали	презирали
образую	образую
разных	разных
лежачего	лежачего
лишить	лишить
носить	носить
переставили	переставили
мысли	мысли
страшное	страшное
прости	прости
духовной	духовной
Самая	Самая
получила	получила
обставливает	обставливает
судить	судить
отыгрывающий	отыгрывающий
карфагенянам	карфагенянам
десяти	десяти
предвыборная	предвыборная
неподкупным	неподкупным
да	да
антигельминтное	антигельминтное
зимой	зимой
язве	язве
сожигать	сожигать
скрытом	скрытом
обваляем	обваляем
дети	дети
гитлеровское	гитлеровское
княгинь	княгинь
восклицать	восклицать
корму	корму
заключен	заключен
выбежали	выбежали
видимою	видимою
неверного	неверного
обновитесь	обновитесь
имейле	имейле
припал	припал
Мне	Мне
прилагайте	прилагайте
заглавия	заглавия
нечистоте	нечистоте
дачное	дачное
развратился	развратился
погромщиц	погромщиц
Божием	Божием
изволила	изволила
ободрился	ободрился
свиста	свиста
приехал	приехал
последовать	последовать
странствуйте	странствуйте
управлять	управлять
принято	принято
Хвалите	Хвалите
лесомелиоративной	лесомелиоративной
брюхе	брюхе
кончен	кончен
засевай	засевай
попойках	попойках
пинать	пинать
кидару	кидару
котором	котором
задержках	задержках
лгите	лгите
грешите	грешите
либраций	либраций
современность	современность
пловцы	пловцы
созреют	созреют
твердых	твердых
бросившийся	бросившийся
платите	платите
какого	какого
стояла	стояла
готское	готское
распознать	распознать
превратился	превратился
обратила	обратила
колонию	колонию
ненавидели	ненавидели
последуй	последуй
приземлилась	приземлилась
животные	животные
морозное	морозное
отверженный	отверженный
ладят	ладят
привозить	привозить
отлаживая	отлаживая
положила	положила
бакинцами	бакинцами
почните	почните
тысяченачальника	тысяченачальника
непредвиденном	непредвиденном
Сия	Сия
созывало	созывало
легкомыслии	легкомыслии
ненавидела	ненавидела
расположи	расположи
брюхоногого	брюхоногого
возвратился	возвратился
щёлкаю	щёлкаю
одною	одною
использовывающий	использовывающий
озадаченной	озадаченной
воронов	воронов
диод	диод
упросить	упросить
сверкающей	сверкающей
предназначением	предназначением
сверкающим	сверкающим
подпускав	подпускав
огорчился	огорчился
отвесного	отвесного
управляли	управляли
микрорайоны	микрорайоны
беззащитным	беззащитным
послужить	послужить
простирать	простирать
напоминай	напоминай
сказали	сказали
обосретесь	обосретесь
вылезаю	вылезаю
блудодействуя	блудодействуя
оплакивали	оплакивали
аромунку	аромунку
перлах	перлах
сама	сама
задумываем	задумываем
первые	первые
нагой	нагой
выводящий	выводящий
сторож	сторож
мины-ловушки	мины-ловушки
над	над
кочкарями	кочкарями
травы	травы
клячи	клячи
лесистости	лесистости
упырями	упырями
утешился	утешился
упали	упали
спрятали	спрятали
пило	пило
принужден	принужден
сии	сии
научился	научился
посыпкам	посыпкам
бемолю	бемолю
имеет	имеет
влепляющий	влепляющий
рассеять	рассеять
грохотала	грохотала
гидравлические	гидравлические
развязала	развязала
правильным	правильным
ритмическая	ритмическая
блейзерами	блейзерами
падишаха	падишаха
превозносим	превозносим
пленным	пленным
принимай	принимай
перестал	перестал
преуспевали	преуспевали
своди	своди
организаторов	организаторов
амстердамцы	амстердамцы
миновали	миновали
жалобе	жалобе
убедила	убедила
нечист	нечист
грязей	грязей
потонуло	потонуло
Тысячу	Тысячу
твердым	твердым
камни	камни
чтокаешь	чтокаешь
потерянною	потерянною
композиционные	композиционные
сексуальным	сексуальным
заковывая	заковывая
принимать	принимать
никакое	никакое
референдум	референдум
мальчишка	мальчишка
возьмем	возьмем
сжимали	сжимали
поднять	поднять
изнеженных	изнеженных
смешанное	смешанное
мне	мне
вомбаты	вомбаты
лесопарк	лесопарк
борщам	борщам
божествах	божествах
явками	явками
энтузиазмам	энтузиазмам
чья	чья
выгнать	выгнать
автоматизирована	автоматизирована
аккомпанементах	аккомпанементах
шерстяная	шерстяная
горькая	горькая
потаённом	потаённом
пианистками	пианистками
помилуйте	помилуйте
надевай	надевай
обыгрывающий	обыгрывающий
могут	могут
условии	условии
яловце	яловце
пола	пола
умницей	умницей
саранчи	саранчи
губит	губит
спросили	спросили
хранить	хранить
кирковое	кирковое
дома	дома
немалому	немалому
изумили	изумили
преклонили	преклонили
региональную	региональную
вопрошали	вопрошали
целенаправленны	целенаправленны
слушали	слушали
рифмой	рифмой
свесило	свесило
поверьтесь	поверьтесь
тяжестями	тяжестями
тихвинскому	тихвинскому
всходим	всходим
вытянетесь	вытянетесь
сверкающий	сверкающий
круиз	круиз
пистолете-пулемёте	пистолете-пулемёте
исследовал	исследовал
вытянувшийся	вытянувшийся
жалкая	жалкая
они	они
немноги	немноги
упоминавший	упоминавший
предавать	предавать
постыдить	постыдить
пробыла	пробыла
готским	готским
страдающий	страдающий
бюрократизмами	бюрократизмами
парадокса	парадокса
матерями	матерями
тысяче	тысяче
распростерли	распростерли
злого	злого
колпакам	колпакам
чье	чье
запри	запри
прибыл	прибыл
подумывай	подумывай
наслышусь	наслышусь
разделился	разделился
зарянке	зарянке
показать	показать
эгоисту	эгоисту
наружность	наружность
обещал	обещал
полупустое	полупустое
выливайте	выливайте
нездоровой	нездоровой
португальцы	португальцы
раскрытой	раскрытой
которою	которою
топтали	топтали
наполни	наполни
захлёстываниям	захлёстываниям
мочу	мочу
быть	быть
дедское	дедское
овцою	овцою
табуреток	табуреток
просите	просите
скверных	скверных
рехнись	рехнись
прославился	прославился
разгружай	разгружай
вытрите	вытрите
Жертва	Жертва
исполни	исполни
сверить	сверить
египтологах	египтологах
правовой	правовой
простерла	простерла
сироты	сироты
озеленениям	озеленениям
венике	венике
норной	норной
всякого	всякого
отказывал	отказывал
открывай	открывай
дала	дала
телефонен	телефонен
благом	благом
ветвям	ветвям
белом	белом
страдали	страдали
тихвинским	тихвинским
замышляли	замышляли
репортажей	репортажей
удовлетворилась	удовлетворилась
рукопашные	рукопашные
презент	презент
повстречать	повстречать
бесстрастным	бесстрастным
обладать	обладать
данник	данник
левша	левша
укрепите	укрепите
неправые	неправые
женьшень	женьшень
кабестанам	кабестанам
скатившийся	скатившийся
льдины	льдины
засохло	засохло
подслушиваниях	подслушиваниях
обвисал	обвисал
землетрясением	землетрясением
рубя	рубя
уронить	уронить
благе	благе
тьме	тьме
выполняла	выполняла
возросли	возросли
разносите	разносите
умножьте	умножьте
возвещу	возвещу
повысивший	повысивший
расовой	расовой
монумента	монумента
взмою	взмою
трущобы	трущобы
огорчен	огорчен
возроптали	возроптали
килобайту	килобайту
подбрасывают	подбрасывают
лотерей	лотерей
излишком	излишком
воздали	воздали
обозрели	обозрели
взирать	взирать
самого	самого
подгруппа	подгруппа
ищи	ищи
неверных	неверных
всесожжении	всесожжении
спросим	спросим
ходили	ходили
составляли	составляли
Кис	Кис
царит	царит
унизьтесь	унизьтесь
окружить	окружить
главного	главного
благотворительностям	благотворительностям
примечательного	примечательного
скройтесь	скройтесь
некрасивый	некрасивый
Сделали	Сделали
поднято	поднято
встали	встали
гумна	гумна
бактериолога	бактериолога
возвестим	возвестим
грешке	грешке
засчитывать	засчитывать
садили	садили
четвёртым	четвёртым
портимый	портимый
написанных	написанных
подходить	подходить
превозносите	превозносите
компетентного	компетентного
посулила	посулила
наступив	наступив
труса	труса
мгновенном	мгновенном
Самом	Самом
попкорнов	попкорнов
говори	говори
соделай	соделай
стояли	стояли
каплют	каплют
червяка	червяка
целого	целого
самаркандские	самаркандские
колесу	колесу
стеллажу	стеллажу
приняло	приняло
сестёр	сестёр
наполняй	наполняй
оборотился	оборотился
говорите	говорите
избили	избили
сиборгии	сиборгии
яствах	яствах
наезды	наезды
заразы	заразы
возьмет	возьмет
чьи	чьи
дворового	дворового
новых	новых
чад	чад
обыгрывает	обыгрывает
произносить	произносить
растят	растят
пребыл	пребыл
заразою	заразою
внимать	внимать
изнемогший	изнемогший
познайте	познайте
хулив	хулив
адепты	адепты
честностях	честностях
омрачали	омрачали
отрыгиваю	отрыгиваю
перевалил	перевалил
Как	Как
Цари	Цари
поправьте	поправьте
аминокислоту	аминокислоту
автомашины	автомашины
благодарили	благодарили
погромщицу	погромщицу
журчало	журчало
нами	нами
констебли	констебли
парижан	парижан
невиданны	невиданны
саранче	саранче
рождали	рождали
гневи	гневи
разные	разные
хвалите	хвалите
хрюкая	хрюкая
почётна	почётна
комплектация	комплектация
искушайте	искушайте
буду	буду
завистливому	завистливому
неровностью	неровностью
когереру	когереру
лепок	лепок
влепляет	влепляет
честолюбивые	честолюбивые
Стань	Стань
омывали	омывали
приведи	приведи
наказы	наказы
кенотафе	кенотафе
поговорить	поговорить
бесчести	бесчести
немо	немо
сослуживцы	сослуживцы
рубленный	рубленный
кричали	кричали
малых	малых
запрятывай	запрятывай
запрет	запрет
самой	самой
стервятников	стервятников
убедительность	убедительность
рубрика	рубрика
упоминало	упоминало
чиновнице	чиновнице
прикипав	прикипав
системного	системного
исландце	исландце
неверия	неверия
тюленёнка	тюленёнка
вешать	вешать
злом	злом
фабрикуете	фабрикуете
Будет	Будет
увели	увели
кульминациями	кульминациями
расплющивающий	расплющивающий
сумкообразном	сумкообразном
мельтешнях	мельтешнях
простирала	простирала
пудреном	пудреном
наклонили	наклонили
дай	дай
лесопарка	лесопарка
искушали	искушали
трусы	трусы
решающей	решающей
патоген	патоген
срачей	срачей
областеначальникам	областеначальникам
образцов	образцов
аквамарине	аквамарине
перейдем	перейдем
взяла	взяла
встретили	встретили
неровности	неровности
сферы	сферы
увязывается	увязывается
наг	наг
выносив	выносив
взмокают	взмокают
тюбетейкам	тюбетейкам
прорубили	прорубили
шурупов	шурупов
гнались	гнались
прибыла	прибыла
подражали	подражали
вызывали	вызывали
разрывают	разрывают
раздавали	раздавали
выдерните	выдерните
имевшая	имевшая
израильтянках	израильтянках
избранных	избранных
любованиями	любованиями
киской	киской
проломали	проломали
привезла	привезла
застирывай	застирывай
нечистые	нечистые
отплыли	отплыли
ценить	ценить
отрезал	отрезал
нетронутой	нетронутой
эгоистах	эгоистах
австрийским	австрийским
выступите	выступите
Лилия	Лилия
узнали	узнали
претворяло	претворяло
соделает	соделает
помышляли	помышляли
поселить	поселить
Дине	Дине
блуждали	блуждали
составить	составить
Какое	Какое
покрывал	покрывал
нехороши	нехороши
возлагали	возлагали
почало	почало
отдели	отдели
наливала	наливала
половцев	половцев
партий	партий
приспособятся	приспособятся
погребали	погребали
непоседу	непоседу
влекла	влекла
научите	научите
надевать	надевать
заключить	заключить
схоронить	схоронить
возмутить	возмутить
принята	принята
сказуемым	сказуемым
скоростного	скоростного
абиотрофия	абиотрофия
темень	темень
грабам	грабам
тайна	тайна
возвестили	возвестили
томила	томила
прочитать	прочитать
расплату	расплату
читать	читать
посинения	посинения
резвятся	резвятся
лилового	лилового
избавив	избавив
обрати	обрати
жало	жало
расслабив	расслабив
Свой	Свой
звёзд	звёзд
храни	храни
закрыли	закрыли
целуются	целуются
тысячах	тысячах
сжимаешься	сжимаешься
самое	самое
призовое	призовое
бухлу	бухлу
сопернике	сопернике
принуждали	принуждали
следовали	следовали
убедишь	убедишь
целовать	целовать
налавливали	налавливали
пройду	пройду
ехидны	ехидны
говорила	говорила
избавлять	избавлять
латинизация	латинизация
изумился	изумился
каждою	каждою
обитаем	обитаем
шестом	шестом
синагоги	синагоги
покрыла	покрыла
кадите	кадите
пустоши	пустоши
сожигает	сожигает
пассажира	пассажира
нагорным	нагорным
духовного	духовного
аромунок	аромунок
сокруши	сокруши
аутисту	аутисту
заклёпке	заклёпке
соевых	соевых
перебрасываешь	перебрасываешь
брезентах	брезентах
долгих	долгих
страшные	страшные
переключаемся	переключаемся
допевайте	допевайте
затрепетал	затрепетал
аккомпанементам	аккомпанементам
малое	малое
налагать	налагать
угробьте	угробьте
вело	вело
литых	литых
алхимику	алхимику
необрезанный	необрезанный
избавить	избавить
литым	литым
внутреннему	внутреннему
носильщику	носильщику
отстать	отстать
освободить	освободить
бросали	бросали
злосчастного	злосчастного
золотом	золотом
поднимите	поднимите
подняла	подняла
отрекитесь	отрекитесь
зарянки	зарянки
овце	овце
двусмысленность	двусмысленность
ездя	ездя
рыбачьей	рыбачьей
низринут	низринут
уи	уи
написала	написала
царями	царями
песнопение	песнопение
завозне	завозне
филолога	филолога
злоумышленный	злоумышленный
мотыжить	мотыжить
оттаешь	оттаешь
просек	просек
открытом	открытом
теми	теми
шаткий	шаткий
тверда	тверда
неподдельного	неподдельного
примиряемся	примиряемся
кроило	кроило
плеснуть	плеснуть
осматривать	осматривать
клиперами	клиперами
взывавший	взывавший
экспертизу	экспертизу
предсмертна	предсмертна
четвертой	четвертой
кадили	кадили
сидеть	сидеть
унывали	унывали
считаете	считаете
которое	которое
язвой	язвой
заклянете	заклянете
магазинчик	магазинчик
порист	порист
грамотности	грамотности
приглаживая	приглаживая
благотворить	благотворить
похвалился	похвалился
манною	манною
растянула	растянула
контролировавшийся	контролировавшийся
воспоминать	воспоминать
мещанках	мещанках
Дина	Дина
страшилищем	страшилищем
угодной	угодной
поядал	поядал
томился	томился
лекарях	лекарях
распрямляют	распрямляют
убедительностями	убедительностями
немалую	немалую
се	се
приукрашивающий	приукрашивающий
железобетонный	железобетонный
распространённое	распространённое
нечиста	нечиста
орудии	орудии
потением	потением
подходящий	подходящий
устроили	устроили
исследуйте	исследуйте
одаряйте	одаряйте
плётки	плётки
торопливой	торопливой
пожелал	пожелал
латинянину	латинянину
мою	мою
язв	язв
взаимностях	взаимностях
ожидальне	ожидальне
слушала	слушала
старое	старое
глядела	глядела
потерпела	потерпела
спускам	спускам
полагай	полагай
добычу	добычу
коллекционировала	коллекционировала
сердив	сердив
выстрелили	выстрелили
унизился	унизился
взяло	взяло
дубинок	дубинок
накалы	накалы
гарантировал	гарантировал
проезжая	проезжая
раскусывай	раскусывай
разуметь	разуметь
прикасайся	прикасайся
удерживай	удерживай
пленный	пленный
отошли	отошли
благословляй	благословляй
язях	язях
оказать	оказать
всходите	всходите
уговаривать	уговаривать
превозносимый	превозносимый
свернулись	свернулись
соблюди	соблюди
стенали	стенали
пел	пел
создать	создать
заразили	заразили
аутиста	аутиста
факелках	факелках
тугрики	тугрики
полюбовавшийся	полюбовавшийся
пьянствовавший	пьянствовавший
пожирать	пожирать
обнажи	обнажи
отряхивались	отряхивались
утвердился	утвердился
вепсского	вепсского
драматургам	драматургам
кормила	кормила
потускло	потускло
успокоили	успокоили
коварства	коварства
зуммера	зуммера
напрягайтесь	напрягайтесь
разговорчивое	разговорчивое
протяни	протяни
неуёмные	неуёмные
окружите	окружите
сербской	сербской
окинь	окинь
подвесным	подвесным
мстили	мстили
ратифицируете	ратифицируете
опорным	опорным
каучуковой	каучуковой
компаньонов	компаньонов
мой	мой
спросила	спросила
одетого	одетого
выведите	выведите
чужого	чужого
отворачивающий	отворачивающий
левши	левши
поспособствуете	поспособствуете
закрой	закрой
вэньянь	вэньянь
шубе	шубе
главврачу	главврачу
старому	старому
заклят	заклят
заинтересованность	заинтересованность
губить	губить
диоды	диоды
хлопотливых	хлопотливых
поверившийся	поверившийся
заковывай	заковывай
вымыли	вымыли
глухою	глухою
поешь	поешь
вывожу	вывожу
разрушили	разрушили
едком	едком
безволосой	безволосой
управляющий	управляющий
налавливая	налавливая
заключили	заключили
сел	сел
собою	собою
сторожу	сторожу
убеди	убеди
вероятным	вероятным
провожу	провожу
постиг	постиг
убогого	убогого
громады	громады
превозносили	превозносили
заколают	заколают
возьмете	возьмете
томить	томить
повесившийся	повесившийся
амбициозными	амбициозными
сожигают	сожигают
лексиконе	лексиконе
пораженцам	пораженцам
благообразная	благообразная
променять	променять
ножиками	ножиками
идентичным	идентичным
астраханском	астраханском
увещевали	увещевали
добрейшим	добрейшим
домбре	домбре
встревожили	встревожили
предкрылку	предкрылку
полированную	полированную
пистолеты-пулемёты	пистолеты-пулемёты
противодействующую	противодействующую
язвою	язвою
сели	сели
крахмальные	крахмальные
пасхе	пасхе
копить	копить
головы	головы
уповать	уповать
другою	другою
забормочете	забормочете
искала	искала
произвела	произвела
бойлеру	бойлеру
храмы	храмы
дровокольного	дровокольного
начала	начала
тяготили	тяготили
подтащит	подтащит
репортажу	репортажу
герце	герце
сию	сию
краткостью	краткостью
отвели	отвели
микрорайоне	микрорайоне
тьма	тьма
асимметричные	асимметричные
соблюли	соблюли
думать	думать
принесла	принесла
веской	веской
рыбачье	рыбачье
аквамаринам	аквамаринам
уничижали	уничижали
начинай	начинай
несмысленным	несмысленным
рассекли	рассекли
делавшийся	делавшийся
вспоминать	вспоминать
щадите	щадите
грабах	грабах
которая	которая
смутили	смутили
оказывайте	оказывайте
чужое	чужое
подснежником	подснежником
заколют	заколют
грызе	грызе
смущен	смущен
попечителями	попечителями
терафима	терафима
сироту	сироту
заковываю	заковываю
рубить	рубить
Будут	Будут
укрощавший	укрощавший
влекло	влекло
звёздами	звёздами
апокалипсисов	апокалипсисов
задержкам	задержкам
вознегодовали	вознегодовали
мобильники	мобильники
радикальных	радикальных
честолюбив	честолюбив
вещичку	вещичку
выполняйте	выполняйте
крымскотатарскому	крымскотатарскому
батуты	батуты
мальчишке	мальчишке
поспособствует	поспособствует
выдаться	выдаться
ослабеешь	ослабеешь
пресечете	пресечете
спроси	спроси
родословными	родословными
захлестнуло	захлестнуло
агломераты	агломераты
видите	видите
собраньях	собраньях
родинах	родинах
разбит	разбит
любование	любование
пристало	пристало
кидар	кидар
давир	давир
зазвонила	зазвонила
избавился	избавился
засвечивайся	засвечивайся
приложилась	приложилась
скопца	скопца
истовое	истовое
винное	винное
судебной	судебной
романское	романское
брали	брали
проклятого	проклятого
ядро	ядро
желай	желай
скрытое	скрытое
отложите	отложите
сербскохорватские	сербскохорватские
каждых	каждых
всходила	всходила
уподобился	уподобился
стоим	стоим
бедны	бедны
оборвемся	оборвемся
вспыхивал	вспыхивал
ненаказанным	ненаказанным
известивший	известивший
красный	красный
Это	Это
воскликнули	воскликнули
отключает	отключает
воспрепятствовали	воспрепятствовали
садите	садите
повесился	повесился
зенитчику	зенитчику
нижегородским	нижегородским
возвратите	возвратите
принадлежащую	принадлежащую
водиться	водиться
составился	составился
низина	низина
приношением	приношением
прочитай	прочитай
алхимиками	алхимиками
вводите	вводите
считай	считай
пьяных	пьяных
раздробляете	раздробляете
укрепить	укрепить
причёсанный	причёсанный
повстречавший	повстречавший
округляешь	округляешь
утихло	утихло
прокаженным	прокаженным
скрепить	скрепить
вырабатываемый	вырабатываемый
разбудить	разбудить
напоен	напоен
ветвях	ветвях
вредителем	вредителем
ельчан	ельчан
почитаете	почитаете
обысками	обысками
пустошам	пустошам
блузкам	блузкам
вьюгах	вьюгах
темных	темных
Пила	Пила
Матери	Матери
фурункул	фурункул
перенаселениях	перенаселениях
давить	давить
два	два
ослабеете	ослабеете
продолжай	продолжай
правосудии	правосудии
аборигенке	аборигенке
обещать	обещать
люби	люби
пустыни	пустыни
долгие	долгие
невежд	невежд
сканером	сканером
брякала	брякала
постройках	постройках
села	села
приверженности	приверженности
приносили	приносили
немых	немых
простирает	простирает
юлит	юлит
зла	зла
безоговорочна	безоговорочна
приписывают	приписывают
излишки	излишки
отрапортуй	отрапортуй
дохну	дохну
разорит	разорит
лепками	лепками
отринув	отринув
веснушкой	веснушкой
фотопулемёт	фотопулемёт
выстоите	выстоите
выпали	выпали
прострочил	прострочил
вылезать	вылезать
зло	зло
мочило	мочило
старинны	старинны
набрала	набрала
тырьте	тырьте
юркнуть	юркнуть
желать	желать
правосудием	правосудием
наполните	наполните
передались	передались
гребне	гребне
познает	познает
бункер	бункер
сочетают	сочетают
тоталитарной	тоталитарной
автомашинам	автомашинам
лишен	лишен
поверенному	поверенному
издевающийся	издевающийся
пражский	пражский
неутешительную	неутешительную
двусмысленностью	двусмысленностью
нашли	нашли
мертвою	мертвою
зафиксируете	зафиксируете
выгребет	выгребет
умышлять	умышлять
назвали	назвали
камзоле	камзоле
лицу	лицу
изделии	изделии
диалектического	диалектического
выслушали	выслушали
убийца	убийца
вымерла	вымерла
благо	благо
спаси	спаси
зерновой	зерновой
хазарах	хазарах
поцелую	поцелую
обстреливали	обстреливали
узнаем	узнаем
зачерпнуть	зачерпнуть
простираешь	простираешь
хваля	хваля
даровала	даровала
бесчестили	бесчестили
напоили	напоили
обговаривав	обговаривав
ширишь	ширишь
награбило	награбило
подумывают	подумывают
киске	киске
налагай	налагай
принятые	принятые
разбросали	разбросали
вомбатах	вомбатах
тверды	тверды
саранчу	саранчу
полюдья	полюдья
парусами	парусами
посыпкой	посыпкой
теменами	теменами
застенком	застенком
одетый	одетый
бегу	бегу
комментаторе	комментаторе
конной	конной
ткнись	ткнись
удивлением	удивлением
языческую	языческую
отяготило	отяготило
Возлюбленном	Возлюбленном
хрипело	хрипело
другого	другого
наполняйте	наполняйте
бурого	бурого
померкнув	померкнув
любимы	любимы
требуйте	требуйте
животным	животным
твердое	твердое
искомой	искомой
разведку	разведку
потакав	потакав
написать	написать
оповещаю	оповещаю
обратился	обратился
встречных	встречных
Будь	Будь
сожги	сожги
ангельского	ангельского
искушать	искушать
обрывают	обрывают
попускал	попускал
ходи	ходи
намерены	намерены
ванилином	ванилином
протоне	протоне
холь	холь
заняты	заняты
отнята	отнята
называйте	называйте
спросивший	спросивший
всемогущее	всемогущее
холостяка	холостяка
избранным	избранным
ножонкам	ножонкам
сагитируете	сагитируете
вступили	вступили
сохраняйте	сохраняйте
тайною	тайною
налагала	налагала
брякало	брякало
шапки	шапки
уду	уду
ампутации	ампутации
вышли	вышли
проезжал	проезжал
своем	своем
неверным	неверным
торжествуйте	торжествуйте
ласкового	ласкового
алкогольное	алкогольное
сверкали	сверкали
захотели	захотели
разит	разит
выберем	выберем
анкх	анкх
священнодействовать	священнодействовать
греческие	греческие
голов	голов
содержите	содержите
слог	слог
воспойте	воспойте
ненаказанно	ненаказанно
выпало	выпало
ожил	ожил
поёт	поёт
томлению	томлению
передумываемый	передумываемый
хранивший	хранивший
изменениях	изменениях
продемонстрировавшись	продемонстрировавшись
питали	питали
одарённости	одарённости
посерьёзнели	посерьёзнели
посчитай	посчитай
тойтерьер	тойтерьер
парламентское	парламентское
стекаются	стекаются
рукопашных	рукопашных
слезу	слезу
разбогател	разбогател
ловкостях	ловкостях
кабестан	кабестан
мадер	мадер
Трое	Трое
растивший	растивший
родить	родить
избранного	избранного
неординарен	неординарен
отрезать	отрезать
дорожащий	дорожащий
возвещённый	возвещённый
чтили	чтили
автотомией	автотомией
возненавидели	возненавидели
скупают	скупают
нажучу	нажучу
колечкам	колечкам
тайны	тайны
сексуальной	сексуальной
изменишь	изменишь
вспоминали	вспоминали
святая	святая
родословное	родословное
овладели	овладели
полочку	полочку
подходите	подходите
Нем	Нем
ничтожества	ничтожества
Божию	Божию
уговаривали	уговаривали
побратиму	побратиму
всякую	всякую
жилищу	жилищу
предкрылке	предкрылке
превышает	превышает
греческой	греческой
оставили	оставили
волноломам	волноломам
новой	новой
роптали	роптали
отрезали	отрезали
обогатить	обогатить
высох	высох
подвигли	подвигли
направился	направился
избирались	избирались
жертвам	жертвам
виден	виден
публикуем	публикуем
оплодотворявший	оплодотворявший
ножики	ножики
девяноста	девяноста
оптимистических	оптимистических
гномы	гномы
маятника	маятника
припомнишь	припомнишь
отрыгивала	отрыгивала
каплет	каплет
расположите	расположите
освежали	освежали
предпредпоследни	предпредпоследни
возврати	возврати
воспылал	воспылал
открыли	открыли
зажаривав	зажаривав
авторизацией	авторизацией
половинками	половинками
принадлежащие	принадлежащие
издерживали	издерживали
умер	умер
возьму	возьму
убитой	убитой
извещу	извещу
нагорного	нагорного
скопляй	скопляй
золота	золота
рукопашную	рукопашную
финали	финали
престижная	престижная
экстракте	экстракте
честным	честным
составлять	составлять
неоднородной	неоднородной
размышление	размышление
зазвонив	зазвонив
перебрасывая	перебрасывая
садить	садить
полтергейстом	полтергейстом
томили	томили
звёздам	звёздам
решимости	решимости
сообществе	сообществе
бронепоезда	бронепоезда
злосчастными	злосчастными
расти	расти
горького	горького
возлюбленных	возлюбленных
послужим	послужим
временных	временных
начертали	начертали
потекло	потекло
изреки	изреки
спустила	спустила
брани	брани
проходимцы	проходимцы
губите	губите
приспособился	приспособился
половину	половину
убит	убит
поспешите	поспешите
мудоёбом	мудоёбом
поядать	поядать
горьком	горьком
расовым	расовым
тяготящий	тяготящий
накреняла	накреняла
подвиг	подвиг
решился	решился
накреняя	накреняя
разностями	разностями
сверху	сверху
язвах	язвах
азалия	азалия
скакало	скакало
отпирали	отпирали
телефонной	телефонной
аблаутом	аблаутом
яловцем	яловцем
рубцом	рубцом
гигантов	гигантов
образовали	образовали
распрямляй	распрямляй
немое	немое
отягощай	отягощай
астробиологии	астробиологии
умножить	умножить
вили	вили
накожной	накожной
изнеженный	изнеженный
поручением	поручением
горюйте	горюйте
расспрос	расспрос
копиркам	копиркам
обитающей	обитающей
диалектическим	диалектическим
фараонах	фараонах
выводила	выводила
воспроизводим	воспроизводим
выводим	выводим
долгоносику	долгоносику
апатридах	апатридах
убегали	убегали
мультика	мультика
солениям	солениям
захватив	захватив
замещениях	замещениях
выросло	выросло
уставляйся	уставляйся
мал	мал
напоминайте	напоминайте
холостяком	холостяком
вцепляться	вцепляться
половиною	половиною
рукополагал	рукополагал
гарантирует	гарантирует
желающий	желающий
ослабело	ослабело
видеозаписи	видеозаписи
Моисеевой	Моисеевой
оживлять	оживлять
смелеть	смелеть
сохранности	сохранности
горькою	горькою
всесожжением	всесожжением
коллекционировал	коллекционировал
омыть	омыть
гармони	гармони
губящий	губящий
пойнтерам	пойнтерам
испытанные	испытанные
абстрактностями	абстрактностями
рудименты	рудименты
наступлениям	наступлениям
похоронить	похоронить
аромунский	аромунский
далёкому	далёкому
следующему	следующему
астраханское	астраханское
сортов	сортов
завещевал	завещевал
Которым	Которым
ехидное	ехидное
имейла	имейла
выводить	выводить
вступите	вступите
кидаре	кидаре
рения	рения
приклеить	приклеить
соперниками	соперниками
согрешали	согрешали
упоминаете	упоминаете
аблаут	аблаут
золотой	золотой
дзельквой	дзельквой
маклере	маклере
захватило	захватило
перца	перца
разговаривали	разговаривали
устанавливался	устанавливался
вышкам	вышкам
шведских	шведских
притворы	притворы
подчинен	подчинен
васильку	васильку
измерительную	измерительную
прокатным	прокатным
мытаря	мытаря
самостоятельности	самостоятельности
собранным	собранным
холю	холю
принимали	принимали
Господню	Господню
сканеры	сканеры
твердою	твердою
ветеркам	ветеркам
будешь	будешь
сострадали	сострадали
переложил	переложил
замечайте	замечайте
разрушить	разрушить
преподали	преподали
орудует	орудует
дилетанткам	дилетанткам
взмыв	взмыв
сближаетесь	сближаетесь
ступеньки	ступеньки
осквернила	осквернила
приняли	приняли
выводишь	выводишь
расплющиваешь	расплющиваешь
отдай	отдай
жила	жила
булавочной	булавочной
кровопролитии	кровопролитии
переустроило	переустроило
анкхи	анкхи
торту	торту
почётная	почётная
аншлюса	аншлюса
килобайт	килобайт
сиборгий	сиборгий
Сила	Сила
изгонять	изгонять
померкший	померкший
прибыли	прибыли
конкретная	конкретная
избирай	избирай
неувязки	неувязки
отпал	отпал
отсечённый	отсечённый
хлестну	хлестну
ёмкостей	ёмкостей
возвращен	возвращен
отвалит	отвалит
обгорелою	обгорелою
искусным	искусным
неверной	неверной
царишь	царишь
ходу	ходу
расползаюсь	расползаюсь
захотела	захотела
полое	полое
откормленных	откормленных
захваченный	захваченный
твои	твои
уразуметь	уразуметь
выстоишь	выстоишь
отборный	отборный
пересказала	пересказала
возливай	возливай
сделали	сделали
ношений	ношений
склонился	склонился
убийству	убийству
тысяченачальник	тысяченачальник
поступив	поступив
Твоя	Твоя
обгорела	обгорела
неотложке	неотложке
дугообразный	дугообразный
смешанный	смешанный
перерезали	перерезали
славистики	славистики
преступлении	преступлении
пишем	пишем
редеете	редеете
воздержанности	воздержанности
отучите	отучите
заваривали	заваривали
костёлов	костёлов
язя	язя
утекал	утекал
сохранился	сохранился
броневое	броневое
медлите	медлите
открытое	открытое
научили	научили
ином	ином
колечке	колечке
прошивают	прошивают
большевика	большевика
охраняющий	охраняющий
гуслиста	гуслиста
подпустите	подпустите
прекрати	прекрати
моем	моем
трое	трое
слогам	слогам
приверженцем	приверженцем
вывез	вывез
добра	добра
твердые	твердые
ушибайте	ушибайте
обирай	обирай
занимательная	занимательная
восходите	восходите
наполнить	наполнить
была	была
чужом	чужом
покачивать	покачивать
поговорив	поговорив
искать	искать
живых	живых
неразговорчива	неразговорчива
посылали	посылали
похвальных	похвальных
партере	партере
до	до
буера	буера
встретила	встретила
махнуло	махнуло
заглавий	заглавий
нетронутым	нетронутым
подняли	подняли
вылезал	вылезал
успокоить	успокоить
сказать	сказать
атмосферные	атмосферные
сдачами	сдачами
предавай	предавай
домом	домом
оборотили	оборотили
целовали	целовали
бюрократизма	бюрократизма
сквознякам	сквознякам
перебили	перебили
захлёстыванием	захлёстыванием
грамотностях	грамотностях
судебную	судебную
загорожу	загорожу
командир	командир
отступаемся	отступаемся
дынях	дынях
превозноси	превозноси
потаенном	потаенном
третейского	третейского
набрали	набрали
инфиксами	инфиксами
избавляйте	избавляйте
малый	малый
растапливают	растапливают
дороге	дороге
корчишься	корчишься
почитали	почитали
подоспейте	подоспейте
бредовых	бредовых
самый	самый
присягнуло	присягнуло
чужому	чужому
хоккейного	хоккейного
как	как
цветение	цветение
утвердите	утвердите
сосчитайте	сосчитайте
гуслист	гуслист
ахроматизме	ахроматизме
потребите	потребите
созвать	созвать
сквозные	сквозные
шоу-бизнесы	шоу-бизнесы
светят	светят
нерадит	нерадит
подступавшийся	подступавшийся
простился	простился
приобщимся	приобщимся
вышки	вышки
отрабатывал	отрабатывал
тропосферы	тропосферы
убийцы	убийцы
стервятнике	стервятнике
эта	эта
долгопяту	долгопяту
забивший	забивший
шейное	шейное
подбирай	подбирай
консульству	консульству
разворачиваешься	разворачиваешься
три	три
эшафота	эшафота
поражался	поражался
слушай	слушай
худо	худо
критической	критической
главных	главных
большевикам	большевикам
истребительного	истребительного
сказывать	сказывать
хоронили	хоронили
половец	половец
титулы	титулы
выговорите	выговорите
брюхи	брюхи
пустою	пустою
обманщика	обманщика
связи	связи
заклеймили	заклеймили
воскликнул	воскликнул
восходили	восходили
оздоровивший	оздоровивший
невежда	невежда
чужая	чужая
возносили	возносили
баллотировался	баллотировался
странствующий	странствующий
шнапсе	шнапсе
Яви	Яви
опалами	опалами
животного	животного
условливалось	условливалось
неясным	неясным
другое	другое
скрыла	скрыла
иного	иного
отучив	отучив
считаешь	считаешь
изморозь	изморозь
солении	солении
дюйма	дюйма
лирическое	лирическое
Одни	Одни
постигла	постигла
будет	будет
совратили	совратили
ксерокопией	ксерокопией
тоталитарное	тоталитарное
щупу	щупу
трамвайным	трамвайным
оказывай	оказывай
колёсами	колёсами
возлег	возлег
цари	цари
испытывали	испытывали
скрепился	скрепился
сестры	сестры
устремили	устремили
древневерхненемецком	древневерхненемецком
совладаешь	совладаешь
приблизить	приблизить
воспитывайте	воспитывайте
поем	поем
предки	предки
кутающий	кутающий
отняли	отняли
записного	записного
пропагандистского	пропагандистского
ехидного	ехидного
зарыдали	зарыдали
красота	красота
скоплять	скоплять
продолжало	продолжало
тверд	тверд
волочим	волочим
сохрани	сохрани
психик	психик
сверкание	сверкание
испытанных	испытанных
завещевает	завещевает
поникли	поникли
возлюбленные	возлюбленные
целых	целых
шведская	шведская
обговаривавший	обговаривавший
пол	пол
пути	пути
цепляв	цепляв
обёрткам	обёрткам
постыдился	постыдился
дочерним	дочерним
открытою	открытою
подстраивавший	подстраивавший
точило	точило
жребием	жребием
прославляли	прославляли
выговаривали	выговаривали
накрыться	накрыться
спросить	спросить
божество	божество
вооружите	вооружите
осетинке	осетинке
раскрываться	раскрываться
предпредпоследняя	предпредпоследняя
отрёкшийся	отрёкшийся
верандам	верандам
заклята	заклята
входное	входное
узнаете	узнаете
прудику	прудику
переустройте	переустройте
било	било
вырос	вырос
превозмогла	превозмогла
жребиев	жребиев
познала	познала
тропосферах	тропосферах
закладываюсь	закладываюсь
носильщикам	носильщикам
слагаю	слагаю
превозносило	превозносило
апоптозы	апоптозы
натапливавший	натапливавший
переспите	переспите
воздать	воздать
рассуждали	рассуждали
всю	всю
предсердие	предсердие
соблюдите	соблюдите
проклинали	проклинали
неоднороден	неоднороден
назвала	назвала
вынесли	вынесли
вин	вин
расслабляются	расслабляются
светите	светите
замечать	замечать
покушалась	покушалась
калужским	калужским
пробуждал	пробуждал
накренятся	накренятся
выпрыгивайте	выпрыгивайте
старинном	старинном
стоят	стоят
сангвиников	сангвиников
оскудели	оскудели
отделить	отделить
жала	жала
созрела	созрела
стесняет	стесняет
подкрепить	подкрепить
гистологиях	гистологиях
воздухоочиститель	воздухоочиститель
змею	змею
убийце	убийце
вихрям	вихрям
ратуем	ратуем
гениальна	гениальна
снискать	снискать
верующий	верующий
добро	добро
немому	немому
владеть	владеть
стакер	стакер
избирателями	избирателями
испёкшийся	испёкшийся
иссякать	иссякать
осекаетесь	осекаетесь
албанок	албанок
похоронен	похоронен
овладеть	овладеть
Мигами	Мигами
кругозоры	кругозоры
замазке	замазке
будем	будем
долгое	долгое
наезжаешь	наезжаешь
синагогах	синагогах
нечаянным	нечаянным
жилищах	жилищах
любимый	любимый
затрепетали	затрепетали
обманули	обманули
одолеть	одолеть
литые	литые
произноси	произноси
выводя	выводя
прорицателе	прорицателе
дыне	дыне
имея	имея
возвращали	возвращали
имбецилами	имбецилами
произвели	произвели
исполнительской	исполнительской
поверенного	поверенного
Мои	Мои
умножили	умножили
хлестнув	хлестнув
утечке	утечке
били	били
изливали	изливали
открыто	открыто
долгими	долгими
узнать	узнать
австрийцев	австрийцев
пищи	пищи
бедным	бедным
скапливал	скапливал
тьмою	тьмою
совершить	совершить
чешу	чешу
кинофильмах	кинофильмах
повторили	повторили
братьям	братьям
понять	понять
дворовый	дворовый
возлюбленною	возлюбленною
отягощала	отягощала
владейте	владейте
сослуживца	сослуживца
обманула	обманула
разгонюсь	разгонюсь
византиец	византиец
пересчитайте	пересчитайте
распорядками	распорядками
презирать	презирать
расслабивший	расслабивший
отыщи	отыщи
поскальзываясь	поскальзываясь
дочь	дочь
драгоценной	драгоценной
зданием	зданием
снискала	снискала
плектр	плектр
трюки	трюки
утехе	утехе
шторы	шторы
Приветствуйте	Приветствуйте
женьшеней	женьшеней
укрепили	укрепили
начинайте	начинайте
взывайте	взывайте
обратного	обратного
вторым	вторым
аудиторское	аудиторское
славил	славил
возлегли	возлегли
тысяченачальниками	тысяченачальниками
отделился	отделился
приносила	приносила
воздала	воздала
локализовала	локализовала
ограничений	ограничений
мыслить	мыслить
громоздили	громоздили
разности	разности
морю	морю
безлюдную	безлюдную
разузнавал	разузнавал
приготовили	приготовили
арматурам	арматурам
волосатые	волосатые
покушаясь	покушаясь
ходить	ходить
открытой	открытой
профиты	профиты
озадачено	озадачено
сохраняла	сохраняла
выносишь	выносишь
пух	пух
областеначальник	областеначальник
ЗАГСы	ЗАГСы
разоблачавшийся	разоблачавшийся
клеветнической	клеветнической
молчали	молчали
потаённым	потаённым
краткости	краткости
возливала	возливала
посинение	посинение
кутал	кутал
мутите	мутите
азиатки	азиатки
пролежите	пролежите
бритого	бритого
имело	имело
чести	чести
устаивалось	устаивалось
спустили	спустили
забормотавший	забормотавший
слушающий	слушающий
Тобой	Тобой
портив	портив
внутриматочной	внутриматочной
обратить	обратить
дорогою	дорогою
подпали	подпали
начало	начало
обатуре	обатуре
остановился	остановился
литой	литой
сказывала	сказывала
подвохи	подвохи
знаком	знаком
пожалуйте	пожалуйте
паническим	паническим
очистили	очистили
двое	двое
следовать	следовать
рубил	рубил
простирал	простирал
превратили	превратили
напился	напился
доживал	доживал
возопили	возопили
объединяются	объединяются
научен	научен
проломал	проломал
искажаете	искажаете
парламентскую	парламентскую
массировав	массировав
далёкими	далёкими
сформировался	сформировался
копали	копали
входите	входите
тестировав	тестировав
билах	билах
приблизился	приблизился
заклянут	заклянут
ратовала	ратовала
спарывая	спарывая
пожелали	пожелали
умницам	умницам
святом	святом
наклони	наклони
презентации	презентации
упросила	упросила
оскорбляли	оскорбляли
скрывать	скрывать
горилку	горилку
согрешит	согрешит
горькой	горькой
гинекологию	гинекологию
уместностям	уместностям
выкипело	выкипело
благовествуй	благовествуй
пятнисты	пятнисты
Три	Три
влекли	влекли
послужили	послужили
генитальным	генитальным
возвестят	возвестят
реабилитировал	реабилитировал
прославлять	прославлять
безлюдным	безлюдным
выказать	выказать
червовый	червовый
служить	служить
женщиной	женщиной
отнял	отнял
пресеку	пресеку
избежанию	избежанию
тороплива	тороплива
мошенниках	мошенниках
объёмами	объёмами
морозные	морозные
одели	одели
возрастной	возрастной
подумал	подумал
Какой	Какой
выстроилась	выстроилась
утешить	утешить
огибаю	огибаю
этом	этом
некрасивое	некрасивое
копыле	копыле
соорудил	соорудил
встряхнешь	встряхнешь
гаркнете	гаркнете
отправили	отправили
излить	излить
исполним	исполним
прикую	прикую
лицо	лицо
думали	думали
проклинайте	проклинайте
светило	светило
избежании	избежании
орудием	орудием
перцы	перцы
Киса	Киса
останови	останови
обреку	обреку
разбоев	разбоев
повторился	повторился
Твоем	Твоем
вводили	вводили
старческие	старческие
пустотам	пустотам
верни	верни
потерянной	потерянной
случая	случая
жителя	жителя
убывайте	убывайте
живою	живою
отсечь	отсечь
пинаемый	пинаемый
партеров	партеров
избавило	избавило
исцелить	исцелить
насадишь	насадишь
изменила	изменила
образ	образ
жребий	жребий
принятое	принятое
игумену	игумену
поспешили	поспешили
славите	славите
перевалим	перевалим
фаната	фаната
возливайте	возливайте
вознесли	вознесли
усядьтесь	усядьтесь
вылечиваем	вылечиваем
испустить	испустить
убедили	убедили
подвёртывайтесь	подвёртывайтесь
образцами	образцами
долгая	долгая
жило	жило
поморщилось	поморщилось
сбереги	сбереги
угодная	угодная
повторной	повторной
церия	церия
тысячам	тысячам
погромщица	погромщица
скатитесь	скатитесь
живого	живого
шерстяные	шерстяные
вспыхивало	вспыхивало
камня	камня
честности	честности
впал	впал
подкидывал	подкидывал
велик	велик
размётывая	размётывая
переключаются	переключаются
благочестием	благочестием
объединяясь	объединяясь
хрипящий	хрипящий
истощила	истощила
амхарскую	амхарскую
очистим	очистим
пророчествуй	пророчествуй
лучниками	лучниками
скупает	скупает
склоняй	склоняй
откормленного	откормленного
владычествовали	владычествовали
лесопильным	лесопильным
внутренние	внутренние
остановить	остановить
возвеличился	возвеличился
духовная	духовная
блудодействуют	блудодействуют
заклятого	заклятого
берилла	берилла
чувяках	чувяках
жертву	жертву
вступился	вступился
португальце	португальце
ассоциациями	ассоциациями
восклицайте	восклицайте
невежды	невежды
двоедушны	двоедушны
главные	главные
отвален	отвален
попускаете	попускаете
Слушайте	Слушайте
отсекли	отсекли
гаркнут	гаркнут
узнаешь	узнаешь
прогревав	прогревав
спецификации	спецификации
багами	багами
настаивал	настаивал
наказывали	наказывали
сокрушаюсь	сокрушаюсь
вспоминай	вспоминай
развели	развели
моделирования	моделирования
кроили	кроили
отсчитать	отсчитать
издёвке	издёвке
главы	главы
Сии	Сии
азиатка	азиатка
пропало	пропало
отсечете	отсечете
дщерь	дщерь
гидравлического	гидравлического
святою	святою
имевшие	имевшие
нужников	нужников
убитою	убитою
искусного	искусного
недопивая	недопивая
согласился	согласился
своя	своя
слагайте	слагайте
чтить	чтить
открывать	открывать
бузиной	бузиной
вами	вами
расселявший	расселявший
уцелел	уцелел
летевший	летевший
правых	правых
обрезывай	обрезывай
тьмы	тьмы
соорудите	соорудите
упился	упился
спасителями	спасителями
критического	критического
здравоохранением	здравоохранением
ненецким	ненецким
византийца	византийца
отнят	отнят
грызам	грызам
меньше	меньше
престижна	престижна
симфоническим	симфоническим
нержавеющего	нержавеющего
конъюнктуры	конъюнктуры
возносить	возносить
парсунам	парсунам
податлива	податлива
наполнился	наполнился
расположен	расположен
комплимента	комплимента
кокетничав	кокетничав
Тем	Тем
захуярив	захуярив
письма	письма
глядеть	глядеть
запустением	запустением
даруешь	даруешь
клянёшь	клянёшь
хулю	хулю
засыхали	засыхали
засвечиваюсь	засвечиваюсь
медвежатниками	медвежатниками
поправлявший	поправлявший
приглаживало	приглаживало
учительской	учительской
отрапортовало	отрапортовало
горькому	горькому
утапливавший	утапливавший
любимую	любимую
смешанной	смешанной
бемолям	бемолям
надел	надел
раскопками	раскопками
приобрели	приобрели
лад	лад
сейсмических	сейсмических
сытый	сытый
чтобы	чтобы
спекуляции	спекуляции
утолю	утолю
поём	поём
каков	каков
подставу	подставу
иссякало	иссякало
несмысленны	несмысленны
откажи	откажи
налетело	налетело
неподкупного	неподкупного
аббате	аббате
пробыл	пробыл
злоумыслила	злоумыслила
выстроился	выстроился
захватите	захватите
распространённая	распространённая
вложились	вложились
чью	чью
исцели	исцели
первою	первою
проклинай	проклинай
продай	продай
хаосам	хаосам
превозмогло	превозмогло
худа	худа
издерживать	издерживать
злой	злой
червонец	червонец
абляции	абляции
приписывала	приписывала
басконкой	басконкой
покрыли	покрыли
ожидальню	ожидальню
рыдать	рыдать
затворив	затворив
убедите	убедите
волшебника	волшебника
храбрецов	храбрецов
омывать	омывать
рассеянный	рассеянный
параграфам	параграфам
убийство	убийство
столпе	столпе
благороден	благороден
похорони	похорони
реабилитация	реабилитация
неверном	неверном
кипчаков	кипчаков
ослабевать	ослабевать
неподдельных	неподдельных
просила	просила
бросила	бросила
живом	живом
квашена	квашена
глухие	глухие
противогазу	противогазу
утих	утих
вьюгами	вьюгами
приклеим	приклеим
унизься	унизься
билом	билом
изменит	изменит
умалился	умалился
простецкому	простецкому
пролился	пролился
обрезывали	обрезывали
вонзила	вонзила
гидростанции	гидростанции
накатают	накатают
абсорбируешься	абсорбируешься
затакт	затакт
воспроизводив	воспроизводив
язва	язва
романских	романских
женьшенями	женьшенями
тюленятами	тюленятами
далёкая	далёкая
немалой	немалой
мраморному	мраморному
покрыло	покрыло
хранила	хранила
твердо	твердо
адвокатах	адвокатах
злодейках	злодейках
призвали	призвали
поддоне	поддоне
ассоциировала	ассоциировала
бутыли	бутыли
чужой	чужой
увеличили	увеличили
сгущаться	сгущаться
ехидна	ехидна
рассеките	рассеките
проклятую	проклятую
буроватой	буроватой
считайте	считайте
уместность	уместность
неба	неба
схоже	схоже
производить	производить
самая	самая
какою	какою
фурункулами	фурункулами
нормативна	нормативна
царскою	царскою
остановила	остановила
выдадите	выдадите
архиереям	архиереям
выкупали	выкупали
щадишь	щадишь
выпускаетесь	выпускаетесь
встретился	встретился
штолен	штолен
пребывали	пребывали
возвестил	возвестил
манна	манна
попойкой	попойкой
Какая	Какая
выводите	выводите
предназначения	предназначения
прогнать	прогнать
восхотел	восхотел
опротивел	опротивел
отличился	отличился
волочу	волочу
повис	повис
рассеете	рассеете
правильное	правильное
выводи	выводи
дать	дать
напрягите	напрягите
пасхальна	пасхальна
непродолжительна	непродолжительна
старческого	старческого
губишь	губишь
растерзать	растерзать
расслабленный	расслабленный
накатаю	накатаю
поладил	поладил
ожидали	ожидали
разводите	разводите
перестать	перестать
оказывали	оказывали
агульской	агульской
обыскам	обыскам
почитайте	почитайте
провалы	провалы
ломкой	ломкой
темным	темным
нечистота	нечистота
троюродным	троюродным
варить	варить
разузнаёте	разузнаёте
коваными	коваными
лизали	лизали
вселяющий	вселяющий
потерпели	потерпели
сионизма	сионизма
запоминаний	запоминаний
женственный	женственный
превозносился	превозносился
живые	живые
изгоняйте	изгоняйте
надстроившийся	надстроившийся
головою	головою
переваливающийся	переваливающийся
сработай	сработай
поручили	поручили
временной	временной
амстердамцев	амстердамцев
астигматизмами	астигматизмами
умоляли	умоляли
сердобольная	сердобольная
реабилитациям	реабилитациям
выбежал	выбежал
драгоценных	драгоценных
золовке	золовке
предшествовали	предшествовали
губленный	губленный
вопрошать	вопрошать
сердечно-сосудистой	сердечно-сосудистой
приукрашивает	приукрашивает
отсек	отсек
большом	большом
бункером	бункером
сукновальню	сукновальню
смирен	смирен
обнажен	обнажен
подходящей	подходящей
соли	соли
Всем	Всем
сохраните	сохраните
двоек	двоек
известив	известив
минам-ловушкам	минам-ловушкам
лиц	лиц
прогнали	прогнали
качку	качку
усилили	усилили
спецхранах	спецхранах
петь	петь
отняты	отняты
утвердили	утвердили
изломом	изломом
вскричал	вскричал
унитарного	унитарного
излился	излился
пощадите	пощадите
рубце	рубце
насажу	насажу
заковывать	заковывать
совершили	совершили
собирала	собирала
зафиксируем	зафиксируем
иным	иным
схожим	схожим
хрюкайте	хрюкайте
вредителями	вредителями
наги	наги
какое	какое
смолчало	смолчало
славянские	славянские
суставного	суставного
мраморная	мраморная
лотереи	лотереи
поют	поют
делаться	делаться
фаворит	фаворит
бурую	бурую
жертвою	жертвою
противодействующих	противодействующих
страшным	страшным
найдем	найдем
восхотели	восхотели
ронине	ронине
сбить	сбить
вырабатывайте	вырабатывайте
подсластители	подсластители
выводивший	выводивший
спецхран	спецхран
размере	размере
чужие	чужие
молодая	молодая
ослабейте	ослабейте
лиловую	лиловую
расслабите	расслабите
уснули	уснули
славили	славили
налагающий	налагающий
своротить	своротить
ксерокопии	ксерокопии
преподало	преподало
выпускаюсь	выпускаюсь
раздосадованные	раздосадованные
орудовал	орудовал
утаивайте	утаивайте
непоколебим	непоколебим
капитализаций	капитализаций
мадерами	мадерами
наполнила	наполнила
Лазаря	Лазаря
электродиагностика	электродиагностика
смелея	смелея
сычами	сычами
правым	правым
повозочной	повозочной
постелило	постелило
логотипах	логотипах
Твою	Твою
клянущий	клянущий
наездах	наездах
выносим	выносим
диспуту	диспуту
трущобу	трущобу
вы	вы
адаптирую	адаптирую
сгущаясь	сгущаясь
жертвами	жертвами
колониях	колониях
горькие	горькие
дзельквы	дзельквы
блуждать	блуждать
пьяною	пьяною
советчиками	советчиками
избивали	избивали
празднестве	празднестве
растил	растил
тематических	тематических
кровопролитен	кровопролитен
простирай	простирай
реки	реки
даем	даем
выказала	выказала
побратимам	побратимам
кёрлинги	кёрлинги
оскудела	оскудела
остригаешь	остригаешь
снимите	снимите
воздай	воздай
соавторстве	соавторстве
минимум	минимум
шестой	шестой
женственным	женственным
нового	нового
одну	одну
вороной	вороной
померкло	померкло
познаю	познаю
объёмы	объёмы
красочной	красочной
кузнеца	кузнеца
жребии	жребии
разбился	разбился
многотысячное	многотысячное
трубить	трубить
оповещаешь	оповещаешь
половина	половина
специальностей	специальностей
параграфа	параграфа
развалинам	развалинам
мокра	мокра
изумишь	изумишь
трюков	трюков
нашу	нашу
соделать	соделать
марафонам	марафонам
приступив	приступив
прихлебнувший	прихлебнувший
проскочу	проскочу
слушать	слушать
заимствовании	заимствовании
пожалели	пожалели
частой	частой
цепную	цепную
дровокольную	дровокольную
жокейское	жокейское
жертв	жертв
топтать	топтать
творите	творите
грунтовых	грунтовых
подсмотрел	подсмотрел
родят	родят
служи	служи
выслушайте	выслушайте
кибернетик	кибернетик
благ	благ
Возьму	Возьму
многотысячные	многотысячные
твердая	твердая
разорю	разорю
вывести	вывести
голень	голень
узнаю	узнаю
умалить	умалить
умилостивить	умилостивить
кочкаре	кочкаре
срывать	срывать
набиваешься	набиваешься
зоркое	зоркое
увиваем	увиваем
алунитах	алунитах
сравните	сравните
желанный	желанный
злых	злых
имперфекту	имперфекту
достали	достали
приоткроемся	приоткроемся
носите	носите
овладейте	овладейте
исследуй	исследуй
передайся	передайся
плеснул	плеснул
спросив	спросив
само	само
перетекала	перетекала
зорки	зорки
небесные	небесные
запустении	запустении
ухнувший	ухнувший
судился	судился
универсаму	универсаму
уверить	уверить
молите	молите
возвысить	возвысить
привалили	привалили
любимым	любимым
подснежник	подснежник
далёким	далёким
налагав	налагав
хулить	хулить
раздавливайте	раздавливайте
претенциозных	претенциозных
обличать	обличать
шкотиком	шкотиком
скрывайте	скрывайте
служанке	служанке
подражайте	подражайте
гуслистов	гуслистов
падали	падали
негодовании	негодовании
пленили	пленили
нечётны	нечётны
взял	взял
взаимодействовал	взаимодействовал
спросишь	спросишь
иссохло	иссохло
вселял	вселял
меньшая	меньшая
выгребете	выгребете
выдавший	выдавший
сей	сей
двойки	двойки
анатомирования	анатомирования
мог	мог
бойлером	бойлером
выговаривавшийся	выговаривавшийся
вытеснял	вытеснял
перенаселение	перенаселение
вооружился	вооружился
прозрел	прозрел
рифмы	рифмы
есть	есть
поладит	поладит
почетного	почетного
отучит	отучит
воспоминайте	воспоминайте
молодым	молодым
известишь	известишь
компаньоне	компаньоне
досадном	досадном
испекли	испекли
знакомых	знакомых
спрятала	спрятала
одолели	одолели
Твой	Твой
издевавшись	издевавшись
будничному	будничному
ослабевайте	ослабевайте
верноподданному	верноподданному
франчайзинга	франчайзинга
добыч	добыч
равномерный	равномерный
вызывать	вызывать
произвело	произвело
почитай	почитай
свис	свис
положен	положен
потухшего	потухшего
таитянин	таитянин
вступали	вступали
вострепетали	вострепетали
сделайте	сделайте
служителе	служителе
девушках	девушках
немногое	немногое
игумены	игумены
пересчитай	пересчитай
возрос	возрос
фарерские	фарерские
лесозаготовительной	лесозаготовительной
отведи	отведи
помните	помните
пробрал	пробрал
издательнице	издательнице
абаданцах	абаданцах
безвластные	безвластные
скакать	скакать
натёрло	натёрло
ноздри	ноздри
ангельское	ангельское
преследовать	преследовать
выслать	выслать
преследовала	преследовала
добром	добром
Иудин	Иудин
встать	встать
ждать	ждать
поддерживала	поддерживала
ждала	ждала
парус	парус
апоптозов	апоптозов
показали	показали
транспортировках	транспортировках
пребыло	пребыло
отказать	отказать
церковнославянским	церковнославянским
целые	целые
выкопали	выкопали
поднятою	поднятою
ёмкости	ёмкости
спасителей	спасителей
кураже	кураже
гребням	гребням
очисти	очисти
вела	вела
встроенного	встроенного
личностному	личностному
страноведением	страноведением
кованым	кованым
интегрируешься	интегрируешься
желали	желали
разбогатеть	разбогатеть
сосчитай	сосчитай
возрастных	возрастных
бесперспективный	бесперспективный
прорубивший	прорубивший
водосточному	водосточному
компьютерной	компьютерной
оплакивала	оплакивала
зерновому	зерновому
симфонических	симфонических
передвигает	передвигает
цепенел	цепенел
окрашивать	окрашивать
обозвавший	обозвавший
горки	горки
отведите	отведите
постыди	постыди
приготовился	приготовился
шатки	шатки
Сию	Сию
экстрадиции	экстрадиции
бери	бери
знакомые	знакомые
допускала	допускала
больше	больше
найди	найди
тирании	тирании
апории	апории
полочек	полочек
согрешим	согрешим
предсердии	предсердии
сочетавший	сочетавший
чёрточками	чёрточками
развалиною	развалиною
подчинился	подчинился
приоткрывшись	приоткрывшись
назидает	назидает
сокрушить	сокрушить
скрывала	скрывала
прибиравший	прибиравший
кругозором	кругозором
предвыборных	предвыборных
желтками	желтками
парижанин	парижанин
померк	померк
трепетной	трепетной
прямых	прямых
приближению	приближению
разожмем	разожмем
конкретной	конкретной
дюйму	дюйму
подвёртывался	подвёртывался
первом	первом
неверующая	неверующая
иссохли	иссохли
пленные	пленные
отнесли	отнесли
Мало	Мало
пшека	пшека
загоните	загоните
шалей	шалей
сделало	сделало
влеплю	влеплю
милиции	милиции
живым	живым
допытывайся	допытывайся
никакая	никакая
издавшись	издавшись
раскрываюсь	раскрываюсь
разговаривал	разговаривал
рассеянного	рассеянного
ноздрями	ноздрями
воссияло	воссияло
приняла	приняла
скрытого	скрытого
выстроили	выстроили
возвеличить	возвеличить
меньшие	меньшие
простите	простите
времени	времени
обзовет	обзовет
сгибаться	сгибаться
веранды	веранды
ожить	ожить
третейское	третейское
бесстрастному	бесстрастному
геккона	геккона
принесем	принесем
неверующие	неверующие
убедив	убедив
варите	варите
исправляли	исправляли
золото	золото
епитимьёй	епитимьёй
ромбика	ромбика
вынимать	вынимать
региональной	региональной
разгневали	разгневали
правами	правами
берете	берете
разодрали	разодрали
утвердить	утвердить
рубила	рубила
древесине	древесине
идентичную	идентичную
всякой	всякой
Котором	Котором
прокаженных	прокаженных
она	она
объедал	объедал
сковать	сковать
освежаете	освежаете
сплющила	сплющила
ремонтам	ремонтам
щегол	щегол
силуэтам	силуэтам
зенитчиком	зенитчиком
топчемся	топчемся
подняло	подняло
удерживали	удерживали
громоздите	громоздите
мстить	мстить
стабильных	стабильных
ободри	ободри
созвали	созвали
произвольной	произвольной
долгой	долгой
радею	радею
небесного	небесного
проводили	проводили
одни	одни
огорчали	огорчали
рыдали	рыдали
половинах	половинах
иммуноферментного	иммуноферментного
геноцидам	геноцидам
дорогой	дорогой
отступили	отступили
топчусь	топчусь
далёкой	далёкой
выслушай	выслушай
милашке	милашке
отборен	отборен
собранья	собранья
скользок	скользок
призови	призови
получали	получали
считать	считать
забыла	забыла
умножь	умножь
крыло	крыло
расползаются	расползаются
ниобиев	ниобиев
терпи	терпи
встретить	встретить
Самый	Самый
реконструировал	реконструировал
кипчак	кипчак
презенты	презенты
отходы	отходы
завладеть	завладеть
птичку	птичку
рекомендовались	рекомендовались
бить	бить
абитуриентского	абитуриентского
бесславии	бесславии
писаки	писаки
замышляй	замышляй
разоривший	разоривший
шейный	шейный
импорт	импорт
выкаливаем	выкаливаем
сочинениями	сочинениями
имейлах	имейлах
пролетают	пролетают
пили	пили
высохли	высохли
вытрут	вытрут
взглянули	взглянули
владели	владели
даровать	даровать
отдать	отдать
отправлять	отправлять
делённый	делённый
сосуществованиях	сосуществованиях
решали	решали
выполю	выполю
эти	эти
выдавайте	выдавайте
крестятся	крестятся
сказывайте	сказывайте
саранчою	саранчою
излому	излому
лиственным	лиственным
миллисекунды	миллисекунды
претендовал	претендовал
неуёмных	неуёмных
опустошен	опустошен
полюбуется	полюбуется
увеличить	увеличить
удалить	удалить
окружила	окружила
утомили	утомили
злою	злою
приветствуют	приветствуют
стоишь	стоишь
посмеянием	посмеянием
окружали	окружали
покрывала	покрывала
рубимый	рубимый
обветшала	обветшала
обличи	обличи
Стану	Стану
причесавший	причесавший
сердите	сердите
раздражить	раздражить
славящий	славящий
вторичным	вторичным
сатану	сатану
заколать	заколать
нимфами	нимфами
гили	гили
Марком	Марком
вопить	вопить
проповедуй	проповедуй
исполнительскую	исполнительскую
открыть	открыть
плату	плату
лопатам	лопатам
зле	зле
жокейская	жокейская
пусти	пусти
подпускала	подпускала
изоляторе	изоляторе
долгопятов	долгопятов
радиопередатчиков	радиопередатчиков
явить	явить
нахождениях	нахождениях
приходить	приходить
вышло	вышло
силуэте	силуэте
стильный	стильный
приведем	приведем
пролежав	пролежав
сокрушен	сокрушен
невеждам	невеждам
жертве	жертве
имбецилом	имбецилом
литого	литого
бесславить	бесславить
Царю	Царю
открытую	открытую
углового	углового
образовала	образовала
отделили	отделили
снисходительный	снисходительный
изготавливайтесь	изготавливайтесь
нестабильным	нестабильным
кумиром	кумиром
целое	целое
выдать	выдать
выспросивший	выспросивший
набивайся	набивайся
река	река
медпунктов	медпунктов
аппаратные	аппаратные
впитана	впитана
церкой	церкой
сейсмическим	сейсмическим
эшафоте	эшафоте
бюрократической	бюрократической
говорили	говорили
журчав	журчав
выливай	выливай
приклонился	приклонился
фонетического	фонетического
превозношу	превозношу
вымерли	вымерли
погрязли	погрязли
элиминирований	элиминирований
целовала	целовала
атмосферное	атмосферное
вооружайтесь	вооружайтесь
недопивать	недопивать
болеутоляющи	болеутоляющи
обновишь	обновишь
закрыла	закрыла
сквозят	сквозят
разносить	разносить
скрыты	скрыты
Сам	Сам
внутреннем	внутреннем
маятники	маятники
прибивай	прибивай
привалив	привалив
вредит	вредит
плектрам	плектрам
полтергейст	полтергейст
отпускайте	отпускайте
блёванный	блёванный
поверженной	поверженной
гумнам	гумнам
столпа	столпа
твердую	твердую
металлургическом	металлургическом
титулам	титулам
перебило	перебило
сбили	сбили
полустанок	полустанок
борщи	борщи
раздробляющий	раздробляющий
питает	питает
анонимности	анонимности
немом	немом
сооружённый	сооружённый
продолжали	продолжали
арменисте	арменисте
новоиспечённой	новоиспечённой
осматривали	осматривали
называли	называли
сухая	сухая
сообщества	сообщества
взывать	взывать
избранный	избранный
испытанную	испытанную
открывайте	открывайте
подходили	подходили
это	это
компетентные	компетентные
выпучив	выпучив
палит	палит
разделила	разделила
убегу	убегу
рассеянных	рассеянных
пчёлах	пчёлах
чувяке	чувяке
умножило	умножило
извратить	извратить
выговоров	выговоров
произошли	произошли
натру	натру
присягнете	присягнете
наступили	наступили
немые	немые
святым	святым
вылезающий	вылезающий
кинофильмами	кинофильмами
поступите	поступите
фаворитов	фаворитов
выпрыгивало	выпрыгивало
чьем	чьем
об	об
иных	иных
записной	записной
покаяться	покаяться
отлучился	отлучился
стихотворений	стихотворений
лоснились	лоснились
сонен	сонен
помнили	помнили
еси	еси
пою	пою
вкрадчивы	вкрадчивы
всесоюзное	всесоюзное
созрей	созрей
камнем	камнем
спорите	спорите
возлюбленную	возлюбленную
спуском	спуском
ожерельем	ожерельем
изготавливаюсь	изготавливаюсь
препроводили	препроводили
прищуривается	прищуривается
метрового	метрового
случай	случай
благодарите	благодарите
обличить	обличить
держу	держу
жилища	жилища
постройкой	постройкой
лотерея	лотерея
франчайзингу	франчайзингу
нехорош	нехорош
поднятых	поднятых
отплывете	отплывете
чреватым	чреватым
попирали	попирали
засохли	засохли
укреплять	укреплять
звезду	звезду
узнают	узнают
требуй	требуй
уклоняю	уклоняю
рассекали	рассекали
обманщиками	обманщиками
разматываете	разматываете
нынешнем	нынешнем
стакеров	стакеров
посолят	посолят
отправить	отправить
вооружав	вооружав
лужичанине	лужичанине
поскальзываешься	поскальзываешься
соделаю	соделаю
несмысленного	несмысленного
заключительных	заключительных
смело	смело
вывело	вывело
познать	познать
пряностей	пряностей
жутику	жутику
накренись	накренись
претендующий	претендующий
пряность	пряность
узнай	узнай
ксерокопированием	ксерокопированием
царям	царям
носила	носила
приручать	приручать
причитается	причитается
киноаппарат	киноаппарат
воззови	воззови
доставляло	доставляло
пианистке	пианистке
были	были
раскрытых	раскрытых
любили	любили
языческой	языческой
начислению	начислению
путем	путем
изливайте	изливайте
наркозе	наркозе
езди	езди
дошкольным	дошкольным
вносите	вносите
предавала	предавала
латинизаций	латинизаций
взаимозависимости	взаимозависимости
инфракрасную	инфракрасную
логотипу	логотипу
каждом	каждом
публиковала	публиковала
пробыли	пробыли
солнцестояний	солнцестояний
отключила	отключила
мурлычет	мурлычет
приучало	приучало
роптать	роптать
затактов	затактов
прилагать	прилагать
лично	лично
причастие	причастие
ушибая	ушибая
подними	подними
едкие	едкие
оврага	оврага
большая	большая
голосистых	голосистых
удовлетворился	удовлетворился
хулите	хулите
бел	бел
просты	просты
своротила	своротила
удивлении	удивлении
всесильная	всесильная
отступить	отступить
маскулинное	маскулинное
приветствовал	приветствовал
Будете	Будете
молодых	молодых
гражданско-правового	гражданско-правового
иная	иная
дали	дали
отошлите	отошлите
всевозможного	всевозможного
немыми	немыми
господства	господства
засаживаемый	засаживаемый
Марка	Марка
командиров	командиров
сукновальня	сукновальня
убийцу	убийцу
отрабатывайте	отрабатывайте
бордового	бордового
хотела	хотела
доставляй	доставляй
моря	моря
далёкого	далёкого
фазы	фазы
прославляй	прославляй
радикальный	радикальный
сонаре	сонаре
всплеска	всплеска
взывали	взывали
имперфекты	имперфекты
скакала	скакала
направили	направили
погреби	погреби
жилищами	жилищами
открывали	открывали
месте	месте
отличить	отличить
водить	водить
иррациональна	иррациональна
сестра	сестра
немало	немало
бы	бы
отсеки	отсеки
женьшени	женьшени
ладой	ладой
помогите	помогите
нашла	нашла
другие	другие
попкорн	попкорн
принятую	принятую
слизистые	слизистые
невиданного	невиданного
бегите	бегите
иссох	иссох
раскопки	раскопки
бросился	бросился
лицами	лицами
пчела	пчела
пас	пас
разговаривают	разговаривают
прожил	прожил
нареки	нареки
испеки	испеки
давире	давире
содержали	содержали
людях	людях
доступном	доступном
обитая	обитая
взаимности	взаимности
пасхи	пасхи
свешенный	свешенный
выпадение	выпадение
по	по
воспела	воспела
горизонтали	горизонтали
гумне	гумне
головах	головах
мультиком	мультиком
отговаривают	отговаривают
гневящий	гневящий
редеют	редеют
принесло	принесло
наклонился	наклонился
рули	рули
изволя	изволя
мотыльками	мотыльками
уклейке	уклейке
родишь	родишь
новым	новым
спутавшийся	спутавшийся
обрёкши	обрёкши
тысяча	тысяча
вперед	вперед
тематического	тематического
замещениям	замещениям
двудольному	двудольному
скрепите	скрепите
назидайте	назидайте
решимостью	решимостью
кёрлинг	кёрлинг
коммуналках	коммуналках
сирот	сирот
пятнистой	пятнистой
расселяешь	расселяешь
москвичек	москвичек
вывези	вывези
обмануть	обмануть
прищурила	прищурила
столпы	столпы
посвящай	посвящай
проколотый	проколотый
теменью	теменью
язвами	язвами
стремнистых	стремнистых
отяготишь	отяготишь
жил	жил
истощился	истощился
тысяч	тысяч
разорим	разорим
старыми	старыми
расслабил	расслабил
оградам	оградам
размышлению	размышлению
корчимся	корчимся
потребам	потребам
подражать	подражать
непредвиденна	непредвиденна
банды	банды
препроводить	препроводить
прикипает	прикипает
правые	правые
лиманом	лиманом
засчитывавший	засчитывавший
скривлённый	скривлённый
фторам	фторам
щеголом	щеголом
странствуя	странствуя
черновым	черновым
патогена	патогена
налагайте	налагайте
наглядеться	наглядеться
обыграешь	обыграешь
поменяется	поменяется
дохни	дохни
табуреткам	табуреткам
застенку	застенку
одарённостями	одарённостями
снисходите	снисходите
фонетическому	фонетическому
браните	браните
постигло	постигло
зеваешь	зеваешь
горизонталях	горизонталях
тьму	тьму
извести	извести
свисший	свисший
позвали	позвали
временным	временным
выступив	выступив
семинары	семинары
простить	простить
родился	родился
которого	которого
отходах	отходах
уклонял	уклонял
соединился	соединился
выливаешь	выливаешь
шуруп	шуруп
точиле	точиле
яствам	яствам
вороху	вороху
насадивший	насадивший
приложилось	приложилось
пролили	пролили
подумали	подумали
возвестить	возвестить
затворите	затворите
очищали	очищали
принципиальных	принципиальных
хрюкали	хрюкали
знойному	знойному
двумя	двумя
рибонуклеиновых	рибонуклеиновых
предъявляться	предъявляться
великою	великою
тонзурах	тонзурах
чреватое	чреватое
раскинуть	раскинуть
показывай	показывай
Иудиной	Иудиной
превозносил	превозносил
аденоидам	аденоидам
затыкали	затыкали
саранча	саранча
подкидывает	подкидывает
спали	спали
нижегородские	нижегородские
празднества	празднества
приносить	приносить
заклятыми	заклятыми
досадовали	досадовали
напустила	напустила
полустанка	полустанка
изгнать	изгнать
возобнови	возобнови
преследовали	преследовали
желало	желало
надстройтесь	надстройтесь
ваш	ваш
развей	развей
дошкольное	дошкольное
последовали	последовали
подкрепился	подкрепился
высосавший	высосавший
металлургической	металлургической
нагляжусь	нагляжусь
отдали	отдали
завозен	завозен
припали	припали
городовая	городовая
чужими	чужими
катеростроителя	катеростроителя
будничный	будничный
рассвирепел	рассвирепел
встречном	встречном
обратное	обратное
несмысленные	несмысленные
веснушки	веснушки
могло	могло
хвалишь	хвалишь
лицах	лицах
ангелом	ангелом
обыски	обыски
аденоидов	аденоидов
высвободи	высвободи
семь	семь
погнать	погнать
блага	блага
столпу	столпу
бюрократическая	бюрократическая
слушало	слушало
пойте	пойте
лучницу	лучницу
откормленный	откормленный
интернационализмы	интернационализмы
удочерите	удочерите
гербарии	гербарии
отмывай	отмывай
сковали	сковали
красив	красив
видимо	видимо
здании	здании
развязать	развязать
преступлением	преступлением
поселили	поселили
огнищан	огнищан
царя	царя
очаровательного	очаровательного
возвестив	возвестив
открытый	открытый
программой	программой
дубинки	дубинки
царски	царски
призывником	призывником
со	со
осекаться	осекаться
разорил	разорил
черновой	черновой
оргазмах	оргазмах
сковало	сковало
досадной	досадной
миру	миру
бедно	бедно
отнятого	отнятого
горке	горке
вылечивавший	вылечивавший
пой	пой
каждый	каждый
переспал	переспал
роду	роду
подкрепите	подкрепите
внесись	внесись
убедить	убедить
пересказали	пересказали
необрезаны	необрезаны
дерзновении	дерзновении
выкупите	выкупите
отстали	отстали
судили	судили
позвать	позвать
разделите	разделите
переночевать	переночевать
отважился	отважился
засохла	засохла
отделен	отделен
откройте	откройте
уподобить	уподобить
положи	положи
спорили	спорили
нехорошо	нехорошо
прогревать	прогревать
расслабило	расслабило
тёсел	тёсел
затишье	затишье
дельтапланы	дельтапланы
впитанного	впитанного
наводчиках	наводчиках
азалий	азалий
столоначальников	столоначальников
накатываю	накатываю
добавлениях	добавлениях
освободи	освободи
славянским	славянским
соорудило	соорудило
начал	начал
красоты	красоты
простерли	простерли
познай	познай
приложить	приложить
проклятою	проклятою
бризу	бризу
реке	реке
выведи	выведи
поверженный	поверженный
пустую	пустую
негодуете	негодуете
мульчей	мульчей
разгонись	разгонись
проводить	проводить
подразделявшись	подразделявшись
ослабеть	ослабеть
рада	рада
предоставитесь	предоставитесь
донжонами	донжонами
принеси	принеси
раскапывают	раскапывают
выбрасывать	выбрасывать
бутылями	бутылями
изрекали	изрекали
плюхаюсь	плюхаюсь
вещь	вещь
рубца	рубца
намерен	намерен
почётные	почётные
чем	чем
разматывать	разматывать
самые	самые
покрывало	покрывало
изгнаниях	изгнаниях
принятым	принятым
отсечет	отсечет
полую	полую
возлегло	возлегло
каждое	каждое
успокоился	успокоился
язвы	язвы
прямую	прямую
ладишь	ладишь
предка	предка
тройню	тройню
кормить	кормить
Которой	Которой
благотворите	благотворите
выливал	выливал
ела	ела
потакало	потакало
спарываете	спарываете
ветерка	ветерка
теннисной	теннисной
лесоводческий	лесоводческий
епитимий	епитимий
звать	звать
возьмешь	возьмешь
потаённого	потаённого
белою	белою
ищем	ищем
почетных	почетных
постукивай	постукивай
позолотивший	позолотивший
всем	всем
погребен	погребен
истребительной	истребительной
аромунское	аромунское
зуммерами	зуммерами
негодовал	негодовал
бросить	бросить
пыли	пыли
оставится	оставится
допускали	допускали
инфракрасной	инфракрасной
рассказывай	рассказывай
двойственность	двойственность
снабжайте	снабжайте
апатрида	апатрида
крахмальную	крахмальную
ходите	ходите
подозрительной	подозрительной
убийц	убийц
медпункты	медпункты
стабильность	стабильность
помнила	помнила
извратила	извратила
обёртки	обёртки
тырит	тырит
плётка	плётка
оставляй	оставляй
жертвы	жертвы
всходил	всходил
призывайте	призывайте
охраняй	охраняй
оставляйте	оставляйте
вызывающий	вызывающий
закричали	закричали
разматываешь	разматываешь
круиза	круиза
даруй	даруй
наркозам	наркозам
поспешив	поспешив
починайте	починайте
поядает	поядает
гуманные	гуманные
починают	починают
положить	положить
дачного	дачного
исповедайтесь	исповедайтесь
безвредным	безвредным
нагою	нагою
вывезли	вывезли
политрука	политрука
совладаете	совладаете
кенотафом	кенотафом
теплился	теплился
нажучат	нажучат
взыскали	взыскали
отложился	отложился
Вила	Вила
пражская	пражская
размерами	размерами
каучуковое	каучуковое
протонами	протонами
затворили	затворили
платили	платили
нарушить	нарушить
конденсатами	конденсатами
служила	служила
гусеница	гусеница
парадоксе	парадоксе
болеутоляющ	болеутоляющ
самокруток	самокруток
погромщицы	погромщицы
генерал-майора	генерал-майора
сошло	сошло
партии	партии
крылышке	крылышке
кормите	кормите
специальности	специальности
чтоб	чтоб
обладайте	обладайте
взмётывалось	взмётывалось
хотели	хотели
поддерживали	поддерживали
асимметричной	асимметричной
целовалось	целовалось
дайте	дайте
тверди	тверди
бела	бела
повитухе	повитухе
внутриматочное	внутриматочное
зачерпнешь	зачерпнешь
которых	которых
заклятые	заклятые
полагали	полагали
сирота	сирота
остановили	остановили
реабилитируя	реабилитируя
москвитянами	москвитянами
завещеваю	завещеваю
замедленный	замедленный
пузырьковым	пузырьковым
бредовый	бредовый
посттравматической	посттравматической
нагромождали	нагромождали
микрокатера	микрокатера
бедного	бедного
кенотафу	кенотафу
рассею	рассею
дало	дало
начали	начали
проколют	проколют
дельтаплану	дельтаплану
раздолья	раздолья
рад	рад
ручниста	ручниста
светили	светили
простираете	простираете
хваливший	хваливший
толщины	толщины
ухитряясь	ухитряясь
теснили	теснили
гармоникам	гармоникам
взглянуть	взглянуть
внучках	внучках
клеветническая	клеветническая
потаенных	потаенных
добрейшая	добрейшая
заключила	заключила
напрягался	напрягался
олы	олы
восклицали	восклицали
слепцами	слепцами
начерпала	начерпала
приветствуете	приветствуете
литую	литую
скверному	скверному
уразумел	уразумел
немым	немым
заколал	заколал
нагойских	нагойских
святые	святые
женевской	женевской
клипер	клипер
автострад	автострад
ядру	ядру
превознесли	превознесли
бедном	бедном
ожидать	ожидать
нормативным	нормативным
опорной	опорной
паёк	паёк
злодеек	злодеек
померкнешь	померкнешь
инертных	инертных
пасхальные	пасхальные
соверши	соверши
поднял	поднял
твой	твой
иною	иною
выстроить	выстроить
басконке	басконке
холодную	холодную
стояло	стояло
выломали	выломали
видали	видали
побивать	побивать
погряз	погряз
изменениям	изменениям
дугой	дугой
хлопотливым	хлопотливым
хоронить	хоронить
муэдзина	муэдзина
тысяченачальнику	тысяченачальнику
щёлкаем	щёлкаем
комментатором	комментатором
встречу	встречу
половинки	половинки
новое	новое
прям	прям
печатниках	печатниках
сладкого	сладкого
простирали	простирали
горды	горды
накатываешь	накатываешь
кованой	кованой
почернела	почернела
вводить	вводить
застирывал	застирывал
пассивный	пассивный
добыча	добыча
яви	яви
грязями	грязями
жилищ	жилищ
арменист	арменист
страдать	страдать
одолело	одолело
ангелах	ангелах
гол	гол
хаосах	хаосах
рождала	рождала
этого	этого
родит	родит
кадке	кадке
карфагенян	карфагенян
приступали	приступали
нечётной	нечётной
абляций	абляций
распознает	распознает
пощадило	пощадило
умирать	умирать
расслаблявшись	расслаблявшись
ваши	ваши
нею	нею
разорить	разорить
сионизм	сионизм
облысение	облысение
албанка	албанка
пудреным	пудреным
отправляли	отправляли
сущностную	сущностную
самодельной	самодельной
дирижёром	дирижёром
оставить	оставить
изо	изо
комплектации	комплектации
выудило	выудило
эгоисте	эгоисте
спросило	спросило
ничтожество	ничтожество
авторизаций	авторизаций
испытанным	испытанным
выдайте	выдайте
жали	жали
возлюбленным	возлюбленным
сатаны	сатаны
поехал	поехал
моли	моли
знакомого	знакомого
блейзеру	блейзеру
тысяченачальникам	тысяченачальникам
ращу	ращу
остригали	остригали
встроенные	встроенные
вырезываю	вырезываю
изнеможете	изнеможете
хотите	хотите
петля	петля
Они	Они
скакали	скакали
спидометры	спидометры
абаданец	абаданец
чтите	чтите
мытарь	мытарь
собой	собой
появлении	появлении
обтекают	обтекают
преследуй	преследуй
ожесточился	ожесточился
потаенного	потаенного
отстреляетесь	отстреляетесь
некрасивых	некрасивых
древневерхненемецкому	древневерхненемецкому
нага	нага
велико	велико
напоила	напоила
кузнецом	кузнецом
вологодское	вологодское
жилищам	жилищам
садился	садился
приверженцу	приверженцу
отряхивавшись	отряхивавшись
выкаливая	выкаливая
избирали	избирали
слеп	слеп
лизать	лизать
человекоубийц	человекоубийц
частичке	частичке
аффриката	аффриката
самую	самую
привить	привить
выверенный	выверенный
полтергейста	полтергейста
червовой	червовой
светить	светить
обратите	обратите
мамонте	мамонте
изгоняли	изгоняли
допытывалось	допытывалось
выносит	выносит
звала	звала
божеству	божеству
отыгрывал	отыгрывал
скрывшийся	скрывшийся
камзолами	камзолами
почитает	почитает
которым	которым
лесопильный	лесопильный
избавлю	избавлю
плюхайся	плюхайся
надавливаемый	надавливаемый
нагромождают	нагромождают
новые	новые
лопату	лопату
претворяем	претворяем
конное	конное
отложи	отложи
квадрантами	квадрантами
приготовить	приготовить
разным	разным
пористых	пористых
обновите	обновите
хордах	хордах
из	из
избирателей	избирателей
Слушай	Слушай
немая	немая
стеллажам	стеллажам
жили	жили
первых	первых
митрополитов	митрополитов
царствовали	царствовали
желала	желала
геноциде	геноциде
попускаешь	попускаешь
гордо	гордо
вляпайтесь	вляпайтесь
пугать	пугать
платить	платить
Которого	Которого
леера	леера
держали	держали
моя	моя
живой	живой
сосчитать	сосчитать
сквозняк	сквозняк
томлении	томлении
жребия	жребия
животных	животных
сумкообразный	сумкообразный
враждовать	враждовать
смел	смел
целую	целую
развратили	развратили
щеглят	щеглят
вымыла	вымыла
взмокающий	взмокающий
торжествующий	торжествующий
спецификаций	спецификаций
раскинули	раскинули
донжону	донжону
подстраиваем	подстраиваем
вскричали	вскричали
раба	раба
преодолению	преодолению
проповедуйте	проповедуйте
возопил	возопил
столоначальнику	столоначальнику
заворчало	заворчало
заклеймённый	заклеймённый
превознесем	превознесем
чадо	чадо
воспроизводили	воспроизводили
ремонта	ремонта
отнеси	отнеси
всемогущих	всемогущих
упоена	упоена
холодной	холодной
храму	храму
курчатовии	курчатовии
пленила	пленила
спелых	спелых
другую	другую
пораженцами	пораженцами
исполнился	исполнился
перебить	перебить
нечистым	нечистым
мережку	мережку
резвилась	резвилась
привели	привели
сокройте	сокройте
любимых	любимых
духовен	духовен
любимое	любимое
приехали	приехали
генерал-майоров	генерал-майоров
убила	убила
пели	пели
самодельного	самодельного
променяй	променяй
утешали	утешали
спрашивали	спрашивали
минимумах	минимумах
другом	другом
аббатам	аббатам
укрепи	укрепи
узнайте	узнайте
обатуров	обатуров
актёрское	актёрское
ксивах	ксивах
раскапывать	раскапывать
терафим	терафим
царю	царю
старые	старые
повитуху	повитуху
обвисали	обвисали
скрытая	скрытая
восстать	восстать
обыграет	обыграет
несдержанностью	несдержанностью
сосуществований	сосуществований
царили	царили
сравнишь	сравнишь
сгибайтесь	сгибайтесь
необрезанных	необрезанных
грунтовое	грунтовое
констебля	констебля
раздирайте	раздирайте
славистике	славистике
пробыть	пробыть
рассеяла	рассеяла
прославить	прославить
приготовила	приготовила
усилить	усилить
перлов	перлов
ехидным	ехидным
кидары	кидары
агванцев	агванцев
мало	мало
родили	родили
чувствительности	чувствительности
пожалело	пожалело
звали	звали
аболиционистское	аболиционистское
радеющий	радеющий
спрятать	спрятать
манжеты	манжеты
нечистою	нечистою
побудили	побудили
печатниками	печатниками
натапливает	натапливает
превозносила	превозносила
баллотируйся	баллотируйся
импортами	импортами
рабою	рабою
променяли	променяли
сагитировали	сагитировали
всякая	всякая
нездоровы	нездоровы
кирковые	кирковые
гонюсь	гонюсь
написанные	написанные
осознаете	осознаете
Самой	Самой
новом	новом
броневого	броневого
печаткой	печаткой
суставное	суставное
раздражили	раздражили
энтузиазма	энтузиазма
повысят	повысят
отучишь	отучишь
объявлявшийся	объявлявшийся
сомнительные	сомнительные
превозмогли	превозмогли
марсы	марсы
выслали	выслали
всасыванием	всасыванием
изменится	изменится
выспрошенный	выспрошенный
офигенностям	офигенностям
ракообразных	ракообразных
выпросили	выпросили
замер	замер
преклонился	преклонился
ворону	ворону
мельтешни	мельтешни
разить	разить
царе	царе
мамонтов	мамонтов
обгорело	обгорело
элиминированиях	элиминированиях
последовало	последовало
солнцестояние	солнцестояние
миниатюрные	миниатюрные
приносите	приносите
возлюбленный	возлюбленный
реконструировала	реконструировала
архиереями	архиереями
сними	сними
подули	подули
молодую	молодую
статуэтке	статуэтке
любимой	любимой
кроссовке	кроссовке
поправляем	поправляем
преподать	преподать
пройди	пройди
монументу	монументу
ракообразном	ракообразном
поддерживать	поддерживать
извратили	извратили
идентичной	идентичной
крупинки	крупинки
напрягу	напрягу
воззовем	воззовем
собранных	собранных
нечистых	нечистых
убогие	убогие
выносите	выносите
соевую	соевую
лесозаготовительный	лесозаготовительный
нам	нам
оставила	оставила
ломтика	ломтика
лирической	лирической
держите	держите
предшествовать	предшествовать
хорда	хорда
парадигме	парадигме
вынеси	вынеси
хранили	хранили
читай	читай
воспламенился	воспламенился
оно	оно
обручился	обручился
Она	Она
непоколебимое	непоколебимое
разрушен	разрушен
инфиксам	инфиксам
бесперспективным	бесперспективным
ним	ним
глядели	глядели
наши	наши
необрезан	необрезан
безделья	безделья
веник	веник
продемонстрируешься	продемонстрируешься
обветшали	обветшали
аффрикате	аффрикате
эпидемиологического	эпидемиологического
молила	молила
книжице	книжице
немую	немую
внимали	внимали
сему	сему
проломленный	проломленный
лужичанина	лужичанина
баги	баги
бордовой	бордовой
замкнут	замкнут
змеи	змеи
взирали	взирали
добавлениям	добавлениям
сироте	сироте
свекрови	свекрови
спрашивай	спрашивай
сострадать	сострадать
пристали	пристали
нимфы	нимфы
двойственностям	двойственностям
резная	резная
осквернился	осквернился
приветствовала	приветствовала
чёрточке	чёрточке
Моисееву	Моисееву
наш	наш
коррективом	коррективом
возносите	возносите
растянули	растянули
подаянию	подаянию
овладел	овладел
ритмического	ритмического
восхищения	восхищения
чехословацкого	чехословацкого
заимствования	заимствования
приводите	приводите
подмостки	подмостки
соделали	соделали
втросиловая	втросиловая
отнято	отнято
проскочить	проскочить
человекоубийца	человекоубийца
портативных	портативных
пристал	пристал
иной	иной
взалкал	взалкал
полустанке	полустанке
внимайте	внимайте
танкодром	танкодром
закономерности	закономерности
курчатовиям	курчатовиям
верование	верование
огнищанам	огнищанам
золоте	золоте
жаб	жаб
втискивайся	втискивайся
входных	входных
стороживший	стороживший
привалите	привалите
малым	малым
хазарине	хазарине
разводить	разводить
приближения	приближения
простецкую	простецкую
лиманам	лиманам
растите	растите
выдавать	выдавать
переваливалось	переваливалось
лешими	лешими
личном	личном
ржевитянин	ржевитянин
шести	шести
отринь	отринь
шкотиках	шкотиках
прямой	прямой
изложений	изложений
сущностным	сущностным
отнятое	отнятое
отважен	отважен
великой	великой
осознав	осознав
имбецилах	имбецилах
явок	явок
пейте	пейте
удалился	удалился
превышаешь	превышаешь
вылитых	вылитых
зарекомендуешь	зарекомендуешь
возделывали	возделывали
отгадать	отгадать
малые	малые
рассуждать	рассуждать
напали	напали
устрашили	устрашили
влез	влез
разжал	разжал
завладейте	завладейте
посвящали	посвящали
воду	воду
рабах	рабах
последовала	последовала
укрепляй	укрепляй
соделается	соделается
Мой	Мой
покрывать	покрывать
изводя	изводя
тумбочки	тумбочки
почитаю	почитаю
разбудили	разбудили
выслушать	выслушать
оттаиваю	оттаиваю
сокрой	сокрой
краны	краны
познаем	познаем
прищурят	прищурят
казахстанской	казахстанской
совратить	совратить
утверди	утверди
пострадали	пострадали
угробь	угробь
пихт	пихт
троюродных	троюродных
покройте	покройте
подоспеешь	подоспеешь
маньякам	маньякам
теплившийся	теплившийся
столпов	столпов
познаете	познаете
воздайте	воздайте
бедная	бедная
просили	просили
избирать	избирать
рудимент	рудимент
принимала	принимала
половины	половины
тройнях	тройнях
жилами	жилами
вторых	вторых
умножился	умножился
ломкую	ломкую
имейл	имейл
ручнистами	ручнистами
превышений	превышений
скрытых	скрытых
держи	держи
обвязывай	обвязывай
получите	получите
засел	засел
позвала	позвала
отвердений	отвердений
свету	свету
приказывала	приказывала
первым	первым
крестился	крестился
обитающие	обитающие
зарекомендуй	зарекомендуй
толщина	толщина
обтекающий	обтекающий
ненадежное	ненадежное
оплодотворяешь	оплодотворяешь
Над	Над
бесчестите	бесчестите
тангенсы	тангенсы
Приветствует	Приветствует
втором	втором
проклятые	проклятые
смолчав	смолчав
озеленении	озеленении
лососёвую	лососёвую
вкрадчивых	вкрадчивых
крылом	крылом
потаённое	потаённое
воспрепятствовал	воспрепятствовал
давиром	давиром
соедини	соедини
радиопередатчике	радиопередатчике
выверят	выверят
отягощали	отягощали
Этого	Этого
бранило	бранило
снимали	снимали
спросит	спросит
выкупи	выкупи
Вил	Вил
засыхай	засыхай
необработана	необработана
мифологии	мифологии
любим	любим
познаешь	познаешь
пузырьковая	пузырьковая
чехословацкий	чехословацкий
умоляла	умоляла
распахать	распахать
негодованием	негодованием
свои	свои
выкаливать	выкаливать
продали	продали
чертях	чертях
славя	славя
переправился	переправился
голени	голени
кровопролитием	кровопролитием
воспой	воспой
предавали	предавали
гиганта	гиганта
гувернантку	гувернантку
переберет	переберет
пали	пали
оживляй	оживляй
проходимцу	проходимцу
добре	добре
встроенной	встроенной
литыми	литыми
собранному	собранному
цветениях	цветениях
чёртом	чёртом
разорите	разорите
социал-демократическую	социал-демократическую
плену	плену
исповедалась	исповедалась
сухие	сухие
терафимы	терафимы
загнал	загнал
молчуна	молчуна
эмигрантского	эмигрантского
давали	давали
брезентом	брезентом
внутрь	внутрь
возвестится	возвестится
раздирать	раздирать
воспламенили	воспламенили
увеличился	увеличился
оных	оных
шоу-бизнесам	шоу-бизнесам
очаровательна	очаровательна
зеваем	зеваем
птичкою	птичкою
необходимые	необходимые
припомните	припомните
тихоходки	тихоходки
решающее	решающее
подразделяемся	подразделяемся
четвереньках	четвереньках
дерзновением	дерзновением
видим	видим
мертвых	мертвых
лицензирования	лицензирования
самых	самых
заколи	заколи
отринутый	отринутый
берем	берем
ратифицируемый	ратифицируемый
удалили	удалили
посылать	посылать
осведомлю	осведомлю
начать	начать
смутился	смутился
всасывания	всасывания
Одного	Одного
возносило	возносило
призывника	призывника
лежали	лежали
понос	понос
странствуем	странствуем
караимское	караимское
изменитесь	изменитесь
амёбный	амёбный
посылайте	посылайте
смешанною	смешанною
разведках	разведках
приобрела	приобрела
делали	делали
возлюбленной	возлюбленной
увещевать	увещевать
психики	психики
собранном	собранном
двойственности	двойственности
поправив	поправив
потекли	потекли
пил	пил
второй	второй
тонзуры	тонзуры
фазу	фазу
пока	пока
метровым	метровым
суди	суди
искушай	искушай
припекаете	припекаете
произвольный	произвольный
смешанных	смешанных
дезу	дезу
возвратили	возвратили
поручите	поручите
концентратами	концентратами
марафону	марафону
ослабел	ослабел
пухла	пухла
протянут	протянут
прострочить	прострочить
бронхит	бронхит
вселилась	вселилась
прищуриваешься	прищуриваешься
спорить	спорить
утехи	утехи
рукопашной	рукопашной
матери	матери
делаем	делаем
думайте	думайте
мутить	мутить
хватается	хватается
диспутировал	диспутировал
отаве	отаве
твою	твою
Возлюбленный	Возлюбленный
казахстанским	казахстанским
рождать	рождать
умещавшийся	умещавшийся
железобетонному	железобетонному
расслабь	расслабь
чиновница	чиновница
пространственной	пространственной
мала	мала
медлили	медлили
лишили	лишили
оттаивавший	оттаивавший
произносила	произносила
почитать	почитать
пасли	пасли
альманахе	альманахе
змея	змея
отказал	отказал
вносить	вносить
разделительным	разделительным
накожных	накожных
нечистой	нечистой
ожили	ожили
образа	образа
молодом	молодом
взываем	взываем
налагают	налагают
укативший	укативший
расцелуете	расцелуете
достаем	достаем
принятая	принятая
оставляли	оставляли
четвёртую	четвёртую
египтологе	египтологе
аутсайдера	аутсайдера
долог	долог
переправили	переправили
звезд	звезд
сторожить	сторожить
лееру	лееру
матерью	матерью
сердечно-сосудистым	сердечно-сосудистым
немы	немы
отплыл	отплыл
интернационализмами	интернационализмами
завершаться	завершаться
называть	называть
скрытой	скрытой
сухою	сухою
немой	немой
воскрешает	воскрешает
просчитывали	просчитывали
называй	называй
имеете	имеете
рулем	рулем
усилился	усилился
рассвирепели	рассвирепели
подбирала	подбирала
нарыва	нарыва
дилетантке	дилетантке
сумме	сумме
москвичка	москвичка
сербским	сербским
заразишь	заразишь
одет	одет
парсун	парсун
растила	растила
отправляйте	отправляйте
утекавший	утекавший
растаяли	растаяли
сформируемся	сформируемся
отдайте	отдайте
разводное	разводное
взять	взять
колпак	колпак
всесоюзным	всесоюзным
предвыборным	предвыборным
забирать	забирать
рассейте	рассейте
посохом	посохом
индустриализации	индустриализации
право	право
безволосого	безволосого
отключаешь	отключаешь
калачами	калачами
скрупулёзной	скрупулёзной
послужат	послужат
благочестии	благочестии
вещичкой	вещичкой
раздосадованных	раздосадованных
молодой	молодой
девчат	девчат
оградах	оградах
тюрьме	тюрьме
семинаром	семинаром
светя	светя
влезли	влезли
произошло	произошло
известите	известите
гениального	гениального
Моисеевы	Моисеевы
ночевали	ночевали
отчаялось	отчаялось
ренегаты	ренегаты
жив	жив
жабы	жабы
бесчестить	бесчестить
трактатами	трактатами
надели	надели
выводимый	выводимый
наскучили	наскучили
деля	деля
выговорить	выговорить
терафимов	терафимов
взывав	взывав
либрациям	либрациям
приношении	приношении
аборигенкой	аборигенкой
всходив	всходив
созывают	созывают
узнала	узнала
расспросы	расспросы
филологом	филологом
имели	имели
принимайте	принимайте
беден	беден
межчелюстной	межчелюстной
драматургами	драматургами
откажу	откажу
фундаментальной	фундаментальной
открытых	открытых
оздоровите	оздоровите
концентрату	концентрату
устроен	устроен
жабах	жабах
сладкие	сладкие
укрепляли	укрепляли
дёргал	дёргал
парализую	парализую
опубликовывайте	опубликовывайте
переберут	переберут
всесильных	всесильных
проси	проси
могли	могли
посвящать	посвящать
сокрыт	сокрыт
унывайте	унывайте
ночуете	ночуете
был	был
чувствительностью	чувствительностью
свалят	свалят
земляке	земляке
поручен	поручен
поняли	поняли
устремился	устремился
сестре	сестре
опубликовывавший	опубликовывавший
заграждать	заграждать
упоминать	упоминать
качествам	качествам
москвитянах	москвитянах
прямым	прямым
прибавить	прибавить
винных	винных
сверх	сверх
каждым	каждым
изложением	изложением
мной	мной
полустанкам	полустанкам
свалит	свалит
произносили	произносили
вступись	вступись
раздирающий	раздирающий
исправленном	исправленном
переночевали	переночевали
лучшую	лучшую
начинали	начинали
страшился	страшился
кончили	кончили
серебримый	серебримый
рукомойником	рукомойником
подбору	подбору
срач	срач
поступить	поступить
утомился	утомился
посмеянии	посмеянии
вихре	вихре
осквернить	осквернить
расслабят	расслабят
оказали	оказали
умудрился	умудрился
молили	молили
духовному	духовному
унынии	унынии
ткнусь	ткнусь
считают	считают
домой	домой
отдало	отдало
перебрасывав	перебрасывав
направить	направить
сотрудничество	сотрудничество
ломтиком	ломтиком
научи	научи
сатана	сатана
каждые	каждые
слепого	слепого
влепило	влепило
владычествовать	владычествовать
бухло	бухло
раздражите	раздражите
поджигая	поджигая
духовности	духовности
имейте	имейте
разоблачался	разоблачался
отчайся	отчайся
спасали	спасали
оздоровительного	оздоровительного
настоящем	настоящем
увенчиваете	увенчиваете
сопровождать	сопровождать
повторный	повторный
поменялось	поменялось
стабильностям	стабильностям
буркаете	буркаете
шлаку	шлаку
выносил	выносил
тюрьмой	тюрьмой
аргументирование	аргументирование
прибавите	прибавите
экстракту	экстракту
напялишь	напялишь
другой	другой
пумам	пумам
славив	славив
звезде	звезде
приложите	приложите
поядающий	поядающий
исследовать	исследовать
сказывали	сказывали
развеяла	развеяла
явился	явился
небом	небом
изымайте	изымайте
издёвкам	издёвкам
умудрить	умудрить
пузырьковую	пузырьковую
конденсатах	конденсатах
написали	написали
ревнуй	ревнуй
жокейского	жокейского
слушайте	слушайте
постелить	постелить
сработав	сработав
возлюбленном	возлюбленном
дельца	дельца
удерживать	удерживать
рушиться	рушиться
магазинчиком	магазинчиком
совершали	совершали
трубите	трубите
королькам	королькам
попечители	попечители
финалью	финалью
утешения	утешения
отринут	отринут
пихту	пихту
воспитывали	воспитывали
облокотятся	облокотятся
родинам	родинам
слепые	слепые
поддерживайте	поддерживайте
условие	условие
предсмертном	предсмертном
покой	покой
ручников	ручников
непоседой	непоседой
Бруклин	Бруклин
скуют	скуют
приняты	приняты
страшных	страшных
полиуретановой	полиуретановой
пылу	пылу
камню	камню
сладкою	сладкою
педантов	педантов
пожалел	пожалел
приклони	приклони
избивать	избивать
вина	вина
посплю	посплю
администраторам	администраторам
отвалят	отвалят
изливать	изливать
монополисту	монополисту
горькую	горькую
письмам	письмам
разбудила	разбудила
хлынул	хлынул
маловероятна	маловероятна
унывать	унывать
предавайте	предавайте
кричите	кричите
условливайтесь	условливайтесь
древесина	древесина
прудики	прудики
системную	системную
беззаконии	беззаконии
социал-демократическими	социал-демократическими
имеем	имеем
Буду	Буду
помышляйте	помышляйте
анатомировании	анатомировании
признают	признают
исполнительского	исполнительского
дружины	дружины
хвалить	хвалить
поднята	поднята
хоккейное	хоккейное
ведите	ведите
пожирали	пожирали
жилы	жилы
согласные	согласные
выговаривающий	выговаривающий
парализуешь	парализуешь
которую	которую
празднуйте	празднуйте
сморкавший	сморкавший
раскаливал	раскаливал
возвестивший	возвестивший
полагать	полагать
распознаем	распознаем
загородят	загородят
поносу	поносу
немногие	немногие
возобновят	возобновят
оболочке	оболочке
двудолен	двудолен
литая	литая
ехидной	ехидной
составили	составили
юливший	юливший
собирайте	собирайте
встревожился	встревожился
прекратился	прекратился
учить	учить
толкали	толкали
заваривают	заваривают
донесутся	донесутся
слепой	слепой
прошивав	прошивав
иные	иные
занимательного	занимательного
потухшим	потухшим
хвалит	хвалит
встречали	встречали
проводите	проводите
приложился	приложился
стрехи	стрехи
исполнили	исполнили
если	если
теснить	теснить
испытанного	испытанного
почетном	почетном
обрывает	обрывает
животном	животном
исландцев	исландцев
кидав	кидав
гинекологий	гинекологий
ксерокопированию	ксерокопированию
спустился	спустился
обжорах	обжорах
зажаривал	зажаривал
собственной	собственной
сберегите	сберегите
алкогольных	алкогольных
донесется	донесется
теснился	теснился
голыми	голыми
маскулинной	маскулинной
неради	неради
захвачу	захвачу
обваляй	обваляй
знойного	знойного
коровьему	коровьему
поя	поя
отпали	отпали
запрятывая	запрятывая
антивоенное	антивоенное
написанное	написанное
раздавить	раздавить
Бруклину	Бруклину
организаторах	организаторах
отдёргиваешь	отдёргиваешь
рениями	рениями
творили	творили
растишь	растишь
ухитрялся	ухитрялся
выросли	выросли
вознегодовал	вознегодовал
лежите	лежите
обесчестить	обесчестить
осложняете	осложняете
отговариваемый	отговариваемый
приступить	приступить
стоит	стоит
тварь	тварь
встряхнул	встряхнул
сохранность	сохранность
тюбетейке	тюбетейке
связь	связь
терпим	терпим
адвокате	адвокате
аттометр	аттометр
судив	судив
честные	честные
достать	достать
тумбочек	тумбочек
требовать	требовать
отверженному	отверженному
духовность	духовность
перестали	перестали
имущества	имущества
кровопролитное	кровопролитное
вэньяню	вэньяню
зеленого	зеленого
укатишь	укатишь
сгибался	сгибался
Жертвы	Жертвы
выбери	выбери
сфинкс	сфинкс
равномерной	равномерной
Моем	Моем
юркнет	юркнет
желтков	желтков
дорожа	дорожа
Одно	Одно
сем	сем
вооружает	вооружает
растили	растили
раскаливало	раскаливало
кульминации	кульминации
отключило	отключило
сгибаясь	сгибаясь
всплесков	всплесков
обгорели	обгорели
обставливаете	обставливаете
приковала	приковала
пространственным	пространственным
согрешите	согрешите
кибернетике	кибернетике
ксиву	ксиву
начислением	начислением
современности	современности
заколешь	заколешь
слышим	слышим
золотого	золотого
финиширующий	финиширующий
избавили	избавили
мертвого	мертвого
прочитайте	прочитайте
скользкое	скользкое
угловых	угловых
некрасива	некрасива
посрамился	посрамился
избить	избить
пузырьковое	пузырьковое
испёкшись	испёкшись
палить	палить
певший	певший
отступите	отступите
экстрадицию	экстрадицию
каждого	каждого
медвежатникам	медвежатникам
какой	какой
призовем	призовем
пред	пред
администраторе	администраторе
предъявляющийся	предъявляющийся
имеешь	имеешь
герцы	герцы
литому	литому
страноведению	страноведению
открытого	открытого
нуту	нуту
благообразных	благообразных
обозреть	обозреть
убили	убили
сам	сам
самом	самом
нейтралитетам	нейтралитетам
представлять	представлять
призвать	призвать
обвязывать	обвязывать
подбирать	подбирать
летев	летев
голове	голове
посохи	посохи
обжор	обжор
коммуналки	коммуналки
стабильная	стабильная
горилки	горилки
аудиторский	аудиторский
засыпали	засыпали
схоронили	схоронили
ночевать	ночевать
астробиологиях	астробиологиях
побивали	побивали
вычитаниях	вычитаниях
простывая	простывая
безвредна	безвредна
благородному	благородному
переставивший	переставивший
зипунам	зипунам
досадовать	досадовать
произнеси	произнеси
выть	выть
подул	подул
разматывал	разматывал
откормленные	откормленные
всякою	всякою
темени	темени
мастурбация	мастурбация
гордою	гордою
заглавие	заглавие
расслабила	расслабила
беды	беды
утолить	утолить
буркаешь	буркаешь
попирать	попирать
продать	продать
родным	родным
возвести	возвести
притвору	притвору
нехороша	нехороша
настаивали	настаивали
растапливаю	растапливаю
возвратить	возвратить
совершился	совершился
посчитанный	посчитанный
научить	научить
летите	летите
возвысился	возвысился
сокрытую	сокрытую
ослабела	ослабела
согласного	согласного
предсказывайте	предсказывайте
шали	шали
творить	творить
полициям	полициям
наихудший	наихудший
ней	ней
рассеянным	рассеянным
брюхоногий	брюхоногий
похвалить	похвалить
поющий	поющий
веривший	веривший
признали	признали
царях	царях
родных	родных
осел	осел
гусенице	гусенице
жертвах	жертвах
самою	самою
раздражен	раздражен
прямая	прямая
посрамить	посрамить
нагойским	нагойским
молился	молился
посрами	посрами
хлынь	хлынь
рукополагать	рукополагать
обновишься	обновишься
согрешили	согрешили
Сделай	Сделай
разделить	разделить
отлучите	отлучите
абсорбируемся	абсорбируемся
Мать	Мать
стебле	стебле
выстроиться	выстроиться
наборами	наборами
признаю	признаю
чужою	чужою
испекла	испекла
тугрика	тугрика
булавочных	булавочных
горько	горько
траву	траву
отстрелялась	отстрелялась
требовали	требовали
хулят	хулят
блудодействуешь	блудодействуешь
убийства	убийства
шубу	шубу
пасть	пасть
согрешишь	согрешишь
бросили	бросили
далёкую	далёкую
заперла	заперла
крымскотатарского	крымскотатарского
последуйте	последуйте
подпустят	подпустят
издательницы	издательницы
красочные	красочные
разрывал	разрывал
худ	худ
женевское	женевское
голою	голою
применения	применения
колет	колет
сгрузите	сгрузите
выстрелила	выстрелила
пригласитесь	пригласитесь
благотворительностями	благотворительностями
проломил	проломил
выполет	выполет
умерщвляй	умерщвляй
ловкостями	ловкостями
приветствуй	приветствуй
пить	пить
лучин	лучин
австрийском	австрийском
замазкам	замазкам
истовым	истовым
показывать	показывать
профессора	профессора
распухло	распухло
заключительной	заключительной
дивилось	дивилось
пев	пев
рубили	рубили
отмывайте	отмывайте
ромбиком	ромбиком
слез	слез
чину	чину
уславливаемся	уславливаемся
немого	немого
легли	легли
открыла	открыла
произносите	произносите
косишься	косишься
лгали	лгали
заручится	заручится
умилостивился	умилостивился
разбить	разбить
мести	мести
жутике	жутике
родила	родила
подвесную	подвесную
проводят	проводят
таитянах	таитянах
которые	которые
совместными	совместными
образе	образе
отавы	отавы
китайского	китайского
одушевленных	одушевленных
читали	читали
отнимите	отнимите
монополиста	монополиста
рассеку	рассеку
китайское	китайское
имеющий	имеющий
преподала	преподала
полу	полу
исполнила	исполнила
выудила	выудила
сухощав	сухощав
внучка	внучка
матерях	матерях
уничижила	уничижила
бейте	бейте
лекарю	лекарю
написал	написал
поручали	поручали
отнимали	отнимали
воевали	воевали
окутали	окутали
унизить	унизить
празднуй	празднуй
горьких	горьких
разбила	разбила
красного	красного
хранит	хранит
развалинами	развалинами
пазникам	пазникам
антигельминтного	антигельминтного
подставах	подставах
компьютерные	компьютерные
изделием	изделием
ели	ели
устное	устное
непостоянного	непостоянного
полы	полы
язву	язву
открой	открой
благословляли	благословляли
наводчиками	наводчиками
восстало	восстало
благоговеть	благоговеть
подумайте	подумайте
среду	среду
жокейские	жокейские
втросиловой	втросиловой
оном	оном
поникло	поникло
куражам	куражам
сатане	сатане
завистлив	завистлив
ферму	ферму
кадках	кадках
нормальные	нормальные
раскрытая	раскрытая
ухнули	ухнули
коряво	коряво
глухого	глухого
умоляй	умоляй
рыдание	рыдание
храню	храню
неувязке	неувязке
разодрала	разодрала
сахаридов	сахаридов
познали	познали
завтрашнему	завтрашнему
умирали	умирали
страшить	страшить
поцелуй	поцелуй
кончился	кончился
ненецкие	ненецкие
аргументированиях	аргументированиях
преуспевайте	преуспевайте
пребывать	пребывать
остром	остром
тяжестью	тяжестью
норный	норный
лососёвым	лососёвым
общиной	общиной
воскрешаю	воскрешаю
четвертую	четвертую
микрокатерах	микрокатерах
помогали	помогали
растерзали	растерзали
твердой	твердой
упоены	упоены
рентабельных	рентабельных
благовестить	благовестить
пролетай	пролетай
умерли	умерли
эгоист	эгоист
желанным	желанным
засаживал	засаживал
полюдьем	полюдьем
пребыли	пребыли
бедна	бедна
ждал	ждал
соделала	соделала
старом	старом
очистился	очистился
люди	люди
несдержанность	несдержанность
латинян	латинян
удержанием	удержанием
наступить	наступить
сердобольной	сердобольной
шёлкопрядильни	шёлкопрядильни
хвалился	хвалился
иное	иное
будете	будете
гитлеровском	гитлеровском
чему	чему
автотомии	автотомии
сокрушили	сокрушили
сторожей	сторожей
антисоветскую	антисоветскую
сближавшийся	сближавшийся
долгим	долгим
чтокая	чтокая
списали	списали
вступимся	вступимся
двум	двум
стереги	стереги
испытывайте	испытывайте
доступное	доступное
церковнославянских	церковнославянских
старта	старта
прожили	прожили
нахождения	нахождения
презентацией	презентацией
богатейшего	богатейшего
жителями	жителями
умножу	умножу
благовествуйте	благовествуйте
рубите	рубите
возвестит	возвестит
опустошили	опустошили
весёлым	весёлым
рассеял	рассеял
дозволительные	дозволительные
лишился	лишился
пристраиваешь	пристраиваешь
сошли	сошли
пища	пища
Матерь	Матерь
аттометрам	аттометрам
отгадали	отгадали
производите	производите
умолять	умолять
смирить	смирить
головами	головами
оскорблять	оскорблять
пластины	пластины
скривив	скривив
подборе	подборе
противостать	противостать
старых	старых
представляла	представляла
партией	партией
исцеляла	исцеляла
мыслите	мыслите
срывай	срывай
гекконов	гекконов
нержавеющим	нержавеющим
изменить	изменить
лоснимся	лоснимся
вынуждаешь	вынуждаешь
обо	обо
призвала	призвала
считает	считает
искало	искало
ожесточили	ожесточили
храним	храним
экспертизой	экспертизой
побудишь	побудишь
корольком	корольком
изымаем	изымаем
подпал	подпал
временное	временное
отпирать	отпирать
воронам	воронам
исцеляйте	исцеляйте
помилуй	помилуй
дружинами	дружинами
имеют	имеют
самым	самым
искома	искома
потускли	потускли
носили	носили
примиряющийся	примиряющийся
стильные	стильные
смешанная	смешанная
аннексии	аннексии
вытру	вытру
прикасающийся	прикасающийся
исполните	исполните
умножила	умножила
ношениям	ношениям
нечестием	нечестием
совершите	совершите
располагает	располагает
твари	твари
просеки	просеки
вероятной	вероятной
гадолиний	гадолиний
здравоохранениями	здравоохранениями
шатра	шатра
бузину	бузину
восстали	восстали
колбочкам	колбочкам
неясного	неясного
поединки	поединки
отсчитайте	отсчитайте
когереры	когереры
тысячу	тысячу
святой	святой
выпросился	выпросился
конъюнктурах	конъюнктурах
сербскохорватского	сербскохорватского
резавший	резавший
отдала	отдала
вознеси	вознеси
фундаментальный	фундаментальный
необрезанным	необрезанным
Мною	Мною
обрели	обрели
неверное	неверное
обирать	обирать
красоте	красоте
поехали	поехали
стеблю	стеблю
отпускать	отпускать
гей-парадах	гей-парадах
бедные	бедные
нормальны	нормальны
сила	сила
оробели	оробели
суммах	суммах
встал	встал
адептах	адептах
делить	делить
замедлили	замедлили
упырей	упырей
капишоны	капишоны
изгнанием	изгнанием
неправая	неправая
благодарив	благодарив
одела	одела
хотел	хотел
сохранили	сохранили
захлестнут	захлестнут
разговаривать	разговаривать
уснуть	уснуть
воздухоочистители	воздухоочистители
аркада	аркада
ножонок	ножонок
превратить	превратить
эту	эту
служили	служили
гипонимам	гипонимам
Святом	Святом
чужды	чужды
нарекла	нарекла
опротивело	опротивело
управляй	управляй
тёслами	тёслами
сторожа	сторожа
кранами	кранами
иноходи	иноходи
набором	набором
алкашей	алкашей
вынуждайте	вынуждайте
бабёнки	бабёнки
изумят	изумят
личностных	личностных
запоминались	запоминались
автограф	автограф
любить	любить
выстрелив	выстрелив
известит	известит
возвестило	возвестило
поддон	поддон
расслабим	расслабим
уповайте	уповайте
причастия	причастия
покаялся	покаялся
подсластителям	подсластителям
нему	нему
видеозаписями	видеозаписями
звездах	звездах
славило	славило
гумну	гумну
принять	принять
назидая	назидая
которой	которой
уверен	уверен
городовую	городовую
сохранить	сохранить
решите	решите
высвобожденный	высвобожденный
обгорел	обгорел
учительская	учительская
одетые	одетые
арматур	арматур
ахроматизм	ахроматизм
воспылали	воспылали
парадигмами	парадигмами
возвестите	возвестите
грешили	грешили
наскучил	наскучил
избранное	избранное
апорий	апорий
червь	червь
комплименты	комплименты
уразумейте	уразумейте
приказывали	приказывали
обветшало	обветшало
распорядку	распорядку
причинный	причинный
капитализациях	капитализациях
звезда	звезда
вселитесь	вселитесь
главврачи	главврачи
превозносишь	превозносишь
зелени	зелени
изменился	изменился
амёбное	амёбное
заклятых	заклятых
литом	литом
клинкерах	клинкерах
офигенности	офигенности
выдавай	выдавай
собирай	собирай
возьми	возьми
удочерила	удочерила
хулишь	хулишь
большой	большой
литое	литое
расслабит	расслабит
лесомелиоративные	лесомелиоративные
ввело	ввело
израильтянок	израильтянок
птичка	птичка
нарыве	нарыве
сверкания	сверкания
крупинок	крупинок
нута	нута
дремучую	дремучую
церий	церий
оздоровительной	оздоровительной
факелки	факелки
уклейки	уклейки
червю	червю
презирайте	презирайте
главным	главным
привела	привела
возмутился	возмутился
Приветствуй	Приветствуй
проклинать	проклинать
наказывай	наказывай
захоронений	захоронений
провожали	провожали
Лилиях	Лилиях
свернуться	свернуться
сгрузивший	сгрузивший
вернет	вернет
профессорами	профессорами
внутриматочного	внутриматочного
исполняй	исполняй
облокотись	облокотись
пострадал	пострадал
завихрениях	завихрениях
каждой	каждой
познают	познают
окрашивала	окрашивала
отплывите	отплывите
возносимый	возносимый
толки	толки
страшного	страшного
раскусываете	раскусываете
сопровождали	сопровождали
пассажире	пассажире
сказуемом	сказуемом
стихотворения	стихотворения
натянули	натянули
образу	образу
уведомляющий	уведомляющий
увела	увела
василька	василька
массируя	массируя
сманеврировало	сманеврировало
осядут	осядут
поручи	поручи
калужские	калужские
материалами	материалами
похвальным	похвальным
серебря	серебря
Тобою	Тобою
верованиями	верованиями
малого	малого
отвела	отвела
кроссовок	кроссовок
замерло	замерло
рекомендуйся	рекомендуйся
претерпеть	претерпеть
возроптал	возроптал
устрашился	устрашился
нечисты	нечисты
звездам	звездам
каждую	каждую
шатрах	шатрах
смирите	смирите
поручился	поручился
гномам	гномам
вонзили	вонзили
броситься	броситься
большого	большого
отступив	отступив
помнить	помнить
стерегли	стерегли
композиционна	композиционна
совету	совету
транспортировка	транспортировка
собранной	собранной
сангвиникам	сангвиникам
автографы	автографы
дщери	дщери
лексикона	лексикона
свекровь	свекровь
бедными	бедными
квашеная	квашеная
трущобе	трущобе
писакам	писакам
воплем	воплем
абакумычами	абакумычами
распух	распух
приучаешь	приучаешь
располагал	располагал
воздевающий	воздевающий
известим	известим
отделите	отделите
оробел	оробел
шлёпанцами	шлёпанцами
воссиял	воссиял
смешанного	смешанного
начерпали	начерпали
нечаянного	нечаянного
воевать	воевать
уповали	уповали
олами	олами
этой	этой
блюют	блюют
сквозив	сквозив
агульские	агульские
разгружала	разгружала
наезжая	наезжая
стоите	стоите
предсказывали	предсказывали
тысячи	тысячи
тысячами	тысячами
изводивший	изводивший
избранные	избранные
уведомляла	уведомляла
разделительной	разделительной
всевозможные	всевозможные
комнатушке	комнатушке
предстали	предстали
примечателен	примечателен
превозносят	превозносят
сторожам	сторожам
строжайшим	строжайшим
патриотизмам	патриотизмам
предоставится	предоставится
долгому	долгому
отступалось	отступалось
всплывайте	всплывайте
девяносто	девяносто
мещанку	мещанку
покрывали	покрывали
разорила	разорила
убывал	убывал
внесясь	внесясь
вил	вил
пуме	пуме
превозносив	превозносив
завладели	завладели
устроить	устроить
шлёпанцы	шлёпанцы
красных	красных
показывали	показывали
объявлялся	объявлялся
злы	злы
марсу	марсу
взмётывавшийся	взмётывавшийся
занятые	занятые
раскатала	раскатала
дозволительная	дозволительная
похвалили	похвалили
веруйте	веруйте
очищен	очищен
пощадивший	пощадивший
приходили	приходили
Надо	Надо
пленных	пленных
программами	программами
собирали	собирали
пролить	пролить
похоронили	похоронили
черви	черви
вопили	вопили
точила	точила
говорящий	говорящий
сонным	сонным
ручник	ручник
хранят	хранят
производили	производили
забив	забив
язвам	язвам
сожгли	сожгли
восходить	восходить
женевский	женевский
выговариваетесь	выговариваетесь
частых	частых
питать	питать
снотворными	снотворными
восстал	восстал
прельстился	прельстился
поступали	поступали
отдёргиваете	отдёргиваете
осведомило	осведомило
вникая	вникая
локализовав	локализовав
батутом	батутом
вороные	вороные
гистологии	гистологии
заперли	заперли
стремнистого	стремнистого
преуспевать	преуспевать
бронхита	бронхита
мирен	мирен
рыдайте	рыдайте
уставитесь	уставитесь
вспылили	вспылили
оказывать	оказывать
терпите	терпите
допускать	допускать
бакинцев	бакинцев
расположился	расположился
охраняйте	охраняйте
покачивав	покачивав
доброю	доброю
землетрясении	землетрясении
щучьего	щучьего
скрупулёзным	скрупулёзным
бубновые	бубновые
первое	первое
заколали	заколали
оправдать	оправдать
пустота	пустота
антикварки	антикварки
ради	ради
безоговорочных	безоговорочных
напечатают	напечатают
написанного	написанного
ниобиям	ниобиям
всякое	всякое
длинного	длинного
разумеешь	разумеешь
утечек	утечек
шлак	шлак
мною	мною
убитых	убитых
хватаюсь	хватаюсь
проводит	проводит
известят	известят
лоботрясом	лоботрясом
банде	банде
нейтралитеты	нейтралитеты
псарня	псарня
пророчествуйте	пророчествуйте
скверен	скверен
принесли	принесли
воспели	воспели
Свои	Свои
леших	леших
цели	цели
призовые	призовые
неправдой	неправдой
совершила	совершила
сказало	сказало
похороните	похороните
среды	среды
подвох	подвох
погоняющийся	погоняющийся
твердом	твердом
доказать	доказать
миниатюрную	миниатюрную
вынимали	вынимали
автоматизированного	автоматизированного
учите	учите
почерпнули	почерпнули
одетым	одетым
демонстрации	демонстрации
мстите	мстите
использовыванный	использовыванный
звезды	звезды
взяли	взяли
родословным	родословным
потаённые	потаённые
Теми	Теми
пищевые	пищевые
коровий	коровий
допевать	допевать
астигматизма	астигматизма
водилась	водилась
корявого	корявого
разбили	разбили
управляем	управляем
пожалеть	пожалеть
превознося	превознося
трясём	трясём
австралийку	австралийку
наихудшей	наихудшей
референдумам	референдумам
представляй	представляй
разбогатели	разбогатели
разгневал	разгневал
приобщились	приобщились
сказывай	сказывай
измерительных	измерительных
отсчитай	отсчитай
срывали	срывали
парализуют	парализуют
парализуя	парализуя
соблюдем	соблюдем
отказывай	отказывай
послужу	послужу
отвесно	отвесно
соблюдали	соблюдали
перетекая	перетекая
диспут	диспут
второе	второе
вороха	вороха
внутриматочным	внутриматочным
нынешнему	нынешнему
мотылькам	мотылькам
реши	реши
восемью	восемью
сквозного	сквозного
наполняло	наполняло
собранный	собранный
громадой	громадой
предназначились	предназначились
интегрируетесь	интегрируетесь
накрывшийся	накрывшийся
бабёнке	бабёнке
возьмут	возьмут
спит	спит
тому	тому
отступали	отступали
пассивной	пассивной
какая	какая
обращена	обращена
духовное	духовное
твоем	твоем
обещали	обещали
низине	низине
приводили	приводили
дугообразная	дугообразная
воспитывала	воспитывала
аркадах	аркадах
благоговели	благоговели
вине	вине
утерпишь	утерпишь
самаркандское	самаркандское
сводом	сводом
наполняла	наполняла
вычитания	вычитания
упоминай	упоминай
расцеловав	расцеловав
располагая	располагая
послуживший	послуживший
горьким	горьким
долгом	долгом
обирал	обирал
малы	малы
молчите	молчите
рехнулся	рехнулся
маклерам	маклерам
доказали	доказали
заручись	заручись
почитал	почитал
превозносить	превозносить
обстреливало	обстреливало
передвигают	передвигают
подсмотренный	подсмотренный
банкротства	банкротства
наливай	наливай
хотят	хотят
привился	привился
завихрение	завихрение
выговоришь	выговоришь
распашете	распашете
исправлять	исправлять
маловероятный	маловероятный
дремучим	дремучим
впала	впала
зачаровали	зачаровали
наружности	наружности
постигли	постигли
исследовали	исследовали
скопцы	скопцы
оттаивает	оттаивает
оба	оба
пловцом	пловцом
оптимистического	оптимистического
неверные	неверные
десятой	десятой
пробуждали	пробуждали
углубление	углубление
води	води
слизистое	слизистое
павильоном	павильоном
задумываете	задумываете
вторичны	вторичны
катеростроителями	катеростроителями
террористическая	террористическая
наказом	наказом
первого	первого
усядешься	усядешься
удерживайте	удерживайте
вмещала	вмещала
термины	термины
животное	животное
стерегла	стерегла
расслабили	расслабили
пьянствуете	пьянствуете
сади	сади
банкротствах	банкротствах
лицом	лицом
несмысленное	несмысленное
ввязывался	ввязывался
выдаст	выдаст
расставляйте	расставляйте
поднимали	поднимали
приручайте	приручайте
совершись	совершись
взыскать	взыскать
повеления	повеления
профита	профита
изморозях	изморозях
кляче	кляче
оскверните	оскверните
чужд	чужд
выведя	выведя
выпал	выпал
горькое	горькое
вестовым	вестовым
тесните	тесните
выбрасывайте	выбрасывайте
межчелюстные	межчелюстные
петый	петый
вепсским	вепсским
унизили	унизили
вашу	вашу
подкрепили	подкрепили
фарерских	фарерских
махнули	махнули
взалкали	взалкали
объедать	объедать
утихли	утихли
отличен	отличен
пропали	пропали
раскатанный	раскатанный
волосатая	волосатая
судите	судите
выпадения	выпадения
выгнали	выгнали
неординарной	неординарной
скрывай	скрывай
рыданию	рыданию
адаптировавший	адаптировавший
областеначальником	областеначальником
безвластной	безвластной
Святым	Святым
обитать	обитать
передвигай	передвигай
уснул	уснул
Лазарь	Лазарь
расиста	расиста
просчитываемый	просчитываемый
спросите	спросите
нашем	нашем
бедной	бедной
какую	какую
тихоходке	тихоходке
прорицателей	прорицателей
чешет	чешет
Который	Который
удалите	удалите
потаенные	потаенные
поединках	поединках
убедил	убедил
увивать	увивать
соделались	соделались
умирающий	умирающий
получить	получить
оправдай	оправдай
фанатами	фанатами
сия	сия
ваше	ваше
чёрта	чёрта
отнятых	отнятых
книжицы	книжицы
острой	острой
претенциозную	претенциозную
господством	господством
детях	детях
вытесняла	вытесняла
избрала	избрала
скрыли	скрыли
сделала	сделала
абиотрофию	абиотрофию
гумном	гумном
отсрочиваете	отсрочиваете
временные	временные
ассоциируете	ассоциируете
страшилищ	страшилищ
вмещать	вмещать
пугал	пугал
губим	губим
возношу	возношу
покрою	покрою
сейте	сейте
субботний	субботний
большакам	большакам
обогатила	обогатила
лег	лег
напоминать	напоминать
колу	колу
педанту	педанту
рассеяли	рассеяли
полтергейстами	полтергейстами
фторы	фторы
генитального	генитального
потребы	потребы
подстерегали	подстерегали
выведенный	выведенный
поправил	поправил
ждавший	ждавший
ширить	ширить
выводило	выводило
жертва	жертва
антивоенными	антивоенными
храбрец	храбрец
обрела	обрела
комнатушки	комнатушки
гипонимах	гипонимах
неутешительной	неутешительной
подняты	подняты
устрашить	устрашить
оползень	оползень
ночуют	ночуют
пересказывай	пересказывай
мгновенную	мгновенную
петли	петли
вся	вся
приложили	приложили
красоту	красоту
собрать	собрать
ревнуйте	ревнуйте
посылала	посылала
напоить	напоить
прозы	прозы
подслушивания	подслушивания
маньяках	маньяках
позолотите	позолотите
погонялась	погонялась
причитающийся	причитающийся
прокаженные	прокаженные
замедлите	замедлите
бензиновую	бензиновую
атлеток	атлеток
Вся	Вся
благовестием	благовестием
горюю	горюю
эпитафия	эпитафия
приветствовали	приветствовали
поморщитесь	поморщитесь
аболиционистской	аболиционистской
Возлюбленного	Возлюбленного
уронила	уронила
завладел	завладел
сожигали	сожигали
прозрели	прозрели
служанкою	служанкою
освободился	освободился
будь	будь
утешении	утешении
припекаем	припекаем
сделай	сделай
раздели	раздели
полиуретановому	полиуретановому
мошенникам	мошенникам
ступенька	ступенька
лучникам	лучникам
уславливался	уславливался
веди	веди
выводили	выводили
собирать	собирать
патриотизм	патриотизм
сжимаешь	сжимаешь
