samlades	samlades
höres	höres
Sådant	Sådant
Ismaels	Ismaels
allt	allt
vise	vise
bok	bok
besökt	besökt
Rehabeams	Rehabeams
Kanaan	Kanaan
Lod	Lod
krigarna	krigarna
tröstar	tröstar
rädd	rädd
driva	driva
döpes	döpes
läkt	läkt
slakt	slakt
siares	siares
företaga	företaga
upplöst	upplöst
somt	somt
Asaf	Asaf
sådana	sådana
renat	renat
lovade	lovade
låga	låga
Aran	Aran
Babel	Babel
libyerna	libyerna
Aten	Aten
kastade	kastade
Meriba	Meriba
vant	vant
blotten	blotten
Tre	Tre
avfallen	avfallen
rannsakade	rannsakade
sliten	sliten
råds	råds
slösare	slösare
upphöjt	upphöjt
man	man
Mose	Mose
byten	byten
räta	räta
trätt	trätt
finnes	finnes
kriget	kriget
borgare	borgare
Ned	Ned
avbärga	avbärga
vilken	vilken
ställen	ställen
beviset	beviset
stadiers	stadiers
fyllen	fyllen
Högstes	Högstes
Akbor	Akbor
taga	taga
ställt	ställt
mana	mana
bortförda	bortförda
vänt	vänt
brus	brus
upphöjde	upphöjde
Hanoks	Hanoks
Arba	Arba
gräten	gräten
Susan	Susan
Ingen	Ingen
uträckt	uträckt
bruse	bruse
anklagare	anklagare
städerna	städerna
avbärgade	avbärgade
Hasor	Hasor
fostrade	fostrade
öre	öre
Hebron	Hebron
Talen	Talen
hållen	hållen
huggen	huggen
överstes	överstes
uträcken	uträcken
stjäla	stjäla
Efron	Efron
skugga	skugga
betrycktes	betrycktes
vårdar	vårdar
nästa	nästa
bortrycktes	bortrycktes
dennas	dennas
enes	enes
kor	kor
mödar	mödar
Milkas	Milkas
hörare	hörare
ökade	ökade
bröder	bröder
länder	länder
trängde	trängde
Båda	Båda
blottade	blottade
beskärda	beskärda
Lemeks	Lemeks
förtryckt	förtryckt
Aner	Aner
förgjorda	förgjorda
vika	vika
Hul	Hul
mördande	mördande
varde	varde
Högste	Högste
Dessa	Dessa
förres	förres
Noa	Noa
avhållen	avhållen
sko	sko
hålen	hålen
kände	kände
liden	liden
Persiens	Persiens
Abida	Abida
övergiva	övergiva
arglistighet	arglistighet
svälja	svälja
Persien	Persien
Ehuds	Ehuds
spott	spott
efterfölja	efterfölja
bin	bin
bästa	bästa
drogs	drogs
tillgiven	tillgiven
uppgiven	uppgiven
handla	handla
aga	aga
skjuta	skjuta
vanärade	vanärade
spände	spände
vila	vila
spotten	spotten
budens	budens
släppe	släppe
tänke	tänke
Sina	Sina
förtälj	förtälj
Hanok	Hanok
travare	travare
Rabba	Rabba
tillredes	tillredes
bortkastad	bortkastad
anden	anden
förgjordes	förgjordes
Efraim	Efraim
Nea	Nea
biträde	biträde
Maria	Maria
Johanna	Johanna
Vilken	Vilken
snärjas	snärjas
Rehabeam	Rehabeam
Gera	Gera
Elis	Elis
Marias	Marias
Bekers	Bekers
Jair	Jair
fast	fast
vis	vis
hylla	hylla
förlitat	förlitat
omsluta	omsluta
rätas	rätas
Simons	Simons
Lea	Lea
Sadok	Sadok
Noas	Noas
förlikt	förlikt
jublande	jublande
mala	mala
förstörs	förstörs
fråga	fråga
segrar	segrar
tjänarna	tjänarna
vit	vit
kort	kort
Guds	Guds
Beria	Beria
Ande	Ande
fören	fören
Hanan	Hanan
vitt	vitt
stores	stores
ring	ring
värme	värme
täckta	täckta
rev	rev
hövdingdöme	hövdingdöme
Diana	Diana
följe	följe
hören	hören
görare	görare
fyllas	fyllas
läger	läger
förehaves	förehaves
vissna	vissna
vett	vett
Heber	Heber
fattat	fattat
betade	betade
behållna	behållna
Farao	Farao
vederkvicka	vederkvicka
räcken	räcken
träta	träta
menade	menade
arbetare	arbetare
vållen	vållen
vakade	vakade
befälhavare	befälhavare
Abram	Abram
Tabors	Tabors
göres	göres
tränga	tränga
förblive	förblive
gören	gören
Simmas	Simmas
kramade	kramade
vreden	vreden
Isebels	Isebels
upptänden	upptänden
givare	givare
Jerusalem	Jerusalem
uppgivna	uppgivna
Tagen	Tagen
Sutelas	Sutelas
Et	Et
Israel	Israel
utsläckes	utsläckes
Eliesers	Eliesers
inbärgen	inbärgen
gudsfruktan	gudsfruktan
bereda	bereda
göda	göda
spridde	spridde
översta	översta
uppfyllen	uppfyllen
lärare	lärare
siare	siare
svalkas	svalkas
glädes	glädes
rannsaken	rannsaken
Ada	Ada
nitälsken	nitälsken
bägare	bägare
sport	sport
smälta	smälta
Dennes	Dennes
höre	höre
Gads	Gads
slagna	slagna
ledas	ledas
lösen	lösen
budbärarna	budbärarna
märkt	märkt
viljen	viljen
kramades	kramades
säljes	säljes
upphäven	upphäven
visa	visa
anlete	anlete
hölje	hölje
hurudan	hurudan
sovo	sovo
uppsatta	uppsatta
axet	axet
nitälskan	nitälskan
föröke	föröke
läses	läses
Gode	Gode
Moses	Moses
självt	självt
fyllde	fyllde
smälte	smälte
Tamars	Tamars
Betuels	Betuels
utvalde	utvalde
upphöjd	upphöjd
yngstes	yngstes
Helt	Helt
Resa	Resa
förgöra	förgöra
omsluten	omsluten
Beta	Beta
mods	mods
Vars	Vars
bestämda	bestämda
mödade	mödade
våldsverkares	våldsverkares
ända	ända
sälje	sälje
lärd	lärd
råd	råd
ställa	ställa
förökades	förökades
anförare	anförare
hjälpare	hjälpare
förstörd	förstörd
sköte	sköte
längtan	längtan
sova	sova
orena	orena
sakens	sakens
bränna	bränna
dräpes	dräpes
Isaks	Isaks
Esaus	Esaus
gräte	gräte
räknades	räknades
Sjustjärnorna	Sjustjärnorna
utvaldas	utvaldas
räknen	räknen
fördragen	fördragen
uträcker	uträcker
Massa	Massa
tänk	tänk
hämnas	hämnas
Libanons	Libanons
skuggade	skuggade
Samarias	Samarias
tungas	tungas
samme	samme
hacka	hacka
Dan	Dan
vandrade	vandrade
väckas	väckas
utrote	utrote
Jakob	Jakob
glänsa	glänsa
förbytt	förbytt
Hiskia	Hiskia
samma	samma
säga	säga
Bröder	Bröder
tankarna	tankarna
bortryckta	bortryckta
grunden	grunden
föra	föra
lagen	lagen
sköten	sköten
utbredda	utbredda
överfallen	överfallen
mista	mista
näpsa	näpsa
förströdde	förströdde
fördärv	fördärv
Husas	Husas
Libanon	Libanon
strids	strids
halt	halt
betryckta	betryckta
bägarna	bägarna
förgäte	förgäte
uträcka	uträcka
rike	rike
falle	falle
utföres	utföres
planterade	planterade
täckes	täckes
hemsöka	hemsöka
etiopierna	etiopierna
fört	fört
talades	talades
hållna	hållna
råka	råka
fattade	fattade
vårdare	vårdare
menen	menen
Amminadabs	Amminadabs
döme	döme
förtryck	förtryck
Kain	Kain
vätas	vätas
lägges	lägges
fruktade	fruktade
fatten	fatten
minne	minne
säljare	säljare
Jonatans	Jonatans
enas	enas
röras	röras
fiskare	fiskare
stinka	stinka
förstörda	förstörda
träda	träda
räckas	räckas
bäres	bäres
Salem	Salem
som	som
Vakna	Vakna
betäckt	betäckt
ofta	ofta
råkade	råkade
förtäre	förtäre
betäcka	betäcka
gripna	gripna
mätta	mätta
lever	lever
tiga	tiga
Sjustjärnornas	Sjustjärnornas
släkterna	släkterna
bestämde	bestämde
försörjare	försörjare
smide	smide
höj	höj
dessas	dessas
Seirs	Seirs
knyte	knyte
sköta	sköta
Onan	Onan
Sådana	Sådana
domar	domar
fötterna	fötterna
vetet	vetet
rycke	rycke
Vilka	Vilka
invigen	invigen
Ana	Ana
Hebers	Hebers
födes	födes
öga	öga
höje	höje
bot	bot
frambär	frambär
göre	göre
Sauls	Sauls
uppfylle	uppfylle
draga	draga
funne	funne
arglistige	arglistige
lånen	lånen
byarna	byarna
gömmes	gömmes
dragna	dragna
fullbordades	fullbordades
uppföra	uppföra
Jakobs	Jakobs
utforskade	utforskade
Bosra	Bosra
kläder	kläder
inbärga	inbärga
drivas	drivas
rörande	rörande
förnimmen	förnimmen
funno	funno
förökade	förökade
sina	sina
Kemuel	Kemuel
koken	koken
Assur	Assur
undan	undan
övergive	övergive
uträckas	uträckas
rädes	rädes
utbredde	utbredde
mäta	mäta
viskade	viskade
vare	vare
erövrade	erövrade
förfölja	förfölja
flytt	flytt
Salman	Salman
sjunge	sjunge
sken	sken
Naftalis	Naftalis
årens	årens
Tamar	Tamar
Sanna	Sanna
gömmas	gömmas
Saul	Saul
Bosras	Bosras
plåga	plåga
uppfylla	uppfylla
blåst	blåst
ena	ena
förhärligen	förhärligen
hala	hala
försvunno	försvunno
läras	läras
ende	ende
täckte	täckte
knyta	knyta
läge	läge
loven	loven
dragen	dragen
släckt	släckt
Davids	Davids
höljas	höljas
brunne	brunne
efterföljare	efterföljare
rycka	rycka
Abrahams	Abrahams
fött	fött
Din	Din
förlita	förlita
binda	binda
mött	mött
värmen	värmen
store	store
Berias	Berias
Bara	Bara
hörda	hörda
vederkvickt	vederkvickt
låta	låta
Efrons	Efrons
hålla	hålla
hjälpt	hjälpt
avhålla	avhålla
bjudna	bjudna
röres	röres
förunne	förunne
Susa	Susa
koret	koret
Asas	Asas
Mahalalels	Mahalalels
tvagna	tvagna
grumlen	grumlen
plågade	plågade
Abiram	Abiram
Akaja	Akaja
dräpa	dräpa
jublen	jublen
uppförde	uppförde
stadga	stadga
köpare	köpare
löpen	löpen
Elia	Elia
byggda	byggda
Manasse	Manasse
åt	åt
moder	moder
förlike	förlike
följande	följande
genomsöka	genomsöka
anställa	anställa
tills	tills
Berea	Berea
böjes	böjes
köpt	köpt
vilka	vilka
marker	marker
flögo	flögo
vandrarna	vandrarna
gjutna	gjutna
säge	säge
vars	vars
Anaks	Anaks
täcke	täcke
stigen	stigen
förkunnades	förkunnades
sälja	sälja
omgivna	omgivna
låge	låge
kläda	kläda
Inga	Inga
drucken	drucken
försörja	försörja
nymånadsdagen	nymånadsdagen
mördade	mördade
blindas	blindas
spännen	spännen
drive	drive
förskräcka	förskräcka
lutade	lutade
No	No
skrymtade	skrymtade
stänger	stänger
fetmas	fetmas
Ruben	Ruben
vända	vända
stänkes	stänkes
Abimelek	Abimelek
varandra	varandra
beskäres	beskäres
skrymtan	skrymtan
tog	tog
lögnprofeternas	lögnprofeternas
hjärtat	hjärtat
drage	drage
märke	märke
Het	Het
Efraims	Efraims
sjuka	sjuka
tillträde	tillträde
förgjorde	förgjorde
förlåta	förlåta
Judas	Judas
tjänen	tjänen
fetma	fetma
uppgiva	uppgiva
döpa	döpa
marks	marks
bunden	bunden
hugges	hugges
jämt	jämt
klädda	klädda
väckes	väckes
Lot	Lot
uppsatte	uppsatte
Sikem	Sikem
övrigas	övrigas
anställd	anställd
upphäves	upphäves
Kabul	Kabul
förhärligade	förhärligade
omsnärjde	omsnärjde
förbytes	förbytes
löst	löst
gödda	gödda
störes	störes
sålda	sålda
besöka	besöka
Milka	Milka
fylla	fylla
agade	agade
invig	invig
utsträckt	utsträckt
besatte	besatte
Den	Den
sitter	sitter
skifte	skifte
fylld	fylld
väljen	väljen
hjälpa	hjälpa
släktet	släktet
ens	ens
köpa	köpa
fallna	fallna
utfören	utfören
intagen	intagen
tröstare	tröstare
skrapa	skrapa
äldstes	äldstes
rådande	rådande
drages	drages
förstören	förstören
stor	stor
Bela	Bela
resande	resande
oftare	oftare
binde	binde
bindes	bindes
stjärntydarna	stjärntydarna
uppfödd	uppfödd
till	till
höljes	höljes
korer	korer
mödat	mödat
förstöres	förstöres
uppföda	uppföda
yngste	yngste
upphöjda	upphöjda
vin	vin
Denne	Denne
San	San
förföljare	förföljare
Joas	Joas
Kemuels	Kemuels
Akajas	Akajas
styrka	styrka
söks	söks
rest	rest
dröj	dröj
döma	döma
Beker	Beker
Dans	Dans
förtäres	förtäres
Judeen	Judeen
övriga	övriga
Sutela	Sutela
sabbat	sabbat
plats	plats
böjt	böjt
anletes	anletes
Jafets	Jafets
anklagades	anklagades
vänd	vänd
Seras	Seras
ringas	ringas
Jered	Jered
skiften	skiften
bespejare	bespejare
vandren	vandren
gångar	gångar
lysande	lysande
hugga	hugga
give	give
kokt	kokt
droge	droge
mötes	mötes
nedgjorde	nedgjorde
vittne	vittne
jämte	jämte
Haso	Haso
dragare	dragare
dödas	dödas
bygges	bygges
stadier	stadier
fördöma	fördöma
skapare	skapare
Nod	Nod
slaktet	slaktet
före	före
talen	talen
behövande	behövande
arglistigt	arglistigt
Heles	Heles
blinda	blinda
bortföra	bortföra
född	född
Joa	Joa
udd	udd
skiftade	skiftade
givna	givna
fortfare	fortfare
Nebajots	Nebajots
Beten	Beten
deltaga	deltaga
omvända	omvända
uppbygges	uppbygges
manas	manas
fyll	fyll
tillreds	tillreds
både	både
uppfyllda	uppfyllda
levande	levande
slites	slites
vana	vana
renade	renade
fostrare	fostrare
ammade	ammade
undantagna	undantagna
burna	burna
läs	läs
bon	bon
friköpa	friköpa
given	given
tage	tage
upptaga	upptaga
ekar	ekar
stadgas	stadgas
verkade	verkade
upptändas	upptändas
göra	göra
äldste	äldste
skarpa	skarpa
borgar	borgar
uppröres	uppröres
frossare	frossare
grunda	grunda
förkunnare	förkunnare
Jairs	Jairs
stoderna	stoderna
hjärtas	hjärtas
förödes	förödes
vrede	vrede
vida	vida
täckts	täckts
veta	veta
bäre	bäre
gör	gör
höra	höra
armen	armen
sakerna	sakerna
sålde	sålde
vållade	vållade
fördärvade	fördärvade
skrämmes	skrämmes
kasten	kasten
skapade	skapade
Leviatan	Leviatan
havande	havande
öken	öken
brändes	brändes
gileaditen	gileaditen
göden	göden
eder	eder
förehaven	förehaven
bräde	bräde
beskära	beskära
ansedda	ansedda
frossa	frossa
drives	drives
smältes	smältes
bortförde	bortförde
styrkas	styrkas
frälsare	frälsare
överdragna	överdragna
brinna	brinna
Denna	Denna
söka	söka
stärka	stärka
kända	kända
Naftali	Naftali
Jerusalems	Jerusalems
föden	föden
prisade	prisade
födas	födas
betänk	betänk
Hebrons	Hebrons
inga	inga
dåd	dåd
tillredda	tillredda
vanära	vanära
lära	lära
tänka	tänka
fästas	fästas
vakar	vakar
förtära	förtära
anfallen	anfallen
stört	stört
förundren	förundren
vaken	vaken
upplåten	upplåten
gånge	gånge
nödgas	nödgas
vilade	vilade
Merari	Merari
såren	såren
ringare	ringare
Belas	Belas
sans	sans
Jotam	Jotam
Joram	Joram
visade	visade
löpa	löpa
revo	revo
Rubens	Rubens
badade	badade
eds	eds
bortfört	bortfört
upptagen	upptagen
grumlade	grumlade
rådde	rådde
betänkte	betänkte
hemsökes	hemsökes
varen	varen
Abrams	Abrams
Jafet	Jafet
handlade	handlade
avlat	avlat
förtärda	förtärda
Vaken	Vaken
Kedars	Kedars
förvaltade	förvaltade
luta	luta
fördömen	fördömen
förnimma	förnimma
Gad	Gad
Hanes	Hanes
Gud	Gud
förstöra	förstöra
bortkastat	bortkastat
ägare	ägare
betydande	betydande
gläds	gläds
varandras	varandras
tiger	tiger
planteren	planteren
bunde	bunde
spejade	spejade
minnes	minnes
kysst	kysst
bespejen	bespejen
Satans	Satans
synas	synas
hot	hot
upphöjen	upphöjen
beträden	beträden
läkare	läkare
Nebo	Nebo
avmätt	avmätt
födda	födda
vanna	vanna
Ai	Ai
domarna	domarna
gräto	gräto
dröja	dröja
sådanas	sådanas
förlöst	förlöst
lames	lames
förras	förras
förbliva	förbliva
fördömde	fördömde
utrotade	utrotade
vita	vita
ställd	ställd
Anak	Anak
Det	Det
Anatot	Anatot
snärjda	snärjda
förtryckare	förtryckare
frågade	frågade
Gat	Gat
skilda	skilda
steka	steka
Nilens	Nilens
Rahab	Rahab
sträckt	sträckt
stinkande	stinkande
Josefs	Josefs
släktens	släktens
spänna	spänna
Hulda	Hulda
Hanna	Hanna
tillhöra	tillhöra
Edom	Edom
äte	äte
bortkastade	bortkastade
Serubbabel	Serubbabel
än	än
Melek	Melek
förlik	förlik
Joktans	Joktans
predikat	predikat
uppbyggda	uppbyggda
vilkas	vilkas
träd	träd
sådda	sådda
HERRENs	HERRENs
följda	följda
dräpen	dräpen
trängt	trängt
Joktan	Joktan
agas	agas
ökades	ökades
frambära	frambära
styrkt	styrkt
Melkisedek	Melkisedek
stjälen	stjälen
Bered	Bered
samlen	samlen
denna	denna
många	många
markerna	markerna
vittnade	vittnade
Asa	Asa
förströdda	förströdda
vara	vara
lame	lame
övergivna	övergivna
uppväcka	uppväcka
visst	visst
miste	miste
anföra	anföra
brinnande	brinnande
fordran	fordran
blottas	blottas
Ard	Ard
förtrycken	förtrycken
tages	tages
fällas	fällas
mätt	mätt
denne	denne
gileaditerna	gileaditerna
budbärare	budbärare
föda	föda
Nebajot	Nebajot
korn	korn
uppförd	uppförd
sålden	sålden
arme	arme
Rahabs	Rahabs
pelarna	pelarna
amma	amma
beredd	beredd
stänka	stänka
hövdingdömet	hövdingdömet
ha	ha
Rebeckas	Rebeckas
bedraga	bedraga
Seir	Seir
upprörd	upprörd
brunnens	brunnens
kläde	kläde
undantagen	undantagen
manade	manade
vedergälla	vedergälla
hölja	hölja
giva	giva
Leas	Leas
kommande	kommande
höjen	höjen
Ais	Ais
resa	resa
första	första
slicke	slicke
Sådan	Sådan
drivna	drivna
sådan	sådan
Bileam	Bileam
utlysa	utlysa
förkunnen	förkunnen
förföljda	förföljda
lika	lika
möta	möta
lidande	lidande
dräp	dräp
fordren	fordren
våldsverkarna	våldsverkarna
gömma	gömma
lärde	lärde
beta	beta
klöv	klöv
vid	vid
Sisaks	Sisaks
drog	drog
uppfyll	uppfyll
räckt	räckt
hindarna	hindarna
inbärgar	inbärgar
synd	synd
lider	lider
var	var
svalka	svalka
året	året
saker	saker
Hans	Hans
stadgar	stadgar
överdragen	överdragen
skapades	skapades
resas	resas
Mahalalel	Mahalalel
hjärta	hjärta
församlas	församlas
platserna	platserna
håla	håla
Dina	Dina
Lotan	Lotan
etiopier	etiopier
skänkt	skänkt
gileadit	gileadit
utforsken	utforsken
vattnas	vattnas
nästas	nästas
falls	falls
dennes	dennes
vätt	vätt
återstodo	återstodo
tjänare	tjänare
ställde	ställde
hava	hava
friköpt	friköpt
viken	viken
nymånadsdagar	nymånadsdagar
ringa	ringa
utroten	utroten
Aras	Aras
äga	äga
täckt	täckt
stänga	stänga
rövare	rövare
funna	funna
Balaks	Balaks
brödet	brödet
sports	sports
anställde	anställde
städ	städ
Att	Att
gångerna	gångerna
bärare	bärare
den	den
handlar	handlar
Alls	Alls
hörn	hörn
stadgen	stadgen
like	like
döm	döm
förra	förra
förehava	förehava
Ain	Ain
hoppade	hoppade
Assyriens	Assyriens
bröderna	bröderna
tillträda	tillträda
behållare	behållare
förunnade	förunnade
fattas	fattas
rövade	rövade
skrapade	skrapade
lytt	lytt
slaktade	slaktade
tillgiva	tillgiva
Taga	Taga
uppgives	uppgives
gräns	gräns
klädde	klädde
korsar	korsar
sann	sann
talar	talar
Husen	Husen
stängda	stängda
dukade	dukade
uppfylles	uppfylles
styrkes	styrkes
förlika	förlika
Balak	Balak
Judeens	Judeens
Natan	Natan
lysa	lysa
bestänkt	bestänkt
fördärvades	fördärvades
hals	hals
gränserna	gränserna
Lemek	Lemek
döpt	döpt
Kanaans	Kanaans
Eder	Eder
väns	väns
Uria	Uria
mättas	mättas
fallen	fallen
betrycktas	betrycktas
förste	förste
Jesajas	Jesajas
Varde	Varde
övergiven	övergiven
Uris	Uris
öppnade	öppnade
fyllda	fyllda
sårande	sårande
sons	sons
dessa	dessa
Ehud	Ehud
fördolde	fördolde
fäste	fäste
drypa	drypa
berömda	berömda
arglistig	arglistig
Jo	Jo
stärkt	stärkt
sanna	sanna
drömmar	drömmar
läst	läst
fat	fat
rörde	rörde
Geras	Geras
slitna	slitna
Ett	Ett
dröjen	dröjen
böjde	böjde
blotta	blotta
utvalda	utvalda
Laban	Laban
värma	värma
upptages	upptages
vedergäll	vedergäll
korna	korna
förda	förda
Dess	Dess
vredes	vredes
visen	visen
bära	bära
viskas	viskas
tankar	tankar
stycke	stycke
bortförd	bortförd
libyer	libyer
rykande	rykande
sjunga	sjunga
smida	smida
slickade	slickade
blygs	blygs
bindas	bindas
sitta	sitta
bete	bete
arbete	arbete
Sems	Sems
fördolda	fördolda
bud	bud
behålla	behålla
ansedde	ansedde
drype	drype
ute	ute
koka	koka
förlite	förlite
åten	åten
tagna	tagna
ögat	ögat
bestänka	bestänka
skriva	skriva
förbyta	förbyta
snärja	snärja
förlåte	förlåte
säljen	säljen
möte	möte
vette	vette
Jedutuns	Jedutuns
Sisak	Sisak
kyssa	kyssa
ut	ut
skänk	skänk
förödda	förödda
Både	Både
dån	dån
upptage	upptage
vedergälle	vedergälle
klövs	klövs
anställda	anställda
Isak	Isak
pelare	pelare
syndarna	syndarna
gripes	gripes
rykte	rykte
Adas	Adas
Abirams	Abirams
falla	falla
åte	åte
brukade	brukade
blygas	blygas
komme	komme
Egypten	Egypten
vikt	vikt
Omar	Omar
togs	togs
beskärde	beskärde
fällda	fällda
De	De
slösade	slösade
lovar	lovar
avsatserna	avsatserna
siktades	siktades
räcka	räcka
juble	juble
förtäljen	förtäljen
Sereds	Sereds
flyta	flyta
sälj	sälj
hinder	hinder
förlösa	förlösa
arbetade	arbetade
byar	byar
hålles	hålles
avla	avla
Akbors	Akbors
sjuke	sjuke
Sadoks	Sadoks
rikt	rikt
utrotades	utrotades
dukat	dukat
lägga	lägga
bars	bars
brännes	brännes
orenen	orenen
leva	leva
sov	sov
föröda	föröda
utsträcka	utsträcka
utgjutes	utgjutes
fullborde	fullborde
silverbägare	silverbägare
bruke	bruke
avfalla	avfalla
föröken	föröken
Jeriko	Jeriko
Lots	Lots
förundran	förundran
gives	gives
betar	betar
avmäta	avmäta
brännande	brännande
Labans	Labans
gjutes	gjutes
sabbaterna	sabbaterna
åter	åter
lösa	lösa
Gileads	Gileads
glänsande	glänsande
död	död
Kedar	Kedar
lyte	lyte
krig	krig
byta	byta
Syriens	Syriens
Edoms	Edoms
verke	verke
viljes	viljes
Ars	Ars
Hets	Hets
Josef	Josef
nämnes	nämnes
Assyrien	Assyrien
stige	stige
förleder	förleder
hövdingdömen	hövdingdömen
då	då
fördömd	fördömd
Goa	Goa
blyges	blyges
funnes	funnes
förundrade	förundrade
vände	vände
Ismael	Ismael
Ögat	Ögat
Joabs	Joabs
barn	barn
Abias	Abias
laga	laga
stjäl	stjäl
förskräckes	förskräckes
släkte	släkte
Lud	Lud
Melkisedeks	Melkisedeks
hackade	hackade
spända	spända
modet	modet
Massas	Massas
Absaloms	Absaloms
vann	vann
hoppas	hoppas
Resen	Resen
läsa	läsa
tiggare	tiggare
Anatots	Anatots
frågen	frågen
tillspillogivna	tillspillogivna
hat	hat
bevise	bevise
styckade	styckade
behöves	behöves
lärt	lärt
fångade	fångade
tränges	tränges
Abraham	Abraham
förstes	förstes
Mas	Mas
Jesaja	Jesaja
malen	malen
skrämma	skrämma
sin	sin
Gats	Gats
syns	syns
Jereds	Jereds
lägge	lägge
tjäna	tjäna
fästa	fästa
mätten	mätten
råder	råder
ledda	ledda
följd	följd
församlade	församlade
bräderna	bräderna
bespejade	bespejade
spejare	spejare
talade	talade
Juda	Juda
hör	hör
Satan	Satan
huggna	huggna
uddar	uddar
rört	rört
alls	alls
Kabuls	Kabuls
anklagen	anklagen
gudsfruktans	gudsfruktans
omgives	omgives
Fallen	Fallen
Man	Man
ringar	ringar
Jedutun	Jedutun
omvände	omvände
böja	böja
själva	själva
skarpt	skarpt
döda	döda
omsnärjt	omsnärjt
åkerstycken	åkerstycken
näst	näst
viska	viska
Abimeleks	Abimeleks
Samaria	Samaria
betyda	betyda
hållare	hållare
förvaltare	förvaltare
strida	strida
utföre	utföre
hämnare	hämnare
utlyst	utlyst
travarna	travarna
ställda	ställda
frambäres	frambäres
märka	märka
sådant	sådant
bjude	bjude
Barn	Barn
Amon	Amon
spridda	spridda
Tabor	Tabor
Samuels	Samuels
Nebos	Nebos
rätt	rätt
hemsökt	hemsökt
läsen	läsen
förgörare	förgörare
beredde	beredde
blåses	blåses
buren	buren
överfalla	överfalla
läka	läka
Jotams	Jotams
Jonatan	Jonatan
höjes	höjes
allas	allas
räknade	räknade
tycka	tycka
Elias	Elias
Absalom	Absalom
utpantat	utpantat
Sur	Sur
berömt	berömt
Brödet	Brödet
bevis	bevis
inbärgning	inbärgning
företagen	företagen
mörker	mörker
backarna	backarna
uppfört	uppfört
skrivna	skrivna
Tala	Tala
röra	röra
behöva	behöva
mångas	mångas
förgöres	förgöres
tycke	tycke
behövs	behövs
mörka	mörka
Maas	Maas
fördömda	fördömda
Surs	Surs
under	under
anklagade	anklagade
båda	båda
besatta	besatta
lida	lida
dräpt	dräpt
borgen	borgen
Bileams	Bileams
Abels	Abels
uppläst	uppläst
uppfödde	uppfödde
lända	lända
frukte	frukte
blinde	blinde
tvagen	tvagen
Ono	Ono
Tro	Tro
dödande	dödande
skänke	skänke
utgjutna	utgjutna
verket	verket
Elieser	Elieser
mördare	mördare
avsats	avsats
skilde	skilde
Simma	Simma
Arbas	Arbas
Abel	Abel
åkerstycke	åkerstycke
bedragare	bedragare
prisen	prisen
erövrare	erövrare
förkunnade	förkunnade
Salems	Salems
äta	äta
klädd	klädd
gripen	gripen
din	din
hos	hos
Israels	Israels
inhägnad	inhägnad
Edens	Edens
ek	ek
Meribas	Meribas
Urias	Urias
flöge	flöge
betänken	betänken
skött	skött
Jasons	Jasons
Gilead	Gilead
Esau	Esau
skuldoffersväduren	skuldoffersväduren
Sered	Sered
näpst	näpst
bara	bara
upptagna	upptagna
tillspillogiven	tillspillogiven
störstes	störstes
tjäne	tjäne
sträcka	sträcka
skuldoffersvädur	skuldoffersvädur
trängd	trängd
Falla	Falla
genomsökt	genomsökt
tillhörande	tillhörande
Amminadab	Amminadab
gileaditer	gileaditer
släkt	släkt
stode	stode
bärande	bärande
vete	vete
biträda	biträda
Nilen	Nilen
dugande	dugande
upplåta	upplåta
Isebel	Isebel
störste	störste
skjuten	skjuten
mat	mat
omkommo	omkommo
sårade	sårade
seende	seende
öra	öra
rädda	rädda
utpantning	utpantning
Anas	Anas
Om	Om
spottade	spottade
upptändes	upptändes
omgiven	omgiven
Öga	Öga
längten	längten
uppväcken	uppväcken
låte	låte
näste	näste
bit	bit
kors	kors
frälse	frälse
försvunna	försvunna
vilket	vilket
lärda	lärda
son	son
Job	Job
ingen	ingen
betänka	betänka
Salma	Salma
omkomma	omkomma
skrymtarna	skrymtarna
Jason	Jason
fullbordade	fullbordade
stärken	stärken
bedrage	bedrage
föres	föres
Saras	Saras
skänka	skänka
Sans	Sans
korset	korset
avhålle	avhålle
bjudes	bjudes
höljda	höljda
driven	driven
fördärvet	fördärvet
HERREN	HERREN
Rebecka	Rebecka
förtrycka	förtrycka
styra	styra
Simon	Simon
öppnades	öppnades
Tres	Tres
beten	beten
blåsa	blåsa
seendes	seendes
såge	såge
enda	enda
Mana	Mana
bundna	bundna
fullbordan	fullbordan
silverbägarna	silverbägarna
backar	backar
dia	dia
fången	fången
släppa	släppa
bade	bade
betänkt	betänkt
återstod	återstod
bytt	bytt
lögnprofeterna	lögnprofeterna
efterföljd	efterföljd
sjukt	sjukt
plågas	plågas
Joab	Joab
fördraga	fördraga
Rabbas	Rabbas
Obeds	Obeds
frambären	frambären
nedgjorda	nedgjorda
finne	finne
drömma	drömma
åts	åts
Meraris	Meraris
fortfara	fortfara
veten	veten
befälhavarna	befälhavarna
boks	boks
armes	armes
utför	utför
Lus	Lus
Faraos	Faraos
bedragna	bedragna
tunga	tunga
Kains	Kains
Syrien	Syrien
slags	slags
nymånadsdag	nymånadsdag
uträckte	uträckte
råda	råda
predikare	predikare
sikte	sikte
bäste	bäste
lånade	lånade
upphöja	upphöja
göras	göras
sväljt	sväljt
dömen	dömen
bevisade	bevisade
Baal	Baal
beredda	beredda
nödgade	nödgade
tigga	tigga
borttaga	borttaga
år	år
tagen	tagen
andas	andas
Evad	Evad
berömde	berömde
springare	springare
Babels	Babels
sågade	sågade
Baals	Baals
stänkt	stänkt
utsläckt	utsläckt
upplöses	upplöses
lägg	lägg
våldsverkare	våldsverkare
anfalla	anfalla
fatte	fatte
Sara	Sara
fortfarande	fortfarande
förödande	förödande
släcka	släcka
fiskade	fiskade
Sin	Sin
Natans	Natans
mister	mister
ryka	ryka
vaka	vaka
släckes	släckes
bytte	bytte
visas	visas
dömda	dömda
sväljen	sväljen
tänkt	tänkt
fyllt	fyllt
duga	duga
Sikems	Sikems
böjd	böjd
bjuda	bjuda
Eva	Eva
Manasses	Manasses
borttagen	borttagen
inviga	inviga
leven	leven
Leviatans	Leviatans
Jerikos	Jerikos
smides	smides
Amons	Amons
förgätna	förgätna
Vilket	Vilket
skildes	skildes
David	David
vet	vet
frälsa	frälsa
öppnen	öppnen
brända	brända
beskärt	beskärt
Dianas	Dianas
springa	springa
förtälja	förtälja
skrivare	skrivare
ene	ene
inhägnade	inhägnade
lösas	lösas
sökt	sökt
segrare	segrare
intaga	intaga
det	det
Asafs	Asafs
ed	ed
uppväckt	uppväckt
fördärven	fördärven
styre	styre
Serubbabels	Serubbabels
uppläsa	uppläsa
nästen	nästen
stekt	stekt
förstörare	förstörare
slita	slita
upptända	upptända
upptänd	upptänd
beträda	beträda
Meleks	Meleks
städer	städer
tvaget	tvaget
förre	förre
Jobs	Jobs
Samuel	Samuel
förlåten	förlåten
såddes	såddes
Egyptens	Egyptens
Johannes	Johannes
Jorams	Jorams
Allas	Allas
stiga	stiga
kastades	kastades
axens	axens
sto	sto
faste	faste
Betuel	Betuel
Hiskias	Hiskias
fattades	fattades
väta	väta
läggen	läggen
agat	agat
omsnärjer	omsnärjer
hurudant	hurudant
Assurs	Assurs
förstörde	förstörde
förtäljes	förtäljes
tröstade	tröstade
Obed	Obed
lama	lama
springande	springande
deltagande	deltagande
druckna	druckna
vattnade	vattnade
täcktes	täcktes
förskräckt	förskräckt
förleda	förleda
Sem	Sem
Vare	Vare
rövar	rövar
de	de
åkerstycket	åkerstycket
tjänade	tjänade
stjärntydare	stjärntydare
Sera	Sera
hyllade	hyllade
känden	känden
nämnda	nämnda
beskärd	beskärd
täckas	täckas
Jona	Jona
hurudana	hurudana
synds	synds
stjäle	stjäle
ringe	ringe
förtryckes	förtryckes
födde	födde
välj	välj
förlåtna	förlåtna
