Jedutun	Jedutun
mörka	mörka
funna	funna
gräto	gräto
upplåta	upplåta
Gileads	Gileads
ansedda	ansedda
rörde	rörde
Amminadab	Amminadab
skjuten	skjuten
Abraham	Abraham
fullbordan	fullbordan
räddas	räddas
koken	koken
Hets	Hets
kallade	kallade
lägg	lägg
stenhuggare	stenhuggare
pluggarna	pluggarna
tjänare	tjänare
utfärdade	utfärdade
Vare	Vare
avsatserna	avsatserna
barn	barn
fjättrar	fjättrar
utvaldas	utvaldas
förkunnare	förkunnare
Sems	Sems
vänt	vänt
uppgiva	uppgiva
Hanan	Hanan
vrede	vrede
förunnade	förunnade
sälje	sälje
skänke	skänke
lösa	lösa
gravarna	gravarna
vädurens	vädurens
snöret	snöret
Abrams	Abrams
järnet	järnet
förstörare	förstörare
upplagda	upplagda
döpt	döpt
byarna	byarna
länder	länder
skattmästare	skattmästare
Moabs	Moabs
berg	berg
Josefs	Josefs
göre	göre
Simmas	Simmas
skifte	skifte
öppnade	öppnade
bevise	bevise
förenade	förenade
Asaf	Asaf
lämnades	lämnades
svänga	svänga
omfång	omfång
Beker	Beker
krig	krig
anställd	anställd
åkerstycke	åkerstycke
sikte	sikte
skål	skål
loge	loge
förtrycken	förtrycken
köpebrevet	köpebrevet
leva	leva
Johanna	Johanna
konungadöme	konungadöme
inbärgar	inbärgar
efterföljare	efterföljare
bortförd	bortförd
lamms	lamms
hyst	hyst
Samuels	Samuels
vakttornet	vakttornet
skäl	skäl
resa	resa
svalkas	svalkas
egyptiers	egyptiers
Bosras	Bosras
axens	axens
behöva	behöva
flottar	flottar
fört	fört
kor	kor
fördärvades	fördärvades
anstiftade	anstiftade
fogade	fogade
talar	talar
omvände	omvände
lärare	lärare
vätt	vätt
hyllade	hyllade
födda	födda
frälsa	frälsa
Lemeks	Lemeks
vant	vant
ödmjukade	ödmjukade
ark	ark
förkunnades	förkunnades
åkerstycken	åkerstycken
betänkte	betänkte
återstodo	återstodo
föda	föda
svansarna	svansarna
förblivande	förblivande
bortrycktes	bortrycktes
Jakobs	Jakobs
anlete	anlete
tysta	tysta
berget	berget
Samarias	Samarias
vållen	vållen
bådas	bådas
Sebaot	Sebaot
Sanna	Sanna
tändas	tändas
uppgivna	uppgivna
Ute	Ute
lamm	lamm
brunnens	brunnens
torkade	torkade
tagna	tagna
vare	vare
lagen	lagen
ena	ena
åter	åter
första	första
Lus	Lus
ödelägga	ödelägga
räta	räta
äldstes	äldstes
Iskariot	Iskariot
Judas	Judas
siktades	siktades
förbud	förbud
binde	binde
uppenbarades	uppenbarades
utstakat	utstakat
gives	gives
dessas	dessas
planteren	planteren
vilket	vilket
knyta	knyta
bäres	bäres
lyckas	lyckas
höra	höra
besöka	besöka
utfärdades	utfärdades
inställa	inställa
upptagen	upptagen
hurudan	hurudan
förgjorda	förgjorda
påskalamm	påskalamm
avlämnades	avlämnades
domarna	domarna
märka	märka
kläder	kläder
förhärligen	förhärligen
fördömda	fördömda
gripes	gripes
sakens	sakens
valkare	valkare
Joktan	Joktan
sköta	sköta
byten	byten
upplopp	upplopp
Undan	Undan
påskalammet	påskalammet
synas	synas
Johannes	Johannes
budet	budet
dröj	dröj
göden	göden
förnimmen	förnimmen
rädd	rädd
nämnes	nämnes
inbärga	inbärga
läger	läger
drogs	drogs
försvunno	försvunno
stjäla	stjäla
vaka	vaka
sträckt	sträckt
benet	benet
sårade	sårade
uppförd	uppförd
förre	förre
före	före
sakerna	sakerna
gudsfruktans	gudsfruktans
skarpa	skarpa
tröstade	tröstade
fördolda	fördolda
försvarare	försvarare
stengolv	stengolv
lår	lår
prisen	prisen
mottaga	mottaga
visade	visade
aga	aga
Gamaliel	Gamaliel
uppväcken	uppväcken
klappa	klappa
läge	läge
skänk	skänk
Efraims	Efraims
Ai	Ai
lames	lames
klagade	klagade
utrönt	utrönt
arglistighet	arglistighet
befälhavarna	befälhavarna
förrättade	förrättade
Folk	Folk
dammarna	dammarna
Rahabs	Rahabs
väges	väges
försörjare	försörjare
Asafs	Asafs
Abrahams	Abrahams
marker	marker
stilla	stilla
rannsaken	rannsaken
bon	bon
Brödet	Brödet
sås	sås
mödar	mödar
hållare	hållare
inga	inga
skylde	skylde
Beten	Beten
Sin	Sin
födas	födas
torka	torka
betrycktas	betrycktas
utgjutes	utgjutes
libyerna	libyerna
förordnades	förordnades
fördolde	fördolde
kort	kort
vändes	vändes
utkräva	utkräva
fatten	fatten
funne	funne
Jakob	Jakob
utför	utför
upphöjt	upphöjt
Anak	Anak
stadgas	stadgas
uppläst	uppläst
föres	föres
bevarades	bevarades
Simons	Simons
Syrien	Syrien
träffas	träffas
Ain	Ain
Ögat	Ögat
dragen	dragen
uppslukade	uppslukade
mätta	mätta
vattnas	vattnas
sitter	sitter
förehava	förehava
våldet	våldet
nästen	nästen
Omar	Omar
nederlaget	nederlaget
Tamars	Tamars
frågade	frågade
inbärgat	inbärgat
invigda	invigda
tränges	tränges
rådande	rådande
Tamar	Tamar
snåret	snåret
oxarna	oxarna
upptända	upptända
man	man
förgäte	förgäte
Svärdet	Svärdet
mödade	mödade
drömma	drömma
Joa	Joa
ämne	ämne
fot	fot
hava	hava
fostrades	fostrades
spände	spände
alls	alls
Libanons	Libanons
Meribas	Meribas
bärare	bärare
nitälskan	nitälskan
skrymtare	skrymtare
hjul	hjul
offrade	offrade
Joktans	Joktans
mark	mark
bindes	bindes
maka	maka
gödda	gödda
Massa	Massa
fördragen	fördragen
fare	fare
upptändas	upptändas
valla	valla
saknas	saknas
fördärv	fördärv
beviset	beviset
skrymtarna	skrymtarna
förlitade	förlitade
domar	domar
annat	annat
förfäras	förfäras
Ahabs	Ahabs
vredes	vredes
budordet	budordet
fyllas	fyllas
trängt	trängt
vilddjuret	vilddjuret
kommande	kommande
stärken	stärken
budord	budord
Judeen	Judeen
vandrarna	vandrarna
vid	vid
böja	böja
etiopier	etiopier
gästabud	gästabud
gripen	gripen
Uris	Uris
namnet	namnet
lärda	lärda
tröstar	tröstar
vette	vette
avsatte	avsatte
Jasons	Jasons
silverbägarna	silverbägarna
eder	eder
glädes	glädes
Jedutuns	Jedutuns
Hiskia	Hiskia
hjulet	hjulet
fyll	fyll
än	än
altaret	altaret
Akaja	Akaja
stänka	stänka
Dina	Dina
bara	bara
Haso	Haso
Gode	Gode
ristade	ristade
klädd	klädd
tända	tända
Hans	Hans
jagades	jagades
tår	tår
Joram	Joram
Aten	Aten
äga	äga
bete	bete
insatte	insatte
synderna	synderna
trampade	trampade
förmörkades	förmörkades
Hesrons	Hesrons
den	den
hurudana	hurudana
Sadok	Sadok
talen	talen
tigga	tigga
betryckt	betryckt
vila	vila
sträcka	sträcka
lögnprofeternas	lögnprofeternas
länge	länge
dryckerna	dryckerna
lammet	lammet
täcktes	täcktes
No	No
Melkisedeks	Melkisedeks
sålden	sålden
fördraga	fördraga
blåste	blåste
Asas	Asas
Mahalalel	Mahalalel
fött	fött
kos	kos
stinka	stinka
Joas	Joas
Anas	Anas
fotblad	fotblad
prisade	prisade
fruktan	fruktan
deltaga	deltaga
ställde	ställde
byar	byar
Om	Om
given	given
Naftalis	Naftalis
manas	manas
löpen	löpen
släcka	släcka
funnes	funnes
badade	badade
brevet	brevet
träda	träda
strävade	strävade
avhållen	avhållen
sådant	sådant
djuret	djuret
skrivna	skrivna
äppelträd	äppelträd
dömen	dömen
gräns	gräns
gemak	gemak
förrättades	förrättades
berövade	berövade
båda	båda
lämnade	lämnade
tillsätta	tillsätta
fördrives	fördrives
flyttade	flyttade
öppnas	öppnas
hämtades	hämtades
lugna	lugna
nedgjorda	nedgjorda
Vilken	Vilken
inviga	inviga
samme	samme
frossa	frossa
Salems	Salems
Alexanders	Alexanders
utsända	utsända
leden	leden
arks	arks
avstånd	avstånd
höje	höje
Ordet	Ordet
bruke	bruke
Jerusalem	Jerusalem
Ner	Ner
undantagna	undantagna
Esters	Esters
slitna	slitna
förleda	förleda
Abias	Abias
anklagade	anklagade
Helt	Helt
Gilead	Gilead
störes	störes
Tala	Tala
rannsakade	rannsakade
tills	tills
halt	halt
gap	gap
inträde	inträde
betäcka	betäcka
fortfarande	fortfarande
stöta	stöta
följeslagare	följeslagare
lära	lära
driven	driven
Arbas	Arbas
Rubens	Rubens
stänger	stänger
hålen	hålen
skapades	skapades
avfalla	avfalla
avsöndrade	avsöndrade
till	till
gräten	gräten
fyllde	fyllde
beredda	beredda
veten	veten
dennas	dennas
fästas	fästas
hindarna	hindarna
byggnadsverket	byggnadsverket
vädurarna	vädurarna
Bekers	Bekers
lärt	lärt
sprida	sprida
höljda	höljda
äppelträdet	äppelträdet
uppbådade	uppbådade
uppdraget	uppdraget
Allt	Allt
övergåve	övergåve
plågas	plågas
blodbadet	blodbadet
beta	beta
Benjamin	Benjamin
lutade	lutade
tycka	tycka
Salome	Salome
brodern	brodern
Dans	Dans
biträda	biträda
bok	bok
klippa	klippa
överlämnades	överlämnades
tage	tage
läsa	läsa
uppsatta	uppsatta
upphöjda	upphöjda
förehaven	förehaven
stiga	stiga
frambära	frambära
omringade	omringade
beseglade	beseglade
Vilka	Vilka
kallas	kallas
stillades	stillades
skarpt	skarpt
avskära	avskära
samtycka	samtycka
arms	arms
strida	strida
koret	koret
skålarna	skålarna
göres	göres
upphäven	upphäven
mister	mister
manades	manades
spenabarn	spenabarn
släckt	släckt
vingarna	vingarna
rötterna	rötterna
inbärgen	inbärgen
stormade	stormade
bönerna	bönerna
breda	breda
förödes	förödes
födes	födes
Assyrien	Assyrien
avhålla	avhålla
Elisas	Elisas
lysande	lysande
räcken	räcken
förtälj	förtälj
kallades	kallades
sina	sina
mörker	mörker
Goa	Goa
Lea	Lea
förordnade	förordnade
söks	söks
lagade	lagade
företagen	företagen
moln	moln
lidandet	lidandet
hackade	hackade
slickade	slickade
välva	välva
Merari	Merari
upptänd	upptänd
vilka	vilka
bedrives	bedrives
vandren	vandren
oftare	oftare
Visar	Visar
erövrade	erövrade
utlysa	utlysa
inne	inne
din	din
förbytt	förbytt
konungadömet	konungadömet
förskräckte	förskräckte
förtryckes	förtryckes
uppfylle	uppfylle
rövade	rövade
sjunga	sjunga
Diana	Diana
enes	enes
utvalda	utvalda
rövare	rövare
buren	buren
vis	vis
Ingen	Ingen
sårande	sårande
åkerstycket	åkerstycket
beskärt	beskärt
Tres	Tres
omkommo	omkommo
köpa	köpa
rena	rena
nästas	nästas
värmen	värmen
antända	antända
bröderna	bröderna
slites	slites
omstörtade	omstörtade
Betuel	Betuel
räddade	räddade
sålde	sålde
utlyst	utlyst
slösade	slösade
bärande	bärande
råd	råd
märkt	märkt
förslaget	förslaget
avvända	avvända
Sans	Sans
moderliv	moderliv
bedraga	bedraga
hjärtat	hjärtat
rötter	rötter
utpantning	utpantning
format	format
verke	verke
Alls	Alls
dömda	dömda
bohag	bohag
Son	Son
hemsökt	hemsökt
sena	sena
skapade	skapade
vägs	vägs
upphöjd	upphöjd
Tagen	Tagen
sväljt	sväljt
Denne	Denne
uppbygga	uppbygga
Babels	Babels
uppfylles	uppfylles
överfalla	överfalla
vetekorn	vetekorn
göra	göra
det	det
lidande	lidande
Adas	Adas
företaga	företaga
Vaken	Vaken
försåt	försåt
rörande	rörande
moder	moder
deltagande	deltagande
tårarna	tårarna
agat	agat
tröstare	tröstare
Jonatans	Jonatans
ende	ende
förgjordes	förgjordes
Abels	Abels
tänka	tänka
bevis	bevis
inbärgning	inbärgning
förstånd	förstånd
Ais	Ais
uppfyllen	uppfyllen
värden	värden
Meleks	Meleks
välvt	välvt
undersökt	undersökt
kända	kända
förskingrade	förskingrade
genomsöka	genomsöka
bevekt	bevekt
mista	mista
smide	smide
stötes	stötes
Rahab	Rahab
Absaloms	Absaloms
gjutes	gjutes
Jotam	Jotam
förgör	förgör
invigen	invigen
Abel	Abel
uppfylla	uppfylla
sköljes	sköljes
Meriba	Meriba
höj	höj
församlas	församlas
gemaket	gemaket
Hiskias	Hiskias
Rabbas	Rabbas
Lud	Lud
jämte	jämte
komma	komma
lösas	lösas
ägare	ägare
brännes	brännes
säljare	säljare
Husas	Husas
budens	budens
vakttorn	vakttorn
upptänts	upptänts
vinna	vinna
HERRENs	HERRENs
Gad	Gad
bröllop	bröllop
råka	råka
anklagen	anklagen
visen	visen
fårs	fårs
inhägnade	inhägnade
axet	axet
nymånadsdagen	nymånadsdagen
Sadoks	Sadoks
Hagar	Hagar
linda	linda
säte	säte
sport	sport
hela	hela
Hela	Hela
taga	taga
mottages	mottages
hals	hals
förtrycka	förtrycka
rätas	rätas
enda	enda
upphäves	upphäves
Amminadabs	Amminadabs
gladas	gladas
utplånade	utplånade
vissna	vissna
Sköt	Sköt
hövdingdöme	hövdingdöme
sjukt	sjukt
Kanaans	Kanaans
bedragare	bedragare
vandrade	vandrade
Folket	Folket
räknade	räknade
orena	orena
brinnande	brinnande
utstöta	utstöta
spänna	spänna
utgöra	utgöra
näpsa	näpsa
förslag	förslag
lägges	lägges
uppenbaras	uppenbaras
stickade	stickade
Amon	Amon
sko	sko
Samuel	Samuel
följeslagares	följeslagares
dräpt	dräpt
sköte	sköte
siares	siares
Eva	Eva
Assur	Assur
Jo	Jo
jämna	jämna
förstöra	förstöra
trampas	trampas
struts	struts
kramades	kramades
Falla	Falla
uppbyggda	uppbyggda
anställde	anställde
klipper	klipper
omgivna	omgivna
vara	vara
sticka	sticka
uppläsa	uppläsa
uträcker	uträcker
kränka	kränka
upplyste	upplyste
vedergälle	vedergälle
tagen	tagen
plågade	plågade
minnes	minnes
fullbordades	fullbordades
sådanas	sådanas
belopp	belopp
vind	vind
görare	görare
sänka	sänka
fullborde	fullborde
upphäva	upphäva
ute	ute
invånare	invånare
fatet	fatet
fångade	fångade
gångar	gångar
hölje	hölje
omskära	omskära
Asa	Asa
svinet	svinet
Persien	Persien
berömt	berömt
minskade	minskade
lida	lida
kasten	kasten
utsprida	utsprida
upplöst	upplöst
Israel	Israel
utkräves	utkräves
tages	tages
säga	säga
Leas	Leas
förfölja	förfölja
palatset	palatset
släkt	släkt
vrida	vrida
upprört	upprört
San	San
smida	smida
snara	snara
märke	märke
slita	slita
upphöjen	upphöjen
upplåten	upplåten
bytte	bytte
gileaditen	gileaditen
bägarna	bägarna
låta	låta
Ussias	Ussias
klövarna	klövarna
Visa	Visa
Ställ	Ställ
tabernakel	tabernakel
pressar	pressar
hövdingdömen	hövdingdömen
nära	nära
valkares	valkares
pelare	pelare
borttappade	borttappade
dina	dina
skugga	skugga
betrodde	betrodde
hjärtas	hjärtas
lända	lända
försvarade	försvarade
strålade	strålade
täckas	täckas
daglönare	daglönare
Saul	Saul
stigen	stigen
täckta	täckta
stenhuggarna	stenhuggarna
stänkes	stänkes
fästa	fästa
omgives	omgives
rykte	rykte
nedgjorde	nedgjorde
rätt	rätt
uttåg	uttåg
tvaget	tvaget
äldste	äldste
löpa	löpa
inmönstrade	inmönstrade
sänkt	sänkt
mods	mods
seende	seende
förlöst	förlöst
föröke	föröke
arbete	arbete
frågen	frågen
som	som
nödgas	nödgas
ställt	ställt
behövs	behövs
utsändes	utsändes
Asien	Asien
avsöndrades	avsöndrades
resas	resas
avmäta	avmäta
utgjuta	utgjuta
tillhörande	tillhörande
viljes	viljes
arbetade	arbetade
förlösa	förlösa
molnet	molnet
giva	giva
svängde	svängde
Öga	Öga
Elia	Elia
flyttades	flyttades
stänkt	stänkt
bosätten	bosätten
Gat	Gat
svalt	svalt
Iskariots	Iskariots
anställda	anställda
sättes	sättes
köpare	köpare
gränserna	gränserna
Sjustjärnornas	Sjustjärnornas
dödsriket	dödsriket
ytterst	ytterst
döme	döme
taket	taket
Nea	Nea
styrka	styrka
dräpa	dräpa
renat	renat
skriva	skriva
Baal	Baal
Job	Job
närande	närande
sådana	sådana
fördömde	fördömde
blåst	blåst
mönstrades	mönstrades
hämnas	hämnas
anletes	anletes
stor	stor
boks	boks
Resa	Resa
tankar	tankar
bruset	bruset
våra	våra
skurna	skurna
vände	vände
fästes	fästes
drabbade	drabbade
slakt	slakt
uppbådades	uppbådades
betäckt	betäckt
täckes	täckes
grumlen	grumlen
ene	ene
sändes	sändes
rovet	rovet
smädare	smädare
järn	järn
Tabors	Tabors
Heles	Heles
miste	miste
Ren	Ren
kysst	kysst
slagna	slagna
revo	revo
lidandes	lidandes
Ahab	Ahab
dödade	dödade
täcka	täcka
arglistig	arglistig
satte	satte
Abiram	Abiram
utrote	utrote
stjärntydare	stjärntydare
övergivna	övergivna
stjäle	stjäle
fatte	fatte
visar	visar
Fadern	Fadern
täckts	täckts
Aven	Aven
räknades	räknades
dricke	dricke
hot	hot
rädda	rädda
förtälja	förtälja
de	de
siare	siare
utstött	utstött
Både	Både
kors	kors
sova	sova
skuldoffersväduren	skuldoffersväduren
vänd	vänd
varandra	varandra
svala	svala
sälja	sälja
såge	såge
utföres	utföres
like	like
omstörtades	omstörtades
stött	stött
frambäres	frambäres
dödande	dödande
hemsöka	hemsöka
Elieser	Elieser
lika	lika
renade	renade
ek	ek
betydande	betydande
stört	stört
hämtade	hämtade
spott	spott
rev	rev
befästa	befästa
samlen	samlen
röres	röres
Stället	Stället
hålla	hålla
skåden	skåden
Husen	Husen
frälsare	frälsare
livet	livet
mödat	mödat
upplösa	upplösa
sabbaterna	sabbaterna
Kabul	Kabul
havande	havande
make	make
Natan	Natan
spjutet	spjutet
offrades	offrades
armen	armen
spik	spik
tyg	tyg
bunden	bunden
påbud	påbud
förda	förda
följe	följe
gileaditerna	gileaditerna
lyftes	lyftes
sanna	sanna
drage	drage
krossade	krossade
Isebel	Isebel
samtycke	samtycke
drivas	drivas
driva	driva
spejade	spejade
vit	vit
beställa	beställa
vrides	vrides
översta	översta
uppsökte	uppsökte
förföljare	förföljare
Susan	Susan
övergiva	övergiva
tänk	tänk
Hanes	Hanes
strids	strids
styra	styra
gräte	gräte
hat	hat
Resen	Resen
sen	sen
väns	väns
Betuels	Betuels
Leviatans	Leviatans
leven	leven
ansedde	ansedde
yngstes	yngstes
maakatéernas	maakatéernas
dragna	dragna
förtär	förtär
ringas	ringas
gjordes	gjordes
Isaks	Isaks
sken	sken
väljen	väljen
murare	murare
Noas	Noas
löst	löst
bestämde	bestämde
bjude	bjude
behållare	behållare
lånen	lånen
ofta	ofta
sjuke	sjuke
förtära	förtära
verket	verket
Het	Het
beskärda	beskärda
slätt	slätt
fattas	fattas
ringar	ringar
efterfölja	efterfölja
gifta	gifta
Lod	Lod
glänsa	glänsa
tillreda	tillreda
efterföljd	efterföljd
uträckte	uträckte
Uria	Uria
bjudes	bjudes
betänken	betänken
tjänarna	tjänarna
skapare	skapare
trampa	trampa
dån	dån
dräpe	dräpe
krossades	krossades
förtorkade	förtorkade
överdragen	överdragen
dödades	dödades
fylla	fylla
avbärgade	avbärgade
drive	drive
vilade	vilade
Bered	Bered
Isebels	Isebels
mat	mat
utröna	utröna
lägge	lägge
förundren	förundren
murar	murar
Jabin	Jabin
våldsverkare	våldsverkare
möta	möta
Faraos	Faraos
gören	gören
samlades	samlades
Bela	Bela
stänga	stänga
finna	finna
stall	stall
tornet	tornet
Vin	Vin
granne	granne
ösa	ösa
utsatta	utsatta
bjuda	bjuda
inrättades	inrättades
Amons	Amons
böjt	böjt
fyllda	fyllda
hören	hören
göda	göda
förlika	förlika
omringades	omringades
fortfara	fortfara
duga	duga
erövrare	erövrare
Serubbabels	Serubbabels
Fallen	Fallen
bundna	bundna
mana	mana
läras	läras
sabbat	sabbat
avvändes	avvändes
förundrade	förundrade
plåga	plåga
släktens	släktens
förlåten	förlåten
fallna	fallna
yttersta	yttersta
mött	mött
Talar	Talar
lärd	lärd
draga	draga
gjorda	gjorda
förutbestämde	förutbestämde
Ord	Ord
Surs	Surs
räknen	räknen
varandras	varandras
moderssköte	moderssköte
allting	allting
förvarade	förvarade
insatt	insatt
tiggare	tiggare
Kabuls	Kabuls
huvudet	huvudet
omkomma	omkomma
överdraga	överdraga
förlåtna	förlåtna
Lot	Lot
invånares	invånares
huset	huset
tjänade	tjänade
höljas	höljas
Ners	Ners
upptaga	upptaga
förströdda	förströdda
utbyte	utbyte
allt	allt
uttåget	uttåget
betade	betade
fortfare	fortfare
dryck	dryck
överlämnade	överlämnade
skänka	skänka
tänkt	tänkt
utbredde	utbredde
tog	tog
behövande	behövande
bedrage	bedrage
bortkastad	bortkastad
Kain	Kain
backar	backar
agade	agade
försonade	försonade
brunnarna	brunnarna
fördömen	fördömen
folket	folket
Melek	Melek
odjur	odjur
Rabba	Rabba
hälsades	hälsades
ålägges	ålägges
förtryckare	förtryckare
tusental	tusental
intagen	intagen
förlåte	förlåte
liden	liden
tacka	tacka
känden	känden
innan	innan
utgöres	utgöres
hembära	hembära
rikes	rikes
förstör	förstör
skrämma	skrämma
bytt	bytt
styckade	styckade
beträden	beträden
utslag	utslag
Vakna	Vakna
lindade	lindade
Manasse	Manasse
Taga	Taga
lärde	lärde
sändas	sändas
malen	malen
armodet	armodet
samlas	samlas
förföljda	förföljda
Lotan	Lotan
vässt	vässt
kände	kände
vederkvicka	vederkvicka
stode	stode
sökt	sökt
beskärd	beskärd
övrigt	övrigt
Simma	Simma
verkade	verkade
Res	Res
nitälsken	nitälsken
Under	Under
Jobs	Jobs
döva	döva
sovo	sovo
kännes	kännes
fördömd	fördömd
Ava	Ava
fikonträd	fikonträd
Rehabeams	Rehabeams
upplagt	upplagt
Hasor	Hasor
spenabarnet	spenabarnet
vattnade	vattnade
betyda	betyda
hörn	hörn
Onan	Onan
Hulda	Hulda
förbytes	förbytes
gläds	gläds
åker	åker
Sina	Sina
ax	ax
rygga	rygga
Sisaks	Sisaks
hala	hala
sväljen	sväljen
ordspråket	ordspråket
ödmjuka	ödmjuka
Nod	Nod
Ruben	Ruben
hövdingdömet	hövdingdömet
utroten	utroten
tillreds	tillreds
Egyptens	Egyptens
gud	gud
Belas	Belas
bygga	bygga
borgen	borgen
städerna	städerna
Sered	Sered
mönstrade	mönstrade
sågade	sågade
Isak	Isak
känd	känd
Jonatan	Jonatan
väta	väta
Abimelek	Abimelek
förhärligade	förhärligade
beskära	beskära
brödet	brödet
ringare	ringare
byta	byta
genomsökt	genomsökt
vinn	vinn
Edens	Edens
dråp	dråp
slaktet	slaktet
upptecknades	upptecknades
läggen	läggen
avfallen	avfallen
bältet	bältet
Sara	Sara
brända	brända
förskingrades	förskingrades
bröder	bröder
menade	menade
rätta	rätta
Bera	Bera
uddar	uddar
Tre	Tre
fordras	fordras
vett	vett
Melkisedek	Melkisedek
många	många
äktenskapsbrottet	äktenskapsbrottet
dödsrike	dödsrike
minne	minne
väva	väva
jagade	jagade
bakhållet	bakhållet
anstiftades	anstiftades
släkte	släkte
Joab	Joab
Berit	Berit
bud	bud
tycke	tycke
vetet	vetet
Vilket	Vilket
Talen	Talen
mala	mala
allas	allas
uppgives	uppgives
brukade	brukade
gjuta	gjuta
övermodet	övermodet
blodbad	blodbad
markerna	markerna
bespejade	bespejade
övergåvo	övergåvo
ordspråk	ordspråk
klagorop	klagorop
skattmästarna	skattmästarna
avlämnade	avlämnade
formade	formade
anklagare	anklagare
vilken	vilken
helade	helade
lyte	lyte
Sutela	Sutela
omsnärjer	omsnärjer
Simon	Simon
Hul	Hul
byggnadsverk	byggnadsverk
Joabs	Joabs
varen	varen
Tro	Tro
Jason	Jason
förtrycktas	förtrycktas
övertäckt	övertäckt
Elisa	Elisa
drives	drives
förbudet	förbudet
lögnprofeterna	lögnprofeterna
logarna	logarna
glada	glada
borttappat	borttappat
Assurs	Assurs
uppförde	uppförde
öre	öre
omvända	omvända
område	område
kriget	kriget
inställde	inställde
marks	marks
edens	edens
bars	bars
friköpa	friköpa
fält	fält
ställen	ställen
täcke	täcke
rykande	rykande
förras	förras
hälsa	hälsa
råder	råder
Rebecka	Rebecka
jubelåret	jubelåret
vävda	vävda
besökt	besökt
moderlivet	moderlivet
antal	antal
arv	arv
förliten	förliten
tillhöra	tillhöra
förtäljen	förtäljen
finne	finne
vittne	vittne
låga	låga
näst	näst
ödmjukas	ödmjukas
kokte	kokte
stillade	stillade
förutbestämt	förutbestämt
flotta	flotta
stycke	stycke
Salma	Salma
brännsår	brännsår
inträda	inträda
finnes	finnes
styre	styre
ryka	ryka
Nilen	Nilen
fattades	fattades
gileaditer	gileaditer
försåtet	försåtet
resande	resande
dom	dom
läkare	läkare
vittnesbördet	vittnesbördet
skyddade	skyddade
Balak	Balak
sans	sans
fältet	fältet
ledda	ledda
uppsatte	uppsatte
tillspillogiven	tillspillogiven
ort	ort
slungade	slungade
droge	droge
förfares	förfares
hacka	hacka
skilde	skilde
släppa	släppa
träffades	träffades
utrotades	utrotades
utslaget	utslaget
talades	talades
hjälpare	hjälpare
skäras	skäras
betryckta	betryckta
förfara	förfara
loven	loven
korsfästas	korsfästas
övergiven	övergiven
inbyggare	inbyggare
utvalde	utvalde
års	års
hylla	hylla
Loven	Loven
fullbordade	fullbordade
utgjutna	utgjutna
tjänen	tjänen
tystade	tystade
sådda	sådda
förhindrade	förhindrade
skära	skära
vingar	vingar
döpa	döpa
falls	falls
besatte	besatte
tillfrisknat	tillfrisknat
beten	beten
laga	laga
svälja	svälja
fråga	fråga
bedriva	bedriva
Rådet	Rådet
predikare	predikare
tryckte	tryckte
förnimma	förnimma
slaktdjur	slaktdjur
förbrännes	förbrännes
uppståndna	uppståndna
förbund	förbund
förhindrades	förhindrades
omsnärjde	omsnärjde
täckte	täckte
ökade	ökade
hysa	hysa
Salem	Salem
ingen	ingen
segrare	segrare
upptages	upptages
anskaffades	anskaffades
vända	vända
säljen	säljen
läs	läs
Gera	Gera
utforskade	utforskade
slags	slags
folk	folk
förstörde	förstörde
frukte	frukte
sänkas	sänkas
vreden	vreden
bäre	bäre
upplöses	upplöses
tvagen	tvagen
helgade	helgade
arvet	arvet
aktades	aktades
travare	travare
dröjen	dröjen
klöv	klöv
välj	välj
kläda	kläda
Gud	Gud
bränna	bränna
uppfört	uppfört
stadiers	stadiers
kränkt	kränkt
uträcka	uträcka
dessa	dessa
församlade	församlade
fällda	fällda
bjudna	bjudna
mättas	mättas
upplåtna	upplåtna
Antikrists	Antikrists
sov	sov
kullarna	kullarna
fören	fören
fräta	fräta
Kemuel	Kemuel
bygges	bygges
utstakade	utstakade
stycken	stycken
fläka	fläka
yngste	yngste
vakade	vakade
betänkt	betänkt
seendes	seendes
stinkande	stinkande
brinna	brinna
maakatéer	maakatéer
lägga	lägga
vårdare	vårdare
Bileams	Bileams
Berias	Berias
huvud	huvud
beseglades	beseglades
Seirs	Seirs
betryckte	betryckte
buds	buds
dyrkar	dyrkar
säljes	säljes
mångas	mångas
uppresa	uppresa
Rehabeam	Rehabeam
hölja	hölja
elände	elände
förvarades	förvarades
undersöka	undersöka
överfallen	överfallen
kärlet	kärlet
Din	Din
omskäres	omskäres
låret	låret
frälse	frälse
håla	håla
orenen	orenen
nämnda	nämnda
brus	brus
givare	givare
befälet	befälet
äta	äta
spjut	spjut
förleder	förleder
visst	visst
fördöma	fördöma
uppföda	uppföda
nymånadsdag	nymånadsdag
Babel	Babel
upptändes	upptändes
svarande	svarande
bosätta	bosätta
Akajas	Akajas
drype	drype
sin	sin
utsatte	utsatte
dia	dia
hinder	hinder
hus	hus
luta	luta
utbreda	utbreda
uträckas	uträckas
modersskötet	modersskötet
veta	veta
följande	följande
var	var
vana	vana
Obed	Obed
dragare	dragare
fetma	fetma
tryckes	tryckes
vida	vida
svans	svans
stärkt	stärkt
årens	årens
tillspillogivna	tillspillogivna
ålägga	ålägga
upplysa	upplysa
snärja	snärja
stadgar	stadgar
bevekande	bevekande
utsträcka	utsträcka
utfören	utfören
läka	läka
skuggade	skuggade
bitarna	bitarna
upptage	upptage
vin	vin
Maria	Maria
hjälpt	hjälpt
mötes	mötes
vederkvickt	vederkvickt
Ada	Ada
utsläckes	utsläckes
år	år
Hagars	Hagars
kyssa	kyssa
avhålle	avhålle
sjuka	sjuka
förunne	förunne
blottas	blottas
främmandes	främmandes
Jesaja	Jesaja
strålande	strålande
bestänkt	bestänkt
alltings	alltings
rättfärdigas	rättfärdigas
hos	hos
Ana	Ana
behållna	behållna
höre	höre
smälte	smälte
Kemuels	Kemuels
HERREN	HERREN
avbärgad	avbärgad
Mana	Mana
skrymtade	skrymtade
förvandlades	förvandlades
Seir	Seir
Högstes	Högstes
grav	grav
Våra	Våra
stenröse	stenröse
Sur	Sur
Abirams	Abirams
gömmas	gömmas
fint	fint
dammet	dammet
Kains	Kains
grunda	grunda
bortförda	bortförda
spottade	spottade
spejare	spejare
fläkt	fläkt
höjes	höjes
Jotams	Jotams
Salomo	Salomo
antändas	antändas
bestämda	bestämda
hörsamma	hörsamma
Leviatan	Leviatan
flögo	flögo
spikarna	spikarna
anförare	anförare
vårdar	vårdar
råda	råda
fattat	fattat
skadade	skadade
torg	torg
förstörs	förstörs
tänke	tänke
Abram	Abram
sån	sån
bortförde	bortförde
ansikte	ansikte
dolda	dolda
Sem	Sem
avskäres	avskäres
saker	saker
utföra	utföra
anden	anden
smältes	smältes
lama	lama
vedergäll	vedergäll
hindrade	hindrade
stoderna	stoderna
gripa	gripa
Kanaan	Kanaan
Anatots	Anatots
samma	samma
drivna	drivna
dåd	dåd
vilen	vilen
backarna	backarna
lugnade	lugnade
rulla	rulla
faste	faste
fåren	fåren
renades	renades
förökades	förökades
fotbladet	fotbladet
stengolvet	stengolvet
Sikem	Sikem
gömmes	gömmes
våldsverkarna	våldsverkarna
bevarade	bevarade
Massas	Massas
ansiktes	ansiktes
upprätta	upprätta
blåses	blåses
skada	skada
modet	modet
syndarna	syndarna
vikt	vikt
hornet	hornet
eds	eds
nederlag	nederlag
beträda	beträda
tiga	tiga
garnet	garnet
bära	bära
sjunge	sjunge
öga	öga
stärka	stärka
förkunnen	förkunnen
skälet	skälet
skrämmes	skrämmes
dövas	dövas
användas	användas
flytt	flytt
byggda	byggda
Det	Det
förmörkade	förmörkade
Syriens	Syriens
namns	namns
mätten	mätten
fördärvare	fördärvare
Marias	Marias
grunden	grunden
Denna	Denna
skjuta	skjuta
Balaks	Balaks
Seras	Seras
intaga	intaga
Barn	Barn
kläde	kläde
undan	undan
född	född
Jona	Jona
ätes	ätes
åte	åte
hjälpa	hjälpa
bräderna	bräderna
hugges	hugges
Vars	Vars
tvagna	tvagna
behålla	behålla
förste	förste
dess	dess
röras	röras
fyllt	fyllt
förströdde	förströdde
gifte	gifte
övrigas	övrigas
daglönares	daglönares
dennes	dennes
vedergälla	vedergälla
självt	självt
mätt	mätt
läkt	läkt
damm	damm
slagen	slagen
dröja	dröja
dolde	dolde
fiskade	fiskade
upprest	upprest
förtäres	förtäres
sköten	sköten
helas	helas
förtryck	förtryck
hoppade	hoppade
Sådana	Sådana
ledas	ledas
upptänt	upptänt
förskräckt	förskräckt
vallar	vallar
förtäre	förtäre
blottade	blottade
David	David
gripna	gripna
betänk	betänk
agas	agas
hjärta	hjärta
fetmas	fetmas
snärjda	snärjda
förgäta	förgäta
drabbades	drabbades
stenröset	stenröset
bespejare	bespejare
uppslukades	uppslukades
etiopierna	etiopierna
tillfrisknade	tillfrisknade
ryckes	ryckes
slaktades	slaktades
predikade	predikade
Labans	Labans
Lammet	Lammet
bortkastade	bortkastade
frätas	frätas
fara	fara
rista	rista
pressade	pressade
arbetare	arbetare
blive	blive
vitt	vitt
Ehuds	Ehuds
döda	döda
löftet	löftet
tillgiven	tillgiven
försörja	försörja
flyga	flyga
såddes	såddes
brunne	brunne
Kedar	Kedar
retade	retade
avsats	avsats
ingångens	ingångens
bortryckta	bortryckta
springa	springa
bäckarna	bäckarna
tackade	tackade
utsläcka	utsläcka
förtryckt	förtryckt
död	död
tankarna	tankarna
Manasses	Manasses
kon	kon
förbränna	förbränna
fällas	fällas
horn	horn
blottades	blottades
öppnen	öppnen
inbyggares	inbyggares
viken	viken
nät	nät
släckes	släckes
fadern	fadern
penningarna	penningarna
livs	livs
hon	hon
Orions	Orions
bekännare	bekännare
förstörd	förstörd
läses	läses
lycka	lycka
förvandlade	förvandlade
befäl	befäl
uträcken	uträcken
blott	blott
utplånades	utplånades
vars	vars
betrodda	betrodda
Ester	Ester
huggen	huggen
förvaltade	förvaltade
budbärare	budbärare
uppföra	uppföra
Persiens	Persiens
lytt	lytt
grannarna	grannarna
vanna	vanna
säkra	säkra
förgöres	förgöres
både	både
stängda	stängda
ställd	ställd
flyge	flyge
förlåta	förlåta
klagoropet	klagoropet
Hanna	Hanna
utsättes	utsättes
råkade	råkade
förstes	förstes
bälte	bälte
Meraris	Meraris
Jafets	Jafets
gudsfruktan	gudsfruktan
korsfästa	korsfästa
hindrades	hindrades
Svärd	Svärd
omfånget	omfånget
förtryckta	förtryckta
bäckens	bäckens
förjagades	förjagades
räckt	räckt
kastade	kastade
utforsken	utforsken
följda	följda
upptecknade	upptecknade
förbundet	förbundet
fogades	fogades
bot	bot
träta	träta
vävare	vävare
Ande	Ande
valvet	valvet
altare	altare
anklagades	anklagades
förbliva	förbliva
värde	värde
sålda	sålda
inhägnad	inhägnad
upploppet	upploppet
visa	visa
handlade	handlade
förskräckes	förskräckes
Aras	Aras
bruse	bruse
lånade	lånade
hållen	hållen
blåsa	blåsa
förstöres	förstöres
förlite	förlite
utpantat	utpantat
ut	ut
köpebrev	köpebrev
sliten	sliten
vise	vise
skrapa	skrapa
väckes	väckes
Gudarna	Gudarna
inrättade	inrättade
äktenskapsbrott	äktenskapsbrott
korna	korna
stjäl	stjäl
penningar	penningar
fostrare	fostrare
säg	säg
brännsåret	brännsåret
löpare	löpare
Jafet	Jafet
viljen	viljen
fälla	fälla
berömde	berömde
friade	friade
lever	lever
denne	denne
varde	varde
uppenbarade	uppenbarade
året	året
förödda	förödda
frossare	frossare
förtorkades	förtorkades
läsen	läsen
koka	koka
våldsverkares	våldsverkares
blotten	blotten
drypa	drypa
handla	handla
Edoms	Edoms
dräp	dräp
trygga	trygga
springande	springande
betrycktes	betrycktes
drog	drog
sto	sto
hämnare	hämnare
markens	markens
mjölet	mjölet
kullar	kullar
låte	låte
bespejen	bespejen
fången	fången
stupa	stupa
kramade	kramade
uppväcka	uppväcka
Antikrist	Antikrist
utsträckt	utsträckt
slunga	slunga
Sera	Sera
skrymtan	skrymtan
Dess	Dess
utbyta	utbyta
rikt	rikt
Serubbabel	Serubbabel
orterna	orterna
falle	falle
höres	höres
store	store
fjättrade	fjättrade
släktet	släktet
stores	stores
Beria	Beria
uppfyll	uppfyll
höjd	höjd
förena	förena
flyta	flyta
aktade	aktade
rycka	rycka
Hanoks	Hanoks
fäste	fäste
gäckas	gäckas
Sisak	Sisak
stadga	stadga
söka	söka
rycke	rycke
avbärgat	avbärgat
Sauls	Sauls
dukat	dukat
snärjas	snärjas
pelarna	pelarna
ben	ben
spridde	spridde
hurudant	hurudant
Salman	Salman
mäta	mäta
skiftade	skiftade
främmande	främmande
behöves	behöves
Naftali	Naftali
menen	menen
Juda	Juda
Maas	Maas
Et	Et
ödelägges	ödelägges
släppt	släppt
ögat	ögat
sports	sports
arglistige	arglistige
arme	arme
fordran	fordran
log	log
försonas	försonas
annan	annan
nedbrytes	nedbrytes
släta	släta
Benjamins	Benjamins
svin	svin
öst	öst
viska	viska
Satan	Satan
Assyriens	Assyriens
smälta	smälta
garn	garn
fordren	fordren
sökte	sökte
avbärga	avbärga
enas	enas
rådde	rådde
släppe	släppe
Akan	Akan
Nebos	Nebos
fiskar	fiskar
ryggas	ryggas
tillträda	tillträda
knyte	knyte
förrådshus	förrådshus
föröken	föröken
Inga	Inga
Moses	Moses
återstod	återstod
tunga	tunga
Esau	Esau
avskilde	avskilde
Hesron	Hesron
De	De
tåga	tåga
klädda	klädda
synd	synd
Bileam	Bileam
ens	ens
Dan	Dan
give	give
Akas	Akas
Sutelas	Sutelas
Efraim	Efraim
förlik	förlik
steka	steka
skrapade	skrapade
slås	slås
näste	näste
talade	talade
sträva	sträva
förbjuda	förbjuda
avla	avla
sända	sända
hoppas	hoppas
anfalla	anfalla
beskäres	beskäres
låge	låge
plågades	plågades
minska	minska
rädes	rädes
sätta	sätta
skölja	skölja
förskräcka	förskräcka
åt	åt
nämnde	nämnde
Samaria	Samaria
såld	såld
stormades	stormades
beskärde	beskärde
gileadit	gileadit
avsatt	avsatt
skäres	skäres
sky	sky
Lots	Lots
tillsättes	tillsättes
Sereds	Sereds
döpes	döpes
blindas	blindas
Natans	Natans
Egypten	Egypten
flöge	flöge
lösen	lösen
korn	korn
Faders	Faders
stadgen	stadgen
upprättade	upprättade
bestänka	bestänka
andas	andas
Evad	Evad
höljes	höljes
murbruket	murbruket
sådan	sådan
drages	drages
föreläsa	föreläsa
Att	Att
sändebudet	sändebudet
föreläses	föreläses
borgare	borgare
Geras	Geras
skilda	skilda
plugg	plugg
slaktdjuret	slaktdjuret
odjuret	odjuret
somt	somt
drömmar	drömmar
förbyta	förbyta
tabernakels	tabernakels
hälsade	hälsade
åka	åka
upphöja	upphöja
Farao	Farao
Ett	Ett
fördriva	fördriva
förundran	förundran
svävade	svävade
trycka	trycka
invig	invig
klappade	klappade
störstes	störstes
befästas	befästas
betar	betar
bin	bin
blyges	blyges
Sådan	Sådan
faders	faders
bohaget	bohaget
bortkastat	bortkastat
böjes	böjes
spännen	spännen
Den	Den
Edom	Edom
Jair	Jair
använda	använda
synds	synds
Aran	Aran
räckas	räckas
frambär	frambär
skuldoffersvädur	skuldoffersvädur
Dianas	Dianas
rike	rike
förlitat	förlitat
svarade	svarade
trängde	trängde
träd	träd
värme	värme
Akbor	Akbor
kärve	kärve
smältas	smältas
övriga	övriga
åten	åten
vindarna	vindarna
möte	möte
Efron	Efron
döma	döma
Nebajots	Nebajots
tillträde	tillträde
armes	armes
Bara	Bara
antändes	antändes
ringe	ringe
rullas	rullas
Berea	Berea
dricka	dricka
krönt	krönt
bereda	bereda
ihågkommen	ihågkommen
mördare	mördare
huggna	huggna
löfte	löfte
nätet	nätet
ändamålet	ändamålet
Milka	Milka
köpt	köpt
Jairs	Jairs
stickas	stickas
platserna	platserna
uppröres	uppröres
avfallna	avfallna
skrivare	skrivare
födde	födde
Baals	Baals
korsfästes	korsfästes
Sebaots	Sebaots
styrkas	styrkas
vann	vann
Esaus	Esaus
valv	valv
Abida	Abida
armod	armod
vanärade	vanärade
uppsöka	uppsöka
Moab	Moab
Gads	Gads
förkunnade	förkunnade
lysa	lysa
städ	städ
nödgade	nödgade
övergive	övergive
beställt	beställt
libyer	libyer
dyrkades	dyrkades
Båda	Båda
ammade	ammade
vaken	vaken
nästa	nästa
Davids	Davids
sälj	sälj
budbärarna	budbärarna
våldföra	våldföra
Varde	Varde
förbjudes	förbjudes
ära	ära
gode	gode
Susa	Susa
längs	längs
sann	sann
stallet	stallet
mätte	mätte
fostrade	fostrade
uppfyllda	uppfyllda
förra	förra
näpst	näpst
löses	löses
egyptierna	egyptierna
Mahalalels	Mahalalels
förres	förres
Lamm	Lamm
upptänden	upptänden
ämnade	ämnade
gånge	gånge
Ned	Ned
hör	hör
stige	stige
smides	smides
lyftas	lyftas
kokt	kokt
Sikems	Sikems
blinde	blinde
göras	göras
ihågkomma	ihågkomma
firades	firades
Ut	Ut
tyckes	tyckes
saknade	saknade
undantagen	undantagen
uppenbara	uppenbara
någons	någons
hållna	hållna
Gats	Gats
Elias	Elias
böjde	böjde
syns	syns
namn	namn
utdelade	utdelade
funno	funno
Jerusalems	Jerusalems
jämnas	jämnas
retas	retas
anfallen	anfallen
väcka	väcka
omsluta	omsluta
uppfödd	uppfödd
smädade	smädade
Obeds	Obeds
dukade	dukade
såren	såren
antalet	antalet
stupade	stupade
predikades	predikades
räcka	räcka
Mas	Mas
förstören	förstören
Hebron	Hebron
sida	sida
oren	oren
dödas	dödas
förjagade	förjagade
Anaks	Anaks
ring	ring
trälarbete	trälarbete
bröllopet	bröllopet
berömda	berömda
pålägga	pålägga
vet	vet
röra	röra
betänka	betänka
murbruk	murbruk
grumlade	grumlade
tusentals	tusentals
utbytte	utbytte
eländet	eländet
förtäljes	förtäljes
hembäre	hembäre
förgätna	förgätna
gäckade	gäckade
lider	lider
fria	fria
utspridde	utspridde
styrkes	styrkes
förfärade	förfärade
gods	gods
Jeremia	Jeremia
Judeens	Judeens
handlar	handlar
dräpes	dräpes
Arba	Arba
brytes	brytes
lame	lame
skyarna	skyarna
klädde	klädde
rov	rov
beredd	beredd
besatta	besatta
Jeriko	Jeriko
uträckt	uträckt
borttagen	borttagen
föden	föden
Saras	Saras
öppnades	öppnades
kastades	kastades
tungas	tungas
Bosra	Bosra
längten	längten
bakhåll	bakhåll
förtärda	förtärda
skiften	skiften
firade	firade
fattade	fattade
rövar	rövar
uppbygges	uppbygges
övertäcka	övertäcka
vete	vete
Eliesers	Eliesers
Bröder	Bröder
styrkt	styrkt
Man	Man
borrade	borrade
Abimeleks	Abimeleks
gör	gör
lovade	lovade
Hebers	Hebers
bedragna	bedragna
skänkt	skänkt
omgiva	omgiva
överstes	överstes
mången	mången
förödande	förödande
hörsammade	hörsammade
renas	renas
ställda	ställda
blygs	blygs
svalka	svalka
komme	komme
bit	bit
vätas	vätas
binda	binda
snår	snår
klagande	klagande
längtan	längtan
förgörare	förgörare
bade	bade
tyget	tyget
Anatot	Anatot
kärvarna	kärvarna
slicke	slicke
vållade	vållade
föröda	föröda
skådade	skådade
tjäne	tjäne
fötterna	fötterna
förrådshuset	förrådshuset
glänsande	glänsande
viskas	viskas
korsar	korsar
bäste	bäste
stjärntydarna	stjärntydarna
blotta	blotta
levande	levande
upptagna	upptagna
friköpt	friköpt
slån	slån
Råd	Råd
Ehud	Ehud
påbudet	påbudet
mördade	mördade
ed	ed
pålägges	pålägges
stjälen	stjälen
Milkas	Milkas
blygas	blygas
läst	läst
Gamaliels	Gamaliels
denna	denna
Ussia	Ussia
tiger	tiger
kärl	kärl
rättas	rättas
skuren	skuren
manade	manade
Rebeckas	Rebeckas
fruktade	fruktade
vilddjur	vilddjur
upphöjde	upphöjde
Lovat	Lovat
Absalom	Absalom
fots	fots
drucken	drucken
beredde	beredde
bekänna	bekänna
Noa	Noa
beröven	beröven
borttaga	borttaga
bryta	bryta
åts	åts
amma	amma
omgiven	omgiven
ha	ha
Vårt	Vårt
vändas	vändas
Guds	Guds
anställa	anställa
Jorams	Jorams
säkras	säkras
förståndet	förståndet
vita	vita
förehaves	förehaves
togs	togs
Beta	Beta
borgar	borgar
döm	döm
öken	öken
vilkas	vilkas
Akbors	Akbors
krigarna	krigarna
Baraks	Baraks
frambären	frambären
Hanok	Hanok
fylld	fylld
området	området
bunde	bunde
Alexander	Alexander
tryggade	tryggade
dyrkade	dyrkade
känna	känna
Laban	Laban
vanära	vanära
utbredda	utbredda
försvunna	försvunna
Israels	Israels
skylt	skylt
förökade	förökade
ingångarna	ingångarna
skydda	skydda
släkterna	släkterna
omsluten	omsluten
befälhavare	befälhavare
uppfödde	uppfödde
Hebrons	Hebrons
tillredes	tillredes
dräpen	dräpen
övermod	övermod
Lemek	Lemek
skildes	skildes
dugande	dugande
hemsökes	hemsökes
Elis	Elis
vakar	vakar
anföra	anföra
bortföra	bortföra
slösare	slösare
Heber	Heber
Ismaels	Ismaels
fördärvet	fördärvet
jubelår	jubelår
fat	fat
förlita	förlita
Eder	Eder
palats	palats
utrotade	utrotade
tillredda	tillredda
förlike	förlike
korset	korset
Land	Land
dråparna	dråparna
Soan	Soan
Jerikos	Jerikos
gästabudet	gästabudet
användes	användes
uppväckt	uppväckt
spotten	spotten
vika	vika
hugga	hugga
själva	själva
jublande	jublande
son	son
stod	stod
segrar	segrar
Ismael	Ismael
ökades	ökades
räddades	räddades
stekt	stekt
inmönstrades	inmönstrades
bortfört	bortfört
vittnesbörd	vittnesbörd
burna	burna
Högste	Högste
travarna	travarna
avskilda	avskilda
Efrons	Efrons
avmätt	avmätt
stillas	stillas
sitta	sitta
springare	springare
omsnärjt	omsnärjt
gudarna	gudarna
slaktade	slaktade
tågade	tågade
kröna	kröna
stötte	stötte
störste	störste
täckt	täckt
fikonträdet	fikonträdet
Ono	Ono
Landet	Landet
fördärven	fördärven
gångerna	gångerna
ringarna	ringarna
viskade	viskade
överdragna	överdragna
Tabor	Tabor
trälarbetet	trälarbetet
sångerna	sångerna
höjen	höjen
vittnade	vittnade
Aner	Aner
Urias	Urias
vetekornet	vetekornet
någon	någon
jämt	jämt
Asiens	Asiens
snöre	snöre
trängd	trängd
väckas	väckas
upprörd	upprörd
Jabins	Jabins
Barak	Barak
avlat	avlat
avståndet	avståndet
ställa	ställa
snart	snart
vässer	vässer
Vid	Vid
rört	rört
utföre	utföre
följd	följd
under	under
våld	våld
rest	rest
Josef	Josef
Mose	Mose
säges	säges
äras	äras
upprättades	upprättades
bitens	bitens
torn	torn
bindas	bindas
uppgiven	uppgiven
värma	värma
rättfärdiga	rättfärdiga
spridda	spridda
druckna	druckna
Dennes	Dennes
hörsammades	hörsammades
ringa	ringa
borrar	borrar
djur	djur
Jeremias	Jeremias
sons	sons
broders	broders
visas	visas
gapet	gapet
spända	spända
klövs	klövs
fyllen	fyllen
juble	juble
plats	plats
skött	skött
sångarna	sångarna
fast	fast
maakatéerna	maakatéerna
Nilens	Nilens
gjutna	gjutna
Jesajas	Jesajas
tränga	tränga
jublen	jublen
förlikt	förlikt
fallen	fallen
mördande	mördande
böjd	böjd
utsätta	utsätta
silverbägare	silverbägare
råds	råds
helgades	helgades
Sköna	Sköna
väckt	väckt
Ars	Ars
torget	torget
bästa	bästa
kalla	kalla
hörda	hörda
ekar	ekar
brev	brev
förgjorde	förgjorde
förgöra	förgöra
förblive	förblive
beloppet	beloppet
fiskare	fiskare
då	då
öra	öra
Sjustjärnorna	Sjustjärnorna
ändamål	ändamål
äte	äte
bliva	bliva
strutsarna	strutsarna
udd	udd
uppstånden	uppstånden
stadier	stadier
satta	satta
Kedars	Kedars
brändes	brändes
trätt	trätt
utsläckt	utsläckt
anskaffade	anskaffade
bräde	bräde
biträde	biträde
bägare	bägare
sändebud	sändebud
fälles	fälles
arglistigt	arglistigt
uppdrag	uppdrag
lovar	lovar
brännande	brännande
hålles	hålles
Orion	Orion
föra	föra
Sådant	Sådant
predikat	predikat
hörare	hörare
blinda	blinda
oxens	oxens
säge	säge
vårt	vårt
sätet	sätet
ända	ända
Nebo	Nebo
fördärvade	fördärvade
utdelat	utdelat
bön	bön
mjöl	mjöl
våldföres	våldföres
städer	städer
falla	falla
Allas	Allas
Ard	Ard
tak	tak
förvaltare	förvaltare
planterade	planterade
Jereds	Jereds
bevisade	bevisade
svävande	svävande
bredd	bredd
tjäna	tjäna
nedbryta	nedbryta
förstörda	förstörda
Nebajot	Nebajot
tillgiva	tillgiva
Jered	Jered
Libanon	Libanon
Satans	Satans
korer	korer
Dessa	Dessa
nymånadsdagar	nymånadsdagar
lyfta	lyfta
givna	givna
gömma	gömma
