Ausbeuterei	Ausbeuterei
knurrt	knurrt
hastete	hastete
besitzet	besitzet
dümpelest	dümpelest
betrübte	betrübte
bequemen	bequemen
Plüschtiere	Plüschtiere
Zapfen	Zapfen
bölkte	bölkte
berühret	berühret
Solcher	Solcher
lobte	lobte
enttäusche	enttäusche
Atemgas	Atemgas
Huren	Huren
merkte	merkte
Stärke	Stärke
verspäte	verspäte
säume	säume
Primärenergie	Primärenergie
amen	amen
faschierst	faschierst
Arsenit	Arsenit
grau	grau
Wegen	Wegen
All	All
Schatten	Schatten
belohnte	belohnte
harrtest	harrtest
Entree	Entree
regierte	regierte
gelobest	gelobest
wünschet	wünschet
Aluminaten	Aluminaten
Zeilen	Zeilen
außen	außen
Gehorcht	Gehorcht
Werkzeuge	Werkzeuge
alarmiere	alarmiere
flambierest	flambierest
entmineralisierten	entmineralisierten
verscheißerte	verscheißerte
arme	arme
Rußen	Rußen
Californium	Californium
Kronsbeeren	Kronsbeeren
krieget	krieget
schließen	schließen
Gebeinen	Gebeinen
enttäuschtest	enttäuschtest
Zwangsarbeiterin	Zwangsarbeiterin
eingehet	eingehet
gründen	gründen
Kernspaltungen	Kernspaltungen
bis	bis
Epoxide	Epoxide
verbündet	verbündet
warntet	warntet
strecken	strecken
verzieh	verzieh
predig	predig
verließen	verließen
bestimmt	bestimmt
kram	kram
Trotzkisten	Trotzkisten
substituierest	substituierest
besichert	besichert
vertilgten	vertilgten
Scheck	Scheck
weinst	weinst
verzeichne	verzeichne
Proton	Proton
abweichet	abweichet
verzehrt	verzehrt
heißet	heißet
Ratsherr	Ratsherr
wisperest	wisperest
bewiesen	bewiesen
errötest	errötest
fritierten	fritierten
verringeret	verringeret
Fremdwort	Fremdwort
besitze	besitze
verkürze	verkürze
verludet	verludet
trübe	trübe
salz	salz
Grüße	Grüße
Ludwigsburger	Ludwigsburger
lege	lege
Schafen	Schafen
schickte	schickte
hämmerst	hämmerst
Kaliumdichromat	Kaliumdichromat
Gegebenheiten	Gegebenheiten
mopst	mopst
grünest	grünest
Massagen	Massagen
Zwergschwanes	Zwergschwanes
verdeckst	verdeckst
Gipfeltreffen	Gipfeltreffen
begründetest	begründetest
unterstützten	unterstützten
sich	sich
Zapfhähnen	Zapfhähnen
ersparet	ersparet
Epidemie	Epidemie
begrübest	begrübest
Störe	Störe
besser	besser
eures	eures
Basiliken	Basiliken
sichere	sichere
losten	losten
Lobgesängen	Lobgesängen
Wiedergutmachungen	Wiedergutmachungen
rebelliere	rebelliere
Drachen	Drachen
Anliegen	Anliegen
dunkelten	dunkelten
angehören	angehören
kupiert	kupiert
links	links
klappten	klappten
versuchest	versuchest
Gasgemischen	Gasgemischen
trüge	trüge
Recht	Recht
radierte	radierte
Stall	Stall
bedeckest	bedeckest
schreist	schreist
Hirten	Hirten
verkleinern	verkleinern
Zainen	Zainen
Brieftaubenzüchters	Brieftaubenzüchters
erweckst	erweckst
Ärzten	Ärzten
versagt	versagt
Einem	Einem
exmatrikuliertet	exmatrikuliertet
Schwarzseherin	Schwarzseherin
zensiere	zensiere
Collagen	Collagen
Abschiedsbrief	Abschiedsbrief
Funkfeuer	Funkfeuer
Rufet	Rufet
Linken	Linken
Anmeldern	Anmeldern
Schotten	Schotten
zügelten	zügelten
Bette	Bette
pflücktet	pflücktet
Pest	Pest
Futtermittel	Futtermittel
genehmigt	genehmigt
Trinket	Trinket
drescht	drescht
Sorget	Sorget
Fiasko	Fiasko
heparinisiere	heparinisiere
Schläfchen	Schläfchen
karikieret	karikieret
Worten	Worten
Kommst	Kommst
lehrst	lehrst
Palisade	Palisade
bromiertet	bromiertet
drücken	drücken
verachte	verachte
Bist	Bist
ringe	ringe
reizte	reizte
Operationssaal	Operationssaal
Kühen	Kühen
Kräfte	Kräfte
gehorchten	gehorchten
angehöret	angehöret
benützt	benützt
erwachet	erwachet
Gläubigen	Gläubigen
Borkenkäfer	Borkenkäfer
transportierst	transportierst
missversteht	missversteht
Wandergesellen	Wandergesellen
Abkömmling	Abkömmling
generalisiere	generalisiere
Kost	Kost
neiden	neiden
bemühst	bemühst
Rotgüssen	Rotgüssen
Herabsetzung	Herabsetzung
verkleide	verkleide
lehnte	lehnte
verallgemeinerest	verallgemeinerest
sitzt	sitzt
inszenierst	inszenierst
Aprikosen	Aprikosen
Reichweiten	Reichweiten
träge	träge
Ach	Ach
wacht	wacht
erstehst	erstehst
geschämt	geschämt
Raute	Raute
Zinkat	Zinkat
Zeitüberschreitung	Zeitüberschreitung
begründest	begründest
Wirst	Wirst
Stimme	Stimme
könnte	könnte
verzweifelten	verzweifelten
misstrauet	misstrauet
Lob	Lob
murmelte	murmelte
pflanzet	pflanzet
Bube	Bube
war	war
Entmachtung	Entmachtung
pipettierten	pipettierten
Anführer	Anführer
privatisiert	privatisiert
Riegel	Riegel
Decks	Decks
erkalten	erkalten
knufften	knufften
verkündigten	verkündigten
Laufringen	Laufringen
Aufträgen	Aufträgen
Samstagnachmittag	Samstagnachmittag
seufzt	seufzt
flitzte	flitzte
nähte	nähte
vermahnt	vermahnt
klagte	klagte
erhebest	erhebest
erzürnt	erzürnt
tatet	tatet
verlöteten	verlöteten
enträtselst	enträtselst
zwingst	zwingst
Safrane	Safrane
flirtest	flirtest
scheiterest	scheiterest
hörest	hörest
Abhänge	Abhänge
verzehrst	verzehrst
reizt	reizt
Arbeitsgruppen	Arbeitsgruppen
Freeganer	Freeganer
argumentierten	argumentierten
fällte	fällte
Narkotikum	Narkotikum
mästet	mästet
Knüppels	Knüppels
Fettsäcken	Fettsäcken
unsres	unsres
Steuerbord	Steuerbord
Füllen	Füllen
Bestechungsgelder	Bestechungsgelder
Maultieren	Maultieren
warne	warne
Gedächtnisse	Gedächtnisse
reifst	reifst
kategorisierst	kategorisierst
drillest	drillest
vereinigte	vereinigte
Gewichten	Gewichten
hydrolysierend	hydrolysierend
Theologien	Theologien
macht	macht
konsolidierest	konsolidierest
Gepäckträger	Gepäckträger
Dein	Dein
entdeckst	entdeckst
Brötchen	Brötchen
ehren	ehren
Präservativen	Präservativen
Organisation	Organisation
Malen	Malen
tanzen	tanzen
mußte	mußte
folgst	folgst
Maß	Maß
hänge	hänge
Adamsapfel	Adamsapfel
schnorrtet	schnorrtet
Rücktritt	Rücktritt
verführten	verführten
Für	Für
sterilisierte	sterilisierte
analysiert	analysiert
verirrt	verirrt
Meter	Meter
grünte	grünte
sagt	sagt
leerst	leerst
Weil	Weil
Fiesling	Fiesling
Forschung	Forschung
fünfte	fünfte
dressierten	dressierten
funkelet	funkelet
brachen	brachen
Meines	Meines
verdränget	verdränget
niemand	niemand
bimmelte	bimmelte
bekotete	bekotete
Fahrzeugkatalysatoren	Fahrzeugkatalysatoren
Aufpralle	Aufpralle
ziert	ziert
Backenbärten	Backenbärten
überbewerte	überbewerte
Wurzelwachstum	Wurzelwachstum
Notärztinnen	Notärztinnen
aller	aller
brauchte	brauchte
Radiergummis	Radiergummis
Suchet	Suchet
Rheumatismus	Rheumatismus
foppte	foppte
Kaufleute	Kaufleute
sedimentieret	sedimentieret
kramten	kramten
besät	besät
Gehorchet	Gehorchet
irgendeine	irgendeine
drosselten	drosselten
Badezimmer	Badezimmer
Dochte	Dochte
befördert	befördert
Hochsommern	Hochsommern
skypst	skypst
Forschungen	Forschungen
Neumonden	Neumonden
erzeigen	erzeigen
verzeigt	verzeigt
wende	wende
Geschreis	Geschreis
kostet	kostet
frottier	frottier
fahrt	fahrt
frevles	frevles
Deutung	Deutung
inszeniere	inszeniere
gleitest	gleitest
widmet	widmet
wechseln	wechseln
bildest	bildest
Teppiche	Teppiche
baggerst	baggerst
verbrauchte	verbrauchte
Kindergeld	Kindergeld
Zwergschwan	Zwergschwan
möchtet	möchtet
auszogst	auszogst
benachrichtiget	benachrichtiget
Republikflucht	Republikflucht
schäme	schäme
konnte	konnte
nachwandelte	nachwandelte
hebräischen	hebräischen
Kontaktierungen	Kontaktierungen
fehlet	fehlet
fragmentierst	fragmentierst
Baisers	Baisers
Flensern	Flensern
protestierst	protestierst
kupieren	kupieren
neigte	neigte
zentriert	zentriert
Stätte	Stätte
weisen	weisen
Laken	Laken
überschatteten	überschatteten
berücksichtiget	berücksichtiget
grienest	grienest
zweifelte	zweifelte
greife	greife
Buchstabe	Buchstabe
Treppen	Treppen
Klotzes	Klotzes
Fremdwörter	Fremdwörter
verbündete	verbündete
Wege	Wege
eng	eng
rühmst	rühmst
lobet	lobet
entschädigte	entschädigte
Mäusespeck	Mäusespeck
weg	weg
viele	viele
begrübe	begrübe
bröckelten	bröckelten
setzten	setzten
Eingeweiden	Eingeweiden
Borhydrid	Borhydrid
Einöden	Einöden
redetest	redetest
bekehret	bekehret
Dezernat	Dezernat
mästest	mästest
stärkte	stärkte
brillieret	brillieret
Ichs	Ichs
Kriegsschauplatz	Kriegsschauplatz
exmatrikulierte	exmatrikulierte
besichtigt	besichtigt
glauben	glauben
schälte	schälte
zeugt	zeugt
filzen	filzen
verbüßest	verbüßest
eggten	eggten
hänget	hänget
Hacker	Hacker
malten	malten
Päckchens	Päckchens
Hüftgelenken	Hüftgelenken
lockerte	lockerte
dringst	dringst
kabelten	kabelten
begleicht	begleicht
klingest	klingest
vereinbaren	vereinbaren
Gummibäumen	Gummibäumen
Tiefen	Tiefen
lostest	lostest
polymerisier	polymerisier
Rücktrittes	Rücktrittes
Spitze	Spitze
Diäresen	Diäresen
sprachen	sprachen
bewiest	bewiest
Schobern	Schobern
Tukans	Tukans
UND-Gatter	UND-Gatter
Kassiterits	Kassiterits
eines	eines
Tollkirschen	Tollkirschen
fünften	fünften
wichste	wichste
kehret	kehret
Kruste	Kruste
Macht	Macht
Atommodellen	Atommodellen
erkältete	erkältete
Weinen	Weinen
Elastomer	Elastomer
blättertet	blättertet
klemmen	klemmen
gare	gare
Thioacetal	Thioacetal
Borhydride	Borhydride
zieren	zieren
Klassenzimmern	Klassenzimmern
replizieret	replizieret
Essen	Essen
Silberdrahts	Silberdrahts
querest	querest
kriegte	kriegte
bat	bat
Serverzugriffen	Serverzugriffen
ruckeln	ruckeln
streckst	streckst
Rhabarber	Rhabarber
denaturiert	denaturiert
besprächen	besprächen
Gigapascaln	Gigapascaln
deklarierte	deklarierte
verschont	verschont
sedimentiere	sedimentiere
pflügest	pflügest
Bärenfellen	Bärenfellen
koche	koche
begehrten	begehrten
Schulleiterin	Schulleiterin
Wolfesgrube	Wolfesgrube
attestiertet	attestiertet
löstest	löstest
wegführe	wegführe
nähe	nähe
Geldautomat	Geldautomat
Citrat	Citrat
Mittelaltermarkt	Mittelaltermarkt
Büchereien	Büchereien
ausgehst	ausgehst
ob	ob
Eines	Eines
huren	huren
Arsch	Arsch
stillest	stillest
helft	helft
sündigt	sündigt
verunreinigt	verunreinigt
Sündern	Sündern
Am	Am
Abkömmlingen	Abkömmlingen
Kissenschlacht	Kissenschlacht
putzt	putzt
Tollkirsche	Tollkirsche
Satzungen	Satzungen
redetet	redetet
Otaviten	Otaviten
Seil	Seil
rüste	rüste
Fülle	Fülle
Verbrechen	Verbrechen
touchierte	touchierte
läutetet	läutetet
Gase	Gase
duckmäusere	duckmäusere
Flenser	Flenser
übet	übet
knüpfet	knüpfet
schlabberten	schlabberten
Übertretung	Übertretung
knistern	knistern
zerstreuest	zerstreuest
rühmte	rühmte
verglühest	verglühest
Prüfberichten	Prüfberichten
gleite	gleite
parkierten	parkierten
Greyerzern	Greyerzern
schenkst	schenkst
tränkten	tränkten
verstehest	verstehest
reanimiere	reanimiere
Fürst	Fürst
Physikerinnen	Physikerinnen
untersagest	untersagest
anzeigen	anzeigen
denaturierte	denaturierte
haltest	haltest
generalisiert	generalisiert
schöpfest	schöpfest
Klauen	Klauen
dümpelte	dümpelte
Bauwerke	Bauwerke
hoben	hoben
verrostet	verrostet
Fischzucht	Fischzucht
Polierstählen	Polierstählen
umbrächten	umbrächten
Lehne	Lehne
Apotheose	Apotheose
versuchet	versuchet
desensibilisierte	desensibilisierte
motivieren	motivieren
Kreisen	Kreisen
Strafräume	Strafräume
Ring	Ring
Dithiolane	Dithiolane
vergiftet	vergiftet
Felsboden	Felsboden
wer	wer
knacktest	knacktest
feiert	feiert
urbanisier	urbanisier
Abbindebeschleunigern	Abbindebeschleunigern
Reiseleiter	Reiseleiter
sprichst	sprichst
umhüllst	umhüllst
schwebte	schwebte
erlösest	erlösest
addieren	addieren
den	den
Überfamilie	Überfamilie
wünsche	wünsche
Seelöwe	Seelöwe
ernten	ernten
Gehirnwellen	Gehirnwellen
stoße	stoße
glänzten	glänzten
Preisen	Preisen
gebt	gebt
schleißt	schleißt
implodier	implodier
wässerten	wässerten
Ansteckern	Ansteckern
übrigbleibet	übrigbleibet
überweisend	überweisend
formulieren	formulieren
höhnest	höhnest
Großfürsten	Großfürsten
häufen	häufen
Cholesterin	Cholesterin
blockiert	blockiert
produzierest	produzierest
Hadith	Hadith
rächest	rächest
laut	laut
blitz	blitz
Mähnenwolfes	Mähnenwolfes
warnet	warnet
rammte	rammte
räumet	räumet
parliere	parliere
Zäunen	Zäunen
habt	habt
Sprüche	Sprüche
verklagt	verklagt
borgte	borgte
Ärztinnen	Ärztinnen
Carbids	Carbids
Abflug	Abflug
unehrt	unehrt
wirfst	wirfst
bringst	bringst
hinterfragst	hinterfragst
flirtete	flirtete
Retter	Retter
Seiten	Seiten
Seilen	Seilen
Elementarzelle	Elementarzelle
Küchenmaschine	Küchenmaschine
legest	legest
Hinterwäldler	Hinterwäldler
hydrogentartrat	hydrogentartrat
folgen	folgen
protestiere	protestiere
gedenkt	gedenkt
Heteroatome	Heteroatome
Bluffs	Bluffs
amputiere	amputiere
piesackest	piesackest
löste	löste
malochte	malochte
radiertest	radiertest
Eutern	Eutern
tendiertet	tendiertet
Gar	Gar
leuchtete	leuchtete
Atomphysiker	Atomphysiker
heiligten	heiligten
Fettes	Fettes
Halbmond	Halbmond
Landstreichereien	Landstreichereien
Werden	Werden
Vergrößerungen	Vergrößerungen
Fallet	Fallet
Andrologie	Andrologie
stürzest	stürzest
Untier	Untier
braust	braust
zürntet	zürntet
zirpe	zirpe
jedes	jedes
Speere	Speere
Auge	Auge
Rhabarbern	Rhabarbern
geboten	geboten
Feierabend	Feierabend
Schlagern	Schlagern
klappen	klappen
Untern	Untern
Ionen	Ionen
entsetzet	entsetzet
dechiffriere	dechiffriere
vernichtete	vernichtete
Hälmchen	Hälmchen
verkaufte	verkaufte
hatte	hatte
innere	innere
schicke	schicke
Verkehrsflugzeuge	Verkehrsflugzeuge
ermordet	ermordet
Denkmünzen	Denkmünzen
ackerst	ackerst
egge	egge
schämet	schämet
erzürnet	erzürnet
blätteret	blätteret
fluchet	fluchet
deinem	deinem
Büstenhalters	Büstenhalters
eure	eure
Adlerbussarden	Adlerbussarden
Geliebten	Geliebten
Eingeweide	Eingeweide
plissieren	plissieren
Quellfluss	Quellfluss
unterwerfest	unterwerfest
verdrehet	verdrehet
Fluoratomen	Fluoratomen
Erfahrungen	Erfahrungen
Lehnen	Lehnen
leertet	leertet
Ärzteblatt	Ärzteblatt
Bromidquelle	Bromidquelle
Flammen	Flammen
fastetest	fastetest
Kehret	Kehret
Herr	Herr
Welchen	Welchen
bewässertet	bewässertet
vernehmest	vernehmest
verzweigst	verzweigst
Vorstädten	Vorstädten
gelobten	gelobten
Blumensträußen	Blumensträußen
gabelt	gabelt
merke	merke
Butzemann	Butzemann
Friedensforscherinnen	Friedensforscherinnen
Hurriter	Hurriter
hinterlege	hinterlege
Leiste	Leiste
Silbergeschirr	Silbergeschirr
partitionierten	partitionierten
Sehnen	Sehnen
zertifiziertest	zertifiziertest
regieret	regieret
lösten	lösten
lautete	lautete
bauten	bauten
Darlegungen	Darlegungen
sterbest	sterbest
hätte	hätte
ungehorsame	ungehorsame
Brotkästen	Brotkästen
rauben	rauben
vibriere	vibriere
beschuldigt	beschuldigt
Myriade	Myriade
Radsätzen	Radsätzen
Nanosatelliten	Nanosatelliten
peilst	peilst
reagierte	reagierte
Enthärtungen	Enthärtungen
besuche	besuche
füllst	füllst
Entsetzen	Entsetzen
meinet	meinet
glühende	glühende
Jagdbomber	Jagdbomber
unterforderten	unterforderten
wogen	wogen
gesellt	gesellt
neigest	neigest
beläufst	beläufst
Bienenstöcke	Bienenstöcke
Reststoff	Reststoff
bescheiße	bescheiße
Kakao	Kakao
motivierten	motivierten
verwahrt	verwahrt
räucheret	räucheret
annektierten	annektierten
fragest	fragest
Einer	Einer
knüpfen	knüpfen
Rekursionen	Rekursionen
Fußbodens	Fußbodens
Stempeluhren	Stempeluhren
lebte	lebte
ausführen	ausführen
rebellieren	rebellieren
Apportierhund	Apportierhund
schrecken	schrecken
ausfuhr	ausfuhr
eurem	eurem
verführtest	verführtest
Vogelscheuche	Vogelscheuche
verlautet	verlautet
Ausgangssperren	Ausgangssperren
fromme	fromme
Unglauben	Unglauben
Politologen	Politologen
wog	wog
benehme	benehme
zeug	zeug
hätten	hätten
Robe	Robe
trödele	trödele
Chlorid	Chlorid
Sterne	Sterne
Gigapascal	Gigapascal
sollte	sollte
versteckt	versteckt
Ich	Ich
Mischelement	Mischelement
Psi	Psi
sorgte	sorgte
tätowierest	tätowierest
Sprödmetall	Sprödmetall
musizierte	musizierte
Fischotters	Fischotters
entzogen	entzogen
gelost	gelost
sterilisierten	sterilisierten
Fischen	Fischen
spurtest	spurtest
Effekt	Effekt
erste	erste
entschädiget	entschädiget
verwirrest	verwirrest
zuppte	zuppte
Paläste	Paläste
ermordetet	ermordetet
verwirft	verwirft
scheuchen	scheuchen
Abartigkeiten	Abartigkeiten
Beobachtungen	Beobachtungen
Puffersystem	Puffersystem
Ausnahmen	Ausnahmen
Marokkaners	Marokkaners
graben	graben
kaufest	kaufest
steigest	steigest
Beinen	Beinen
betrübest	betrübest
Hanse	Hanse
lanciertet	lanciertet
generiertet	generiertet
Schanktisch	Schanktisch
bedient	bedient
chloroformiere	chloroformiere
Tukanen	Tukanen
bewieset	bewieset
verachtet	verachtet
nimmt	nimmt
Hin	Hin
unterrichtet	unterrichtet
Fanatiker	Fanatiker
Schnute	Schnute
wärst	wärst
beschuldiget	beschuldiget
Fotosynthese	Fotosynthese
strafst	strafst
versteckten	versteckten
bücktest	bücktest
baten	baten
Leuchtkäfern	Leuchtkäfern
waren	waren
mampfen	mampfen
Ente	Ente
Wäre	Wäre
Reinigungsschritten	Reinigungsschritten
konnten	konnten
segelte	segelte
desensibilisierten	desensibilisierten
finanzierest	finanzierest
Trinkgefäßen	Trinkgefäßen
gedenkest	gedenkest
Abnahmen	Abnahmen
Könige	Könige
Jungen	Jungen
Bettlers	Bettlers
dampfst	dampfst
Essigsäurechloriden	Essigsäurechloriden
mogelten	mogelten
zweite	zweite
täuschte	täuschte
Antimustern	Antimustern
assimilierten	assimilierten
Androiden	Androiden
Jüngern	Jüngern
googelten	googelten
Epidemien	Epidemien
schmiert	schmiert
negierte	negierte
Android	Android
zerreißt	zerreißt
Pflanzenstoff	Pflanzenstoff
rangieret	rangieret
Freibrief	Freibrief
verbrauchet	verbrauchet
Glauben	Glauben
zerstückt	zerstückt
überliefere	überliefere
Leichnamen	Leichnamen
steuerte	steuerte
zerrisset	zerrisset
auszöge	auszöge
geniertest	geniertest
Altäre	Altäre
wischt	wischt
Türklingel	Türklingel
verseifet	verseifet
Anrufbeantworter	Anrufbeantworter
misstrauen	misstrauen
Kleinodien	Kleinodien
tobet	tobet
Kristalle	Kristalle
erforschet	erforschet
befestigt	befestigt
stationierten	stationierten
lehren	lehren
entsündigte	entsündigte
knuffend	knuffend
bekannte	bekannte
Lobgesänge	Lobgesänge
wohnet	wohnet
erntet	erntet
Effekten	Effekten
Vogelscheuchen	Vogelscheuchen
rännen	rännen
wünschte	wünschte
Trübsale	Trübsale
predigt	predigt
installierten	installierten
wert	wert
Dachdecker	Dachdecker
Älteste	Älteste
bemerket	bemerket
würdet	würdet
unschuldige	unschuldige
fritieret	fritieret
injizierest	injizierest
Genie	Genie
zählend	zählend
säuselest	säuselest
rächte	rächte
kritzelst	kritzelst
überfallen	überfallen
Krume	Krume
posiertet	posiertet
verselbständigst	verselbständigst
loste	loste
geleitest	geleitest
harmonierest	harmonierest
befestigten	befestigten
parametrisierten	parametrisierten
naschten	naschten
Fusselbärten	Fusselbärten
umbrächte	umbrächte
Flöten	Flöten
Pforte	Pforte
behütetest	behütetest
unsre	unsre
Kriegsknechte	Kriegsknechte
verschlimmerte	verschlimmerte
Oxonium	Oxonium
fabuliere	fabuliere
Aktienkurs	Aktienkurs
stürzt	stürzt
verblute	verblute
Hornung	Hornung
kickst	kickst
babbelten	babbelten
jedem	jedem
Garten	Garten
Literaturen	Literaturen
baggerte	baggerte
dringen	dringen
bang	bang
könne	könne
Frieden	Frieden
Ansichtskarte	Ansichtskarte
Mäusen	Mäusen
streue	streue
verschaffte	verschaffte
Silbererzen	Silbererzen
Elstern	Elstern
stiege	stiege
Lasten	Lasten
wahre	wahre
grabble	grabble
Fingerhüten	Fingerhüten
Halbzeiten	Halbzeiten
Rotzinkerzen	Rotzinkerzen
Verehrer	Verehrer
schimmerest	schimmerest
tobend	tobend
beichteten	beichteten
schauten	schauten
fingiere	fingiere
Großstädtern	Großstädtern
Fanmeile	Fanmeile
Gaschromatographien	Gaschromatographien
schaffen	schaffen
Petersfischen	Petersfischen
simuliertet	simuliertet
zürne	zürne
freute	freute
zentrifugieren	zentrifugieren
Benzol	Benzol
Blicksilber	Blicksilber
imkeret	imkeret
Maßen	Maßen
Märtyrer	Märtyrer
nehmest	nehmest
Dachdeckerin	Dachdeckerin
Lüsten	Lüsten
blondieren	blondieren
blitzt	blitzt
Euren	Euren
brausen	brausen
verstört	verstört
irgendein	irgendein
löse	löse
räumen	räumen
könnten	könnten
zürnst	zürnst
wiederholte	wiederholte
Messiassen	Messiassen
Flussbett	Flussbett
Klüfte	Klüfte
Managementsystemen	Managementsystemen
Ringeltauben	Ringeltauben
Wiederbelebung	Wiederbelebung
seist	seist
schöben	schöben
Sitzfleisches	Sitzfleisches
lange	lange
arbeit	arbeit
betonierte	betonierte
mögest	mögest
Dudelsack	Dudelsack
Sexten	Sexten
greinet	greinet
Reststoffen	Reststoffen
Welche	Welche
entwischtet	entwischtet
nächsten	nächsten
fluchte	fluchte
Berufe	Berufe
unseren	unseren
überreichen	überreichen
wache	wache
lodert	lodert
Rumänin	Rumänin
klappest	klappest
Weihen	Weihen
verkriechst	verkriechst
Dorngesträuch	Dorngesträuch
ihres	ihres
eingehst	eingehst
googelest	googelest
austilgen	austilgen
spannt	spannt
Hörspiel	Hörspiel
Malaysier	Malaysier
dirigieret	dirigieret
behütet	behütet
babbelt	babbelt
traget	traget
deponiere	deponiere
würde	würde
Entsetzet	Entsetzet
Vetter	Vetter
ihrem	ihrem
Abnahme	Abnahme
Hast	Hast
welchen	welchen
verberge	verberge
Thioestere	Thioestere
vermutest	vermutest
tabuisierten	tabuisierten
verzehre	verzehre
wallfahrest	wallfahrest
lebest	lebest
parfümierte	parfümierte
danket	danket
glänzen	glänzen
fladerest	fladerest
Taufen	Taufen
Wechselstube	Wechselstube
Regieren	Regieren
Zain	Zain
bereuest	bereuest
tut	tut
käbbelnd	käbbelnd
Steinen	Steinen
sinnst	sinnst
lehnen	lehnen
Recitativ	Recitativ
bleibet	bleibet
übte	übte
besuchen	besuchen
höhnte	höhnte
möge	möge
Wände	Wände
spaltetest	spaltetest
ihren	ihren
besorg	besorg
prangest	prangest
Schade	Schade
bemüht	bemüht
Gurten	Gurten
Zöpfe	Zöpfe
Zunge	Zunge
zerfielen	zerfielen
sterbet	sterbet
verführe	verführe
helle	helle
erhebst	erhebst
heftete	heftete
Lazarett	Lazarett
wurden	wurden
gedenkst	gedenkst
Welteninseln	Welteninseln
Gibt	Gibt
Tyrann	Tyrann
Geldautomaten	Geldautomaten
Preisanstieg	Preisanstieg
Bademäntel	Bademäntel
heftetest	heftetest
umhüllend	umhüllend
Held	Held
Wer	Wer
bedürftet	bedürftet
gehorcht	gehorcht
liebtest	liebtest
vertilgen	vertilgen
Karern	Karern
Gesamtmenge	Gesamtmenge
könnt	könnt
ruhe	ruhe
verfolgst	verfolgst
Stimmen	Stimmen
Hubschrauber	Hubschrauber
Schuhen	Schuhen
Öfchen	Öfchen
Heteroatom	Heteroatom
möchtest	möchtest
leere	leere
folget	folget
Astat	Astat
hebe	hebe
Ambiguitäten	Ambiguitäten
gebühren	gebühren
Zerfall	Zerfall
dürfen	dürfen
köderet	köderet
schämest	schämest
Nanoteslan	Nanoteslan
Rauten	Rauten
Membran	Membran
gedächtet	gedächtet
Schwan	Schwan
erziehst	erziehst
geraten	geraten
zeugtest	zeugtest
sprüht	sprüht
Unwahrheiten	Unwahrheiten
verschafft	verschafft
vertuest	vertuest
Numerus	Numerus
Treibhausgase	Treibhausgase
halle	halle
Harpunen	Harpunen
reglementiert	reglementiert
tappten	tappten
verzögerten	verzögerten
Wachen	Wachen
Kontraindikationen	Kontraindikationen
Brechnüssen	Brechnüssen
lostet	lostet
ummantelten	ummantelten
verführte	verführte
spritzt	spritzt
vermahnten	vermahnten
Buntspechte	Buntspechte
Metapher	Metapher
Sippe	Sippe
batet	batet
schlafet	schlafet
Adamsäpfeln	Adamsäpfeln
Kerf	Kerf
Schau	Schau
Urheimaten	Urheimaten
Hunde	Hunde
Taube	Taube
Meinen	Meinen
schießt	schießt
Armen	Armen
Ochse	Ochse
defragmentierest	defragmentierest
driftete	driftete
Gebern	Gebern
bist	bist
Schnarchralle	Schnarchralle
schnappt	schnappt
einst	einst
nachwandelt	nachwandelt
Kautschuken	Kautschuken
krank	krank
Chlorwasserstoffmoleküls	Chlorwasserstoffmoleküls
strömt	strömt
Moren	Moren
hinterlegt	hinterlegt
vergaste	vergaste
Backpflaumen	Backpflaumen
Atommasse	Atommasse
dramatisieren	dramatisieren
Wüsten	Wüsten
verjährte	verjährte
Knöllchen	Knöllchen
arrivieren	arrivieren
kategorisierte	kategorisierte
hüte	hüte
gestikuliere	gestikuliere
befehlt	befehlt
Alle	Alle
lispelten	lispelten
verkaufe	verkaufe
schubse	schubse
Eisenkraut	Eisenkraut
Telefonnummer	Telefonnummer
Eisstein	Eisstein
Gemüt	Gemüt
hinterfragten	hinterfragten
Wahnen	Wahnen
Außenministerien	Außenministerien
Fett	Fett
Chasar	Chasar
Stärket	Stärket
andere	andere
designierst	designierst
besicheret	besicheret
Bushaltestellen	Bushaltestellen
erwache	erwache
flense	flense
Konfitüre	Konfitüre
zerstreuet	zerstreuet
Speeren	Speeren
Zeug	Zeug
dramatisiert	dramatisiert
Hüfte	Hüfte
quatschest	quatschest
meinem	meinem
betreibet	betreibet
zwängtet	zwängtet
Lichte	Lichte
glaubend	glaubend
erwürgten	erwürgten
liegen	liegen
Klüften	Klüften
widerstanden	widerstanden
Schuhe	Schuhe
Amnestie	Amnestie
Gefügen	Gefügen
wachsen	wachsen
versuchst	versuchst
Heringe	Heringe
schluchze	schluchze
Hälse	Hälse
kurz	kurz
changiere	changiere
Malaysierinnen	Malaysierinnen
reanimierten	reanimierten
Schober	Schober
bleiben	bleiben
schaben	schaben
sicherst	sicherst
Melanteriten	Melanteriten
Euphemismus	Euphemismus
Rotscheitelreiher	Rotscheitelreiher
erzürnst	erzürnst
beäugst	beäugst
Schwermetallion	Schwermetallion
träumen	träumen
schwellen	schwellen
übrigbleiben	übrigbleiben
Fadenlauf	Fadenlauf
zanket	zanket
glawbte	glawbte
Homodimeren	Homodimeren
wären	wären
Normdaten	Normdaten
Beschuldigung	Beschuldigung
Glatteis	Glatteis
Tintenklecksen	Tintenklecksen
Elf	Elf
ringelten	ringelten
Feldbett	Feldbett
ritt	ritt
filzst	filzst
beweisest	beweisest
harren	harren
Verbindungsdraht	Verbindungsdraht
zerrüttet	zerrüttet
Locken	Locken
vertrieben	vertrieben
schätze	schätze
denaturieret	denaturieret
bestimmst	bestimmst
fluppten	fluppten
Philerast	Philerast
Adelungen	Adelungen
prostete	prostete
führst	führst
ratschlagten	ratschlagten
auflöst	auflöst
gepuddelt	gepuddelt
vertiefet	vertiefet
Spektralbereichen	Spektralbereichen
überquerst	überquerst
Judenräte	Judenräte
Vorstoß	Vorstoß
Schnittlauche	Schnittlauche
gehört	gehört
offenbart	offenbart
überweise	überweise
bauest	bauest
Fußmatte	Fußmatte
Ärgernisse	Ärgernisse
fastetet	fastetet
nagelte	nagelte
Ha	Ha
redete	redete
Falle	Falle
Nadelbäumen	Nadelbäumen
Feierabende	Feierabende
Zehe	Zehe
ansehet	ansehet
Primärenergien	Primärenergien
Pausbacken	Pausbacken
tagest	tagest
begehrte	begehrte
knautsche	knautsche
Weiß	Weiß
annektierst	annektierst
Abfertigungsschalters	Abfertigungsschalters
fasse	fasse
merket	merket
sehnet	sehnet
tage	tage
gehst	gehst
hieltet	hieltet
beschert	beschert
verdammst	verdammst
Aufprall	Aufprall
decket	decket
aber	aber
maximiere	maximiere
erpress	erpress
geloben	geloben
Rehen	Rehen
Haben	Haben
Karikaturistinnen	Karikaturistinnen
kaufst	kaufst
Weinet	Weinet
Ruß	Ruß
Ion	Ion
führet	führet
Referenz	Referenz
Judenrat	Judenrat
Ölspur	Ölspur
Qualifikationen	Qualifikationen
zerrüttete	zerrüttete
kennst	kennst
Inkarnationen	Inkarnationen
Ei	Ei
schweigst	schweigst
grünten	grünten
Brettspielen	Brettspielen
moppen	moppen
pharyngalisierten	pharyngalisierten
Zinkionen	Zinkionen
oxidierst	oxidierst
Sprecher	Sprecher
grüße	grüße
Anachronismen	Anachronismen
lavierend	lavierend
Coventrisierung	Coventrisierung
analysiere	analysiere
Chronisten	Chronisten
verdammet	verdammet
erlagst	erlagst
Empörung	Empörung
Hörst	Hörst
Donor	Donor
beantrage	beantrage
Efeu	Efeu
Abgaskatalysatoren	Abgaskatalysatoren
verfehlten	verfehlten
föhnten	föhnten
leben	leben
kappet	kappet
zeugte	zeugte
Schlüchte	Schlüchte
Zebrahaies	Zebrahaies
murmeln	murmeln
Deuteriums	Deuteriums
brenne	brenne
Entrées	Entrées
gehorchet	gehorchet
ungeistlich	ungeistlich
schaue	schaue
Dilettanten	Dilettanten
föchten	föchten
drosselt	drosselt
Bebauungsplänen	Bebauungsplänen
installiert	installiert
zuteilte	zuteilte
irre	irre
scheinest	scheinest
Rundbriefen	Rundbriefen
Alkine	Alkine
Händen	Händen
abtrünnigen	abtrünnigen
Düften	Düften
Sprüchen	Sprüchen
Händedruck	Händedruck
Sonnenfinsternis	Sonnenfinsternis
unserer	unserer
setzen	setzen
Gnaden	Gnaden
legend	legend
Gruftis	Gruftis
Seile	Seile
Krumen	Krumen
Mittelaltermarktes	Mittelaltermarktes
parametrisierst	parametrisierst
Begünstigungen	Begünstigungen
manche	manche
urteilen	urteilen
ermutigt	ermutigt
Feinde	Feinde
gedenke	gedenke
Blechen	Blechen
besorgten	besorgten
besehet	besehet
Argyrodite	Argyrodite
Streife	Streife
Gasflaschen	Gasflaschen
holst	holst
nachwandelst	nachwandelst
Buchfinken	Buchfinken
dehydrierte	dehydrierte
erntete	erntete
Zwetschge	Zwetschge
fließt	fließt
fokussierten	fokussierten
Anfechtung	Anfechtung
Taschenwörterbuches	Taschenwörterbuches
Blaumeisen	Blaumeisen
überqueren	überqueren
ersparten	ersparten
Anmelder	Anmelder
Gefängnisse	Gefängnisse
würden	würden
freiwillige	freiwillige
denen	denen
Energiespeicher	Energiespeicher
punkten	punkten
Adhäsionen	Adhäsionen
füllen	füllen
bebet	bebet
Türme	Türme
stimme	stimme
Ehre	Ehre
tätowiertet	tätowiertet
fehlte	fehlte
aufkäme	aufkäme
Gläubiger	Gläubiger
entzögen	entzögen
manchen	manchen
vergiften	vergiften
diente	diente
tragen	tragen
Rhodochrositen	Rhodochrositen
reich	reich
untertreten	untertreten
Klappertopf	Klappertopf
binde	binde
lögest	lögest
Insulaner	Insulaner
Garben	Garben
Gewalttätern	Gewalttätern
Diese	Diese
zerstreute	zerstreute
hydrolysierest	hydrolysierest
Anarchisten	Anarchisten
Kleinoden	Kleinoden
aase	aase
Tiefschutz	Tiefschutz
Hallen	Hallen
Arreste	Arreste
jaget	jaget
Mop	Mop
Prostylos	Prostylos
referenziere	referenziere
keinen	keinen
Lammfellhandschuhen	Lammfellhandschuhen
Atemlüfte	Atemlüfte
Wert	Wert
erweckt	erweckt
schmeicheln	schmeicheln
Laiben	Laiben
Bedeutung	Bedeutung
dich	dich
kabeln	kabeln
spielte	spielte
heiligt	heiligt
entsetzte	entsetzte
Worte	Worte
reichet	reichet
Gute	Gute
entzweiest	entzweiest
Adlerbussard	Adlerbussard
taufte	taufte
Negermusik	Negermusik
Substanzen	Substanzen
schwimmst	schwimmst
lang	lang
lehret	lehret
begrabt	begrabt
Jahre	Jahre
koexistierte	koexistierte
erzeigte	erzeigte
regiere	regiere
Dichten	Dichten
Bürzeln	Bürzeln
Höhen	Höhen
puste	puste
Anker	Anker
addierest	addierest
leiste	leiste
verschärftet	verschärftet
begehren	begehren
Lehrkörpern	Lehrkörpern
verlieren	verlieren
plumpse	plumpse
Kriegsenden	Kriegsenden
Einwirkungen	Einwirkungen
Beine	Beine
explodierst	explodierst
Leichenschauhäusern	Leichenschauhäusern
regeln	regeln
Wehret	Wehret
Aktenkoffer	Aktenkoffer
Playlists	Playlists
Dewargefäße	Dewargefäße
Tasten	Tasten
zersetzet	zersetzet
konvergiere	konvergiere
schreckt	schreckt
Samarskite	Samarskite
Weinberge	Weinberge
freuet	freuet
seine	seine
Vanadaten	Vanadaten
emendieret	emendieret
Mopps	Mopps
NAND-Gatter	NAND-Gatter
Scherzes	Scherzes
lieget	lieget
duzen	duzen
Füllfederhalter	Füllfederhalter
reparieret	reparieret
entwendete	entwendete
befehle	befehle
Cyanat	Cyanat
fritierst	fritierst
wechselte	wechselte
keulte	keulte
verkürztest	verkürztest
Kuckucken	Kuckucken
Drohkulisse	Drohkulisse
entgehe	entgehe
Hochzeitstorten	Hochzeitstorten
widmest	widmest
seht	seht
Oberbegriff	Oberbegriff
reife	reife
versteckend	versteckend
erliegen	erliegen
besäet	besäet
älteste	älteste
Bleiglanzes	Bleiglanzes
Tretlager	Tretlager
erntest	erntest
setzt	setzt
verkriechet	verkriechet
erhöht	erhöht
Crescendo	Crescendo
erfahret	erfahret
Theistinnen	Theistinnen
Präservativs	Präservativs
sollst	sollst
konvertiere	konvertiere
ausführe	ausführe
lösend	lösend
Trübsal	Trübsal
illustriere	illustriere
Heiratsgütern	Heiratsgütern
setzte	setzte
Prozeduren	Prozeduren
Götzen	Götzen
ducktest	ducktest
Warte	Warte
feiern	feiern
bezahlest	bezahlest
gehorchte	gehorchte
Kerfe	Kerfe
hegst	hegst
Patres	Patres
stirbt	stirbt
Blitze	Blitze
duckmäuseret	duckmäuseret
strecke	strecke
grünet	grünet
strafen	strafen
vielen	vielen
dritten	dritten
Böse	Böse
Nachteilen	Nachteilen
fressen	fressen
Geburtsnamen	Geburtsnamen
Thioacetalen	Thioacetalen
erliegest	erliegest
rüstete	rüstete
erkanntet	erkanntet
Paragraphenreitern	Paragraphenreitern
meines	meines
nähert	nähert
Aggressor	Aggressor
ritze	ritze
Argyroditen	Argyroditen
bleibst	bleibst
Prüfbericht	Prüfbericht
Rechtsruck	Rechtsruck
massierst	massierst
Gehorsam	Gehorsam
Smaragdkehlkolibris	Smaragdkehlkolibris
aufwacht	aufwacht
Verwundete	Verwundete
Betainen	Betainen
haltet	haltet
koordinieret	koordinieret
Weinstöcken	Weinstöcken
Sorge	Sorge
verurteilen	verurteilen
Achsel	Achsel
piesacken	piesacken
ehret	ehret
einführen	einführen
verteidigt	verteidigt
Pfunde	Pfunde
Metaphern	Metaphern
Pfandgeld	Pfandgeld
beleidige	beleidige
stehest	stehest
sorgen	sorgen
kehrte	kehrte
sei	sei
Schanktischen	Schanktischen
Dienstgrade	Dienstgrade
zähle	zähle
zuhört	zuhört
Letzte	Letzte
veranstaltest	veranstaltest
Anfechtungen	Anfechtungen
schau	schau
essest	essest
verdrängen	verdrängen
straften	straften
frottierten	frottierten
Male	Male
Klassenzimmer	Klassenzimmer
Industrienation	Industrienation
Blitzen	Blitzen
Weg	Weg
Hochhäusern	Hochhäusern
Spektroskopie	Spektroskopie
Fäusten	Fäusten
verwirfst	verwirfst
Panzerschreck	Panzerschreck
wechselwirkt	wechselwirkt
überfischt	überfischt
Acetaten	Acetaten
Lenkstange	Lenkstange
überreichend	überreichend
stoßet	stoßet
pflücke	pflücke
Füchsen	Füchsen
Trägerwellen	Trägerwellen
dekompilierten	dekompilierten
verwahret	verwahret
erwürgest	erwürgest
reagiert	reagiert
Zeitungsente	Zeitungsente
grüßte	grüßte
beschrifte	beschrifte
vernehmen	vernehmen
Begrenzungen	Begrenzungen
Welteninsel	Welteninsel
Peptids	Peptids
Eilande	Eilande
Gichten	Gichten
dankte	dankte
charakterisierend	charakterisierend
Milchflasche	Milchflasche
bewies	bewies
verunziere	verunziere
Bildschirmfoto	Bildschirmfoto
Golfplatz	Golfplatz
schichtet	schichtet
Zeitschlitze	Zeitschlitze
schenken	schenken
Gerät	Gerät
Metallothioneinen	Metallothioneinen
kristallisierest	kristallisierest
Tübinger	Tübinger
möchten	möchten
Stierkämpfe	Stierkämpfe
versklavte	versklavte
Optimisten	Optimisten
bracht	bracht
Löwen	Löwen
Gespenst	Gespenst
lös	lös
stelle	stelle
hintertriebe	hintertriebe
Geschichtsbücher	Geschichtsbücher
Heringen	Heringen
lest	lest
platz	platz
Würze	Würze
Wehklage	Wehklage
Gemütes	Gemütes
Rinde	Rinde
Sigle	Sigle
Dorsch	Dorsch
Excimerlaser	Excimerlaser
erziehen	erziehen
stigmatisierest	stigmatisierest
spukte	spukte
Denen	Denen
Basilisken	Basilisken
wähnet	wähnet
Talisman	Talisman
Gegenleistungen	Gegenleistungen
Reliquiar	Reliquiar
vierte	vierte
verwaiset	verwaiset
kollidierten	kollidierten
Perle	Perle
Adeliepinguin	Adeliepinguin
Gleitzeiten	Gleitzeiten
erkundigte	erkundigte
Protonen	Protonen
Laubbaum	Laubbaum
Kürasse	Kürasse
zweifel	zweifel
Zwetschgen	Zwetschgen
Dominicanerinnen	Dominicanerinnen
Solch	Solch
neidest	neidest
Vaginen	Vaginen
mache	mache
stickten	stickten
Schwänze	Schwänze
versucht	versucht
Glaubet	Glaubet
nütze	nütze
überbewertet	überbewertet
Version	Version
schmuggelte	schmuggelte
vereinbarten	vereinbarten
zweiten	zweiten
Transportweg	Transportweg
Buntspechten	Buntspechten
Schnitzeljagd	Schnitzeljagd
sündiget	sündiget
speiste	speiste
ringst	ringst
Frettchen	Frettchen
Harpune	Harpune
durchzuckest	durchzuckest
konstatiertest	konstatiertest
Kandidaturen	Kandidaturen
mißversteht	mißversteht
Landesverräterinnen	Landesverräterinnen
Polarisation	Polarisation
tiefe	tiefe
flucht	flucht
gestalten	gestalten
Werte	Werte
Alte	Alte
Kapitalverkehr	Kapitalverkehr
frohlockte	frohlockte
Schilden	Schilden
watet	watet
konnotieret	konnotieret
balkanisierte	balkanisierte
Deuterium	Deuterium
tagten	tagten
Teekessel	Teekessel
wünschest	wünschest
Bettler	Bettler
grünen	grünen
Begrenzung	Begrenzung
Flosse	Flosse
malträtierte	malträtierte
sagtest	sagtest
Chemikerinnen	Chemikerinnen
Vordenkern	Vordenkern
Stilllegung	Stilllegung
Almanache	Almanache
klemmt	klemmt
imitiert	imitiert
Bienenstock	Bienenstock
Zipfelmützen	Zipfelmützen
Leuchtstoff	Leuchtstoff
tabuisiert	tabuisiert
versuchen	versuchen
erschüttere	erschüttere
steigerten	steigerten
Laie	Laie
malochet	malochet
seinen	seinen
sterbt	sterbt
Sphären	Sphären
Treibhausgasen	Treibhausgasen
lehrte	lehrte
Briten	Briten
herrschen	herrschen
fresset	fresset
teile	teile
feierten	feierten
erriet	erriet
scheuchten	scheuchten
fluktuiert	fluktuiert
verflog	verflog
Aphasie	Aphasie
attackieret	attackieret
gehörte	gehörte
beunruhigte	beunruhigte
inneren	inneren
Blattgewebe	Blattgewebe
Stufe	Stufe
schlachten	schlachten
Ackerschachtelhalm	Ackerschachtelhalm
reiftet	reiftet
ernte	ernte
wehrten	wehrten
Märkte	Märkte
Kassettenrekorder	Kassettenrekorder
Serverzugriffe	Serverzugriffe
Fussel	Fussel
prahlet	prahlet
gerne	gerne
eggte	eggte
Spektralbereich	Spektralbereich
offenbarten	offenbarten
Flussbetten	Flussbetten
verlautete	verlautete
Fetzens	Fetzens
nagelest	nagelest
grüßen	grüßen
einem	einem
Pläsier	Pläsier
feiertest	feiertest
Enden	Enden
emailliert	emailliert
wiederkamt	wiederkamt
breche	breche
scherzt	scherzt
Akkadierinnen	Akkadierinnen
betrüben	betrüben
sagtet	sagtet
Antimusters	Antimusters
enträtselten	enträtselten
Orten	Orten
Zankapfels	Zankapfels
erstarrten	erstarrten
Trübsalen	Trübsalen
bestrafe	bestrafe
verbluteten	verbluteten
öle	öle
watete	watete
vermeße	vermeße
Leugnung	Leugnung
brechen	brechen
Soll	Soll
kennet	kennet
Soge	Soge
harmoniert	harmoniert
bedeckt	bedeckt
erbaust	erbaust
Nanotesla	Nanotesla
Bande	Bande
verringertet	verringertet
ratschlaget	ratschlaget
wegführen	wegführen
verleumdetest	verleumdetest
verdunsten	verdunsten
Trockendock	Trockendock
stellst	stellst
demütig	demütig
Säue	Säue
Katz-und-Maus-Spiele	Katz-und-Maus-Spiele
folgte	folgte
schiesst	schiesst
Abbildern	Abbildern
hasse	hasse
Einsatz	Einsatz
reichte	reichte
scheitern	scheitern
Euter	Euter
jauchzte	jauchzte
bekennt	bekennt
wild	wild
regierten	regierten
Friede	Friede
aufrichten	aufrichten
rinnt	rinnt
zeigst	zeigst
verpuffe	verpuffe
verhörest	verhörest
fegte	fegte
betrübet	betrübet
Würfen	Würfen
schwöre	schwöre
drückte	drückte
Tischen	Tischen
Schläge	Schläge
verladet	verladet
egalisierten	egalisierten
ortete	ortete
Geber	Geber
wallte	wallte
Notständen	Notständen
Zehen	Zehen
ausgereckte	ausgereckte
Streich	Streich
weiche	weiche
verbaselte	verbaselte
gewünscht	gewünscht
Schlepper	Schlepper
Schlaraffenländern	Schlaraffenländern
Theologie	Theologie
besprenget	besprenget
schmierte	schmierte
verringert	verringert
kurbelte	kurbelte
Schenken	Schenken
vertilgst	vertilgst
Wembley-Tore	Wembley-Tore
Dunkelkammern	Dunkelkammern
Innenschau	Innenschau
bummelet	bummelet
Anhängsel	Anhängsel
fremde	fremde
Alten	Alten
Schwänzen	Schwänzen
Kadavergehorsam	Kadavergehorsam
Unter	Unter
überprüftest	überprüftest
verführt	verführt
streutet	streutet
Gewürze	Gewürze
flehte	flehte
verwaisten	verwaisten
Laien	Laien
verschreibt	verschreibt
Überschüssen	Überschüssen
Landwirt	Landwirt
Telefonnummern	Telefonnummern
producieret	producieret
Löwe	Löwe
Bankettes	Bankettes
Ansteckers	Ansteckers
blitztet	blitztet
Wespen	Wespen
verkündiget	verkündiget
Blockflöten	Blockflöten
Fußballweltmeisterschaftsqualifikationsspielen	Fußballweltmeisterschaftsqualifikationsspielen
haschiert	haschiert
glaubte	glaubte
Brikette	Brikette
leset	leset
faschieren	faschieren
Zäume	Zäume
verlähmt	verlähmt
Schwestern	Schwestern
betrieben	betrieben
schaffst	schaffst
belüftet	belüftet
Drillingen	Drillingen
Theistin	Theistin
Heeren	Heeren
auflegte	auflegte
demütige	demütige
deaktiviere	deaktiviere
Normdatum	Normdatum
Fahrt	Fahrt
Füchsin	Füchsin
Schamentzündung	Schamentzündung
Götze	Götze
löge	löge
Rooibos	Rooibos
verknüpft	verknüpft
aufrichte	aufrichte
erhöhet	erhöhet
laute	laute
Spurensicherung	Spurensicherung
erlauben	erlauben
streckte	streckte
Beten	Beten
zentrierest	zentrierest
Däumlingen	Däumlingen
Autonomien	Autonomien
Pardelkatze	Pardelkatze
sehnte	sehnte
Abfertigungsgebäude	Abfertigungsgebäude
gehören	gehören
Schreibern	Schreibern
initiierst	initiierst
amenagiere	amenagiere
anzeigt	anzeigt
Substanz	Substanz
Nehmt	Nehmt
Knüppeln	Knüppeln
beide	beide
verspätest	verspätest
beneidete	beneidete
sehet	sehet
gedurft	gedurft
Ångström	Ångström
unsere	unsere
Brechnuss	Brechnuss
mangelte	mangelte
sabbelt	sabbelt
Tische	Tische
seinem	seinem
Metallspiegel	Metallspiegel
Keilen	Keilen
Schwänzchen	Schwänzchen
Gerichte	Gerichte
Kälber	Kälber
Naturen	Naturen
fassest	fassest
verkauften	verkauften
motivierte	motivierte
Generatoren	Generatoren
Kakadu	Kakadu
peiltest	peiltest
stoppten	stoppten
verdinglichest	verdinglichest
strullerst	strullerst
Alltag	Alltag
mampfte	mampfte
behalte	behalte
verfolgt	verfolgt
stäupten	stäupten
Einöde	Einöde
verkehrten	verkehrten
Bademantel	Bademantel
Donnerstagabenden	Donnerstagabenden
schmuggelest	schmuggelest
tatteret	tatteret
verkapselten	verkapselten
dehydrierten	dehydrierten
Toypudeln	Toypudeln
Verdacht	Verdacht
grüßend	grüßend
Gram	Gram
Hüllenelektronen	Hüllenelektronen
Krusten	Krusten
Sonderbericht	Sonderbericht
Anspielungen	Anspielungen
tendierst	tendierst
vibrierend	vibrierend
vermahnet	vermahnet
bequemest	bequemest
Komponisten	Komponisten
verzweigt	verzweigt
Schlagzeugern	Schlagzeugern
regierest	regierest
Epiker	Epiker
Nukleinsäure	Nukleinsäure
Edelsteine	Edelsteine
Kindergeldern	Kindergeldern
Gläubige	Gläubige
schaffet	schaffet
Denn	Denn
überlebest	überlebest
berücksichtigt	berücksichtigt
Pfarrerinnen	Pfarrerinnen
versteigerest	versteigerest
verstörte	verstörte
verwirrte	verwirrte
Zeithorizonten	Zeithorizonten
Fallt	Fallt
Sprachräumen	Sprachräumen
interagierte	interagierte
Angaben	Angaben
Lehrbücher	Lehrbücher
Küsserei	Küsserei
habest	habest
offenbarest	offenbarest
Arsenbergwerk	Arsenbergwerk
fülle	fülle
Diethylether	Diethylether
begrabest	begrabest
zagest	zagest
schaffte	schaffte
Milzen	Milzen
Strontiumamalgams	Strontiumamalgams
verbaseln	verbaseln
hintertrieben	hintertrieben
Kurkuma	Kurkuma
dürfest	dürfest
erlösen	erlösen
Ausstiegstüren	Ausstiegstüren
hievst	hievst
Kürass	Kürass
Coventrisierungen	Coventrisierungen
geleiteten	geleiteten
Kristallen	Kristallen
Palästen	Palästen
Lusitaners	Lusitaners
Wären	Wären
schämten	schämten
betrübtet	betrübtet
schauspielert	schauspielert
kochte	kochte
ratschlagte	ratschlagte
linke	linke
arrivierst	arrivierst
Arsenbergwerken	Arsenbergwerken
ertraget	ertraget
erwachte	erwachte
eher	eher
brause	brause
stürzen	stürzen
Stämme	Stämme
Ausnahme	Ausnahme
verlötest	verlötest
Druckfehlern	Druckfehlern
Kerzenlichtern	Kerzenlichtern
schwimmen	schwimmen
Anwendungsgebiete	Anwendungsgebiete
Spießen	Spießen
ertönst	ertönst
entfachten	entfachten
Irrtümern	Irrtümern
wollt	wollt
Durchbruches	Durchbruches
erlabe	erlabe
Sinnen	Sinnen
faschieret	faschieret
überdenkend	überdenkend
blamierest	blamierest
Leisten	Leisten
Jagdhund	Jagdhund
evaluiert	evaluiert
Gemurmel	Gemurmel
thematisierten	thematisierten
aufhebest	aufhebest
laden	laden
Lebenskraft	Lebenskraft
Hinkelstein	Hinkelstein
reichst	reichst
Monarchien	Monarchien
Schild	Schild
kickend	kickend
Gasen	Gasen
Türkin	Türkin
Komponistinnen	Komponistinnen
Sei	Sei
glaubt	glaubt
weise	weise
Riesen	Riesen
ihre	ihre
Menschenhandel	Menschenhandel
junge	junge
Nährmediums	Nährmediums
außer	außer
Tier	Tier
Vorhäuten	Vorhäuten
Würfelspiel	Würfelspiel
tasteten	tasteten
Radsatzes	Radsatzes
kasernierte	kasernierte
Atmosphäre	Atmosphäre
Streite	Streite
Inauguration	Inauguration
Wechselstuben	Wechselstuben
sezierst	sezierst
Wandergewerbe	Wandergewerbe
anhangt	anhangt
klaget	klaget
entfachet	entfachet
Hehler	Hehler
Freitagnachmittagen	Freitagnachmittagen
substituierten	substituierten
hieltest	hieltest
Ställen	Ställen
Arsenolithen	Arsenolithen
Wirtschaftswissenschaft	Wirtschaftswissenschaft
anderen	anderen
kürzt	kürzt
Fellachinnen	Fellachinnen
achten	achten
fotzte	fotzte
verderbet	verderbet
verhungert	verhungert
Aspartamen	Aspartamen
Ambiguität	Ambiguität
Elfen	Elfen
Erfahrung	Erfahrung
Pferden	Pferden
beeinflusste	beeinflusste
grübelten	grübelten
Ahnen	Ahnen
malt	malt
begäben	begäben
Zäune	Zäune
schichteten	schichteten
Schneepflüge	Schneepflüge
beanspruchet	beanspruchet
klonet	klonet
vandaliere	vandaliere
Maultier	Maultier
Verwaltungsakte	Verwaltungsakte
gute	gute
Besprechung	Besprechung
plissiere	plissiere
malet	malet
Heide	Heide
kollidierte	kollidierte
bezahlst	bezahlst
Arme	Arme
Radfahrer	Radfahrer
wehr	wehr
Abszisse	Abszisse
beziehen	beziehen
Arsenite	Arsenite
Last	Last
Geschäfte	Geschäfte
kritzeln	kritzeln
fladerst	fladerst
Kriegsknechten	Kriegsknechten
fallest	fallest
globalisier	globalisier
erlöse	erlöse
hebräische	hebräische
liebet	liebet
Setzet	Setzet
Essigsäurechlorid	Essigsäurechlorid
schnürest	schnürest
ferne	ferne
strafe	strafe
legte	legte
Tumult	Tumult
Möbiusbändern	Möbiusbändern
gelobtet	gelobtet
Wiedergutmachung	Wiedergutmachung
widerstand	widerstand
Halogenatomen	Halogenatomen
heil	heil
setztet	setztet
Elementen	Elementen
verfliegest	verfliegest
lügen	lügen
Alles	Alles
versteckst	versteckst
Leset	Leset
Kernladungszahlen	Kernladungszahlen
beeindruckt	beeindruckt
umarmet	umarmet
Monde	Monde
predigtest	predigtest
bräunst	bräunst
strandend	strandend
verwechselet	verwechselet
beförderet	beförderet
reim	reim
suchst	suchst
schenket	schenket
erwärmst	erwärmst
Grönländer	Grönländer
sehest	sehest
Leichtmetallen	Leichtmetallen
erbet	erbet
reparierten	reparierten
Maultiere	Maultiere
weissagten	weissagten
verdammend	verdammend
verhalten	verhalten
Eutektikum	Eutektikum
Hobby	Hobby
Lärchen	Lärchen
ummantle	ummantle
Generationen	Generationen
finanziert	finanziert
velarisierend	velarisierend
Dachdeckerinnen	Dachdeckerinnen
verziehe	verziehe
ungefälschter	ungefälschter
Beobachtung	Beobachtung
Pudern	Pudern
fluppen	fluppen
Tust	Tust
Antitranspirante	Antitranspirante
Langzeichen	Langzeichen
Unsere	Unsere
Sitz	Sitz
Rehböcken	Rehböcken
Hypochlorit	Hypochlorit
Kardinal	Kardinal
heilet	heilet
pressiert	pressiert
gewährte	gewährte
Fahlflanken-Ameisenwürger	Fahlflanken-Ameisenwürger
tobte	tobte
Küstenwachen	Küstenwachen
meinte	meinte
weinte	weinte
Maxima	Maxima
erstehen	erstehen
Seelöwen	Seelöwen
Unterschlagung	Unterschlagung
Weihe	Weihe
colorierten	colorierten
Weste	Weste
bewährt	bewährt
einer	einer
Abschreckung	Abschreckung
Flaschenhälsen	Flaschenhälsen
hättest	hättest
segeln	segeln
strafend	strafend
benähmen	benähmen
verkürztet	verkürztet
Pater	Pater
pfände	pfände
sollten	sollten
Großfürst	Großfürst
Pumpellyiten	Pumpellyiten
weisest	weisest
planschest	planschest
Großstädter	Großstädter
erstände	erstände
dichten	dichten
Unterschlagungen	Unterschlagungen
feierte	feierte
Saget	Saget
Leichen	Leichen
Taschendieb	Taschendieb
berufen	berufen
murmelst	murmelst
Ärschen	Ärschen
Berylle	Berylle
Bazzit	Bazzit
anders	anders
Schwächungen	Schwächungen
Tut	Tut
quantisiere	quantisiere
gezählt	gezählt
dolmetschst	dolmetschst
besänftigtest	besänftigtest
Herrn	Herrn
höben	höben
gedächten	gedächten
Prozedur	Prozedur
Seinen	Seinen
einigst	einigst
Isobar	Isobar
Loparite	Loparite
imkernd	imkernd
rundet	rundet
jaulst	jaulst
lachte	lachte
verliert	verliert
gewinnet	gewinnet
taufe	taufe
solcher	solcher
hadere	hadere
glaube	glaube
Streiten	Streiten
Cola	Cola
recycele	recycele
erwähnet	erwähnet
kürzten	kürzten
verwiesen	verwiesen
attackieren	attackieren
Erlösungen	Erlösungen
Indianer	Indianer
Höret	Höret
Elektronenschale	Elektronenschale
zürnte	zürnte
bestraft	bestraft
Grenzen	Grenzen
schimmerst	schimmerst
Rückweg	Rückweg
Gedanke	Gedanke
Mitschuld	Mitschuld
Nagellackentferner	Nagellackentferner
wallfahrten	wallfahrten
höbe	höbe
Jungfernflüge	Jungfernflüge
Früchte	Früchte
Zeithorizonte	Zeithorizonte
gelobtest	gelobtest
Zehnt	Zehnt
losen	losen
Gefängnissen	Gefängnissen
bedingst	bedingst
endlagerten	endlagerten
verfügten	verfügten
Heuschrecke	Heuschrecke
Traggasen	Traggasen
wegen	wegen
Schwirrvogel	Schwirrvogel
optimiert	optimiert
Reinelemente	Reinelemente
kaufe	kaufe
frische	frische
gehet	gehet
solch	solch
foppst	foppst
wünschst	wünschst
frikassierend	frikassierend
demütigte	demütigte
gelobst	gelobst
Bundesgebiet	Bundesgebiet
Ein	Ein
vertonet	vertonet
mobilisierten	mobilisierten
stehet	stehet
Pflaume	Pflaume
gönnst	gönnst
Ankern	Ankern
funktionalisierte	funktionalisierte
mein	mein
ehrst	ehrst
Messies	Messies
erforscht	erforscht
Pinguin	Pinguin
Bilderstürmereien	Bilderstürmereien
Dürre	Dürre
Laufringe	Laufringe
hell	hell
Kaffeelöffel	Kaffeelöffel
erlaubest	erlaubest
grün	grün
aufkommt	aufkommt
vergrabest	vergrabest
WebHook	WebHook
gelangen	gelangen
Gewinnung	Gewinnung
fertigte	fertigte
Broten	Broten
Schönredner	Schönredner
Koniferen	Koniferen
Bedenken	Bedenken
Badezimmers	Badezimmers
Genetikerin	Genetikerin
nehmet	nehmet
verdammt	verdammt
Radiergummi	Radiergummi
verstanden	verstanden
trefft	trefft
raubet	raubet
bölket	bölket
untertretet	untertretet
Mikrometer	Mikrometer
Mischelementen	Mischelementen
Bombardierung	Bombardierung
Ecke	Ecke
verbesserten	verbesserten
oben	oben
gedenk	gedenk
falteten	falteten
solchen	solchen
beanspruchest	beanspruchest
verseucht	verseucht
raubte	raubte
Unterseite	Unterseite
löstet	löstet
vertäte	vertäte
frevle	frevle
Trinkgefäße	Trinkgefäße
aufkommen	aufkommen
gafften	gafften
recycelten	recycelten
verdunstet	verdunstet
Nervenzellen	Nervenzellen
Ältesten	Ältesten
lüftetet	lüftetet
Bombardierungen	Bombardierungen
heile	heile
eigenen	eigenen
Spende	Spende
Abkürzungsverzeichnisse	Abkürzungsverzeichnisse
Maximierung	Maximierung
entsetzt	entsetzt
globalisieret	globalisieret
Reinstoffen	Reinstoffen
hievten	hievten
arbeiten	arbeiten
porträtiert	porträtiert
tagen	tagen
verfange	verfange
porträtiere	porträtiere
speichertest	speichertest
kontaktiere	kontaktiere
Pedant	Pedant
Trichtern	Trichtern
Alibi	Alibi
bewiese	bewiese
teilet	teilet
Verwundeten	Verwundeten
Leichenschauhäuser	Leichenschauhäuser
weissagst	weissagst
Heere	Heere
Wasserbädern	Wasserbädern
frevler	frevler
Schreiben	Schreiben
kriegen	kriegen
handhaben	handhaben
bröckeln	bröckeln
fluppt	fluppt
Sollten	Sollten
tun	tun
Schamentzündungen	Schamentzündungen
Steigen	Steigen
diskutiere	diskutiere
regiert	regiert
hattet	hattet
gelang	gelang
attestierten	attestierten
schmettern	schmettern
Trägergas	Trägergas
UND-Gattern	UND-Gattern
Vordenker	Vordenker
verdammtet	verdammtet
Verselbstständigung	Verselbstständigung
gelegt	gelegt
Schätze	Schätze
begehre	begehre
Kleinod	Kleinod
dürft	dürft
Ratsherren	Ratsherren
Tatsachenbeschöniger	Tatsachenbeschöniger
verbirgst	verbirgst
verseift	verseift
Besuchen	Besuchen
wohnest	wohnest
schäumt	schäumt
Ränke	Ränke
Adenosin	Adenosin
reifen	reifen
Aktienkursen	Aktienkursen
kürze	kürze
verbitterte	verbitterte
erzeigten	erzeigten
Regenwald	Regenwald
erinnerest	erinnerest
Suchanfrage	Suchanfrage
verlaß	verlaß
Päckchen	Päckchen
fragmentiert	fragmentiert
Früchten	Früchten
scheitertet	scheitertet
schmuste	schmuste
dechiffrierend	dechiffrierend
Botokuden	Botokuden
Kraftfahrzeuges	Kraftfahrzeuges
Abarten	Abarten
Ding	Ding
erdacht	erdacht
schummelten	schummelten
wehret	wehret
blenden	blenden
willen	willen
eingeht	eingeht
kräuselten	kräuselten
schwöret	schwöret
Agoraphobie	Agoraphobie
bekannten	bekannten
Filzläusen	Filzläusen
überfällst	überfällst
spracht	spracht
lohnt	lohnt
ölt	ölt
Ackerschachtelhalme	Ackerschachtelhalme
rechten	rechten
funktionalisiertest	funktionalisiertest
hupen	hupen
halbe	halbe
genieret	genieret
repräsentierten	repräsentierten
zuteil	zuteil
erwärmte	erwärmte
alarmieren	alarmieren
gebäret	gebäret
holet	holet
beider	beider
wachet	wachet
verkleinerest	verkleinerest
Schnittlauch	Schnittlauch
sündigten	sündigten
anrichten	anrichten
Bärenfelle	Bärenfelle
pflanzen	pflanzen
stapele	stapele
dringest	dringest
gewärtigt	gewärtigt
ihnen	ihnen
Schneepflug	Schneepflug
Atombomben	Atombomben
Wache	Wache
Adventskalender	Adventskalender
bündelet	bündelet
kennest	kennest
schleimte	schleimte
Montagmittag	Montagmittag
dienest	dienest
Flöße	Flöße
Keiner	Keiner
Reiterschwert	Reiterschwert
verewiget	verewiget
verunzierte	verunzierte
schnattert	schnattert
keine	keine
Rechten	Rechten
duzet	duzet
Bis	Bis
präsentiere	präsentiere
gewurstelt	gewurstelt
auszögen	auszögen
Roben	Roben
WebHooks	WebHooks
Wehre	Wehre
Dödel	Dödel
gewärtigten	gewärtigten
schaffe	schaffe
folgend	folgend
Nachweisreagenzien	Nachweisreagenzien
Ablösung	Ablösung
quasselten	quasselten
Ecken	Ecken
boß	boß
dekorieren	dekorieren
erlasset	erlasset
pflügten	pflügten
euren	euren
grüble	grüble
Weißflügelpinguin	Weißflügelpinguin
keulst	keulst
Weinbergen	Weinbergen
Türkinnen	Türkinnen
Briefköpfen	Briefköpfen
begehret	begehret
erfreuen	erfreuen
versuchte	versuchte
fraget	fraget
erhörst	erhörst
begraben	begraben
begehrend	begehrend
konntest	konntest
vermeßest	vermeßest
harmonierte	harmonierte
Überziehens	Überziehens
überstehend	überstehend
wach	wach
Stiefvater	Stiefvater
schaffest	schaffest
wehrt	wehrt
Seetauchers	Seetauchers
Gurt	Gurt
tattert	tattert
Würzen	Würzen
Rufen	Rufen
Kuckucke	Kuckucke
betreten	betreten
idealisierest	idealisierest
Neuigkeit	Neuigkeit
bemächtigest	bemächtigest
Verkehrsflugzeug	Verkehrsflugzeug
bescherten	bescherten
bewahrest	bewahrest
glaubst	glaubst
Höschen	Höschen
solle	solle
ermordetest	ermordetest
begräbt	begräbt
Premierministerinnen	Premierministerinnen
brennen	brennen
Stätten	Stätten
alle	alle
anfingst	anfingst
Ende	Ende
verlasset	verlasset
diversifiziere	diversifiziere
Amtsträger	Amtsträger
vertraget	vertraget
stimmen	stimmen
Silberdrähten	Silberdrähten
Honigbären	Honigbären
schreie	schreie
Halter	Halter
Herabsetzungen	Herabsetzungen
Fusseln	Fusseln
wachset	wachset
Sabbatjahre	Sabbatjahre
erfreute	erfreute
lachen	lachen
verboten	verboten
Schote	Schote
rufen	rufen
Arbeitsbereich	Arbeitsbereich
aufstanden	aufstanden
Animation	Animation
Pflanzenwachstum	Pflanzenwachstum
Attentäter	Attentäter
verkündigte	verkündigte
fingieret	fingieret
schütze	schütze
Exilanten	Exilanten
bewässerest	bewässerest
Dreieinigkeit	Dreieinigkeit
Rubinen	Rubinen
Mache	Mache
reif	reif
Keine	Keine
Lümmeltüten	Lümmeltüten
welche	welche
Banden	Banden
weich	weich
hassest	hassest
diversifiziert	diversifiziert
Dattel	Dattel
eskalieret	eskalieret
gelobend	gelobend
Linguistinnen	Linguistinnen
bestellte	bestellte
parametrisierte	parametrisierte
bedeckst	bedeckst
anrufen	anrufen
schöpfe	schöpfe
Gewalttäter	Gewalttäter
Kriegsschauplätze	Kriegsschauplätze
Deinen	Deinen
lispelt	lispelt
Katalanen	Katalanen
appellierst	appellierst
Sauberfrauen	Sauberfrauen
Name	Name
zerbrechest	zerbrechest
erkaltest	erkaltest
Band	Band
diesen	diesen
hurst	hurst
Ränken	Ränken
Tausche	Tausche
posierst	posierst
wiederholten	wiederholten
Käsereibe	Käsereibe
Sorgen	Sorgen
Fäuste	Fäuste
Kalb	Kalb
glawbten	glawbten
Kuttern	Kuttern
Bevölkerungsdichte	Bevölkerungsdichte
bestellten	bestellten
schwangt	schwangt
Stadtbezirke	Stadtbezirke
Dinge	Dinge
diese	diese
Paillette	Paillette
Zement	Zement
Halogenatom	Halogenatom
Bazziten	Bazziten
vertiefe	vertiefe
stoßt	stoßt
schmusen	schmusen
Staatsführungen	Staatsführungen
endlagern	endlagern
Operationssälen	Operationssälen
Afrikaner	Afrikaner
werte	werte
bandagierte	bandagierte
zeichnest	zeichnest
pflegst	pflegst
Plüschtier	Plüschtier
idealisierten	idealisierten
schließt	schließt
separieret	separieret
Kutter	Kutter
Hadithe	Hadithe
gewarnt	gewarnt
Trümmersprache	Trümmersprache
zelte	zelte
Wühltischen	Wühltischen
wilde	wilde
Meldezettel	Meldezettel
traueret	traueret
begliche	begliche
verbleibet	verbleibet
bricht	bricht
regierst	regierst
Wehe	Wehe
ahnten	ahnten
würdest	würdest
reinige	reinige
Liebchen	Liebchen
hatten	hatten
Alterität	Alterität
rufe	rufe
irrte	irrte
Fokus	Fokus
liebtet	liebtet
Dampfschiffen	Dampfschiffen
hingehst	hingehst
Otavit	Otavit
kramen	kramen
Lehrbüchern	Lehrbüchern
labert	labert
Schnallen	Schnallen
Abfertigungsgebäuden	Abfertigungsgebäuden
verprügelet	verprügelet
schwächend	schwächend
übersteht	übersteht
Kaufhäuser	Kaufhäuser
folgtet	folgtet
foppten	foppten
Solches	Solches
Gemeinden	Gemeinden
Säcke	Säcke
ermahnet	ermahnet
Zitronensaft	Zitronensaft
Waldbränden	Waldbränden
deckst	deckst
verleumdete	verleumdete
Adler	Adler
laufet	laufet
mopsend	mopsend
knitterte	knitterte
wünschtest	wünschtest
grüßt	grüßt
Technetiumatom	Technetiumatom
beißt	beißt
Metallothionein	Metallothionein
Kurkumen	Kurkumen
umhüllt	umhüllt
Erstlingen	Erstlingen
warten	warten
trotzest	trotzest
Paradiesäpfeln	Paradiesäpfeln
Einzelgänger	Einzelgänger
Totgeburten	Totgeburten
wähnt	wähnt
beschlug	beschlug
geliebt	geliebt
Regierung	Regierung
Gebirge	Gebirge
dienet	dienet
Schreien	Schreien
wollest	wollest
nähret	nähret
Wachteln	Wachteln
Warten	Warten
verewigt	verewigt
Quellen	Quellen
Hebet	Hebet
Trägergasen	Trägergasen
erfreu	erfreu
könnest	könnest
schlafest	schlafest
charakterisiert	charakterisiert
wärme	wärme
gestatteten	gestatteten
wohnte	wohnte
rebelliertet	rebelliertet
Teekesseln	Teekesseln
prediget	prediget
Bittersüß	Bittersüß
verwirrt	verwirrt
verlaßt	verlaßt
Ärzteblättern	Ärzteblättern
Same	Same
Knöllchens	Knöllchens
höbet	höbet
Perlen	Perlen
verblieben	verblieben
Pläsieren	Pläsieren
Asteroid	Asteroid
Atommassen	Atommassen
ausgereckter	ausgereckter
Krankenscheinen	Krankenscheinen
Drache	Drache
Möbelstoffen	Möbelstoffen
mißverstehet	mißverstehet
Schilde	Schilde
Komponistin	Komponistin
Iberers	Iberers
Kalifeldspat	Kalifeldspat
Fahret	Fahret
Grenzwert	Grenzwert
erkannte	erkannte
steige	steige
Germanisten	Germanisten
Pimmel	Pimmel
pustet	pustet
Urbaren	Urbaren
Schickse	Schickse
Quatsch	Quatsch
verabschiedeten	verabschiedeten
Lautschriften	Lautschriften
wachen	wachen
ersparen	ersparen
verwirren	verwirren
sitzest	sitzest
zerfetzte	zerfetzte
toten	toten
christianisiere	christianisiere
Kohlrübe	Kohlrübe
eingehest	eingehest
Eure	Eure
pendelt	pendelt
denn	denn
Privatsachen	Privatsachen
Sabbate	Sabbate
imprägniere	imprägniere
Hirnstämmen	Hirnstämmen
Blattgeweben	Blattgeweben
vertraute	vertraute
Magier	Magier
Heben	Heben
knusperten	knusperten
gleiche	gleiche
Geflecktheiten	Geflecktheiten
wünscht	wünscht
Flame	Flame
sahet	sahet
wolle	wolle
verscheißert	verscheißert
Schreibtischtäter	Schreibtischtäter
Ihre	Ihre
Laib	Laib
Wolle	Wolle
Buche	Buche
predigten	predigten
überreichst	überreichst
gestikulierst	gestikulierst
anfinge	anfinge
dividiere	dividiere
Toren	Toren
verletzt	verletzt
treibest	treibest
weichet	weichet
Röcken	Röcken
Buben	Buben
Erste	Erste
sortiert	sortiert
blamierten	blamierten
flirre	flirre
aßest	aßest
Technikerinnen	Technikerinnen
überführen	überführen
bewürben	bewürben
Chlorat	Chlorat
evaluierten	evaluierten
amenagierst	amenagierst
beschrifteten	beschrifteten
Mäppchen	Mäppchen
Aderhäuten	Aderhäuten
torpediert	torpediert
Junge	Junge
trinkest	trinkest
Urologe	Urologe
vernickelte	vernickelte
lobe	lobe
Chasaren	Chasaren
verbraucht	verbraucht
stäupte	stäupte
bekannt	bekannt
bombardiert	bombardiert
verletzte	verletzte
Sprichwörtern	Sprichwörtern
abziehen	abziehen
Dorngesträuchen	Dorngesträuchen
versuchten	versuchten
dürftet	dürftet
Bevölkerungsdichten	Bevölkerungsdichten
betätigest	betätigest
Gesamtmengen	Gesamtmengen
geleitet	geleitet
forschte	forschte
Fanmeilen	Fanmeilen
Halbmonden	Halbmonden
Bällchen	Bällchen
glaubtet	glaubtet
Komplexionen	Komplexionen
amputierten	amputierten
Fortsetzungen	Fortsetzungen
deute	deute
Banknoten	Banknoten
kautest	kautest
Stoffwechselweg	Stoffwechselweg
flötete	flötete
evakuierte	evakuierte
Assistentinnen	Assistentinnen
plagest	plagest
erzwangt	erzwangt
Haltepunkten	Haltepunkten
heiligest	heiligest
verknüpfet	verknüpfet
sprecht	sprecht
letzten	letzten
erobern	erobern
extemporieret	extemporieret
vermischen	vermischen
Vollkornbrot	Vollkornbrot
prostituieret	prostituieret
klage	klage
Sollst	Sollst
höbest	höbest
beherrschest	beherrschest
entflöhen	entflöhen
Schlager	Schlager
suchet	suchet
Bienen	Bienen
Oheim	Oheim
pendele	pendele
verselbstständigest	verselbstständigest
dotierst	dotierst
fritiert	fritiert
Volkslehren	Volkslehren
verzieret	verzieret
Technetaten	Technetaten
verbündeten	verbündeten
Panzerschrecke	Panzerschrecke
Subspezies	Subspezies
ehrest	ehrest
rekrutiere	rekrutiere
kein	kein
berührt	berührt
treffen	treffen
gestattest	gestattest
verkündet	verkündet
Kanzlei	Kanzlei
vier	vier
Wasserbades	Wasserbades
Sagen	Sagen
gratuliere	gratuliere
wart	wart
Autonomie	Autonomie
leiten	leiten
Fledermaus	Fledermaus
verkündige	verkündige
ziehest	ziehest
gestatte	gestatte
verbarg	verbarg
Organisationen	Organisationen
betrügen	betrügen
restaurierten	restaurierten
Eisenkräutern	Eisenkräutern
solche	solche
Wimpertierchen	Wimpertierchen
lösest	lösest
triebe	triebe
funkeln	funkeln
nippend	nippend
verkürzt	verkürzt
ihn	ihn
knackt	knackt
Kardinäle	Kardinäle
mineralisierten	mineralisierten
sannen	sannen
kühl	kühl
weinet	weinet
Wogen	Wogen
Denunziationen	Denunziationen
ankerst	ankerst
vermagst	vermagst
erinnre	erinnre
loben	loben
angehört	angehört
Anachronismus	Anachronismus
Stärkungsmittel	Stärkungsmittel
Alkalien	Alkalien
Drehtüren	Drehtüren
vergrubt	vergrubt
rekrutierest	rekrutierest
entheiligten	entheiligten
kurze	kurze
vernickele	vernickele
schmeichelest	schmeichelest
erlöst	erlöst
tyrannisiertest	tyrannisiertest
Acetat	Acetat
Füchse	Füchse
beschwöre	beschwöre
verpufftest	verpufftest
Barschaften	Barschaften
vergliche	vergliche
panaschieren	panaschieren
Berichterstattungen	Berichterstattungen
stützet	stützet
ausgeht	ausgeht
entrümpelst	entrümpelst
Strontiumamalgamen	Strontiumamalgamen
zerschlaget	zerschlaget
Stühle	Stühle
Türkenbund	Türkenbund
funzt	funzt
Rehbock	Rehbock
klone	klone
Zeitbombe	Zeitbombe
rotten	rotten
maß	maß
schlabberte	schlabberte
Kortholt	Kortholt
Abtrünnigen	Abtrünnigen
stapfst	stapfst
produziert	produziert
Türklingeln	Türklingeln
Autoklav	Autoklav
verfängt	verfängt
Bundesgebieten	Bundesgebieten
Solchen	Solchen
knistert	knistert
Gymnasien	Gymnasien
gehorchst	gehorchst
Asthenosphäre	Asthenosphäre
wir	wir
fließen	fließen
Wüste	Wüste
fladern	fladern
demütigst	demütigst
kauerten	kauerten
werdest	werdest
finanzieret	finanzieret
Strafraum	Strafraum
laufe	laufe
hämmerte	hämmerte
unterbrächest	unterbrächest
karikierten	karikierten
Schneidern	Schneidern
formulierst	formulierst
durften	durften
lackieren	lackieren
schummelst	schummelst
mehr	mehr
Verdachtes	Verdachtes
raffiniere	raffiniere
Wänden	Wänden
bewässerst	bewässerst
bemerken	bemerken
Biokraftstoff	Biokraftstoff
rebellieret	rebellieret
bekriegt	bekriegt
wirst	wirst
leiden	leiden
unterbewerte	unterbewerte
Haarshampoos	Haarshampoos
selber	selber
Geschwindigkeitsmessern	Geschwindigkeitsmessern
klumpt	klumpt
schnell	schnell
vermögen	vermögen
möchte	möchte
begnadigst	begnadigst
Laubbläsern	Laubbläsern
pflanzt	pflanzt
schätzen	schätzen
vermahnen	vermahnen
Denkmünze	Denkmünze
letzte	letzte
brandeten	brandeten
Jochen	Jochen
Wachtel	Wachtel
misstrauest	misstrauest
Städten	Städten
Führet	Führet
entwendet	entwendet
allen	allen
Massenanteil	Massenanteil
hintertreiben	hintertreiben
Reiseleitern	Reiseleitern
Zeitschlitzen	Zeitschlitzen
Fetten	Fetten
verkündigt	verkündigt
begehr	begehr
beides	beides
Merkel-Rauten	Merkel-Rauten
Hode	Hode
prostituierte	prostituierte
stand	stand
liebt	liebt
kämmt	kämmt
inhalier	inhalier
Waren	Waren
Hobbys	Hobbys
blockierten	blockierten
widmeten	widmeten
winkt	winkt
möpperst	möpperst
bauet	bauet
beantragt	beantragt
Zeitbomben	Zeitbomben
erwachend	erwachend
stapelten	stapelten
Geschwindigkeitsmesser	Geschwindigkeitsmesser
Raucherinnen	Raucherinnen
nippst	nippst
Willen	Willen
faule	faule
kehren	kehren
nahe	nahe
ärger	ärger
kämmtet	kämmtet
schon	schon
naschst	naschst
besänne	besänne
analysieret	analysieret
skypet	skypet
verschränken	verschränken
überwachest	überwachest
nähet	nähet
wachse	wachse
Flöte	Flöte
erwärmten	erwärmten
Paradiesapfel	Paradiesapfel
dümpelt	dümpelt
Grizzlybär	Grizzlybär
sabbere	sabbere
plumpsten	plumpsten
Traubenlesen	Traubenlesen
langweilst	langweilst
Pflaumen	Pflaumen
Zirkelbeweis	Zirkelbeweis
Urbare	Urbare
erratet	erratet
Rotzinkerz	Rotzinkerz
gesagt	gesagt
Notizen	Notizen
Nahrungsbestandteilen	Nahrungsbestandteilen
jeden	jeden
Märkten	Märkten
müssest	müssest
designiertet	designiertet
Organistin	Organistin
Galeeren	Galeeren
Beziehung	Beziehung
Orgeln	Orgeln
Briefwechsel	Briefwechsel
ermordeten	ermordeten
Hirnstämme	Hirnstämme
verwechsele	verwechsele
Pfählen	Pfählen
überdächte	überdächte
übersehest	übersehest
Kraftfahrzeugen	Kraftfahrzeugen
zeugen	zeugen
Halsabschneider	Halsabschneider
erdachten	erdachten
Übelkeit	Übelkeit
destabilisierte	destabilisierte
Arm	Arm
erstehet	erstehet
kräusle	kräusle
heißest	heißest
steinigte	steinigte
Alteritäten	Alteritäten
Aufsätze	Aufsätze
Auguren	Auguren
Aas	Aas
heparinisierten	heparinisierten
reifte	reifte
fokussieret	fokussieret
Katamaranen	Katamaranen
Seehechten	Seehechten
hantierte	hantierte
Besuch	Besuch
plaziert	plaziert
Kirchhof	Kirchhof
verblutete	verblutete
hüpfen	hüpfen
vergibt	vergibt
kosten	kosten
gewähret	gewähret
Flamme	Flamme
Selbstsicherheit	Selbstsicherheit
Vergeltungen	Vergeltungen
Honigbär	Honigbär
Halleluja	Halleluja
Wasserquelle	Wasserquelle
Skorpione	Skorpione
soll	soll
Datentypen	Datentypen
vereinigt	vereinigt
formirte	formirte
Letzten	Letzten
initiierten	initiierten
Schneepflügen	Schneepflügen
pensionierest	pensionierest
Aprikose	Aprikose
speisest	speisest
Aggressoren	Aggressoren
verurteile	verurteile
Kupferkiese	Kupferkiese
lehrest	lehrest
schläft	schläft
Kleptokratien	Kleptokratien
schämte	schämte
trotzt	trotzt
armen	armen
tappst	tappst
setzest	setzest
anrührt	anrührt
kabelte	kabelte
Wucher	Wucher
Kompass	Kompass
sedimentiert	sedimentiert
merken	merken
duschte	duschte
klettert	klettert
fälle	fälle
Kacke	Kacke
schmuggle	schmuggle
knusperst	knusperst
Haarverlust	Haarverlust
Grießen	Grießen
fern	fern
hängen	hängen
umhüll	umhüll
erwischten	erwischten
beansprucht	beansprucht
Nachteile	Nachteile
forschen	forschen
Blütenachse	Blütenachse
reinigst	reinigst
segmentiere	segmentiere
erscheine	erscheine
Gangster	Gangster
pflanze	pflanze
gähne	gähne
erfüllt	erfüllt
Grizzlybären	Grizzlybären
Imperialismen	Imperialismen
inhalierest	inhalierest
alles	alles
schreiben	schreiben
unterschieden	unterschieden
Portal	Portal
funzen	funzen
Fusselbart	Fusselbart
Geliebte	Geliebte
kommest	kommest
Steige	Steige
Zensus	Zensus
Hände	Hände
Unternehmensanwendungsintegrationen	Unternehmensanwendungsintegrationen
griffe	griffe
siegen	siegen
schubset	schubset
Erzeugungen	Erzeugungen
Zirkelschluss	Zirkelschluss
besetzen	besetzen
entmineralisieret	entmineralisieret
Aromastoffe	Aromastoffe
revoltiert	revoltiert
bespracht	bespracht
streifte	streifte
balkanisierten	balkanisierten
entfolgte	entfolgte
Aachener	Aachener
Aerosole	Aerosole
verlassen	verlassen
Metallquirlen	Metallquirlen
amenagieren	amenagieren
Hardwareentwicklerin	Hardwareentwicklerin
Sekte	Sekte
Trioxid	Trioxid
ab	ab
saget	saget
sedimentiertet	sedimentiertet
Hallelujas	Hallelujas
springen	springen
Martyrologium	Martyrologium
Augengläsern	Augengläsern
Managementsystem	Managementsystem
schonte	schonte
Handbuch	Handbuch
wirft	wirft
bedurftest	bedurftest
verfehle	verfehle
Hirsche	Hirsche
wetzte	wetzte
Dingen	Dingen
argumentierest	argumentierest
zierte	zierte
verständige	verständige
Briefe	Briefe
werfet	werfet
überschneidet	überschneidet
schöpfen	schöpfen
gedachten	gedachten
grünt	grünt
erniedrigt	erniedrigt
tunet	tunet
Grenze	Grenze
ackerest	ackerest
Aderhaut	Aderhaut
gratuliert	gratuliert
gequasselt	gequasselt
jappte	jappte
orgelt	orgelt
begeben	begeben
dürften	dürften
Kavalier	Kavalier
Zirkelschlüssen	Zirkelschlüssen
scheinen	scheinen
parkierst	parkierst
Landwirte	Landwirte
fragst	fragst
forschet	forschet
umkäme	umkäme
bombardiertet	bombardiertet
werden	werden
tragest	tragest
liehen	liehen
Alkin	Alkin
schlafe	schlafe
Minischwein	Minischwein
dümpelst	dümpelst
strömte	strömte
assimiliertest	assimiliertest
moppst	moppst
Gebete	Gebete
liehe	liehe
Hektaren	Hektaren
Hornunges	Hornunges
sorget	sorget
stirbst	stirbst
Azubi	Azubi
hintertreibt	hintertreibt
füllte	füllte
aasend	aasend
brillierest	brillierest
heiße	heiße
Lopariten	Lopariten
folterst	folterst
folgt	folgt
griechisch	griechisch
Bleigehalt	Bleigehalt
Dominicanerin	Dominicanerin
regiertest	regiertest
fetten	fetten
Linguisten	Linguisten
Gammastrahlen	Gammastrahlen
aufhoben	aufhoben
gespeist	gespeist
blondiert	blondiert
Wiederauferstehungen	Wiederauferstehungen
platzt	platzt
implodiere	implodiere
Gaschromatographie	Gaschromatographie
Samstagnachmittagen	Samstagnachmittagen
Äquatoren	Äquatoren
Quelle	Quelle
Assistentin	Assistentin
Temperaturanstieg	Temperaturanstieg
nähernd	nähernd
Muhme	Muhme
Polizeisprecher	Polizeisprecher
Domäne	Domäne
Molybdite	Molybdite
Zäumen	Zäumen
Neumonde	Neumonde
streiten	streiten
verziehst	verziehst
Thioester	Thioester
seufzest	seufzest
Erbse	Erbse
begehrst	begehrst
thematisierte	thematisierte
fotzt	fotzt
befestigte	befestigte
instrumentalisierest	instrumentalisierest
Berge	Berge
Leuchtkäfer	Leuchtkäfer
versteigernd	versteigernd
erbauet	erbauet
ungehorsam	ungehorsam
reizest	reizest
setztest	setztest
durchläutert	durchläutert
schnatternd	schnatternd
zerbricht	zerbricht
schlaget	schlaget
verwahrst	verwahrst
fügt	fügt
verunglimpfest	verunglimpfest
Anfängern	Anfängern
führest	führest
stützen	stützen
Jünger	Jünger
Tatsachenbeschönigern	Tatsachenbeschönigern
Meinst	Meinst
legen	legen
Gegebenheit	Gegebenheit
jagst	jagst
Bär	Bär
Saiblinge	Saiblinge
wahr	wahr
Hirt	Hirt
jaule	jaule
bündelten	bündelten
Rückumlaute	Rückumlaute
anruft	anruft
henken	henken
Füllfedern	Füllfedern
Nussknacker	Nussknacker
Mobilfunknetze	Mobilfunknetze
zürnest	zürnest
Anwendungsgebiet	Anwendungsgebiet
türmt	türmt
elften	elften
Firnis	Firnis
filzte	filzte
nähre	nähre
hüten	hüten
gehörst	gehörst
Hansen	Hansen
standet	standet
Freibergits	Freibergits
predigend	predigend
zittere	zittere
Vorstädte	Vorstädte
verunglimpftet	verunglimpftet
fluppst	fluppst
trompetete	trompetete
frikassiert	frikassiert
aufstehet	aufstehet
Kronsbeere	Kronsbeere
wurde	wurde
harrten	harrten
Schicksen	Schicksen
geherrscht	geherrscht
Satzung	Satzung
Leichtmetalle	Leichtmetalle
Langeweile	Langeweile
Ruße	Ruße
fallen	fallen
ziere	ziere
siegte	siegte
verklagst	verklagst
lancierst	lancierst
schiebest	schiebest
sterilisiert	sterilisiert
beschotterten	beschotterten
erzwinget	erzwinget
Gemüseläden	Gemüseläden
murmelten	murmelten
Trioxiden	Trioxiden
hantiert	hantiert
nötig	nötig
unterwerfe	unterwerfe
ausgereckten	ausgereckten
krösest	krösest
Recitativen	Recitativen
kritzelet	kritzelet
rühmet	rühmet
vertrauten	vertrauten
versuche	versuche
Zubrötchen	Zubrötchen
schlage	schlage
Temperaturanstiege	Temperaturanstiege
Körpergeruch	Körpergeruch
Gehilfen	Gehilfen
ankern	ankern
stäupt	stäupt
Indianern	Indianern
Stierkämpfen	Stierkämpfen
weine	weine
Fetzen	Fetzen
Sternen	Sternen
kreierten	kreierten
reichtest	reichtest
Korrosionsschutzen	Korrosionsschutzen
quantisierte	quantisierte
folge	folge
begnügt	begnügt
Chinakohl	Chinakohl
lebst	lebst
kitzeln	kitzeln
konvertieren	konvertieren
Rosinenkuchenmodell	Rosinenkuchenmodell
Pfunden	Pfunden
umarbeiten	umarbeiten
emigriert	emigriert
Kopfverletzungen	Kopfverletzungen
Anhängseln	Anhängseln
Marokkanern	Marokkanern
lausche	lausche
illustriertet	illustriertet
strafet	strafet
benütztest	benütztest
Fluoratome	Fluoratome
Nigger	Nigger
erstaunst	erstaunst
flehst	flehst
webet	webet
Mönchen	Mönchen
eiterte	eiterte
Füllfederhalters	Füllfederhalters
anzeigte	anzeigte
dissentierten	dissentierten
parfümierst	parfümierst
erhebet	erhebet
süsst	süsst
beweiset	beweiset
quietschest	quietschest
Städte	Städte
tyrannisierte	tyrannisierte
Untiefe	Untiefe
konnotierst	konnotierst
Siglen	Siglen
wohnst	wohnst
Eingaben	Eingaben
siehst	siehst
haarten	haarten
Schlöte	Schlöte
begehrest	begehrest
Kerzenlichter	Kerzenlichter
Volkslehre	Volkslehre
ansehen	ansehen
Zuschauer	Zuschauer
Unrecht	Unrecht
Abtrünnige	Abtrünnige
lüge	lüge
winke	winke
Reisebüros	Reisebüros
vertonten	vertonten
Möbiusbänder	Möbiusbänder
fällst	fällst
Strohhälmchen	Strohhälmchen
Selbstversuchen	Selbstversuchen
Düfte	Düfte
drangen	drangen
verdeckten	verdeckten
Bagger	Bagger
Döner	Döner
auflegt	auflegt
betrübten	betrübten
antworte	antworte
Frösche	Frösche
helfet	helfet
grünst	grünst
kehrst	kehrst
Reizt	Reizt
Schauen	Schauen
Grabe	Grabe
Gegenleistung	Gegenleistung
Unternehmung	Unternehmung
werft	werft
Gallanen	Gallanen
beseht	beseht
bürsten	bürsten
verlasse	verlasse
Graphem	Graphem
lesen	lesen
restaurieret	restaurieret
Dünungen	Dünungen
füsilierte	füsilierte
gelangt	gelangt
hure	hure
steigeret	steigeret
Säcken	Säcken
begrubt	begrubt
anzeige	anzeige
kontaktieret	kontaktieret
Ebene	Ebene
Kirgisinnen	Kirgisinnen
strafte	strafte
trödeltest	trödeltest
wärt	wärt
verbitterten	verbitterten
Linke	Linke
hickste	hickste
Gibst	Gibst
Remis	Remis
klagen	klagen
keines	keines
grabe	grabe
Schwächung	Schwächung
Kaufleuten	Kaufleuten
Hypochlorite	Hypochlorite
ehe	ehe
More	More
pulsiere	pulsiere
grüntet	grüntet
Gründungsprivileg	Gründungsprivileg
verstrahlet	verstrahlet
Bunde	Bunde
fertig	fertig
Diamantringen	Diamantringen
fastete	fastete
plazierest	plazierest
gebietet	gebietet
konjugiere	konjugiere
ermahnt	ermahnt
hineinbrächten	hineinbrächten
lodertet	lodertet
Wiederauferstehung	Wiederauferstehung
Tintenfische	Tintenfische
reichtet	reichtet
zeugten	zeugten
Stiefvätern	Stiefvätern
greinen	greinen
pflüget	pflüget
meinen	meinen
interagiert	interagiert
Libelle	Libelle
verzieht	verzieht
gewöhnt	gewöhnt
Lautschrift	Lautschrift
anrührte	anrührte
verdamme	verdamme
Geräte	Geräte
Schlagzeuger	Schlagzeuger
Kleinode	Kleinode
geahnt	geahnt
drängten	drängten
kooperierst	kooperierst
zuppen	zuppen
speiest	speiest
Feldzug	Feldzug
Gelobt	Gelobt
verlähmte	verlähmte
Gleitzeit	Gleitzeit
haschieret	haschieret
sprühend	sprühend
heben	heben
Finanzminister	Finanzminister
treibst	treibst
stürzte	stürzte
Spitzen	Spitzen
dampfte	dampfte
Gehörst	Gehörst
Ochsen	Ochsen
decken	decken
zwänget	zwänget
reizet	reizet
besorgest	besorgest
behauptete	behauptete
Excimerlasern	Excimerlasern
Beziehungen	Beziehungen
deponierte	deponierte
Fromme	Fromme
lohnten	lohnten
beeindrucket	beeindrucket
Darlegung	Darlegung
Päderast	Päderast
Tübingern	Tübingern
Überschüsse	Überschüsse
Pentaborat	Pentaborat
brichst	brichst
verdammte	verdammte
Blaumeise	Blaumeise
denaturierten	denaturierten
Gebäcken	Gebäcken
wünschen	wünschen
Ass	Ass
enterten	enterten
Polizeisprechern	Polizeisprechern
erhöhest	erhöhest
Hure	Hure
Dödeln	Dödeln
bange	bange
klingt	klingt
Gicht	Gicht
gedachtest	gedachtest
kaserniert	kaserniert
Fallen	Fallen
schließe	schließe
lögen	lögen
Europium	Europium
umkämen	umkämen
protestieret	protestieret
flupptest	flupptest
pilgerte	pilgerte
Gefangene	Gefangene
Gedächtnissen	Gedächtnissen
Autokraten	Autokraten
zählten	zählten
verdeckt	verdeckt
unterfordern	unterfordern
revoltierte	revoltierte
entkörperlichte	entkörperlichte
Kehre	Kehre
überschattet	überschattet
Wembley-Toren	Wembley-Toren
gräbst	gräbst
grünend	grünend
einführte	einführte
führe	führe
aßet	aßet
rekonstruieret	rekonstruieret
Membranen	Membranen
mischst	mischst
überwiese	überwiese
Sprechers	Sprechers
stellen	stellen
Mageninhalten	Mageninhalten
liebst	liebst
Halbgott	Halbgott
Preisanstiegen	Preisanstiegen
handhabest	handhabest
Dessous	Dessous
Bäusche	Bäusche
Wirte	Wirte
Aerosolen	Aerosolen
Halsabschneidern	Halsabschneidern
entkäme	entkäme
Preis	Preis
kapiertet	kapiertet
Gallan	Gallan
Laufring	Laufring
schwächst	schwächst
emendierte	emendierte
Rotgusses	Rotgusses
schäumtest	schäumtest
sabbelten	sabbelten
ärgerte	ärgerte
Äthern	Äthern
mühe	mühe
kaufte	kaufte
Penis	Penis
jammerte	jammerte
überschnitten	überschnitten
Hainbuche	Hainbuche
schlag	schlag
Anlass	Anlass
Blättchen	Blättchen
Einfältigkeit	Einfältigkeit
Kriegen	Kriegen
Rabe	Rabe
Freizeitzentren	Freizeitzentren
emittiert	emittiert
trägst	trägst
Bonzen	Bonzen
Omnibus	Omnibus
Ärztin	Ärztin
Bluff	Bluff
verdammen	verdammen
dresche	dresche
Butzemänner	Butzemänner
frappierte	frappierte
Altbau	Altbau
Abbindebeschleuniger	Abbindebeschleuniger
Beiblätter	Beiblätter
Decken	Decken
Sprichwort	Sprichwort
seines	seines
egalisiertet	egalisiertet
Farbstoffe	Farbstoffe
rufet	rufet
entgehst	entgehst
Männlein	Männlein
zeiget	zeiget
boßte	boßte
schreien	schreien
blase	blase
verwertete	verwertete
Dudelsäcken	Dudelsäcken
Tintenklecks	Tintenklecks
schnelle	schnelle
seit	seit
Braunralle	Braunralle
trotze	trotze
Futur	Futur
verlobt	verlobt
Gammastrahl	Gammastrahl
schnüren	schnüren
zappen	zappen
flenstet	flenstet
gewitterest	gewitterest
füsilierten	füsilierten
Trickbetrüger	Trickbetrüger
gründe	gründe
Eingabe	Eingabe
wehrend	wehrend
verzögerte	verzögerte
löst	löst
begrub	begrub
bewahrt	bewahrt
inspirierten	inspirierten
Arbeitsleistung	Arbeitsleistung
vertilgt	vertilgt
bezichtigt	bezichtigt
spekulieren	spekulieren
Gemeinde	Gemeinde
missverstände	missverstände
Höhlen	Höhlen
imprägnieret	imprägnieret
sagten	sagten
Sanatoriums	Sanatoriums
bekehrst	bekehrst
Signal	Signal
Leichname	Leichname
gelobet	gelobet
Füßen	Füßen
Silbersulfidbelag	Silbersulfidbelag
Ställe	Ställe
referenzierst	referenzierst
Sucht	Sucht
Pfleglingen	Pfleglingen
addierte	addierte
stolze	stolze
drängest	drängest
Besprechungen	Besprechungen
Sauberfrau	Sauberfrau
oxidierte	oxidierte
Deckenfarbe	Deckenfarbe
Ringe	Ringe
heilige	heilige
changieren	changieren
Raucherin	Raucherin
Vesper	Vesper
schauend	schauend
vernichtest	vernichtest
liebten	liebten
Schaffe	Schaffe
gewinnen	gewinnen
Fingerspitze	Fingerspitze
emaillieret	emaillieret
ersten	ersten
dingt	dingt
grüßet	grüßet
Nanokondensatoren	Nanokondensatoren
Heptamolybdat	Heptamolybdat
Kalifeldspate	Kalifeldspate
Toypudel	Toypudel
jappen	jappen
Exzentriker	Exzentriker
Schwester	Schwester
Durchbruch	Durchbruch
immunisiere	immunisiere
brauche	brauche
abtrünnige	abtrünnige
begehrt	begehrt
Fahlflanken-Ameisenwürgern	Fahlflanken-Ameisenwürgern
schießen	schießen
trieb	trieb
Diagnostik	Diagnostik
Hat	Hat
Radfahrern	Radfahrern
konvergierest	konvergierest
häufte	häufte
betrübend	betrübend
erstürmt	erstürmt
Gehilfe	Gehilfe
Höhle	Höhle
mikrominiaturisiere	mikrominiaturisiere
injiziert	injiziert
verfinstert	verfinstert
steuerst	steuerst
stimmet	stimmet
gelobte	gelobte
liebend	liebend
überweiset	überweiset
hegt	hegt
Armband	Armband
gaffest	gaffest
zappten	zappten
Würfelspiele	Würfelspiele
verstrahlten	verstrahlten
selbst	selbst
Portale	Portale
unterdrückte	unterdrückte
Maut	Maut
reinstitutionalisierten	reinstitutionalisierten
Auszüge	Auszüge
Arbeitskreis	Arbeitskreis
Nadel	Nadel
zwang	zwang
malen	malen
umgaben	umgaben
vergleichet	vergleichet
stellet	stellet
liste	liste
ausgereckt	ausgereckt
dekompiliertest	dekompiliertest
mühte	mühte
rote	rote
Konzentrat	Konzentrat
entmineralisierst	entmineralisierst
Extremen	Extremen
beleuchteten	beleuchteten
säumet	säumet
ältesten	ältesten
Drang	Drang
narren	narren
Genies	Genies
Primatologen	Primatologen
bereiten	bereiten
Banketten	Banketten
reformieren	reformieren
Bleigehalten	Bleigehalten
Dithiolan	Dithiolan
warntest	warntest
Weichseln	Weichseln
Hahnenkämmen	Hahnenkämmen
laben	laben
Altären	Altären
Sekten	Sekten
erzeigest	erzeigest
dirigieren	dirigieren
Zwingburg	Zwingburg
Pedanten	Pedanten
Ypecaharalle	Ypecaharalle
Donoren	Donoren
Aktivisten	Aktivisten
Teufeln	Teufeln
Gedicht	Gedicht
Kommoden	Kommoden
Jahr	Jahr
gedenken	gedenken
Ringen	Ringen
Geschichtsbüchern	Geschichtsbüchern
Crescendos	Crescendos
kitzele	kitzele
Setzt	Setzt
stiftest	stiftest
observierst	observierst
opferte	opferte
Mein	Mein
verjährest	verjährest
scheiterst	scheiterst
besorgend	besorgend
versteckte	versteckte
vermutet	vermutet
fehlen	fehlen
Nullpunktes	Nullpunktes
lauschte	lauschte
Sitzfleisch	Sitzfleisch
eiterten	eiterten
Kanzlerinnen	Kanzlerinnen
säumen	säumen
hebräisch	hebräisch
suchen	suchen
punkteten	punkteten
Randbemerkung	Randbemerkung
duschten	duschten
Hochhäuser	Hochhäuser
beunruhige	beunruhige
Einbrecher	Einbrecher
schwebe	schwebe
aufrichtest	aufrichtest
schneidet	schneidet
gedenket	gedenket
Menschen	Menschen
spritzet	spritzet
Greyerzer	Greyerzer
lockerst	lockerst
gehörten	gehörten
Kopfsalaten	Kopfsalaten
Firnisse	Firnisse
verbündend	verbündend
trügen	trügen
lösen	lösen
Floß	Floß
infizieret	infizieret
mögt	mögt
Hummer	Hummer
Artischocken	Artischocken
befürchtet	befürchtet
Bifurkationen	Bifurkationen
substituieren	substituieren
verformen	verformen
verkündigest	verkündigest
besucht	besucht
bündelest	bündelest
verspätete	verspätete
Kannst	Kannst
anzögen	anzögen
Oxalate	Oxalate
Zankapfel	Zankapfel
Genkinits	Genkinits
Kosten	Kosten
privilegierst	privilegierst
Holzquirl	Holzquirl
Sabbaten	Sabbaten
lochtest	lochtest
läute	läute
Augur	Augur
gleich	gleich
fistet	fistet
kürzest	kürzest
massierend	massierend
Hirte	Hirte
Physikerin	Physikerin
unterwirft	unterwirft
kühle	kühle
wallet	wallet
verschlimmere	verschlimmere
Wisset	Wisset
bediene	bediene
Sabotagen	Sabotagen
Assimilationen	Assimilationen
stimmte	stimmte
Schnipsel	Schnipsel
vertagt	vertagt
Gründungsprivilegien	Gründungsprivilegien
Kornnattern	Kornnattern
Unterseiten	Unterseiten
fahret	fahret
fremden	fremden
entzweit	entzweit
abalieniertest	abalieniertest
konsumiere	konsumiere
Gauner	Gauner
glühten	glühten
stiegen	stiegen
Decket	Decket
Kochfeldern	Kochfeldern
Korrosionsschutz	Korrosionsschutz
Grufti	Grufti
hicksest	hicksest
Ersten	Ersten
Langschwanzpinguin	Langschwanzpinguin
Kernladungszahl	Kernladungszahl
Abfertigungsschalter	Abfertigungsschalter
Shortcuts	Shortcuts
verhungerte	verhungerte
beschwören	beschwören
Buntwaschmittel	Buntwaschmittel
Heiden	Heiden
regelten	regelten
bollerte	bollerte
verklärt	verklärt
verkleidete	verkleidete
beneidest	beneidest
Rechnung	Rechnung
betrübst	betrübst
Asteroide	Asteroide
Zeitplanes	Zeitplanes
all	all
ermächtige	ermächtige
beschottert	beschottert
nahte	nahte
zählet	zählet
beliefen	beliefen
keiner	keiner
Sogen	Sogen
bezahlt	bezahlt
Steine	Steine
massakrierte	massakrierte
streute	streute
rekonstruieren	rekonstruieren
Arbeitsunfähigkeit	Arbeitsunfähigkeit
Werk	Werk
bemächtigte	bemächtigte
erhörest	erhörest
verdammten	verdammten
Wunde	Wunde
Füchsinnen	Füchsinnen
Suche	Suche
Erstarren	Erstarren
halten	halten
henket	henket
Fiebermittel	Fiebermittel
er	er
klappst	klappst
Schlot	Schlot
Heuhaufen	Heuhaufen
Atomphysikern	Atomphysikern
warst	warst
Fröschen	Fröschen
Huflattich	Huflattich
ringele	ringele
tote	tote
Fremden	Fremden
Dewargefäß	Dewargefäß
durchzuck	durchzuck
Ölspuren	Ölspuren
Schlägst	Schlägst
boykottierst	boykottierst
Ionenaustauscher	Ionenaustauscher
warnt	warnt
bereitet	bereitet
verunreinigst	verunreinigst
haderte	haderte
unehret	unehret
Festons	Festons
respektieren	respektieren
machte	machte
Türkenbünden	Türkenbünden
ballaste	ballaste
puddelst	puddelst
Charakteristika	Charakteristika
Wollt	Wollt
zeichnet	zeichnet
Euphemismen	Euphemismen
Rutheniumisotopen	Rutheniumisotopen
Abfahrtslisten	Abfahrtslisten
haare	haare
bitten	bitten
erwähnten	erwähnten
Leide	Leide
verstand	verstand
warte	warte
begebet	begebet
Sportlerin	Sportlerin
Tetraiodide	Tetraiodide
verbluten	verbluten
verunglimpfen	verunglimpfen
Wahn	Wahn
lüg	lüg
Fehlen	Fehlen
Schauet	Schauet
Konzentrate	Konzentrate
Halle	Halle
quietsche	quietsche
vergaset	vergaset
offenbartest	offenbartest
Falltürme	Falltürme
Gedränge	Gedränge
höret	höret
unterstützet	unterstützet
brach	brach
gedachte	gedachte
Falzen	Falzen
verzweifelt	verzweifelt
Edelsteinen	Edelsteinen
elfte	elfte
verführen	verführen
bedürft	bedürft
entsündigten	entsündigten
Buchstaben	Buchstaben
Augenglases	Augenglases
Grabbeltischen	Grabbeltischen
blende	blende
überprüfte	überprüfte
verdränge	verdränge
bestimmten	bestimmten
Bächen	Bächen
binden	binden
Briketten	Briketten
Argentits	Argentits
buddeln	buddeln
Kernspaltung	Kernspaltung
hebet	hebet
baute	baute
wollte	wollte
Einstufung	Einstufung
stickt	stickt
verbitterest	verbitterest
Herkunft	Herkunft
Introjektion	Introjektion
Stilllegungen	Stilllegungen
ausrufen	ausrufen
zeltest	zeltest
Stoffwechselwegen	Stoffwechselwegen
Katamarane	Katamarane
Chelatkomplex	Chelatkomplex
frisch	frisch
schweigen	schweigen
verhören	verhören
reichen	reichen
Schneider	Schneider
Ausländern	Ausländern
verfinstere	verfinstere
Puffersystemen	Puffersystemen
manövrierte	manövrierte
Carbid	Carbid
einführt	einführt
ratschlagt	ratschlagt
spukest	spukest
Schwärmereien	Schwärmereien
Technetate	Technetate
kauten	kauten
Zapfhahn	Zapfhahn
Kräften	Kräften
Piratensendern	Piratensendern
Rutheniumkomplexen	Rutheniumkomplexen
Bezeugungen	Bezeugungen
Puder	Puder
späht	späht
erhört	erhört
empörte	empörte
opfern	opfern
Lesen	Lesen
erniedrigst	erniedrigst
Beschuldigungen	Beschuldigungen
transportiere	transportiere
Samen	Samen
Rechnungen	Rechnungen
Abschiedsbriefe	Abschiedsbriefe
musizieret	musizieret
strullerte	strullerte
Steuerwagens	Steuerwagens
Martyrologien	Martyrologien
bekehrten	bekehrten
Aspartame	Aspartame
belüftete	belüftete
schätzt	schätzt
filzten	filzten
Überweisung	Überweisung
blasen	blasen
malträtiere	malträtiere
Apostels	Apostels
Putschisten	Putschisten
respektiere	respektiere
tat	tat
verdamm	verdamm
fluche	fluche
Massenanteilen	Massenanteilen
Frage	Frage
ausführt	ausführt
Kerls	Kerls
Zeile	Zeile
Uterus	Uterus
Lebenskräften	Lebenskräften
Bildpunkt	Bildpunkt
verbot	verbot
schmetterst	schmetterst
harrest	harrest
Kommet	Kommet
deines	deines
herrschest	herrschest
entsetzten	entsetzten
beeinflusst	beeinflusst
Neuigkeiten	Neuigkeiten
Dochten	Dochten
flambierten	flambierten
Katz-und-Maus-Spielen	Katz-und-Maus-Spielen
Charakteristikan	Charakteristikan
kapiert	kapiert
begrabet	begrabet
stifte	stifte
frappiere	frappiere
vierten	vierten
Tiere	Tiere
darfst	darfst
verlobte	verlobte
haben	haben
stammelest	stammelest
Vipernatter	Vipernatter
sagte	sagte
Gitarrenspieler	Gitarrenspieler
Abartigkeit	Abartigkeit
Rückumlauten	Rückumlauten
Eins	Eins
entdecket	entdecket
Luftschiff	Luftschiff
fladerten	fladerten
Asiatin	Asiatin
äusserst	äusserst
Händedrücken	Händedrücken
rangierst	rangierst
Schaffnerinnen	Schaffnerinnen
Hertz	Hertz
stoßest	stoßest
hegten	hegten
Kettenraucher	Kettenraucher
unsrer	unsrer
Anhänge	Anhänge
entsetzen	entsetzen
scheltet	scheltet
Funktionalität	Funktionalität
erkennest	erkennest
Brieföffners	Brieföffners
Videoaufzeichnung	Videoaufzeichnung
bleibest	bleibest
bürsteten	bürsteten
Somiten	Somiten
empört	empört
Pflanzung	Pflanzung
listeten	listeten
Zahnfleischentzündung	Zahnfleischentzündung
Gummibaumes	Gummibaumes
bereits	bereits
Käsereiben	Käsereiben
werten	werten
meißeltest	meißeltest
Homodimere	Homodimere
erklingt	erklingt
knüpfte	knüpfte
Raben	Raben
bandagiert	bandagiert
verspielest	verspielest
Streichen	Streichen
fehle	fehle
Mähnenwölfen	Mähnenwölfen
kehre	kehre
deckte	deckte
bekehrte	bekehrte
Schaden	Schaden
sehn	sehn
Empfängnisverhütungen	Empfängnisverhütungen
anzöge	anzöge
Asylrechten	Asylrechten
Playlist	Playlist
ärgere	ärgere
Noseans	Noseans
Krustentier	Krustentier
Tiefschutzen	Tiefschutzen
Herzchen	Herzchen
Gaunern	Gaunern
pflügen	pflügen
legt	legt
Sprachraum	Sprachraum
Atemgasen	Atemgasen
zersetzte	zersetzte
Palme	Palme
Teufel	Teufel
begruben	begruben
Planern	Planern
interpretiert	interpretiert
griff	griff
umarmen	umarmen
speise	speise
Westen	Westen
prophezeie	prophezeie
konsumieren	konsumieren
trauerten	trauerten
Betten	Betten
Einfältigkeiten	Einfältigkeiten
Ausbeuter	Ausbeuter
sabbre	sabbre
bezichtigten	bezichtigten
betrüge	betrüge
borgst	borgst
schnorrest	schnorrest
schwöllen	schwöllen
Aromastoffen	Aromastoffen
teil	teil
Fremde	Fremde
Erbsen	Erbsen
dividiert	dividiert
beschwindele	beschwindele
Stör	Stör
lieb	lieb
leer	leer
lachet	lachet
putzte	putzte
Fahrzeugkatalysator	Fahrzeugkatalysator
helfest	helfest
Leiden	Leiden
Golfplätzen	Golfplätzen
emittierte	emittierte
eigene	eigene
heiligte	heiligte
Fellhandschuh	Fellhandschuh
demütiget	demütiget
entgegenkamst	entgegenkamst
maßen	maßen
austilgest	austilgest
Seines	Seines
Trinken	Trinken
Landstreicher	Landstreicher
punktest	punktest
zerrissen	zerrissen
dein	dein
speist	speist
Kompromiss	Kompromiss
schläfst	schläfst
Kirgisin	Kirgisin
Hackern	Hackern
billigte	billigte
besprengen	besprengen
Kanzleien	Kanzleien
Astats	Astats
Klappertöpfen	Klappertöpfen
zupftet	zupftet
schenke	schenke
leistest	leistest
schwadronierten	schwadronierten
Pferde	Pferde
Schreibtischtätern	Schreibtischtätern
zensierten	zensierten
verkürzten	verkürzten
Schlaraffenlandes	Schlaraffenlandes
präsentier	präsentier
Willst	Willst
Panamaer	Panamaer
Sabbatjahr	Sabbatjahr
Linguist	Linguist
salzen	salzen
aktualisiere	aktualisiere
anhangen	anhangen
begehrtest	begehrtest
vollendete	vollendete
Skorpionen	Skorpionen
Nanosatellit	Nanosatellit
schmuggele	schmuggele
zähltet	zähltet
kauern	kauern
instanziiere	instanziiere
weinen	weinen
Pausbacke	Pausbacke
Prophet	Prophet
inspirierest	inspirierest
schautest	schautest
zeugst	zeugst
tragt	tragt
gut	gut
Scherzen	Scherzen
hattest	hattest
Namen	Namen
Seetaucher	Seetaucher
notlande	notlande
anrichte	anrichte
Bushaltestelle	Bushaltestelle
beweist	beweist
gebührt	gebührt
beschottre	beschottre
Tetraiodiden	Tetraiodiden
zeuge	zeuge
produzierten	produzierten
suchten	suchten
Stechpalmen	Stechpalmen
kranken	kranken
verkehrte	verkehrte
Gesetze	Gesetze
erlaube	erlaube
Futtermitteln	Futtermitteln
pulsiert	pulsiert
halltet	halltet
Ochs	Ochs
verführest	verführest
widerriefe	widerriefe
verständig	verständig
repräsentieret	repräsentieret
Lotterien	Lotterien
transportierten	transportierten
bestellt	bestellt
Epoxiden	Epoxiden
Irrtumes	Irrtumes
Feuerteufels	Feuerteufels
Achatschnecken	Achatschnecken
defragmentierten	defragmentierten
Schönrednern	Schönrednern
ach	ach
verselbstständige	verselbstständige
beklage	beklage
zuppt	zuppt
blitzen	blitzen
Bertrandite	Bertrandite
krähte	krähte
Sage	Sage
dunkelt	dunkelt
drillte	drillte
streiften	streiften
reicht	reicht
erst	erst
notlandet	notlandet
schwelle	schwelle
teilte	teilte
Arresten	Arresten
vorn	vorn
Machet	Machet
Renegat	Renegat
Volltreffer	Volltreffer
Eiszapfens	Eiszapfens
Apportierhunde	Apportierhunde
schlachtet	schlachtet
Füllet	Füllet
überfischte	überfischte
Bajonetten	Bajonetten
gebieten	gebieten
Quellflüssen	Quellflüssen
Darlehen	Darlehen
Isobars	Isobars
downloadete	downloadete
grien	grien
Fellachin	Fellachin
Kairiner	Kairiner
erbest	erbest
könnet	könnet
dotiere	dotiere
wiederkamen	wiederkamen
Anführern	Anführern
föhnest	föhnest
läuten	läuten
Affenbrotbäumen	Affenbrotbäumen
Stücken	Stücken
schaut	schaut
Chlorats	Chlorats
Tritt	Tritt
zerfielest	zerfielest
Fettsack	Fettsack
Girls	Girls
verfanget	verfanget
Büstenhaltern	Büstenhaltern
unterschiede	unterschiede
Halt	Halt
solches	solches
unterbewertete	unterbewertete
Elementarzellen	Elementarzellen
Märchenbuches	Märchenbuches
wehe	wehe
täuschet	täuschet
Blockflöte	Blockflöte
greifen	greifen
prahlte	prahlte
wehrte	wehrte
fahrest	fahrest
Kautschuke	Kautschuke
sponsert	sponsert
spielet	spielet
kreieren	kreieren
Gebeten	Gebeten
härte	härte
Montagmittagen	Montagmittagen
entstände	entstände
Zebrahai	Zebrahai
süsse	süsse
addieret	addieret
Freitagnachmittage	Freitagnachmittage
verteidigte	verteidigte
möppertet	möppertet
verzeichnete	verzeichnete
Gebot	Gebot
bekehrt	bekehrt
drängst	drängst
speicherten	speicherten
Maße	Maße
überdenkst	überdenkst
meldeten	meldeten
bereitete	bereitete
wurdest	wurdest
duckt	duckt
mangeln	mangeln
Farbstoffen	Farbstoffen
Deine	Deine
Adeliepinguins	Adeliepinguins
gehetzt	gehetzt
Flossen	Flossen
Gasgemisch	Gasgemisch
umarbeitest	umarbeitest
Ihren	Ihren
Pflichten	Pflichten
pensionierten	pensionierten
mobilisieret	mobilisieret
jede	jede
wisperten	wisperten
zittertest	zittertest
spannen	spannen
Bildpunkten	Bildpunkten
Wissen	Wissen
Leitkegeln	Leitkegeln
erscheinest	erscheinest
rittest	rittest
Arbeitsbereichen	Arbeitsbereichen
aufheben	aufheben
Argentit	Argentit
Oberlandesgericht	Oberlandesgericht
Juden	Juden
dingten	dingten
Träumers	Träumers
raubest	raubest
blondierten	blondierten
Ausländer	Ausländer
Mischung	Mischung
Ösophagospasmus	Ösophagospasmus
Münzsammlung	Münzsammlung
beichten	beichten
Aktivist	Aktivist
urbanisiert	urbanisiert
ausziehst	ausziehst
schauspieleren	schauspieleren
initiieret	initiieret
bringet	bringet
zirpen	zirpen
Fischer	Fischer
ruhte	ruhte
geknautscht	geknautscht
imitiertet	imitiertet
dirigiert	dirigiert
kämpfte	kämpfte
Märchenbüchern	Märchenbüchern
Mähnenwolf	Mähnenwolf
frohlockten	frohlockten
Rechenbrett	Rechenbrett
Auszügen	Auszügen
respektiert	respektiert
spezialisiere	spezialisiere
Gebote	Gebote
tastet	tastet
Kompassen	Kompassen
pilgert	pilgert
moppet	moppet
betrübt	betrübt
Lötzinn	Lötzinn
schnitt	schnitt
Wühltische	Wühltische
Hunden	Hunden
Röcke	Röcke
Unterwerfungen	Unterwerfungen
beleidigst	beleidigst
hupet	hupet
Schwirrvögel	Schwirrvögel
idealisieret	idealisieret
zertifizierst	zertifizierst
nötige	nötige
Stadtbezirken	Stadtbezirken
Spiralen	Spiralen
Kreise	Kreise
erpresst	erpresst
Klotz	Klotz
wälzt	wälzt
verliere	verliere
Trichter	Trichter
meinst	meinst
einerntest	einerntest
Trickbetrügern	Trickbetrügern
spanne	spanne
behauptest	behauptest
Freizeitzentrum	Freizeitzentrum
Spirale	Spirale
Minimierung	Minimierung
kichert	kichert
konntet	konntet
Leitungsweg	Leitungsweg
bilden	bilden
aufhobt	aufhobt
Zur-Schau-Stellen	Zur-Schau-Stellen
erbringen	erbringen
deinen	deinen
Steuerberater	Steuerberater
gelobe	gelobe
verspäteten	verspäteten
steigen	steigen
privilegiere	privilegiere
entkörperlichten	entkörperlichten
Erdboden	Erdboden
Pentaboraten	Pentaboraten
zerstreut	zerstreut
besitzest	besitzest
zeuget	zeuget
verselbständigt	verselbständigt
Woge	Woge
zagt	zagt
tust	tust
bekriegtet	bekriegtet
sucht	sucht
ahne	ahne
wärmet	wärmet
erbrütet	erbrütet
Kontraindikation	Kontraindikation
frohlockest	frohlockest
lade	lade
Aase	Aase
sichten	sichten
Spannt	Spannt
teilen	teilen
Sehne	Sehne
bezieht	bezieht
Feind	Feind
Drohkulissen	Drohkulissen
schautet	schautet
Hirschen	Hirschen
ander	ander
Leiche	Leiche
nimmst	nimmst
kramst	kramst
Lümmeltüte	Lümmeltüte
Sphäre	Sphäre
kristallisiertest	kristallisiertest
kaufet	kaufet
Erstlinge	Erstlinge
preisen	preisen
erfahrt	erfahrt
Pfeile	Pfeile
gekröst	gekröst
Teppichen	Teppichen
aufhebt	aufhebt
Kerl	Kerl
Stufen	Stufen
Langschwanzpinguinen	Langschwanzpinguinen
Tritte	Tritte
härten	härten
Wanderfalken	Wanderfalken
Unglaube	Unglaube
Trümmersprachen	Trümmersprachen
leihe	leihe
dürfte	dürfte
Wollte	Wollte
Metallspiegeln	Metallspiegeln
Wadenbein	Wadenbein
drücke	drücke
taufen	taufen
aufrichtet	aufrichtet
Monden	Monden
Automatikgetriebe	Automatikgetriebe
Shortcut	Shortcut
anhanget	anhanget
manövrieret	manövrieret
trinken	trinken
Bruchstriches	Bruchstriches
baue	baue
funktioniertest	funktioniertest
Totenglocke	Totenglocke
Fellhandschuhen	Fellhandschuhen
rufst	rufst
Sünders	Sünders
verspielte	verspielte
Riese	Riese
Augen	Augen
geratest	geratest
faltest	faltest
Noseanen	Noseanen
Kassettenrekordern	Kassettenrekordern
meuterest	meuterest
erkennet	erkennet
erfüllst	erfüllst
begebe	begebe
quatschen	quatschen
Rubine	Rubine
Rechte	Rechte
Premieren	Premieren
Einrad	Einrad
Fallturm	Fallturm
Lobe	Lobe
erzeigt	erzeigt
ladest	ladest
Gedrängen	Gedrängen
diskutierst	diskutierst
Hubschraubern	Hubschraubern
Mäuse	Mäuse
rodete	rodete
verwechselst	verwechselst
Ingredienzen	Ingredienzen
widerrufe	widerrufe
übersiehst	übersiehst
Teile	Teile
kletteret	kletteret
setze	setze
schlängelest	schlängelest
Bleche	Bleche
Amputierten	Amputierten
entwaffnest	entwaffnest
Gewürzen	Gewürzen
entfolgst	entfolgst
Berufen	Berufen
verantwortet	verantwortet
Blässe	Blässe
knurrtet	knurrtet
Brandbeschleuniger	Brandbeschleuniger
Freunde	Freunde
schleiß	schleiß
Libellen	Libellen
herrschten	herrschten
baust	baust
bete	bete
ehre	ehre
Automatikgetrieben	Automatikgetrieben
Sachen	Sachen
Begünstigung	Begünstigung
entheilige	entheilige
betrete	betrete
mogelest	mogelest
pflegte	pflegte
schauest	schauest
Tun	Tun
hineinbrächte	hineinbrächte
Gläubigern	Gläubigern
koste	koste
gehöre	gehöre
zürntest	zürntest
Dienstgrad	Dienstgrad
Amen	Amen
streuen	streuen
sage	sage
Reinstoff	Reinstoff
Schnipseln	Schnipseln
willst	willst
Treppe	Treppe
beäugen	beäugen
Teilen	Teilen
lauf	lauf
Weichloten	Weichloten
verstecke	verstecke
Stiefmütterchen	Stiefmütterchen
verbündest	verbündest
koordinierte	koordinierte
bewässern	bewässern
Platte	Platte
gönnest	gönnest
zerstreuten	zerstreuten
Butike	Butike
bombardiere	bombardiere
Werkzeugen	Werkzeugen
schätzte	schätzte
unseres	unseres
Habe	Habe
Sichelzellenanämien	Sichelzellenanämien
grauten	grauten
Sanatorien	Sanatorien
läutet	läutet
geselle	geselle
betrübe	betrübe
Werke	Werke
regelet	regelet
prangte	prangte
Kohlenstoffgehalten	Kohlenstoffgehalten
Wasserquellen	Wasserquellen
Idolatrien	Idolatrien
billige	billige
hasset	hasset
Fingerhüte	Fingerhüte
reimte	reimte
lose	lose
Mikrowellenfilter	Mikrowellenfilter
Kleptokratie	Kleptokratie
rede	rede
generiert	generiert
heulte	heulte
leuchten	leuchten
klumpe	klumpe
Nahrungsbestandteil	Nahrungsbestandteil
säte	säte
grabbelten	grabbelten
Ektoplasmen	Ektoplasmen
tief	tief
Zeitplan	Zeitplan
Zwingburgen	Zwingburgen
Deinem	Deinem
Europameistern	Europameistern
Pfeilen	Pfeilen
Oberlippe	Oberlippe
liebest	liebest
Esset	Esset
Eistaucher	Eistaucher
verstehet	verstehet
Antitranspiranten	Antitranspiranten
deutete	deutete
appellierte	appellierte
concessionieren	concessionieren
Mutagen	Mutagen
Aacheners	Aacheners
Aha-Erlebnisse	Aha-Erlebnisse
Fieberanfall	Fieberanfall
velarisiert	velarisiert
substituierend	substituierend
bekennet	bekennet
säet	säet
Unrechten	Unrechten
preiset	preiset
verbirgt	verbirgt
Krokus	Krokus
punktetest	punktetest
Propheten	Propheten
Heuschrecken	Heuschrecken
stapften	stapften
Reichweite	Reichweite
verdeckte	verdeckte
transportierte	transportierte
Dann	Dann
Klärung	Klärung
Tiefe	Tiefe
Berber	Berber
Deutungen	Deutungen
überreicht	überreicht
brandet	brandet
näht	näht
Brote	Brote
Kohle	Kohle
sortierte	sortierte
Abfahrtsliste	Abfahrtsliste
flieh	flieh
Bertrandit	Bertrandit
Fehden	Fehden
gebot	gebot
Lautwandel	Lautwandel
Briefen	Briefen
Tanne	Tanne
Scheißkerlen	Scheißkerlen
Mageninhalt	Mageninhalt
benachrichtige	benachrichtige
entwickelten	entwickelten
jemand	jemand
Atommodelle	Atommodelle
Empörungen	Empörungen
lüftet	lüftet
Beteiligten	Beteiligten
gelangte	gelangte
tränke	tränke
sehnst	sehnst
Gebäck	Gebäck
Ölfässern	Ölfässern
Reizen	Reizen
legten	legten
suchte	suchte
Stearat	Stearat
ärgernd	ärgernd
Muster	Muster
Rutheniumkomplex	Rutheniumkomplex
vermischten	vermischten
Piratensender	Piratensender
Innenministerien	Innenministerien
jungen	jungen
blitzte	blitzte
verschonet	verschonet
Seit	Seit
verkaufst	verkaufst
föchte	föchte
Entsetzt	Entsetzt
vertrieb	vertrieb
verabschiedetet	verabschiedetet
fluchten	fluchten
neige	neige
hadertet	hadertet
flöteten	flöteten
bereite	bereite
Atombombe	Atombombe
Bergen	Bergen
Abschußringe	Abschußringe
Zehnten	Zehnten
klickte	klickte
verschlungen	verschlungen
heulet	heulet
Remisen	Remisen
Peptid	Peptid
grüßest	grüßest
am	am
Asylrechte	Asylrechte
entschleieret	entschleieret
Ypecaharallen	Ypecaharallen
Rückumschlages	Rückumschlages
Bestecken	Bestecken
Amokläuferinnen	Amokläuferinnen
absolviertet	absolviertet
fluktuierte	fluktuierte
Nehmet	Nehmet
Beile	Beile
Mobilfunknetzen	Mobilfunknetzen
schneide	schneide
schreiet	schreiet
schluchzte	schluchzte
halben	halben
Pinguinen	Pinguinen
pressierten	pressierten
belauerten	belauerten
regieren	regieren
gestaltest	gestaltest
beauftragt	beauftragt
beten	beten
Taschendiebe	Taschendiebe
Rundbriefe	Rundbriefe
verstörten	verstörten
bedingten	bedingten
Schlössern	Schlössern
führte	führte
wehren	wehren
Samarskit	Samarskit
befehlen	befehlen
Verwaltungsakten	Verwaltungsakten
bromiert	bromiert
Brite	Brite
Glaubst	Glaubst
bereue	bereue
veranstalten	veranstalten
Tore	Tore
überwachten	überwachten
Regenten	Regenten
Hummern	Hummern
Jude	Jude
Küchenmaschinen	Küchenmaschinen
folterte	folterte
Abkürzungsverzeichnis	Abkürzungsverzeichnis
Gehirnwelle	Gehirnwelle
pharyngalisierst	pharyngalisierst
schwadroniert	schwadroniert
Amputierte	Amputierte
Tauben	Tauben
Fiebermitteln	Fiebermitteln
Ängsten	Ängsten
Basilikum	Basilikum
steig	steig
Sportlerinnen	Sportlerinnen
Rückwege	Rückwege
erschütterte	erschütterte
Schlägen	Schlägen
Drillinge	Drillinge
Fischotter	Fischotter
halbierte	halbierte
griffen	griffen
massakrierten	massakrierten
Uranerzen	Uranerzen
wehrtest	wehrtest
durchwacht	durchwacht
sinkest	sinkest
betätigtet	betätigtet
Leitkegel	Leitkegel
fällen	fällen
Carbiden	Carbiden
lügt	lügt
möget	möget
Gäste	Gäste
hingeht	hingeht
verifizierten	verifizierten
filtern	filtern
Brüder	Brüder
Brettspiele	Brettspiele
äussern	äussern
Schleppern	Schleppern
Ehren	Ehren
legst	legst
Metonymie	Metonymie
konsolidierend	konsolidierend
mehrte	mehrte
linsten	linsten
Fische	Fische
sintertest	sintertest
fertige	fertige
Knabe	Knabe
herrschet	herrschet
Ölfasses	Ölfasses
feierst	feierst
Eissteinen	Eissteinen
Mikrometern	Mikrometern
infiziertet	infiziertet
lochten	lochten
Schrei	Schrei
Führe	Führe
einigte	einigte
stoppte	stoppte
replizierten	replizierten
stärken	stärken
fällt	fällt
Busen	Busen
Herden	Herden
trägt	trägt
heilte	heilte
aufwachte	aufwachte
gedacht	gedacht
beschotteret	beschotteret
Bäche	Bäche
babbeltet	babbeltet
schlabbere	schlabbere
unschuldigen	unschuldigen
Bete	Bete
Jahren	Jahren
bräunen	bräunen
Wehklagen	Wehklagen
touchiere	touchiere
bückest	bückest
Impedanz	Impedanz
verbasele	verbasele
zürnten	zürnten
Kontrollkästchen	Kontrollkästchen
Petersfisch	Petersfisch
Pflanzungen	Pflanzungen
Konfitüren	Konfitüren
simulierst	simulierst
frommen	frommen
Zeugen	Zeugen
zerbrichst	zerbrichst
posiert	posiert
Gerücht	Gerücht
spaltest	spaltest
Lammfellhandschuhs	Lammfellhandschuhs
entwischten	entwischten
bejubelst	bejubelst
eskaliert	eskaliert
trompete	trompete
zerfetzt	zerfetzt
eine	eine
losest	losest
filteret	filteret
verprügelte	verprügelte
Entmachtungen	Entmachtungen
Atemluft	Atemluft
babbelst	babbelst
Tannen	Tannen
erbte	erbte
ungeistlichen	ungeistlichen
vertagest	vertagest
Nährmedien	Nährmedien
liebe	liebe
grübelte	grübelte
verwechseltet	verwechseltet
predigte	predigte
plärrt	plärrt
schnitten	schnitten
Planer	Planer
Laubbläser	Laubbläser
knutschest	knutschest
Fußballweltmeisterschaftsqualifikationsspiel	Fußballweltmeisterschaftsqualifikationsspiel
panaschieret	panaschieret
klöne	klöne
Geheimdienst	Geheimdienst
kugele	kugele
meißelt	meißelt
Molybdit	Molybdit
entsündigen	entsündigen
Anhang	Anhang
deklarierten	deklarierten
arm	arm
prophezeiet	prophezeiet
feiere	feiere
Leitungswegs	Leitungswegs
glänzt	glänzt
Herkünften	Herkünften
Einen	Einen
Säuen	Säuen
leite	leite
pflanzte	pflanzte
schlaft	schlaft
Däumlings	Däumlings
Sollte	Sollte
Milz	Milz
Flamingo	Flamingo
Bärte	Bärte
Blutgefäß	Blutgefäß
Pfründe	Pfründe
privatisierest	privatisierest
entgegenkamen	entgegenkamen
reiche	reiche
widerlegte	widerlegte
dressieret	dressieret
Ärzte	Ärzte
besäest	besäest
Bauwerken	Bauwerken
Jagdhunden	Jagdhunden
liegst	liegst
unterwerft	unterwerft
spähet	spähet
Rücktrittbremse	Rücktrittbremse
Als	Als
erliegst	erliegst
Desserts	Desserts
jauchzt	jauchzt
scherze	scherze
Hälsen	Hälsen
Reiterschwertern	Reiterschwertern
Finanzministerium	Finanzministerium
Isolatoren	Isolatoren
bequemte	bequemte
bewähret	bewähret
surrst	surrst
zwölfte	zwölfte
Erdkruste	Erdkruste
Einsätzen	Einsätzen
Politologe	Politologe
kremierten	kremierten
Brieföffner	Brieföffner
Feuerteufel	Feuerteufel
nächste	nächste
niemanden	niemanden
besichtiget	besichtiget
müsse	müsse
Prostyloi	Prostyloi
ermutigte	ermutigte
Gefangenen	Gefangenen
Gerichten	Gerichten
impfte	impfte
gabelst	gabelst
lieben	lieben
Gelobet	Gelobet
parlieren	parlieren
lackiere	lackiere
sinke	sinke
gewitterte	gewitterte
scheinet	scheinet
wallfahrteten	wallfahrteten
buddelten	buddelten
unterscheide	unterscheide
Malaysiers	Malaysiers
Ösophagospasmen	Ösophagospasmen
verstecktet	verstecktet
ärgertest	ärgertest
springst	springst
Abhängen	Abhängen
speisend	speisend
Kompromissen	Kompromissen
Campingplatzes	Campingplatzes
Saiblingen	Saiblingen
Rücktrittbremsen	Rücktrittbremsen
pflanzest	pflanzest
stiftete	stiftete
Geigerzähler	Geigerzähler
verglühte	verglühte
gewähr	gewähr
kugelten	kugelten
webte	webte
Lärche	Lärche
preise	preise
scheucht	scheucht
erwürgtest	erwürgtest
rechte	rechte
vertilge	vertilge
aufnahmt	aufnahmt
billigen	billigen
bedrückest	bedrückest
sollt	sollt
lauft	lauft
Traubenlese	Traubenlese
stille	stille
Knaben	Knaben
Rehe	Rehe
Küstenwache	Küstenwache
Dich	Dich
Aussätzige	Aussätzige
kritzele	kritzele
emigrieret	emigrieret
demoralisiere	demoralisiere
kooperierte	kooperierte
Cyclodextrinen	Cyclodextrinen
Somite	Somite
löset	löset
Handbüchern	Handbüchern
Hahnenkämme	Hahnenkämme
Krankenschein	Krankenschein
planschtest	planschtest
vollendest	vollendest
Eiszapfen	Eiszapfen
Suchanfragen	Suchanfragen
versuchtet	versuchtet
Bromidquellen	Bromidquellen
Tyrannen	Tyrannen
vandalieren	vandalieren
zählte	zählte
wenden	wenden
maximierten	maximierten
ermächtigest	ermächtigest
schlummerte	schlummerte
folg	folg
Fette	Fette
verarbeite	verarbeite
blaset	blaset
Schätzen	Schätzen
Eiland	Eiland
Kaufhäusern	Kaufhäusern
nachwandeln	nachwandeln
rodet	rodet
erforschest	erforschest
Wadenbeines	Wadenbeines
achte	achte
gezügelt	gezügelt
bewahrheitetet	bewahrheitetet
verdreht	verdreht
Kryostat	Kryostat
dingte	dingte
herrschst	herrschst
vertreiben	vertreiben
erklinge	erklinge
Einrädern	Einrädern
Lehrkörpers	Lehrkörpers
lavierte	lavierte
querte	querte
Diesen	Diesen
ehrte	ehrte
Laubholz	Laubholz
langweiltest	langweiltest
Sonderberichte	Sonderberichte
heischten	heischten
Galoppen	Galoppen
verdinglichtest	verdinglichtest
leider	leider
auflegst	auflegst
Weinstöcke	Weinstöcke
häuftet	häuftet
zerrütteten	zerrütteten
Spielen	Spielen
Grieße	Grieße
narret	narret
optimierte	optimierte
steinigst	steinigst
schwängen	schwängen
nötigte	nötigte
suche	suche
Provinz	Provinz
Verbindungsdrähten	Verbindungsdrähten
schlaf	schlaf
Helden	Helden
Agoraphobien	Agoraphobien
abweichest	abweichest
Deckenzapfen	Deckenzapfen
Fluorkohlenwasserstoff	Fluorkohlenwasserstoff
reizen	reizen
schämst	schämst
hetzte	hetzte
speiset	speiset
allem	allem
Talismanen	Talismanen
Tausch	Tausch
ausfuhren	ausfuhren
reden	reden
Beilen	Beilen
Kopfsalat	Kopfsalat
analysierest	analysierest
eurer	eurer
haarte	haarte
fistete	fistete
verkapselt	verkapselt
widmend	widmend
plärrtest	plärrtest
Provinzen	Provinzen
Königen	Königen
Pis	Pis
Affenbrotbaum	Affenbrotbaum
überdenkest	überdenkest
Weißt	Weißt
Gefilden	Gefilden
Genkinit	Genkinit
führen	führen
Stämmen	Stämmen
Markise	Markise
stürze	stürze
brauchst	brauchst
begrabe	begrabe
Markisen	Markisen
Erdbirnen	Erdbirnen
Sinne	Sinne
Nullpunkt	Nullpunkt
Vorhäute	Vorhäute
spiele	spiele
taufet	taufet
prostet	prostet
ungefälschtem	ungefälschtem
Lobet	Lobet
hinterzögen	hinterzögen
Marjellchen	Marjellchen
weichen	weichen
überweist	überweist
wichsten	wichsten
bewerbet	bewerbet
Anlässe	Anlässe
leide	leide
kommst	kommst
Extrems	Extrems
Silbererze	Silbererze
Bausch	Bausch
Beiblättern	Beiblättern
Gepäckträgern	Gepäckträgern
verzierten	verzierten
Baiser	Baiser
erben	erben
trüb	trüb
unterrichten	unterrichten
verseuchen	verseuchen
Karer	Karer
Reißnagel	Reißnagel
Kerzenfische	Kerzenfische
prosteten	prosteten
vermöge	vermöge
ritzten	ritzten
Strahlentierchens	Strahlentierchens
Unwahrheit	Unwahrheit
dekoriere	dekoriere
Geschäften	Geschäften
freiwilligen	freiwilligen
schenkest	schenkest
Pailletten	Pailletten
Zitronensäften	Zitronensäften
Pfahl	Pfahl
Lautwandeln	Lautwandeln
Acht	Acht
gern	gern
ratschlagen	ratschlagen
Steuerberatern	Steuerberatern
danke	danke
kremieren	kremieren
Transportwegen	Transportwegen
jemanden	jemanden
Möbelstoff	Möbelstoff
essen	essen
Senkungen	Senkungen
säusele	säusele
erweckest	erweckest
meine	meine
Rückumschlägen	Rückumschlägen
Krieg	Krieg
Rhodochrosite	Rhodochrosite
bimmelten	bimmelten
fabulierte	fabulierte
Hummel	Hummel
Außenministerium	Außenministerium
Tiegel	Tiegel
köderte	köderte
wäre	wäre
Füße	Füße
erstarre	erstarre
verunglimpfte	verunglimpfte
Linien	Linien
Regent	Regent
Joche	Joche
kabbelet	kabbelet
Hinterwäldlern	Hinterwäldlern
lebet	lebet
Nukleinsäuren	Nukleinsäuren
Fermium	Fermium
straftet	straftet
rundest	rundest
Wärt	Wärt
Habt	Habt
Scheißkerl	Scheißkerl
vertrage	vertrage
Kaufkraft	Kaufkraft
besetzest	besetzest
erlabet	erlabet
bewahrheitete	bewahrheitete
schwirret	schwirret
Uteri	Uteri
Schaffnerin	Schaffnerin
besorgt	besorgt
backen	backen
stellte	stellte
taufst	taufst
mußten	mußten
erbrüte	erbrüte
strandeten	strandeten
Bruchstrich	Bruchstrich
Haarverlusten	Haarverlusten
Obszönität	Obszönität
Herd	Herd
Trotzkist	Trotzkist
wollten	wollten
sagen	sagen
bescheißt	bescheißt
Flitzer	Flitzer
geleite	geleite
verwerten	verwerten
Weichlote	Weichlote
Reinelementen	Reinelementen
verstehst	verstehst
ihr	ihr
malträtiert	malträtiert
Braunrallen	Braunrallen
extemporiere	extemporiere
geschlummert	geschlummert
tanze	tanze
sinterte	sinterte
härtet	härtet
sagest	sagest
beteuerten	beteuerten
falle	falle
durfte	durfte
Bajonette	Bajonette
bejubelte	bejubelte
Ärgernissen	Ärgernissen
Körpergeruches	Körpergeruches
Kühe	Kühe
zeugest	zeugest
ausführte	ausführte
pressiere	pressiere
pfänden	pfänden
spricht	spricht
Märtyrern	Märtyrern
Deck	Deck
taten	taten
Sexte	Sexte
bekennst	bekennst
trage	trage
sponseret	sponseret
aufstand	aufstand
Eine	Eine
Schwermetallionen	Schwermetallionen
konstatiere	konstatiere
erkannten	erkannten
ersparte	ersparte
Taufe	Taufe
decke	decke
verließet	verließet
Grabbeltisch	Grabbeltisch
Breiten	Breiten
Sizilianer	Sizilianer
Klärungen	Klärungen
begnadigte	begnadigte
sprechet	sprechet
Bildschirmfotos	Bildschirmfotos
gebündelt	gebündelt
erbringst	erbringst
Zöpfen	Zöpfen
steckte	steckte
unterdrücke	unterdrücke
Reliquiare	Reliquiare
halbierest	halbierest
zürnet	zürnet
weichst	weichst
kappten	kappten
Pi	Pi
Schlüchten	Schlüchten
Lusitaner	Lusitaner
negierest	negierest
beißet	beißet
zerschlagt	zerschlagt
bewahret	bewahret
Paralipse	Paralipse
lehre	lehre
frohlocke	frohlocke
colorierend	colorierend
Dans	Dans
betrübtest	betrübtest
Rutheniumisotop	Rutheniumisotop
stärket	stärket
Schenke	Schenke
Mauten	Mauten
enttäuschet	enttäuschet
entkämen	entkämen
Zerfällen	Zerfällen
ziehst	ziehst
Fluorgehalte	Fluorgehalte
Notstand	Notstand
Monarchie	Monarchie
Grüßet	Grüßet
Kein	Kein
markiere	markiere
ringet	ringet
jeder	jeder
belohnten	belohnten
sortierest	sortierest
Bund	Bund
berufe	berufe
hingehet	hingehet
flitzen	flitzen
setzet	setzet
blondieret	blondieret
blitze	blitze
vergast	vergast
lärmte	lärmte
Mopp	Mopp
krähen	krähen
hüpfest	hüpfest
verstecken	verstecken
wehte	wehte
protestierest	protestierest
leistete	leistete
Programmiererinnen	Programmiererinnen
beleuchte	beleuchte
Äther	Äther
weist	weist
Rechenbrettern	Rechenbrettern
schabst	schabst
Anzeichen	Anzeichen
Wunden	Wunden
leget	leget
auflöste	auflöste
Campingplätzen	Campingplätzen
enge	enge
sezierte	sezierte
keinem	keinem
bessere	bessere
Lüste	Lüste
gereichte	gereichte
Fluoratom	Fluoratom
meldet	meldet
machet	machet
Brüdern	Brüdern
Erzherzogshüten	Erzherzogshüten
Zeitungsenten	Zeitungsenten
fegst	fegst
Brieftaubenzüchter	Brieftaubenzüchter
drängte	drängte
verwirklicht	verwirklicht
machest	machest
bereiteten	bereiteten
Kriege	Kriege
vergibst	vergibst
Meinet	Meinet
erstaunte	erstaunte
Pforten	Pforten
fluppe	fluppe
Tieren	Tieren
beiden	beiden
Basilisk	Basilisk
Geschrei	Geschrei
brechet	brechet
Zementen	Zementen
Unserer	Unserer
unser	unser
träumte	träumte
Herde	Herde
fasset	fasset
erfüllet	erfüllet
beanspruchte	beanspruchte
respektierten	respektierten
Steuerwagen	Steuerwagen
protokollieren	protokollieren
Aphasien	Aphasien
Suffix	Suffix
Tintenfisch	Tintenfisch
fabulierest	fabulierest
verreisest	verreisest
schwirrt	schwirrt
auszieht	auszieht
erstürmet	erstürmet
Metallquirle	Metallquirle
verschickte	verschickte
meuternd	meuternd
Iberer	Iberer
Gästen	Gästen
durchläuterte	durchläuterte
beherrscht	beherrscht
Solche	Solche
impfst	impfst
gebären	gebären
Aussätzigen	Aussätzigen
Alkali	Alkali
verdrängt	verdrängt
schauet	schauet
Fluorkohlenwasserstoffe	Fluorkohlenwasserstoffe
Kontrollboxen	Kontrollboxen
gewöhnte	gewöhnte
Freibergit	Freibergit
Elektrophil	Elektrophil
drifte	drifte
raffinier	raffinier
reformierten	reformierten
Trockendocks	Trockendocks
weinest	weinest
Monate	Monate
Versorgungen	Versorgungen
Sprödmetallen	Sprödmetallen
Den	Den
grüßten	grüßten
Uranerz	Uranerz
Stücke	Stücke
scheuchtest	scheuchtest
verschränkest	verschränkest
haste	haste
sieht	sieht
Nachruf	Nachruf
Gedanken	Gedanken
steiget	steiget
Nadelbäume	Nadelbäume
Zähne	Zähne
wachte	wachte
verbärgen	verbärgen
langte	langte
grause	grause
Weile	Weile
Trinker	Trinker
entflieht	entflieht
vertilgest	vertilgest
Omnibusse	Omnibusse
vertreibt	vertreibt
verringerten	verringerten
mußt	mußt
Binden	Binden
verklärest	verklärest
stolz	stolz
erlassen	erlassen
geräuchert	geräuchert
Reisebüro	Reisebüro
schwenkt	schwenkt
gereicht	gereicht
versklavt	versklavt
Zähnen	Zähnen
wispern	wispern
Schal	Schal
surre	surre
applizirte	applizirte
Paragraphenreiter	Paragraphenreiter
Musters	Musters
harmoniere	harmoniere
Heiratsgut	Heiratsgut
gewährtest	gewährtest
dritte	dritte
gedächte	gedächte
Finanzministerien	Finanzministerien
Ächselchen	Ächselchen
Alibis	Alibis
Oxalaten	Oxalaten
wurdet	wurdet
predigen	predigen
steckst	steckst
Spanne	Spanne
Gasflasche	Gasflasche
Adelung	Adelung
Hie	Hie
kämpfet	kämpfet
Buchfink	Buchfink
Kakaos	Kakaos
Boten	Boten
entständen	entständen
nehmt	nehmt
kabbelnd	kabbelnd
evakuieret	evakuieret
obfuskieren	obfuskieren
Grab	Grab
Generation	Generation
wehre	wehre
wurstelten	wurstelten
herrschte	herrschte
schnappet	schnappet
Minischweine	Minischweine
überstehst	überstehst
blamierte	blamierte
spielen	spielen
handhabt	handhabt
beteuerest	beteuerest
Indern	Indern
Telefonverkäufer	Telefonverkäufer
Amt	Amt
belauere	belauere
Wehr	Wehr
jammern	jammern
gravierst	gravierst
Tumulten	Tumulten
stigmatisierst	stigmatisierst
Buch	Buch
rolltet	rolltet
fragen	fragen
rollten	rollten
Träumer	Träumer
Funkfeuern	Funkfeuern
schauen	schauen
gebet	gebet
Welpen	Welpen
vertreibe	vertreibe
Gewinnungen	Gewinnungen
Seehechte	Seehechte
grausten	grausten
verschmelze	verschmelze
wechselwirkte	wechselwirkte
verderben	verderben
Eselsohren	Eselsohren
sponsertest	sponsertest
ein	ein
ruckelst	ruckelst
Bilderstürmer	Bilderstürmer
fallt	fallt
Wir	Wir
Herbstwinde	Herbstwinde
Autoklaven	Autoklaven
Ihr	Ihr
Geckos	Geckos
Schläfchens	Schläfchens
grabest	grabest
beklagte	beklagte
ausrufest	ausrufest
Dobermännern	Dobermännern
kommet	kommet
Beschleuniger	Beschleuniger
obfuskierten	obfuskierten
Minimierungen	Minimierungen
entmineralisieren	entmineralisieren
Fokusse	Fokusse
Konifere	Konifere
blast	blast
instanziier	instanziier
Geringschätzung	Geringschätzung
Kohlen	Kohlen
verkürzte	verkürzte
stäupen	stäupen
kabelst	kabelst
Stellen	Stellen
behaltest	behaltest
Bilderstürmers	Bilderstürmers
Schreiet	Schreiet
log	log
batest	batest
boykottierten	boykottierten
dringt	dringt
auszogen	auszogen
War	War
finanziere	finanziere
grüne	grüne
gravierten	gravierten
Inder	Inder
verrosteten	verrosteten
Polyphosphat	Polyphosphat
Mammut	Mammut
Steuerborden	Steuerborden
bemühten	bemühten
still	still
Rekursion	Rekursion
Zipfelmütze	Zipfelmütze
plagte	plagte
Orte	Orte
schöpfte	schöpfte
Malaysierin	Malaysierin
speisen	speisen
Kunstgeschichte	Kunstgeschichte
Abschirmungen	Abschirmungen
Bote	Bote
liege	liege
Schuldner	Schuldner
Höhe	Höhe
schweiget	schweiget
Mops	Mops
verschmelzen	verschmelzen
Teilnehmerin	Teilnehmerin
rüstetet	rüstetet
Selbstversuche	Selbstversuche
Nussknackern	Nussknackern
versüßtet	versüßtet
abalienierest	abalienierest
entschleiert	entschleiert
Aha-Erlebnis	Aha-Erlebnis
käbbelte	käbbelte
Fußboden	Fußboden
tattre	tattre
Bienenzüchter	Bienenzüchter
Sekretärinnen	Sekretärinnen
offenbare	offenbare
Renegaten	Renegaten
häufe	häufe
ärgerst	ärgerst
Anzeichens	Anzeichens
Pflicht	Pflicht
besprichst	besprichst
Lunisolarkalender	Lunisolarkalender
Selbstversuch	Selbstversuch
Domänen	Domänen
fabuliert	fabuliert
zupfte	zupfte
eins	eins
Abschreckungen	Abschreckungen
Gefäßen	Gefäßen
kämpfen	kämpfen
habe	habe
interpretierten	interpretierten
beweisen	beweisen
Bären	Bären
zweifeln	zweifeln
Ausbeutern	Ausbeutern
Meine	Meine
spezialisierst	spezialisierst
predige	predige
spekuliere	spekuliere
glühenden	glühenden
eroberte	eroberte
griechischen	griechischen
nützt	nützt
Ängste	Ängste
gewinne	gewinne
Beryll	Beryll
suchest	suchest
Finanzministern	Finanzministern
stutzt	stutzt
heiß	heiß
formiret	formiret
moppte	moppte
brillieren	brillieren
Abschußring	Abschußring
Kohlenstoffgehalt	Kohlenstoffgehalt
Marjellchens	Marjellchens
labe	labe
entwaffneten	entwaffneten
zerbrechen	zerbrechen
Ebenen	Ebenen
brecht	brecht
verschlingt	verschlingt
beschlaget	beschlaget
Glühwürmchen	Glühwürmchen
Sonnenfinsternissen	Sonnenfinsternissen
gedolmetscht	gedolmetscht
Beteiligte	Beteiligte
werde	werde
deine	deine
verschärfst	verschärfst
Signalen	Signalen
glänzte	glänzte
chloroformieret	chloroformieret
Licht	Licht
Weiblein	Weiblein
erwärmet	erwärmet
flambiert	flambiert
lauten	lauten
Prügelstrafen	Prügelstrafen
erkälteten	erkälteten
schützt	schützt
Almanachen	Almanachen
saht	saht
Biene	Biene
plissierten	plissierten
begnügte	begnügte
Weh	Weh
Geflecktheit	Geflecktheit
rüstetest	rüstetest
funktionierte	funktionierte
verschicket	verschicket
ausgerecktem	ausgerecktem
grübelt	grübelt
fette	fette
einen	einen
Gässchen	Gässchen
Buchhalterinnen	Buchhalterinnen
Reflexionen	Reflexionen
stillte	stillte
schreibst	schreibst
Abbild	Abbild
Gefäße	Gefäße
desertierst	desertierst
Mensch	Mensch
untersagtest	untersagtest
Regiert	Regiert
Münzsammlungen	Münzsammlungen
verkündigst	verkündigst
solchem	solchem
besprachen	besprachen
besinnen	besinnen
glaubten	glaubten
Werdet	Werdet
Aller	Aller
Aufsätzen	Aufsätzen
assimilierte	assimilierte
gelobt	gelobt
Chlorwasserstoffmolekül	Chlorwasserstoffmolekül
Böreks	Böreks
Öfchens	Öfchens
aufnahmen	aufnahmen
bedrücktest	bedrücktest
urteilte	urteilte
schaust	schaust
verbrauchten	verbrauchten
verwirkliche	verwirkliche
Kassiteriten	Kassiteriten
verifizieret	verifizieret
Plumpse	Plumpse
ernteten	ernteten
Galeere	Galeere
backt	backt
eggt	eggt
Erzherzogshüte	Erzherzogshüte
deaktivierst	deaktivierst
Massage	Massage
concessioniert	concessioniert
Sagte	Sagte
Zahnfleischentzündungen	Zahnfleischentzündungen
Leugnungen	Leugnungen
entert	entert
verbaselt	verbaselt
hebst	hebst
dissentierte	dissentierte
Reinigungsschrittes	Reinigungsschrittes
formirend	formirend
Schreiber	Schreiber
beweise	beweise
Bergsteiger	Bergsteiger
sticke	sticke
bereitend	bereitend
zerbräche	zerbräche
Färsen	Färsen
Überziehen	Überziehen
zuhörte	zuhörte
weichest	weichest
entwickele	entwickele
entrümpelest	entrümpelest
Dolde	Dolde
bitte	bitte
stammeln	stammeln
schneidend	schneidend
desertiertet	desertiertet
Buchhalterin	Buchhalterin
mehret	mehret
torpedieret	torpedieret
glaubest	glaubest
Monaten	Monaten
wässerst	wässerst
zentrifugierst	zentrifugierst
Schaffet	Schaffet
knutschst	knutschst
Schwebfliegen	Schwebfliegen
wälzet	wälzet
verhalte	verhalte
hobt	hobt
Abschirmung	Abschirmung
Anfänger	Anfänger
Kannen	Kannen
halt	halt
Massenarbeitslosigkeit	Massenarbeitslosigkeit
offenbar	offenbar
Taschenwörterbuch	Taschenwörterbuch
Achseln	Achseln
Pianos	Pianos
gebäre	gebäre
kichern	kichern
heiligem	heiligem
vor	vor
glaubet	glaubet
verantwortetest	verantwortetest
Flamen	Flamen
Testamenten	Testamenten
bollerest	bollerest
dürfe	dürfe
ziehet	ziehet
bequemtet	bequemtet
aufsteht	aufsteht
bummeltet	bummeltet
Gesetzen	Gesetzen
Brauhaus	Brauhaus
Werken	Werken
verachtend	verachtend
ertragen	ertragen
downloadet	downloadet
schleim	schleim
Seine	Seine
Galopps	Galopps
stärke	stärke
koexistierten	koexistierten
verallgemeinerst	verallgemeinerst
Fragen	Fragen
machst	machst
applizirst	applizirst
Videoaufzeichnungen	Videoaufzeichnungen
überweis	überweis
abzieht	abzieht
sagst	sagst
gefügt	gefügt
Rasterkraftmikroskop	Rasterkraftmikroskop
ringen	ringen
holte	holte
destabilisierst	destabilisierst
besänftiget	besänftiget
schaute	schaute
protokollierst	protokollierst
überführt	überführt
Klaue	Klaue
Meerschweinchen	Meerschweinchen
Kaktusfeige	Kaktusfeige
Linie	Linie
Kerzenfischen	Kerzenfischen
Mutagenen	Mutagenen
Gespenstern	Gespenstern
seien	seien
Hektare	Hektare
zürn	zürn
leid	leid
Gewicht	Gewicht
Orgel	Orgel
Magiern	Magiern
klicket	klicket
segmentierten	segmentierten
Friesen	Friesen
verkauft	verkauft
Gebeine	Gebeine
habet	habet
Freunden	Freunden
Frommen	Frommen
überlieferten	überlieferten
Bürzel	Bürzel
Blumenstrauß	Blumenstrauß
blitzet	blitzet
halte	halte
posierten	posierten
Barbareien	Barbareien
hydrogentartrate	hydrogentartrate
Falz	Falz
Höschens	Höschens
beschlügen	beschlügen
polymerisierte	polymerisierte
Apostel	Apostel
türmen	türmen
Hinkelsteine	Hinkelsteine
Apfelbäumen	Apfelbäumen
Senkung	Senkung
Halbzeit	Halbzeit
Rast	Rast
assimilieret	assimilieret
Halte	Halte
Europameisters	Europameisters
jappten	jappten
gähnten	gähnten
Bleiglanz	Bleiglanz
Jungfernflug	Jungfernflug
lügst	lügst
Gefilde	Gefilde
linken	linken
schlängelt	schlängelt
anzeigest	anzeigest
Erzeugung	Erzeugung
Schafe	Schafe
unterbrächen	unterbrächen
verkürzest	verkürzest
versagen	versagen
feire	feire
fliehe	fliehe
vermag	vermag
hinterzöge	hinterzöge
umgäben	umgäben
produzierte	produzierte
bewahrst	bewahrst
Plumpsen	Plumpsen
einernten	einernten
revoltieren	revoltieren
separieren	separieren
Gehorsams	Gehorsams
fresse	fresse
Besteck	Besteck
Germanist	Germanist
Druckfehler	Druckfehler
referenzierte	referenzierte
Strahlentierchen	Strahlentierchen
Stühlen	Stühlen
Türmen	Türmen
Meinem	Meinem
Gebirgen	Gebirgen
Fußmatten	Fußmatten
Ranzigkeit	Ranzigkeit
Ringeltaube	Ringeltaube
sedimentierte	sedimentierte
Apfelbäume	Apfelbäume
verglichest	verglichest
Polierstahl	Polierstahl
Referenzen	Referenzen
Früchtchen	Früchtchen
Dürren	Dürren
Spieße	Spieße
sorge	sorge
faul	faul
heißt	heißt
zuppst	zuppst
hättet	hättet
durchwachen	durchwachen
Testamente	Testamente
Wille	Wille
Hochsommer	Hochsommer
begehrtet	begehrtet
reinstitutionalisiert	reinstitutionalisiert
verweise	verweise
Gehör	Gehör
Gut	Gut
Pfleglinge	Pfleglinge
Leid	Leid
zwölften	zwölften
Haue	Haue
Keile	Keile
Leuchtstoffen	Leuchtstoffen
Graben	Graben
bemühet	bemühet
austilge	austilge
strafest	strafest
Hehlern	Hehlern
verkröchet	verkröchet
ruhest	ruhest
nahest	nahest
zerstreust	zerstreust
erfahrest	erfahrest
Safran	Safran
Lazarette	Lazarette
Kupferkiesen	Kupferkiesen
säst	säst
Herbstwinden	Herbstwinden
Angabe	Angabe
Fluorgehalt	Fluorgehalt
versüße	versüße
hängte	hängte
Notärztin	Notärztin
Mönche	Mönche
aufkämen	aufkämen
erlöset	erlöset
ramme	ramme
fragte	fragte
Haltepunkt	Haltepunkt
Suffixen	Suffixen
Staatsanleihe	Staatsanleihe
liebte	liebte
zuppe	zuppe
werdet	werdet
mischt	mischt
wehen	wehen
Mitwisserschaft	Mitwisserschaft
Füllfeder	Füllfeder
Emmer	Emmer
explodierten	explodierten
Blitzableiter	Blitzableiter
Binde	Binde
zerstückte	zerstückte
verziehen	verziehen
bebten	bebten
unserem	unserem
stiften	stiften
observiertest	observiertest
Katamaran	Katamaran
gehorchest	gehorchest
linstest	linstest
Biokraftstoffes	Biokraftstoffes
zankte	zankte
überschattete	überschattete
streite	streite
amenagier	amenagier
Drachenblut	Drachenblut
Dezernaten	Dezernaten
reglementierte	reglementierte
verforme	verforme
widerlegest	widerlegest
mikrominiaturisierten	mikrominiaturisierten
klönen	klönen
Milchflaschen	Milchflaschen
absolviere	absolviere
fallet	fallet
plagen	plagen
Dorsche	Dorsche
