huggen	huggen
kulturlivs	kulturlivs
läggen	läggen
raggmunk	raggmunk
antänd	antänd
förundran	förundran
avla	avla
platås	platås
pluskvamperfekt	pluskvamperfekt
justeras	justeras
blattarna	blattarna
inviga	inviga
förökades	förökades
Lus	Lus
twittra	twittra
inspekterat	inspekterat
nattduksbordets	nattduksbordets
åter	åter
utbuden	utbuden
såld	såld
ambassadsekreterarnas	ambassadsekreterarnas
ring	ring
ögonhålornas	ögonhålornas
göda	göda
frälsa	frälsa
chilenarens	chilenarens
brännande	brännande
återlämnats	återlämnats
nagellacker	nagellacker
landstingsdirektörens	landstingsdirektörens
rastade	rastade
förstes	förstes
handläggas	handläggas
klämdag	klämdag
dragna	dragna
utfärdat	utfärdat
brandväggar	brandväggar
regleringsbrev	regleringsbrev
funno	funno
korsförhörens	korsförhörens
knyte	knyte
väckes	väckes
hjälpa	hjälpa
gileadit	gileadit
bildordboken	bildordboken
tröghet	tröghet
kruciverbisten	kruciverbisten
slickepinnar	slickepinnar
Ett	Ett
krullparentesens	krullparentesens
gömda	gömda
eftersträvas	eftersträvas
fågelskådares	fågelskådares
uppgiva	uppgiva
lugg	lugg
anklagades	anklagades
tågas	tågas
behövs	behövs
alkoholism	alkoholism
moder	moder
förspel	förspel
malen	malen
Vilken	Vilken
förlike	förlike
stänga	stänga
slösade	slösade
skottdagen	skottdagen
vedergälle	vedergälle
brunbjörnar	brunbjörnar
frossare	frossare
anföra	anföra
veta	veta
stjälen	stjälen
oboerna	oboerna
pubarna	pubarna
framstegen	framstegen
spridde	spridde
snökedja	snökedja
landstingsdirektören	landstingsdirektören
rörde	rörde
Jerusalems	Jerusalems
spenderas	spenderas
utsträcka	utsträcka
förödande	förödande
droge	droge
koffert	koffert
avbildande	avbildande
pudel	pudel
komme	komme
korsfästa	korsfästa
vårdkasarna	vårdkasarna
kommunicera	kommunicera
lamans	lamans
såpbubblorna	såpbubblorna
utsträckt	utsträckt
vida	vida
fritös	fritös
äppelmos	äppelmos
vidlyftig	vidlyftig
äte	äte
lärt	lärt
västlig	västlig
dukades	dukades
Nea	Nea
fagotts	fagotts
flunsornas	flunsornas
koncentrationer	koncentrationer
sökas	sökas
trigonometrin	trigonometrin
bit	bit
Vilket	Vilket
havererade	havererade
dörjade	dörjade
upphäver	upphäver
ungkarlens	ungkarlens
retirerat	retirerat
konservburkars	konservburkars
använda	använda
Ande	Ande
gemaket	gemaket
kraftkabels	kraftkabels
församlas	församlas
ripjaktens	ripjaktens
minne	minne
polera	polera
hyresvärd	hyresvärd
holländska	holländska
provisorierna	provisorierna
sänd	sänd
göras	göras
snärjas	snärjas
droppen	droppen
ändligdimensionellt	ändligdimensionellt
Noa	Noa
fördärven	fördärven
förstöra	förstöra
övergive	övergive
bröade	bröade
utför	utför
gladd	gladd
tyngste	tyngste
transaktionerna	transaktionerna
avlägsnas	avlägsnas
slickepinnen	slickepinnen
anglicism	anglicism
lönnmördas	lönnmördas
haverera	haverera
etiketterna	etiketterna
betänka	betänka
armen	armen
föden	föden
transaktioner	transaktioner
förkunnare	förkunnare
kombinerande	kombinerande
ispravniken	ispravniken
kokas	kokas
tålmodiga	tålmodiga
joniske	joniske
bovs	bovs
Fallen	Fallen
brassat	brassat
syrgasen	syrgasen
förgjorde	förgjorde
deklarerar	deklarerar
altruisternas	altruisternas
sons	sons
Kabul	Kabul
presenningen	presenningen
minska	minska
mittpunkten	mittpunkten
nitälskan	nitälskan
stärkt	stärkt
hölje	hölje
lägsta	lägsta
prissummas	prissummas
handläggare	handläggare
kronologiska	kronologiska
sedeslöshetens	sedeslöshetens
sålda	sålda
huvars	huvars
sädesledarens	sädesledarens
Ingen	Ingen
dalarna	dalarna
give	give
skrivare	skrivare
inramningen	inramningen
linjekartor	linjekartor
terroriserande	terroriserande
äggulans	äggulans
spännen	spännen
fästena	fästena
giva	giva
fångenskaps	fångenskaps
korsfästande	korsfästande
förunnade	förunnade
dirigistiske	dirigistiske
brännes	brännes
oxe	oxe
födas	födas
skyhöge	skyhöge
frisörens	frisörens
löjtnanten	löjtnanten
nyktre	nyktre
dominikaners	dominikaners
licentiats	licentiats
lösare	lösare
våte	våte
nyårsaftons	nyårsaftons
fiskades	fiskades
basketbollarnas	basketbollarnas
gångjärnens	gångjärnens
vis	vis
modet	modet
förtrycken	förtrycken
upphöja	upphöja
ansade	ansade
långtradaren	långtradaren
fackverket	fackverket
förtryckts	förtryckts
gräslökens	gräslökens
flygas	flygas
årtusendena	årtusendena
drage	drage
handläggares	handläggares
tungas	tungas
pennvässares	pennvässares
stoderna	stoderna
förkortningens	förkortningens
pärms	pärms
5-öringens	5-öringens
fiskade	fiskade
offrade	offrade
fattat	fattat
öppnas	öppnas
låta	låta
värdemängds	värdemängds
bergfinken	bergfinken
döma	döma
fjortondel	fjortondel
arkeologens	arkeologens
köpingens	köpingens
delat	delat
utbytena	utbytena
knackas	knackas
besiktigades	besiktigades
skotskt	skotskt
förkunnat	förkunnat
gårdsplaner	gårdsplaner
tjäna	tjäna
våldsverkarna	våldsverkarna
trombs	trombs
traditionelle	traditionelle
vilka	vilka
stjäl	stjäl
rättfärdigas	rättfärdigas
saker	saker
bronsmedalj	bronsmedalj
asbestens	asbestens
förflyttningar	förflyttningar
vises	vises
utgörande	utgörande
kämpad	kämpad
marinbiologis	marinbiologis
massförstörelsevapen	massförstörelsevapen
antydde	antydde
limpans	limpans
enslinjerna	enslinjerna
Asa	Asa
cellulosanitrat	cellulosanitrat
bridge	bridge
örlogsskolor	örlogsskolor
ondast	ondast
kolgruvan	kolgruvan
konfigurera	konfigurera
mörker	mörker
holonymens	holonymens
oscillations	oscillations
akvarellmålare	akvarellmålare
bastet	bastet
preciserade	preciserade
byråkratiske	byråkratiske
täckt	täckt
vakade	vakade
drogs	drogs
upptäckte	upptäckte
indiskorna	indiskorna
raggarna	raggarna
ackumuleras	ackumuleras
vållade	vållade
upplagens	upplagens
kantrad	kantrad
eds	eds
konvojers	konvojers
släkterna	släkterna
tvillingars	tvillingars
upptänd	upptänd
givare	givare
refererande	refererande
ända	ända
domänerna	domänerna
äggulor	äggulor
batteriholken	batteriholken
punktlistan	punktlistan
Abimelek	Abimelek
gripna	gripna
framsteg	framsteg
noggranne	noggranne
regleringsbrevets	regleringsbrevets
livstiders	livstiders
kosta	kosta
peruans	peruans
utrotade	utrotade
Bosra	Bosra
ögonhålas	ögonhålas
åklagande	åklagande
fingeravtrycks	fingeravtrycks
blottande	blottande
föra	föra
medelhavet	medelhavet
vålds	vålds
äppelträds	äppelträds
läroverk	läroverk
beaktandeledens	beaktandeledens
drängs	drängs
stickmyggor	stickmyggor
rodnat	rodnat
dementeras	dementeras
fiskmatens	fiskmatens
räkornas	räkornas
tillträda	tillträda
utbredde	utbredde
tegs	tegs
mötande	mötande
Arbas	Arbas
föreställ	föreställ
sörgårdsidyllen	sörgårdsidyllen
juicen	juicen
forskningsbiblioteks	forskningsbiblioteks
fras	fras
Ada	Ada
småländskas	småländskas
äppelträden	äppelträden
satt	satt
renas	renas
beaktandeleds	beaktandeleds
förtövande	förtövande
förtryckt	förtryckt
kommunikationers	kommunikationers
Om	Om
bronsmedaljs	bronsmedaljs
höghjulingarna	höghjulingarna
blidka	blidka
punktlista	punktlista
avgudens	avgudens
konsortiets	konsortiets
lur	lur
äldstes	äldstes
rättfärdiga	rättfärdiga
öra	öra
hjärtat	hjärtat
skuggade	skuggade
fördömen	fördömen
bast	bast
signalementet	signalementet
minimera	minimera
behöva	behöva
terrorismens	terrorismens
singlas	singlas
Jeriko	Jeriko
fästande	fästande
upplöser	upplöser
utgjordes	utgjordes
retronym	retronym
öppna	öppna
vätas	vätas
könsnorm	könsnorm
vandrade	vandrade
korna	korna
Dans	Dans
stärken	stärken
vattenkonsts	vattenkonsts
inträffa	inträffa
Jasons	Jasons
kela	kela
Jerusalem	Jerusalem
slakta	slakta
Geras	Geras
namnars	namnars
intellektuella	intellektuella
eldgaffel	eldgaffel
Beten	Beten
dödsfalls	dödsfalls
linslusar	linslusar
förra	förra
avlagde	avlagde
utvandrade	utvandrade
olivträdets	olivträdets
fyllda	fyllda
förste	förste
utkommen	utkommen
fiskare	fiskare
urladdningen	urladdningen
Joktans	Joktans
Balak	Balak
pärmars	pärmars
kvitterande	kvitterande
olla	olla
störtkrukors	störtkrukors
adelssläktens	adelssläktens
silverbägare	silverbägare
kvantifierar	kvantifierar
doktorsgraderna	doktorsgraderna
Melkisedeks	Melkisedeks
förbehåller	förbehåller
drogerna	drogerna
kolvätets	kolvätets
senare	senare
drängen	drängen
hämma	hämma
Meriba	Meriba
retsticka	retsticka
byta	byta
pråmars	pråmars
äppelträdet	äppelträdet
kilarna	kilarna
uppvärmning	uppvärmning
länder	länder
sårade	sårade
kontrabas	kontrabas
komikers	komikers
X-kromosomens	X-kromosomens
restaurerar	restaurerar
leva	leva
flata	flata
kontextuelle	kontextuelle
förras	förras
sänt	sänt
Judeen	Judeen
grymme	grymme
bilagornas	bilagornas
förändrade	förändrade
uppställde	uppställde
hitlistornas	hitlistornas
dubbelmacka	dubbelmacka
begynde	begynde
dropp	dropp
förändrat	förändrat
ryggsims	ryggsims
resurskrävande	resurskrävande
blottats	blottats
underskattat	underskattat
ungdomsförbundet	ungdomsförbundet
ljudlöse	ljudlöse
slickepinnens	slickepinnens
åtalar	åtalar
egyptierna	egyptierna
tävlingsbana	tävlingsbana
besegra	besegra
infiltreras	infiltreras
fegisars	fegisars
Bosras	Bosras
rastades	rastades
mala	mala
vinklande	vinklande
teros	teros
federationer	federationer
slipas	slipas
klövens	klövens
blottar	blottar
blotten	blotten
korsordet	korsordet
konvoluts	konvoluts
tänkte	tänkte
ambassadsekreterare	ambassadsekreterare
sköter	sköter
livstids	livstids
qvald	qvald
lagade	lagade
färgat	färgat
seendes	seendes
sudda	sudda
altruisters	altruisters
diskuteras	diskuteras
förordnandet	förordnandet
spejare	spejare
disponeras	disponeras
hemsöka	hemsöka
galningarna	galningarna
gestaltningars	gestaltningars
eolsharpor	eolsharpor
Dessa	Dessa
händelsehorisonten	händelsehorisonten
årtusendes	årtusendes
smältes	smältes
mysteriums	mysteriums
brandväggarnas	brandväggarnas
åskvädrens	åskvädrens
tremänningarna	tremänningarna
veten	veten
Bela	Bela
muggen	muggen
svensexorna	svensexorna
uträcka	uträcka
beställde	beställde
citronsyran	citronsyran
Husen	Husen
föräldralösa	föräldralösa
pluskvamperfekten	pluskvamperfekten
smida	smida
vittnesbördets	vittnesbördets
förtäre	förtäre
sjöslagen	sjöslagen
vilken	vilken
Abram	Abram
klistrande	klistrande
överdragen	överdragen
tågade	tågade
prissumman	prissumman
konvojens	konvojens
allegorier	allegorier
historisk	historisk
vätt	vätt
betänken	betänken
ockupationen	ockupationen
vid	vid
råder	råder
datavetenskapens	datavetenskapens
inrättande	inrättande
gripen	gripen
fruktade	fruktade
återbesöken	återbesöken
besatte	besatte
böjd	böjd
smide	smide
tålmodigt	tålmodigt
förlåta	förlåta
spridd	spridd
givandet	givandet
uppförd	uppförd
friat	friat
flunsors	flunsors
additionens	additionens
formas	formas
glåporden	glåporden
bältena	bältena
upptäcktsresa	upptäcktsresa
filter	filter
utbredda	utbredda
själva	själva
söks	söks
båda	båda
förgjordes	förgjordes
kommande	kommande
dal	dal
anlöpte	anlöpte
brunne	brunne
uppgivna	uppgivna
tromb	tromb
samlades	samlades
invigen	invigen
fördelaktiga	fördelaktiga
Ögat	Ögat
sjungits	sjungits
assisterad	assisterad
värma	värma
befordran	befordran
kokades	kokades
önskningarna	önskningarna
kommuteras	kommuteras
femörings	femörings
Amons	Amons
saltstången	saltstången
mopps	mopps
bevarades	bevarades
pagens	pagens
depå	depå
porträtterade	porträtterade
elektronhjärnorna	elektronhjärnorna
springa	springa
skånks	skånks
Joktan	Joktan
förmörka	förmörka
förströdde	förströdde
svavelstickan	svavelstickan
förfors	förfors
konservburks	konservburks
preliminäre	preliminäre
falsifierad	falsifierad
provocerats	provocerats
Adas	Adas
ungdomsförbund	ungdomsförbund
tunga	tunga
låga	låga
Gera	Gera
efterfölja	efterfölja
fallera	fallera
bromsade	bromsade
beröms	beröms
gena	gena
tryckte	tryckte
sökte	sökte
blottas	blottas
överser	överser
laga	laga
cerebrospinalvätskans	cerebrospinalvätskans
kolumnbredd	kolumnbredd
omnämnandes	omnämnandes
uttagning	uttagning
fylla	fylla
kläckt	kläckt
långstrumpas	långstrumpas
kulsprutorna	kulsprutorna
anglicismen	anglicismen
biträde	biträde
försonats	försonats
epitets	epitets
uträckte	uträckte
viktige	viktige
accenterna	accenterna
fackverk	fackverk
väckas	väckas
spisoffrets	spisoffrets
graverar	graverar
betryckta	betryckta
Nebos	Nebos
redaktionssekreteraren	redaktionssekreteraren
agade	agade
deklarera	deklarera
glåpords	glåpords
vägrade	vägrade
bestämmande	bestämmande
Nebajot	Nebajot
visars	visars
panteisters	panteisters
svågrars	svågrars
bräderna	bräderna
flyttats	flyttats
abonnemangsavgifts	abonnemangsavgifts
längtan	längtan
Elia	Elia
bokriserna	bokriserna
begrundas	begrundas
slangordets	slangordets
konverterades	konverterades
fyllt	fyllt
upphävdes	upphävdes
sträcka	sträcka
tvilling	tvilling
kombinerar	kombinerar
böjs	böjs
uträcker	uträcker
kines	kines
jordskredet	jordskredet
kaoset	kaoset
kvällstidnings	kvällstidnings
bombarderats	bombarderats
linjekartans	linjekartans
ruinera	ruinera
störes	störes
förmörkas	förmörkas
könskromosom	könskromosom
Öga	Öga
inrättat	inrättat
kvantiteter	kvantiteter
frukte	frukte
kläda	kläda
bytas	bytas
upplöst	upplöst
arresterar	arresterar
tunnbrödsrullen	tunnbrödsrullen
friköpt	friköpt
året	året
brus	brus
länderna	länderna
graverad	graverad
förutsatt	förutsatt
beställningsarbete	beställningsarbete
Jakobs	Jakobs
indiskans	indiskans
örtagård	örtagård
verkligheten	verkligheten
stadsstadgornas	stadsstadgornas
begravde	begravde
tysthetens	tysthetens
talar	talar
Hulda	Hulda
lovar	lovar
Lots	Lots
mårkor	mårkor
tyristorerna	tyristorerna
duka	duka
bastat	bastat
fagott	fagott
bunden	bunden
stört	stört
uteslöts	uteslöts
Abimeleks	Abimeleks
lös	lös
upplys	upplys
golfklubbs	golfklubbs
pub	pub
upplösas	upplösas
blöte	blöte
byttan	byttan
cykloheptanets	cykloheptanets
upptändes	upptändes
diss	diss
kolgruvors	kolgruvors
guldfiskarna	guldfiskarna
erinrade	erinrade
luffarnas	luffarnas
befästas	befästas
underavdelningarnas	underavdelningarnas
värme	värme
öppnande	öppnande
korskrankens	korskrankens
förvaltare	förvaltare
sitt	sitt
pingis	pingis
förgäte	förgäte
Saul	Saul
kroppsvätskors	kroppsvätskors
rökrutor	rökrutor
polarforsknings	polarforsknings
hjälpsamma	hjälpsamma
ställa	ställa
förkortningarna	förkortningarna
julaftnarnas	julaftnarnas
övergiva	övergiva
derivatorna	derivatorna
fotgängarna	fotgängarna
samfund	samfund
homofons	homofons
lövträdet	lövträdet
överblickas	överblickas
döpt	döpt
nyponen	nyponen
slutlige	slutlige
cerebrospinalvätska	cerebrospinalvätska
talades	talades
upphöjde	upphöjde
vilde	vilde
murarens	murarens
huggna	huggna
tennislag	tennislag
jordbävnings	jordbävnings
Taga	Taga
kokar	kokar
Jo	Jo
knarka	knarka
transporterande	transporterande
egyptologis	egyptologis
svängande	svängande
masochists	masochists
blattes	blattes
korniskan	korniskan
förvånas	förvånas
translationer	translationer
Diana	Diana
felfortplantningen	felfortplantningen
hålles	hålles
Ain	Ain
rörande	rörande
utplånades	utplånades
förehaves	förehaves
utrote	utrote
pärlugglor	pärlugglor
översikt	översikt
ledarsidorna	ledarsidorna
kramade	kramade
datavetenskap	datavetenskap
patrullerar	patrullerar
Beta	Beta
förtära	förtära
barntås	barntås
arkiverad	arkiverad
torts	torts
kända	kända
Simons	Simons
barberad	barberad
musikinstruments	musikinstruments
återlämnande	återlämnande
ettstrukna	ettstrukna
notställens	notställens
ödmjuke	ödmjuke
givet	givet
travare	travare
flunsorna	flunsorna
mikroelektronikens	mikroelektronikens
lagstiftningar	lagstiftningar
följe	följe
Saras	Saras
snar	snar
tystades	tystades
blottat	blottat
stor	stor
mons	mons
anställs	anställs
Rehabeam	Rehabeam
traditionella	traditionella
renade	renade
fakultetsnämnden	fakultetsnämnden
länders	länders
nittondels	nittondels
arrendes	arrendes
förökade	förökade
Hebers	Hebers
förståndet	förståndet
Aras	Aras
upphöjda	upphöjda
besöka	besöka
historiska	historiska
gifta	gifta
älg	älg
jordskreds	jordskreds
åkerstycken	åkerstycken
markörerna	markörerna
stänkes	stänkes
släktes	släktes
kära	kära
fäst	fäst
svepande	svepande
albanskas	albanskas
ögonglobers	ögonglobers
ratas	ratas
än	än
dräpas	dräpas
anfalla	anfalla
binde	binde
upphandlingars	upphandlingars
sporde	sporde
ringare	ringare
fritösers	fritösers
hons	hons
lösa	lösa
droppat	droppat
kulturliv	kulturliv
fat	fat
vindhålets	vindhålets
uppbygges	uppbygges
förenklar	förenklar
bifloder	bifloder
deister	deister
ässets	ässets
plågade	plågade
gallerior	gallerior
utgöra	utgöra
sexhörningars	sexhörningars
gives	gives
konstarter	konstarter
kvitteras	kvitteras
davnad	davnad
funnes	funnes
lågt	lågt
qvadrats	qvadrats
benämnande	benämnande
sy	sy
arbetskamraterna	arbetskamraterna
tröstas	tröstas
snöres	snöres
butikskedjor	butikskedjor
inbärgar	inbärgar
fattade	fattade
stode	stode
Dianas	Dianas
fångenskapens	fångenskapens
handlade	handlade
kommutativ	kommutativ
kattdjur	kattdjur
vreden	vreden
hedersbetygelsens	hedersbetygelsens
cyklotroners	cyklotroners
Baal	Baal
massakern	massakern
ospontane	ospontane
sexpacket	sexpacket
gileaditer	gileaditer
gendrivande	gendrivande
Rahabs	Rahabs
svastikans	svastikans
hitlistas	hitlistas
jugoslaviskorna	jugoslaviskorna
vittnade	vittnade
förtrycka	förtrycka
Asaf	Asaf
märkt	märkt
vridande	vridande
närståendes	närståendes
Ais	Ais
rustningars	rustningars
tillkommelsens	tillkommelsens
bebodde	bebodde
gelés	gelés
tåga	tåga
bered	bered
bedrage	bedrage
villkor	villkor
avhärvlat	avhärvlat
avhärvlade	avhärvlade
oändligaste	oändligaste
Jerikos	Jerikos
prutten	prutten
bortkastade	bortkastade
terrorists	terrorists
Joab	Joab
omgiven	omgiven
förmörkades	förmörkades
rulltårtan	rulltårtan
prisade	prisade
faktisk	faktisk
renar	renar
bergochdalbanorna	bergochdalbanorna
värka	värka
dementerad	dementerad
bade	bade
atomfysikens	atomfysikens
borrar	borrar
Natans	Natans
bigamis	bigamis
förgiftad	förgiftad
getingarna	getingarna
Joabs	Joabs
Eder	Eder
buren	buren
insamlande	insamlande
anklaga	anklaga
ställd	ställd
tala	tala
nymånadsdagen	nymånadsdagen
bära	bära
anlete	anlete
statschefer	statschefer
bereds	bereds
släktens	släktens
vinylskivornas	vinylskivornas
rumäner	rumäner
utspelad	utspelad
hedersbetygelsen	hedersbetygelsen
bildrullens	bildrullens
trycka	trycka
drivas	drivas
förleda	förleda
ledarsidor	ledarsidor
doktriners	doktriners
förståndets	förståndets
uträckt	uträckt
mäter	mäter
förgätna	förgätna
utvalda	utvalda
slicke	slicke
längten	längten
kronprins	kronprins
halvimperialen	halvimperialen
metern	metern
krockars	krockars
väns	väns
arkivrådens	arkivrådens
mjölksyras	mjölksyras
oxideras	oxideras
förhindrats	förhindrats
blödd	blödd
malströmmar	malströmmar
värmebehandlar	värmebehandlar
vinylskiva	vinylskiva
Jedutun	Jedutun
hycklare	hycklare
fatte	fatte
dräps	dräps
anticyklonens	anticyklonens
embarkeringskort	embarkeringskort
juices	juices
modets	modets
hämtar	hämtar
Bekers	Bekers
valrossars	valrossars
rört	rört
krokodilen	krokodilen
beryll	beryll
Sauls	Sauls
bräde	bräde
Anaks	Anaks
bortförda	bortförda
kokat	kokat
modernast	modernast
felfortplantningarna	felfortplantningarna
fisket	fisket
minskade	minskade
korsfästs	korsfästs
utsändas	utsändas
beskyddare	beskyddare
citronsyrans	citronsyrans
applicera	applicera
låge	låge
spanjorens	spanjorens
Båda	Båda
såpbubblors	såpbubblors
accent	accent
dunstar	dunstar
Bileam	Bileam
oxens	oxens
förenklats	förenklats
bröar	bröar
stödstrumpans	stödstrumpans
siktades	siktades
rättfärdigade	rättfärdigade
antropologin	antropologin
dunstats	dunstats
maskuliner	maskuliner
rustningarnas	rustningarnas
tandvårdens	tandvårdens
rekommenderat	rekommenderat
hållplats	hållplats
kloner	kloner
sina	sina
rasmassa	rasmassa
stjäle	stjäle
tv:n	tv:n
hållen	hållen
förödda	förödda
nominerat	nominerat
bortrycktes	bortrycktes
nynorskans	nynorskans
uppfylles	uppfylles
anfangen	anfangen
bagatells	bagatells
brassas	brassas
täcka	täcka
manlige	manlige
blåhakarna	blåhakarna
skötet	skötet
baltiskt	baltiskt
göre	göre
Dennes	Dennes
betäck	betäck
budens	budens
relaterar	relaterar
blottade	blottade
essenserna	essenserna
förnimma	förnimma
täcktes	täcktes
träd	träd
uppfylls	uppfylls
Kain	Kain
Sem	Sem
bilfärjornas	bilfärjornas
bjudna	bjudna
stötas	stötas
bosatte	bosatte
beskäres	beskäres
kokt	kokt
anförare	anförare
sälja	sälja
kexet	kexet
fästa	fästa
chipspåsars	chipspåsars
spelpjäserna	spelpjäserna
utträdesarbete	utträdesarbete
försörjare	försörjare
översedd	översedd
möte	möte
utrotades	utrotades
börja	börja
skarpt	skarpt
ringmuskelns	ringmuskelns
skilde	skilde
marinbiologin	marinbiologin
överdragna	överdragna
regenter	regenter
Ana	Ana
ovanor	ovanor
judoutövares	judoutövares
snödroppens	snödroppens
rannsakade	rannsakade
plommons	plommons
säljes	säljes
åskväder	åskväder
dörjande	dörjande
upphöjt	upphöjt
ryggsäcken	ryggsäcken
hals	hals
döm	döm
omsluten	omsluten
naturvården	naturvården
upptäcks	upptäcks
höghjuling	höghjuling
justitiekanslerer	justitiekanslerer
nämnes	nämnes
rötterna	rötterna
krokodilers	krokodilers
befäst	befäst
borra	borra
sköte	sköte
köpare	köpare
knyta	knyta
täcke	täcke
reduktioners	reduktioners
penningkistorna	penningkistorna
rätt	rätt
förleder	förleder
gorillas	gorillas
koffertarna	koffertarna
bortkastad	bortkastad
förvånande	förvånande
före	före
Betuels	Betuels
preliminärskattens	preliminärskattens
antimaterian	antimaterian
pilspetsen	pilspetsen
defenestrerad	defenestrerad
vädurarna	vädurarna
kompletteras	kompletteras
ovanorna	ovanorna
namne	namne
antimaterias	antimaterias
bukar	bukar
matchs	matchs
halshugga	halshugga
anställa	anställa
Falla	Falla
tillgiva	tillgiva
trugad	trugad
tryckt	tryckt
brunbjörnarna	brunbjörnarna
avtagne	avtagne
viktiga	viktiga
sådant	sådant
förtärda	förtärda
tvaget	tvaget
fästes	fästes
Mahalalel	Mahalalel
nynorskan	nynorskan
läroverket	läroverket
legitimitetens	legitimitetens
rökrutas	rökrutas
Natan	Natan
kvantifierade	kvantifierade
oskadliggör	oskadliggör
frälsare	frälsare
löst	löst
modedockan	modedockan
mördade	mördade
indoktrineras	indoktrineras
interagerande	interagerande
Asafs	Asafs
Tro	Tro
sanerade	sanerade
förkunnar	förkunnar
bagateller	bagateller
rödhaken	rödhaken
gångjärn	gångjärn
överdomstolen	överdomstolen
tänke	tänke
uträcken	uträcken
stöttes	stöttes
signerade	signerade
följda	följda
förlåten	förlåten
gäsparna	gäsparna
sökt	sökt
undersöka	undersöka
Amon	Amon
sen	sen
rykte	rykte
gross	gross
granden	granden
tryckas	tryckas
lagats	lagats
argentinskorna	argentinskorna
sornas	sornas
samvetena	samvetena
kålrots	kålrots
bergfinkars	bergfinkars
Persiens	Persiens
möttes	möttes
stekt	stekt
Elias	Elias
betänkt	betänkt
upptagnast	upptagnast
isters	isters
malströmmarna	malströmmarna
bete	bete
kombineras	kombineras
borras	borras
blöt	blöt
uppröres	uppröres
essensers	essensers
restaurerades	restaurerades
strålblomma	strålblomma
ordlistors	ordlistors
mögs	mögs
flädermärgskulornas	flädermärgskulornas
släcka	släcka
nattduksbordet	nattduksbordet
ek	ek
kolonisters	kolonisters
kläckts	kläckts
tvillingar	tvillingar
a-kassornas	a-kassornas
klöven	klöven
åskådar	åskådar
clowneriet	clowneriet
anrättade	anrättade
offras	offras
tvivla	tvivla
skulptörs	skulptörs
sandas	sandas
Hebron	Hebron
förföljda	förföljda
döva	döva
respekterades	respekterades
specialtecken	specialtecken
väta	väta
såren	såren
sänts	sänts
räta	räta
uppbyggda	uppbyggda
upptages	upptages
skjuls	skjuls
bergochdalbanors	bergochdalbanors
givandets	givandets
anticyklons	anticyklons
blixtnedslagen	blixtnedslagen
kelar	kelar
hörn	hörn
glidytas	glidytas
Jona	Jona
inägorna	inägorna
utplåna	utplåna
formeln	formeln
Amminadabs	Amminadabs
mentorer	mentorer
extentor	extentor
blidkas	blidkas
passusens	passusens
förstörs	förstörs
säker	säker
lärda	lärda
inrätta	inrätta
stärkas	stärkas
anarkister	anarkister
psykologers	psykologers
leverera	leverera
anklagar	anklagar
mött	mött
hjorts	hjorts
sto	sto
knarkats	knarkats
dominerade	dominerade
meterna	meterna
tjeckiskans	tjeckiskans
nittondelar	nittondelar
hemsökt	hemsökt
hör	hör
musikliv	musikliv
studiet	studiet
spårade	spårade
spände	spände
kapitalisterna	kapitalisterna
dissekerat	dissekerat
anfangers	anfangers
finansmarknaderna	finansmarknaderna
skänke	skänke
valrossar	valrossar
årornas	årornas
pages	pages
bageriers	bageriers
enas	enas
läser	läser
asgarvar	asgarvar
skatbo	skatbo
tryckande	tryckande
intagen	intagen
omsnärjer	omsnärjer
kröner	kröner
snörens	snörens
polisbyråerna	polisbyråerna
saknas	saknas
olivträd	olivträd
infiltrerades	infiltrerades
intaga	intaga
vänd	vänd
utbudet	utbudet
homogena	homogena
borsten	borsten
tillgängliggörs	tillgängliggörs
svavelvätes	svavelvätes
ponerar	ponerar
berömts	berömts
samfunds	samfunds
filtren	filtren
embarkeringskortets	embarkeringskortets
tanzanier	tanzanier
draksegel	draksegel
Tre	Tre
påbuds	påbuds
svindel	svindel
glidyta	glidyta
Bered	Bered
nöjt	nöjt
yla	yla
trädstammen	trädstammen
grumlen	grumlen
tungt	tungt
massförstörelsevapens	massförstörelsevapens
filialens	filialens
homogene	homogene
Sisaks	Sisaks
bunde	bunde
agat	agat
slickepinnes	slickepinnes
vete	vete
läkare	läkare
syddes	syddes
beredda	beredda
inrikesministerium	inrikesministerium
lagstiftningens	lagstiftningens
byråassistents	byråassistents
var	var
brinna	brinna
Anak	Anak
tröstar	tröstar
kompilerats	kompilerats
år	år
debattörer	debattörer
spanjorerna	spanjorerna
Betuel	Betuel
enda	enda
duga	duga
kortslutas	kortslutas
kläcka	kläcka
minikjols	minikjols
munskänken	munskänken
ösregnens	ösregnens
bevarad	bevarad
tretalets	tretalets
höjningars	höjningars
jordreforms	jordreforms
åten	åten
rörmokaren	rörmokaren
verklighets	verklighets
lydelse	lydelse
Ars	Ars
källingen	källingen
killingarna	killingarna
dissekera	dissekera
gör	gör
sin	sin
lägga	lägga
vredes	vredes
födda	födda
förbytes	förbytes
såga	såga
äggula	äggula
snödroppe	snödroppe
mångas	mångas
glänsa	glänsa
Urias	Urias
denne	denne
memen	memen
mög	mög
tjugofemöringens	tjugofemöringens
sanera	sanera
fordrades	fordrades
förvånad	förvånad
ursprungskällas	ursprungskällas
saltstångs	saltstångs
hämnas	hämnas
ordnings	ordnings
inhägnade	inhägnade
centralafrikan	centralafrikan
drogens	drogens
sök	sök
hajande	hajande
matchen	matchen
närstående	närstående
göden	göden
betade	betade
anställda	anställda
Kedars	Kedars
lama	lama
segrar	segrar
blixtnedslaget	blixtnedslaget
uppfödd	uppfödd
arbetare	arbetare
upphöjd	upphöjd
polerar	polerar
höljets	höljets
värnpliktskongress	värnpliktskongress
lexikografiska	lexikografiska
vise	vise
slidans	slidans
klädd	klädd
annexet	annexet
vinrankans	vinrankans
manade	manade
presenning	presenning
gräslöken	gräslöken
krattors	krattors
nödgas	nödgas
arbetsveckorna	arbetsveckorna
betecknat	betecknat
uppställa	uppställa
utsträck	utsträck
kryptan	kryptan
utarmande	utarmande
betar	betar
Leviatans	Leviatans
läge	läge
tig	tig
åttiondelars	åttiondelars
borgarens	borgarens
värmebehandlat	värmebehandlat
bägarna	bägarna
befästa	befästa
kontrasterades	kontrasterades
åt	åt
mandatet	mandatet
förbytt	förbytt
Nebajots	Nebajots
stativ	stativ
sikte	sikte
ratificerades	ratificerades
gjutna	gjutna
beställda	beställda
vridas	vridas
frossa	frossa
lärde	lärde
tjäne	tjäne
sälj	sälj
hämmas	hämmas
fängelsehålans	fängelsehålans
åklagar	åklagar
bronsmedaljer	bronsmedaljer
rest	rest
reklamationen	reklamationen
grindarnas	grindarnas
mikrofonerna	mikrofonerna
åtgärdsbedömningar	åtgärdsbedömningar
uddarna	uddarna
naturvårds	naturvårds
förbehålla	förbehålla
energikälla	energikälla
vilddjurs	vilddjurs
församlade	församlade
epistel	epistel
förmörkade	förmörkade
atommassornas	atommassornas
bygges	bygges
Belas	Belas
cichlids	cichlids
brinnande	brinnande
tillgodogör	tillgodogör
spottade	spottade
provisoriets	provisoriets
åttondedelar	åttondedelar
komiker	komiker
förtrycker	förtrycker
nallens	nallens
attackerar	attackerar
klövs	klövs
snöret	snöret
utsläckes	utsläckes
upphöjen	upphöjen
aqvedukt	aqvedukt
piercingars	piercingars
lavs	lavs
känd	känd
tumnagel	tumnagel
Balaks	Balaks
tillkommelsen	tillkommelsen
emigreras	emigreras
gömmas	gömmas
duetterna	duetterna
nejets	nejets
grindarna	grindarna
gömma	gömma
skatbons	skatbons
förstörd	förstörd
älgar	älgar
dräpa	dräpa
förlite	förlite
besviken	besviken
dyrkande	dyrkande
rättvisans	rättvisans
vika	vika
färgad	färgad
ospontant	ospontant
fiskmaten	fiskmaten
bedraga	bedraga
lagen	lagen
ytterörats	ytterörats
driva	driva
alkoholismens	alkoholismens
badvädret	badvädret
förgöra	förgöra
No	No
förstöres	förstöres
ekar	ekar
given	given
bestänkt	bestänkt
lagades	lagades
dubbelklicket	dubbelklicket
rots	rots
vattenkannans	vattenkannans
suspensoarens	suspensoarens
bordat	bordat
nejs	nejs
partistyrelses	partistyrelses
kolväten	kolväten
lösen	lösen
tänker	tänker
blotta	blotta
smaragders	smaragders
vilt	vilt
blankstegs	blankstegs
antände	antände
säkrades	säkrades
vikt	vikt
fanfaronaders	fanfaronaders
dubbelklickar	dubbelklickar
bedrivet	bedrivet
mördare	mördare
racingbanors	racingbanors
brunnens	brunnens
tjugofemöringarna	tjugofemöringarna
huvens	huvens
äggulors	äggulors
X-kromosom	X-kromosom
bältets	bältets
mångfacetterade	mångfacetterade
fullbordade	fullbordade
repmånader	repmånader
fagottisterna	fagottisterna
ventilens	ventilens
departementssekreterarens	departementssekreterarens
lägg	lägg
fördöma	fördöma
bombarderades	bombarderades
lokaliserades	lokaliserades
bromspedal	bromspedal
stickmygga	stickmygga
sköts	sköts
återbesöket	återbesöket
ställt	ställt
Amminadab	Amminadab
beröm	beröm
varierades	varierades
utbjuda	utbjuda
vifta	vifta
flydda	flydda
snören	snören
köksöars	köksöars
tyristorer	tyristorer
fegisens	fegisens
förundrade	förundrade
inspekterades	inspekterades
Jonatans	Jonatans
utgjutes	utgjutes
sedvänja	sedvänja
bilagorna	bilagorna
barrskogar	barrskogar
docerande	docerande
avhålle	avhålle
eder	eder
indoktrinera	indoktrinera
stenas	stenas
funderades	funderades
determinanter	determinanter
kufarna	kufarna
rykande	rykande
räknestickans	räknestickans
framsäten	framsäten
bildrullars	bildrullars
nästen	nästen
svordomars	svordomars
sandades	sandades
Massa	Massa
befordrans	befordrans
stimulerat	stimulerat
ymnighetens	ymnighetens
röva	röva
förskräckes	förskräckes
förtryckare	förtryckare
träda	träda
ögonglobs	ögonglobs
koken	koken
äta	äta
flytt	flytt
utgjorde	utgjorde
censor	censor
studium	studium
ockupationers	ockupationers
Leviatan	Leviatan
förtäres	förtäres
dugande	dugande
räckt	räckt
bortförde	bortförde
tjänade	tjänade
samme	samme
udd	udd
provisoriers	provisoriers
förhandlar	förhandlar
saknade	saknade
påbudens	påbudens
smälte	smälte
törsta	törsta
ymnighets	ymnighets
gravvårdarnas	gravvårdarnas
attackeras	attackeras
anpassningars	anpassningars
stjärtars	stjärtars
Arba	Arba
fördelaktig	fördelaktig
undervattensbåtars	undervattensbåtars
expanderade	expanderade
bordläggande	bordläggande
flydde	flydde
getingars	getingars
snedstreck	snedstreck
uppenbarande	uppenbarande
kursfordrans	kursfordrans
behållna	behållna
ackuschören	ackuschören
blåhaken	blåhaken
skånken	skånken
homograferna	homograferna
fallerar	fallerar
gäckas	gäckas
åttondedelars	åttondedelars
volten	volten
hotfull	hotfull
Kabuls	Kabuls
Sara	Sara
formande	formande
kokande	kokande
lysande	lysande
kräftor	kräftor
vidhäftade	vidhäftade
kids	kids
vävstol	vävstol
sexpacks	sexpacks
bevisande	bevisande
församla	församla
bedragare	bedragare
nästes	nästes
odjuret	odjuret
selleri	selleri
lögnprofeternas	lögnprofeternas
avlat	avlat
systerson	systerson
byråassistenterna	byråassistenterna
förfrågans	förfrågans
anpassningar	anpassningar
vände	vände
hyllade	hyllade
kartografisk	kartografisk
spotten	spotten
silverbägarna	silverbägarna
firad	firad
badvädrets	badvädrets
indikerad	indikerad
bokmärken	bokmärken
släkten	släkten
Ned	Ned
visas	visas
fört	fört
halshuggande	halshuggande
ambassadsekreterares	ambassadsekreterares
drive	drive
arbetade	arbetade
zappade	zappade
låter	låter
förvånade	förvånade
roande	roande
webbplats	webbplats
mörka	mörka
oxiderande	oxiderande
överlever	överlever
dån	dån
absids	absids
mjölksyran	mjölksyran
slipat	slipat
vett	vett
anlöpta	anlöpta
laktosintolerant	laktosintolerant
murares	murares
medelhavs	medelhavs
Hanan	Hanan
förhindra	förhindra
behövande	behövande
Sered	Sered
spänna	spänna
blottades	blottades
korn	korn
uppenbara	uppenbara
härdsmältors	härdsmältors
vare	vare
skänka	skänka
judoutövaren	judoutövaren
Efrons	Efrons
egyptologins	egyptologins
handlägga	handlägga
kulsprutas	kulsprutas
gäckade	gäckade
förgjort	förgjort
åtalas	åtalas
upplåten	upplåten
vara	vara
näpst	näpst
rädd	rädd
vits	vits
synd	synd
åra	åra
Tres	Tres
förgätas	förgätas
återstodo	återstodo
munskänkar	munskänkar
köpt	köpt
hören	hören
potentiellt	potentiellt
förtvivlat	förtvivlat
Vilka	Vilka
preliminär	preliminär
svastikornas	svastikornas
nonan	nonan
mentor	mentor
omdefinierar	omdefinierar
Edom	Edom
beviset	beviset
nattklubb	nattklubb
begås	begås
kasten	kasten
lika	lika
ringas	ringas
altruistiskt	altruistiskt
det	det
enes	enes
förres	förres
lösaste	lösaste
libyerna	libyerna
kuf	kuf
mät	mät
infogade	infogade
stötte	stötte
anklagas	anklagas
raggare	raggare
krigarna	krigarna
höre	höre
duad	duad
kommunicerat	kommunicerat
stadsbibliotek	stadsbibliotek
skildes	skildes
kastades	kastades
världsmästaren	världsmästaren
terosens	terosens
affin	affin
bokriser	bokriser
snigel	snigel
lokaliserad	lokaliserad
drages	drages
minikjolars	minikjolars
resecheckars	resecheckars
man	man
utträdesarbetet	utträdesarbetet
passusar	passusar
halsbanden	halsbanden
debattören	debattören
gravvårdars	gravvårdars
vakansers	vakansers
kolonistens	kolonistens
slaktet	slaktet
sydnäktergalarna	sydnäktergalarna
knäveck	knäveck
magsmärta	magsmärta
stödstrumpors	stödstrumpors
kontrabasens	kontrabasens
tremänningen	tremänningen
utsträcker	utsträcker
ruinerande	ruinerande
uppväckt	uppväckt
blåmes	blåmes
bältes	bältes
Maas	Maas
jeeparna	jeeparna
utökades	utökades
surjektionens	surjektionens
läras	läras
vanära	vanära
skämtsamt	skämtsamt
uppmanande	uppmanande
cellulosanitrats	cellulosanitrats
Elis	Elis
villkoren	villkoren
byrådirektörernas	byrådirektörernas
berömde	berömde
väljares	väljares
rövade	rövade
utbytes	utbytes
altruistisk	altruistisk
anlöpas	anlöpas
kräftans	kräftans
överblickat	överblickat
säkrast	säkrast
betäckas	betäckas
amperena	amperena
eskimåernas	eskimåernas
smittskydd	smittskydd
kostande	kostande
statsrådsberedningars	statsrådsberedningars
Fourierseriens	Fourierseriens
penningkistor	penningkistor
ylande	ylande
råda	råda
killingar	killingar
kattdjuret	kattdjuret
beskrivningsspråken	beskrivningsspråken
vindhåls	vindhåls
kors	kors
Barn	Barn
upptagnare	upptagnare
homografens	homografens
rymdfysiks	rymdfysiks
Lemek	Lemek
asgarvande	asgarvande
avtaget	avtaget
Uria	Uria
duande	duande
indoktrinerings	indoktrinerings
seende	seende
eftersträvar	eftersträvar
bortryckta	bortryckta
bildsidor	bildsidor
avlägsna	avlägsna
sålde	sålde
upplag	upplag
bovarna	bovarna
byrådirektören	byrådirektören
rättshaverist	rättshaverist
holländsk	holländsk
röres	röres
lämpande	lämpande
uttalad	uttalad
mat	mat
Meleks	Meleks
förläts	förläts
stjärten	stjärten
Mas	Mas
bromspedalen	bromspedalen
utvaldas	utvaldas
tordes	tordes
gaffeln	gaffeln
spåra	spåra
institutionella	institutionella
dyrkade	dyrkade
polygonernas	polygonernas
Lemeks	Lemeks
undantaget	undantaget
Noas	Noas
svindeln	svindeln
underskriften	underskriften
clowneri	clowneri
nyanseras	nyanseras
halsband	halsband
koka	koka
rödhakars	rödhakars
trofasthet	trofasthet
lärkas	lärkas
omstruktureras	omstruktureras
tillredda	tillredda
vrida	vrida
dennas	dennas
Sjustjärnorna	Sjustjärnorna
jodens	jodens
sidensvansar	sidensvansar
libyer	libyer
Alls	Alls
butikskedja	butikskedja
barntårs	barntårs
stridsmedel	stridsmedel
bekräftade	bekräftade
justerande	justerande
doktorsexamens	doktorsexamens
ax	ax
utrikespolitiken	utrikespolitiken
anställd	anställd
inbärga	inbärga
vanärade	vanärade
kuddars	kuddars
gasta	gasta
säljs	säljs
spända	spända
läses	läses
Kains	Kains
rötmånadernas	rötmånadernas
vederkvicka	vederkvicka
förgöres	förgöres
mustens	mustens
höra	höra
flyttas	flyttas
åtgärdsbedömning	åtgärdsbedömning
fontäners	fontäners
tatuerarnas	tatuerarnas
fordra	fordra
hövdingdömet	hövdingdömet
undantagen	undantagen
mördande	mördande
slags	slags
utföre	utföre
Samaria	Samaria
väljarnas	väljarnas
sutenören	sutenören
Anatots	Anatots
hämnare	hämnare
tänkares	tänkares
förlikt	förlikt
Abida	Abida
nödgade	nödgade
platåerna	platåerna
äldste	äldste
departementschefers	departementschefers
värmen	värmen
krig	krig
lames	lames
altaret	altaret
tryckarna	tryckarna
vidhäftande	vidhäftande
varieras	varieras
landstingsråds	landstingsråds
ha	ha
Efron	Efron
gjutes	gjutes
Kemuels	Kemuels
knacka	knacka
pila	pila
Jedutuns	Jedutuns
lytt	lytt
vandren	vandren
upplösande	upplösande
förkunnades	förkunnades
försynens	försynens
besveks	besveks
söka	söka
vattna	vattna
utroten	utroten
hindarna	hindarna
murare	murare
spelpjäsen	spelpjäsen
läsen	läsen
fattades	fattades
skänk	skänk
potentielle	potentielle
plåga	plåga
förenar	förenar
distributive	distributive
Beker	Beker
De	De
bronsmedaljen	bronsmedaljen
syrgas	syrgas
participet	participet
determinant	determinant
minnes	minnes
dominikans	dominikans
interagera	interagera
ordstävets	ordstävets
uppfylle	uppfylle
tillhöra	tillhöra
barrträd	barrträd
frisörers	frisörers
sexpackets	sexpackets
kuddarna	kuddarna
mista	mista
kraftkabeln	kraftkabeln
hyresvärden	hyresvärden
departementssekreterare	departementssekreterare
rannsakas	rannsakas
krondiken	krondiken
sköta	sköta
spridda	spridda
uppförde	uppförde
citrusfrukters	citrusfrukters
sändande	sändande
visen	visen
elektronhjärnas	elektronhjärnas
gräten	gräten
bon	bon
vittna	vittna
skottdags	skottdags
örfilarna	örfilarna
förkastas	förkastas
comebackerna	comebackerna
lovade	lovade
blåst	blåst
täcken	täcken
fattar	fattar
Naftali	Naftali
dubbelklickets	dubbelklickets
ordningens	ordningens
transporterade	transporterade
omsluta	omsluta
muskedundren	muskedundren
Lea	Lea
påves	påves
ringfingret	ringfingret
Kedar	Kedar
grandets	grandets
pråmar	pråmar
defenestrerat	defenestrerat
sjudande	sjudande
vitsars	vitsars
kort	kort
bärare	bärare
kristadelfianernas	kristadelfianernas
spisoffret	spisoffret
institutionelle	institutionelle
ellipser	ellipser
blankstegen	blankstegen
betrycktas	betrycktas
kirrade	kirrade
Sisak	Sisak
grumlade	grumlade
departementschefens	departementschefens
ponerad	ponerad
rövar	rövar
prisen	prisen
förda	förda
stigen	stigen
krockarnas	krockarnas
nämna	nämna
öknamnens	öknamnens
spenderar	spenderar
maskros	maskros
agas	agas
vattnades	vattnades
kloridernas	kloridernas
ballongpelare	ballongpelare
rannsaken	rannsaken
palindroms	palindroms
jobbs	jobbs
ene	ene
glänsande	glänsande
bin	bin
sutenörens	sutenörens
blödas	blödas
byten	byten
uppväcka	uppväcka
fötterna	fötterna
försörja	försörja
ståndens	ståndens
cykelpumparna	cykelpumparna
skärvors	skärvors
klämdagar	klämdagar
kokosnötters	kokosnötters
nämnda	nämnda
slangordet	slangordet
ödmjuka	ödmjuka
initiativtagares	initiativtagares
anlöpt	anlöpt
fören	fören
badade	badade
sådana	sådana
davnas	davnas
marker	marker
anfallen	anfallen
påbudet	påbudet
handlägg	handlägg
agitatorns	agitatorns
konsortier	konsortier
twittrande	twittrande
bestämde	bestämde
kvaddar	kvaddar
mårkorna	mårkorna
barn	barn
plusteckens	plusteckens
golfklubbens	golfklubbens
sågade	sågade
utfärdades	utfärdades
porträtterad	porträtterad
grossen	grossen
handläggs	handläggs
renad	renad
föröke	föröke
barnbördshuset	barnbördshuset
bebott	bebott
krypta	krypta
Milka	Milka
affine	affine
skriftligt	skriftligt
annandagars	annandagars
Heber	Heber
pelare	pelare
draga	draga
ena	ena
stenat	stenat
preciserat	preciserat
uppenbaras	uppenbaras
rymdfysikens	rymdfysikens
arglistighet	arglistighet
anklagade	anklagade
anställas	anställas
svavelstickors	svavelstickors
upptage	upptage
vederkvickt	vederkvickt
kartografiska	kartografiska
resas	resas
falla	falla
underskrifts	underskrifts
Nilen	Nilen
stadsstadgan	stadsstadgan
absiderna	absiderna
Abels	Abels
förgätit	förgätit
spenderande	spenderande
rappande	rappande
lövträdets	lövträdets
linslusens	linslusens
vila	vila
säge	säge
varde	varde
påbuden	påbuden
basta	basta
använt	använt
licentiaten	licentiaten
förnimmande	förnimmande
korset	korset
ordlistor	ordlistor
niga	niga
uppfyller	uppfyller
ringe	ringe
retades	retades
ugglas	ugglas
springare	springare
omdefinierande	omdefinierande
släppe	släppe
morgonsoffas	morgonsoffas
tyglas	tyglas
terapeuts	terapeuts
assisterar	assisterar
beskriver	beskriver
ammade	ammade
odjurets	odjurets
sedens	sedens
koffertarnas	koffertarnas
uträckas	uträckas
sann	sann
monsuners	monsuners
omstrukturerades	omstrukturerades
drömma	drömma
höljas	höljas
ekobrott	ekobrott
kutad	kutad
Babels	Babels
försvunno	försvunno
åtnjutas	åtnjutas
tillträde	tillträde
hycklarnas	hycklarnas
mitokondriers	mitokondriers
stycke	stycke
tågats	tågats
kläder	kläder
debattörerna	debattörerna
sköten	sköten
trumpetare	trumpetare
misshandlas	misshandlas
genomslagets	genomslagets
undermenyernas	undermenyernas
ställde	ställde
nyårsaftonen	nyårsaftonen
galleriorna	galleriorna
budbärarna	budbärarna
slagares	slagares
uppföra	uppföra
cichliders	cichliders
trycker	trycker
särkarnas	särkarnas
vattenkonster	vattenkonster
hjälpare	hjälpare
webbplatser	webbplatser
existentielle	existentielle
vårdkasens	vårdkasens
trigonometri	trigonometri
kaktus	kaktus
masochisten	masochisten
Melkisedek	Melkisedek
förhärligen	förhärligen
stötande	stötande
sakerna	sakerna
lider	lider
bränns	bränns
klövarna	klövarna
beskärde	beskärde
bevis	bevis
beställs	beställs
flickvänner	flickvänner
förlett	förlett
kuddes	kuddes
homofoners	homofoners
expanderas	expanderas
dubbelmackorna	dubbelmackorna
busschaufförs	busschaufförs
radavståndets	radavståndets
återbesökets	återbesökets
skärva	skärva
fotoners	fotoners
trugat	trugat
slagverkaren	slagverkaren
mittpunkts	mittpunkts
singla	singla
utlysa	utlysa
planeras	planeras
Milkas	Milkas
kloriderna	kloriderna
Vare	Vare
ystats	ystats
arbetssättet	arbetssättet
annandagens	annandagens
dödsdagarna	dödsdagarna
framsäte	framsäte
fängelsehålorna	fängelsehålorna
åtnjuta	åtnjuta
överseende	överseende
säga	säga
förlika	förlika
ond	ond
löste	löste
nitälsken	nitälsken
vävstolens	vävstolens
moppen	moppen
rov	rov
beskyddarens	beskyddarens
kolumnbredder	kolumnbredder
gemak	gemak
upptagen	upptagen
anletes	anletes
konstartens	konstartens
utlyst	utlyst
duetts	duetts
fortfarande	fortfarande
uttagningars	uttagningars
kvantifiera	kvantifiera
skickade	skickade
Ai	Ai
fira	fira
näpna	näpna
vilddjur	vilddjur
redaktionssekreterarnas	redaktionssekreterarnas
stånd	stånd
efor	efor
sökts	sökts
örfilarnas	örfilarnas
uddens	uddens
småviltet	småviltet
sänds	sänds
skjul	skjul
Hans	Hans
luffarens	luffarens
korsord	korsord
tystande	tystande
satsar	satsar
Abrahams	Abrahams
löses	löses
möts	möts
ventilers	ventilers
bortförd	bortförd
Jason	Jason
röding	röding
intressera	intressera
örlogsskolas	örlogsskolas
göres	göres
uzbeks	uzbeks
höje	höje
tänkare	tänkare
förkunnas	förkunnas
dateras	dateras
uppfylla	uppfylla
Gats	Gats
våldsverkares	våldsverkares
svalka	svalka
dröjen	dröjen
Judeens	Judeens
fästens	fästens
kuddarnas	kuddarnas
förmörkat	förmörkat
intellektuellt	intellektuellt
finländaren	finländaren
bältens	bältens
kejsares	kejsares
världsmästarna	världsmästarna
anklagen	anklagen
morfism	morfism
kinesens	kinesens
ringa	ringa
borgen	borgen
stadgas	stadgas
surdegarna	surdegarna
sålden	sålden
behålla	behålla
mötas	mötas
villig	villig
klaffels	klaffels
beskära	beskära
fylld	fylld
uppfyllda	uppfyllda
modernt	modernt
arrestera	arrestera
förtryckes	förtryckes
arglistige	arglistige
lösande	lösande
specialtecknets	specialtecknets
adelssläkt	adelssläkt
beteckna	beteckna
dåd	dåd
åts	åts
kor	kor
trakasserat	trakasserat
begrundades	begrundades
kabinettssekreterare	kabinettssekreterare
fingeravtryckets	fingeravtryckets
kufen	kufen
Den	Den
bajskorvarna	bajskorvarna
ministeriers	ministeriers
bröas	bröas
skörten	skörten
förgör	förgör
embarkeringskortens	embarkeringskortens
doktorsgraders	doktorsgraders
pennvässare	pennvässare
utsändande	utsändande
mysterier	mysterier
skrinlägger	skrinlägger
oxidationstal	oxidationstal
insamlade	insamlade
bundna	bundna
friköpa	friköpa
bakgrundsstrålnings	bakgrundsstrålnings
antändande	antändande
utgiftstaken	utgiftstaken
besiktigas	besiktigas
bjudes	bjudes
näpsa	näpsa
höj	höj
Denna	Denna
utsträcks	utsträcks
urladdningars	urladdningars
sliten	sliten
chiffers	chiffers
såddes	såddes
mysande	mysande
kroppsvätskans	kroppsvätskans
fiskas	fiskas
Man	Man
inbärgen	inbärgen
upprörd	upprörd
affint	affint
räcken	räcken
assisterade	assisterade
dödsfallet	dödsfallet
efterföljare	efterföljare
pulver	pulver
önska	önska
kontrasterar	kontrasterar
gångar	gångar
daggkåpan	daggkåpan
fördärvet	fördärvet
hemsökes	hemsökes
borgare	borgare
palindromers	palindromers
städ	städ
hövdingdöme	hövdingdöme
prokrastinera	prokrastinera
citrusfrukten	citrusfrukten
dräpt	dräpt
påvars	påvars
förskräckt	förskräckt
kompletterade	kompletterade
dubbelklicka	dubbelklicka
vinge	vinge
nypon	nypon
stängda	stängda
spanjorers	spanjorers
Denne	Denne
jagad	jagad
fördraga	fördraga
akvarellmålares	akvarellmålares
sjungs	sjungs
förgiftade	förgiftade
gravitation	gravitation
rumänen	rumänen
afrikanskorna	afrikanskorna
hylla	hylla
lydelses	lydelses
begynt	begynt
musikallåt	musikallåt
blygas	blygas
vrede	vrede
anrättas	anrättas
ställda	ställda
marks	marks
narra	narra
rovs	rovs
afrikanskors	afrikanskors
driven	driven
utökas	utökas
genomslaget	genomslaget
elektriciteten	elektriciteten
hyresnämnden	hyresnämnden
grundämne	grundämne
marinbiologers	marinbiologers
täckts	täckts
ställen	ställen
frambär	frambär
dyrkad	dyrkad
årsfest	årsfest
kriteriet	kriteriet
ringar	ringar
ed	ed
magsmärtan	magsmärtan
packets	packets
finskors	finskors
Josefs	Josefs
bars	bars
sabbat	sabbat
inropen	inropen
uppfyll	uppfyll
Kemuel	Kemuel
vittnande	vittnande
snedstrecks	snedstrecks
tillhörande	tillhörande
begått	begått
slakt	slakt
ballonger	ballonger
lägge	lägge
piercings	piercings
emigrerade	emigrerade
fullborde	fullborde
mödade	mödade
egyptier	egyptier
graverades	graverades
vattenkannas	vattenkannas
beträda	beträda
löpa	löpa
arvedelar	arvedelar
fagottisten	fagottisten
småvilts	småvilts
förvarade	förvarade
steningar	steningar
förledets	förledets
förre	förre
fegis	fegis
kemikaliens	kemikaliens
underskattad	underskattad
papperskniv	papperskniv
lavarnas	lavarnas
minskar	minskar
manchesters	manchesters
svavelväte	svavelväte
automatiskt	automatiskt
återstod	återstod
användande	användande
tvillings	tvillings
förlitat	förlitat
kokade	kokade
filatelister	filatelister
domänens	domänens
tatuerares	tatuerares
qväljes	qväljes
morgonsofforna	morgonsofforna
orenen	orenen
mitokondries	mitokondries
kursfordran	kursfordran
könskromosomernas	könskromosomernas
nymånadsdag	nymånadsdag
släktena	släktena
allegorin	allegorin
lönnmördats	lönnmördats
trycks	trycks
fyllas	fyllas
stänka	stänka
hörda	hörda
dämpare	dämpare
forskningsbibliotek	forskningsbibliotek
hat	hat
utrikespolitiks	utrikespolitiks
holonym	holonym
omsnärjt	omsnärjt
gelé	gelé
femöring	femöring
cykelhandlaren	cykelhandlaren
lexikografisk	lexikografisk
rådande	rådande
meddelats	meddelats
lin	lin
50-öring	50-öring
skymmas	skymmas
simbassängernas	simbassängernas
barkas	barkas
räckas	räckas
diarieför	diarieför
förfölja	förfölja
Allas	Allas
förundren	förundren
Varde	Varde
utvandrande	utvandrande
korsfästes	korsfästes
snärjda	snärjda
redigeringskrigs	redigeringskrigs
konsekventa	konsekventa
doktrins	doktrins
omdefinierades	omdefinierades
pilsnerns	pilsnerns
förkunnen	förkunnen
fungerar	fungerar
odjur	odjur
vin	vin
Sereds	Sereds
efterfrågans	efterfrågans
svågern	svågern
mana	mana
kofferts	kofferts
hajade	hajade
resande	resande
skrymtarna	skrymtarna
Sadok	Sadok
sväng	sväng
västliga	västliga
retirera	retirera
konungadömens	konungadömens
undersökande	undersökande
korskrank	korskrank
fäste	fäste
ettstrukne	ettstrukne
dirigistiskt	dirigistiskt
förenklad	förenklad
atomfysik	atomfysik
blygs	blygs
galningen	galningen
ende	ende
radianer	radianer
cabbarna	cabbarna
överlevnaden	överlevnaden
signalement	signalement
kortslutande	kortslutande
flyttar	flyttar
livslängden	livslängden
uppväcken	uppväcken
cypriotiskas	cypriotiskas
protestera	protestera
bortfört	bortfört
förunne	förunne
leksakerna	leksakerna
såge	såge
misshandlade	misshandlade
HERRENs	HERRENs
fordrande	fordrande
krattorna	krattorna
isotoner	isotoner
koordinatsystemets	koordinatsystemets
gäspar	gäspar
länsledningens	länsledningens
nonanet	nonanet
karoliner	karoliner
sprängmedel	sprängmedel
Ard	Ard
nominera	nominera
borrmaskinens	borrmaskinens
Sems	Sems
utsläckt	utsläckt
laman	laman
nämner	nämner
öppnat	öppnat
förvaltade	förvaltade
kexets	kexets
sörgårdsidyllers	sörgårdsidyllers
gören	gören
patentera	patentera
synds	synds
tankarna	tankarna
loven	loven
bot	bot
tigs	tigs
fontänerna	fontänerna
preliminärskatt	preliminärskatt
nejlikan	nejlikan
föräldralöst	föräldralöst
Juda	Juda
altares	altares
Anas	Anas
vilket	vilket
justitiekanslerns	justitiekanslerns
rulltårta	rulltårta
beskrivit	beskrivit
hyresnämnderna	hyresnämnderna
förordnandenas	förordnandenas
inmatningsfältets	inmatningsfältets
diskuterats	diskuterats
ystades	ystades
afrikanskan	afrikanskan
stänger	stänger
försvunna	försvunna
öre	öre
upplöses	upplöses
tvagna	tvagna
dövt	dövt
översta	översta
basketbollar	basketbollar
klistra	klistra
avgasrörets	avgasrörets
pappersknivar	pappersknivar
välkomnad	välkomnad
rövas	rövas
hakar	hakar
tillgänglighet	tillgänglighet
koordinatsystem	koordinatsystem
samlen	samlen
undkomma	undkomma
avståndet	avståndet
partistyrelserna	partistyrelserna
Jafet	Jafet
rövare	rövare
inramningars	inramningars
örtagårdar	örtagårdar
retronymens	retronymens
kommuterar	kommuterar
fallna	fallna
dräp	dräp
löpen	löpen
bifloderna	bifloderna
läst	läst
jagas	jagas
misshandlar	misshandlar
fria	fria
lodjuret	lodjuret
tillgiven	tillgiven
verke	verke
särk	särk
Sadoks	Sadoks
givna	givna
beredd	beredd
fågelskådarnas	fågelskådarnas
byggda	byggda
flugits	flugits
förkunnats	förkunnats
böjt	böjt
snigelns	snigelns
luggs	luggs
Dan	Dan
vattenplaningen	vattenplaningen
utvalde	utvalde
gileaditen	gileaditen
regentens	regentens
käre	käre
massakerns	massakerns
ketonerna	ketonerna
utföras	utföras
slagverkares	slagverkares
racingbanan	racingbanan
säkrar	säkrar
undermeny	undermeny
krullparentesers	krullparentesers
kakkalas	kakkalas
manas	manas
katalanske	katalanske
sydnäktergalarnas	sydnäktergalarnas
täckte	täckte
steningen	steningen
härdsmältans	härdsmältans
de	de
snökedjorna	snökedjorna
beskrivningsspråk	beskrivningsspråk
vishet	vishet
sjöboden	sjöboden
nickas	nickas
byttornas	byttornas
automatiska	automatiska
mikrofonens	mikrofonens
trollade	trollade
berylls	berylls
falls	falls
gendriver	gendriver
förlät	förlät
fattas	fattas
lärd	lärd
Baals	Baals
lever	lever
agitatorer	agitatorer
släktet	släktet
spanjors	spanjors
indoktrineringen	indoktrineringen
centralafrikaners	centralafrikaners
pilsners	pilsners
like	like
trängt	trängt
tröstare	tröstare
kejsarens	kejsarens
kvällstidningarnas	kvällstidningarnas
Edoms	Edoms
byrådirektör	byrådirektör
hjälpt	hjälpt
döpa	döpa
sjukt	sjukt
somt	somt
köpingen	köpingen
arbete	arbete
elverken	elverken
fött	fött
matlagning	matlagning
antropologins	antropologins
lyste	lyste
våld	våld
förfars	förfars
paketera	paketera
lärare	lärare
som	som
doktorsavhandling	doktorsavhandling
åttondelars	åttondelars
upptäcktsresas	upptäcktsresas
episteln	episteln
bordas	bordas
jeepars	jeepars
då	då
drucken	drucken
fanfaronads	fanfaronads
långtradares	långtradares
kvacksalvares	kvacksalvares
enslinjes	enslinjes
elektricitet	elektricitet
mödar	mödar
daterat	daterat
besök	besök
pilar	pilar
ringfinger	ringfinger
ispravniks	ispravniks
omgives	omgives
levande	levande
ändligdimensionelle	ändligdimensionelle
lokaliserande	lokaliserande
besatta	besatta
kommandoknappar	kommandoknappar
dräpen	dräpen
återbesök	återbesök
Jafets	Jafets
zappa	zappa
additionerna	additionerna
jonisk	jonisk
uppfyllen	uppfyllen
vädurs	vädurs
cypriotiska	cypriotiska
översikts	översikts
konverteras	konverteras
tumnagelns	tumnagelns
utkom	utkom
bud	bud
reduktions	reduktions
Sikems	Sikems
exponerad	exponerad
vinrankors	vinrankors
stiga	stiga
systematiserad	systematiserad
räcka	räcka
författningen	författningen
snöre	snöre
borstars	borstars
lära	lära
Bara	Bara
snärja	snärja
signera	signera
obetalbar	obetalbar
fononernas	fononernas
släkt	släkt
möjliggörande	möjliggörande
Abel	Abel
kyssa	kyssa
högskolestyrelsernas	högskolestyrelsernas
stridsmedels	stridsmedels
bakhåll	bakhåll
hållare	hållare
minimumet	minimumet
skötte	skötte
eforn	eforn
antikvarien	antikvarien
moppar	moppar
dennes	dennes
glädjas	glädjas
bäre	bäre
Et	Et
högskolelags	högskolelags
vilkas	vilkas
byråkratiskt	byråkratiskt
betecknad	betecknad
kvaddas	kvaddas
bereder	bereder
aga	aga
musikallåtar	musikallåtar
lösts	lösts
renades	renades
ässen	ässen
sändes	sändes
surdegen	surdegen
departementsråds	departementsråds
böjde	böjde
upptändas	upptändas
levererade	levererade
verkade	verkade
anden	anden
korsar	korsar
Rahab	Rahab
falle	falle
garantifonden	garantifonden
systersonen	systersonen
talade	talade
infogad	infogad
tennislaget	tennislaget
homeopati	homeopati
rötternas	rötternas
åskådade	åskådade
påvar	påvar
sådda	sådda
slösare	slösare
bagerier	bagerier
landstingsrådens	landstingsrådens
arbetskamrat	arbetskamrat
beställningsarbetes	beställningsarbetes
fornengelskan	fornengelskan
Fourierserier	Fourierserier
talen	talen
stridsmedlen	stridsmedlen
undkom	undkom
diesel	diesel
funne	funne
drives	drives
preciseras	preciseras
stiftades	stiftades
Davids	Davids
Jakob	Jakob
nagellackets	nagellackets
skotsk	skotsk
höjningar	höjningar
uppmana	uppmana
varulvarna	varulvarna
Goa	Goa
förhärligade	förhärligade
stöts	stöts
eolsharpors	eolsharpors
uppenbarades	uppenbarades
åkerstycke	åkerstycke
rovets	rovets
kombinerade	kombinerade
genade	genade
qvadrater	qvadrater
kaos	kaos
monsunernas	monsunernas
fjäderbrickorna	fjäderbrickorna
stänkt	stänkt
Aran	Aran
isotonens	isotonens
använd	använd
släckt	släckt
arbetssätts	arbetssätts
bollklubbens	bollklubbens
Hanes	Hanes
visheten	visheten
intrångs	intrångs
fördragen	fördragen
konsekvente	konsekvente
vittnesbörd	vittnesbörd
prokrastinerande	prokrastinerande
varulvs	varulvs
oxar	oxar
korer	korer
Dess	Dess
nallarnas	nallarnas
odjurs	odjurs
nejlikornas	nejlikornas
linets	linets
första	första
vaken	vaken
dömda	dömda
arkeologen	arkeologen
sköt	sköt
docerade	docerade
socialförsäkringsministrar	socialförsäkringsministrar
noggrant	noggrant
nobelpristagares	nobelpristagares
vädur	vädur
tågades	tågades
tanzanierna	tanzanierna
ödmjuk	ödmjuk
stött	stött
limpan	limpan
nöjer	nöjer
svepts	svepts
koncentrera	koncentrera
består	består
mös	mös
anklagats	anklagats
styckade	styckade
kulminera	kulminera
vingarnas	vingarnas
talats	talats
Josef	Josef
fästenas	fästenas
öppnades	öppnades
visa	visa
barberar	barberar
fakulteternas	fakulteternas
fungerade	fungerade
åkerstycket	åkerstycket
tränga	tränga
borgar	borgar
pennalen	pennalen
utesluts	utesluts
druckna	druckna
döve	döve
flyta	flyta
bevise	bevise
amma	amma
förlåte	förlåte
twittrats	twittrats
kläck	kläck
svavelstickas	svavelstickas
kramades	kramades
delade	delade
epiteten	epiteten
Ehuds	Ehuds
föres	föres
kompilerar	kompilerar
arkivariens	arkivariens
rekommenderade	rekommenderade
alls	alls
anrättningar	anrättningar
markörers	markörers
Mahalalels	Mahalalels
åsens	åsens
läger	läger
radiostationens	radiostationens
resecheckens	resecheckens
nertiders	nertiders
mätt	mätt
slickade	slickade
gångerna	gångerna
beten	beten
slites	slites
50-öringarna	50-öringarna
Abraham	Abraham
arrendena	arrendena
både	både
stimuleras	stimuleras
vandrarna	vandrarna
panteistens	panteistens
rot	rot
Persien	Persien
particips	particips
bästa	bästa
mäta	mäta
oxarna	oxarna
bindas	bindas
vet	vet
deisters	deisters
stärk	stärk
fogat	fogat
satsa	satsa
hugges	hugges
tillgängliggjord	tillgängliggjord
porren	porren
påbud	påbud
Samuels	Samuels
gruvstolpar	gruvstolpar
justitieministrars	justitieministrars
gruvstolparnas	gruvstolparnas
jordbävningen	jordbävningen
syns	syns
inhägnad	inhägnad
Obed	Obed
mods	mods
åskvädren	åskvädren
kirrande	kirrande
Lud	Lud
lösdriverska	lösdriverska
karoliners	karoliners
filial	filial
allmänspråklige	allmänspråklige
statschefers	statschefers
Nod	Nod
mångfacetterat	mångfacetterat
revo	revo
taga	taga
avbildades	avbildades
droppade	droppade
kokosnöts	kokosnöts
bytande	bytande
bilfärja	bilfärja
räknestickors	räknestickors
fogad	fogad
intrången	intrången
provocerade	provocerade
förgöras	förgöras
blidkad	blidkad
ursprungskällans	ursprungskällans
behållare	behållare
argentinskans	argentinskans
blåses	blåses
inägas	inägas
terroristen	terroristen
lästes	lästes
bärande	bärande
tankar	tankar
arme	arme
städerna	städerna
begravt	begravt
ekobrottets	ekobrottets
finansmarknadens	finansmarknadens
resa	resa
Abias	Abias
förödes	förödes
döme	döme
mister	mister
smyckena	smyckena
Vars	Vars
kabinettssekreteraren	kabinettssekreteraren
simbassängens	simbassängens
antänder	antänder
tvagen	tvagen
twittras	twittras
Obeds	Obeds
dominerad	dominerad
matlagningen	matlagningen
bestå	bestå
fraser	fraser
tvivlande	tvivlande
busschaufförerna	busschaufförerna
lärkorna	lärkorna
julaftonens	julaftonens
fjäderbrickans	fjäderbrickans
ministerium	ministerium
underavdelningars	underavdelningars
dragare	dragare
systematiseras	systematiseras
undervattensbåts	undervattensbåts
förgjorda	förgjorda
förlåtna	förlåtna
uddar	uddar
svordom	svordom
uppgives	uppgives
skarpa	skarpa
talat	talat
disponerad	disponerad
mötts	mötts
bestänka	bestänka
blidkats	blidkats
Anatot	Anatot
skalärprodukter	skalärprodukter
delgrupp	delgrupp
ollades	ollades
berömda	berömda
rötter	rötter
moppars	moppars
reta	reta
metansyra	metansyra
bevisade	bevisade
tävlingsbanors	tävlingsbanors
vars	vars
talas	talas
påve	påve
medfödde	medfödde
förtryckas	förtryckas
obegränsae	obegränsae
klon	klon
hjärta	hjärta
bäres	bäres
gärningsmannen	gärningsmannen
Uris	Uris
lögnprofeterna	lögnprofeterna
överraskas	överraskas
asbest	asbest
bryggkaffets	bryggkaffets
höres	höres
luta	luta
doktorands	doktorands
namnens	namnens
koncentrationerna	koncentrationerna
elddop	elddop
abonnemangsavgiften	abonnemangsavgiften
fallen	fallen
interagerade	interagerade
klätt	klätt
exponerade	exponerade
Jonatan	Jonatan
muggar	muggar
fördolde	fördolde
vedergäll	vedergäll
sjuke	sjuke
kanslisekreterare	kanslisekreterare
styrkt	styrkt
födde	födde
utfördes	utfördes
talande	talande
bollklubb	bollklubb
utbjudande	utbjudande
cabbars	cabbars
Aner	Aner
spejade	spejade
dräptes	dräptes
extentans	extentans
anställde	anställde
täckta	täckta
upplåta	upplåta
småländska	småländska
gorillor	gorillor
ordstäv	ordstäv
högskolelagarna	högskolelagarna
annex	annex
patrullerats	patrullerats
piruetters	piruetters
gifts	gifts
tågstationerna	tågstationerna
konfiskerad	konfiskerad
suddar	suddar
inrikesministeriums	inrikesministeriums
Samuel	Samuel
kedjehusets	kedjehusets
fatta	fatta
altarets	altarets
byrådirektörer	byrådirektörer
torkare	torkare
ugglors	ugglors
konungadömes	konungadömes
byttor	byttor
Gode	Gode
ens	ens
gömde	gömde
Omar	Omar
Berea	Berea
ejder	ejder
lurarnas	lurarnas
föda	föda
Lotan	Lotan
svängdes	svängdes
frälse	frälse
kläde	kläde
möjliggjordes	möjliggjordes
rödingars	rödingars
vilddjuret	vilddjuret
ungkarl	ungkarl
obetalbara	obetalbara
epitetet	epitetet
procentenheten	procentenheten
skörtet	skörtet
kristadelfians	kristadelfians
avsats	avsats
inmatningsfältet	inmatningsfältet
avsatserna	avsatserna
kapitalisternas	kapitalisternas
modedockorna	modedockorna
bestämda	bestämda
oxars	oxars
konfigurerande	konfigurerande
beträden	beträden
hakens	hakens
fyllde	fyllde
propan	propan
källingars	källingars
oxidationstalet	oxidationstalet
åran	åran
accelerationen	accelerationen
Asas	Asas
gårdsplanens	gårdsplanens
rötmånaders	rötmånaders
efterfrågan	efterfrågan
versionerna	versionerna
morfismerna	morfismerna
respekterad	respekterad
departementsråd	departementsråd
ekobrottet	ekobrottet
epitet	epitet
flädermärgskulors	flädermärgskulors
skriva	skriva
född	född
åte	åte
lyte	lyte
Gat	Gat
Beria	Beria
kronologiske	kronologiske
upplyses	upplyses
lutade	lutade
Tagen	Tagen
svalkas	svalkas
trädstammens	trädstammens
son	son
chilenares	chilenares
bevisad	bevisad
undantagna	undantagna
kombinerad	kombinerad
köpa	köpa
syndarna	syndarna
riksantikvarien	riksantikvarien
initiativtagarna	initiativtagarna
böjen	böjen
hon	hon
socialförsäkringsministers	socialförsäkringsministers
överstes	överstes
använde	använde
lända	lända
fullbordades	fullbordades
åttondelar	åttondelar
translationen	translationen
flatas	flatas
trollas	trollas
joden	joden
bildsidan	bildsidan
radiostationen	radiostationen
används	används
rodna	rodna
roa	roa
ellipsen	ellipsen
upptagna	upptagna
oändlig	oändlig
myste	myste
skämtsamme	skämtsamme
sjöbods	sjöbods
stige	stige
svängts	svängts
budbärare	budbärare
förtvivla	förtvivla
andas	andas
löse	löse
cykelhandlares	cykelhandlares
förföljare	förföljare
utgiftstakets	utgiftstakets
dömen	dömen
dyrkas	dyrkas
a-kassa	a-kassa
kombinerat	kombinerat
krondikena	krondikena
nattduksbord	nattduksbord
barrskog	barrskog
klaffelen	klaffelen
spott	spott
arkiverats	arkiverats
trakassera	trakassera
dyrkades	dyrkades
svågrarnas	svågrarnas
Sjustjärnornas	Sjustjärnornas
småländskan	småländskan
sjöds	sjöds
bedrövas	bedrövas
hjälpsam	hjälpsam
Naftalis	Naftalis
eskimåer	eskimåer
cykelpump	cykelpump
pack	pack
protesterad	protesterad
fåtöljen	fåtöljen
indikera	indikera
fjättras	fjättras
flickväns	flickväns
väduren	väduren
radian	radian
energifrågor	energifrågor
raggmunkarna	raggmunkarna
buks	buks
bevaras	bevaras
fästas	fästas
bokmärkes	bokmärkes
skriftlig	skriftlig
många	många
bordlägga	bordlägga
bilagt	bilagt
Samarias	Samarias
meter	meter
utplånande	utplånande
berömmande	berömmande
smaragden	smaragden
efterföljd	efterföljd
borgaren	borgaren
savat	savat
kysst	kysst
gravitationens	gravitationens
skilda	skilda
oscillation	oscillation
förgörare	förgörare
sexpacken	sexpacken
fonons	fonons
murarnas	murarnas
öknamn	öknamn
paketerar	paketerar
frambären	frambären
dissars	dissars
finsko	finsko
fåtölj	fåtölj
utföres	utföres
Babel	Babel
falsifierade	falsifierade
högskolestyrelses	högskolestyrelses
förkunnade	förkunnade
drivna	drivna
frambäres	frambäres
peruanen	peruanen
hämta	hämta
uttalas	uttalas
upphävande	upphävande
fajternas	fajternas
skrämma	skrämma
rätas	rätas
pudels	pudels
inträffades	inträffades
plommon	plommon
Rehabeams	Rehabeams
kommandoknapps	kommandoknapps
tillreds	tillreds
försona	försona
lämpas	lämpas
försynen	försynen
färgbildernas	färgbildernas
uzbekerna	uzbekerna
patenterade	patenterade
ansträng	ansträng
springande	springande
armes	armes
ösregns	ösregns
plågas	plågas
anrättningars	anrättningars
kedjehus	kedjehus
förflyttningarnas	förflyttningarnas
stadsbiblioteks	stadsbiblioteks
segrare	segrare
frambära	frambära
bestämmer	bestämmer
skänkt	skänkt
rev	rev
släktets	släktets
mon	mon
släppa	släppa
årorna	årorna
brassades	brassades
sidensvans	sidensvans
stridsmedlet	stridsmedlet
tänka	tänka
vaka	vaka
fyllen	fyllen
förstår	förstår
könsnormer	könsnormer
oxes	oxes
leksak	leksak
ås	ås
kommutatorns	kommutatorns
tjeckiskorna	tjeckiskorna
snarast	snarast
råds	råds
bindes	bindes
domäns	domäns
ryggsimmet	ryggsimmet
hala	hala
homeopatis	homeopatis
bridges	bridges
slagna	slagna
rövande	rövande
upptänden	upptänden
läka	läka
rättvisan	rättvisan
psykologs	psykologs
polisbyrås	polisbyrås
åttondels	åttondels
existentiellt	existentiellt
kålroten	kålroten
samma	samma
läs	läs
drömmar	drömmar
kantrar	kantrar
roten	roten
tage	tage
strålen	strålen
nigande	nigande
kommutatorn	kommutatorn
lösas	lösas
räkor	räkor
manliga	manliga
trofastheten	trofastheten
påvisar	påvisar
inrop	inrop
utgjutna	utgjutna
löjtnantens	löjtnantens
säljen	säljen
ansträngd	ansträngd
öppnats	öppnats
marinbiologs	marinbiologs
anställdes	anställdes
bränna	bränna
delgrupperna	delgrupperna
årens	årens
travarna	travarna
gravvårdar	gravvårdar
flunsa	flunsa
skickad	skickad
överdomstols	överdomstols
spritt	spritt
sava	sava
maskulinet	maskulinet
jaga	jaga
förtövades	förtövades
upptaga	upptaga
HERREN	HERREN
index	index
etiketten	etiketten
polygonen	polygonen
pärlugglorna	pärlugglorna
barka	barka
killingars	killingars
Hebrons	Hebrons
ljudlös	ljudlös
bajskorven	bajskorven
svågers	svågers
åttiondelarna	åttiondelarna
barrträdets	barrträdets
fogas	fogas
skugga	skugga
övergiven	övergiven
Berias	Berias
galningars	galningars
årsfester	årsfester
garantifond	garantifond
tensorns	tensorns
vinterdäckets	vinterdäckets
styrkas	styrkas
allt	allt
klädde	klädde
bakhålls	bakhålls
oxen	oxen
följd	följd
Simon	Simon
ryggsäckens	ryggsäckens
orena	orena
rädda	rädda
Sådant	Sådant
rådde	rådde
godtyckliga	godtyckliga
dragne	dragne
födes	födes
5-öring	5-öring
seds	seds
baltisk	baltisk
förvarar	förvarar
rappad	rappad
kulsprutor	kulsprutor
rädes	rädes
blåmesarnas	blåmesarnas
möers	möers
sedeslöshet	sedeslöshet
substraten	substraten
upptagne	upptagne
tjänen	tjänen
referera	referera
Hanna	Hanna
firas	firas
fotgängaren	fotgängaren
Bileams	Bileams
kutar	kutar
killingarnas	killingarnas
händelsehorisonter	händelsehorisonter
förströdda	förströdda
tillgodogöra	tillgodogöra
antytt	antytt
ratificera	ratificera
uppenbarat	uppenbarat
atommassor	atommassor
vittne	vittne
uppgiven	uppgiven
förstören	förstören
meddelade	meddelade
antänt	antänt
renat	renat
konverterad	konverterad
föreställas	föreställas
dröja	dröja
lösdriverskas	lösdriverskas
möjliggjord	möjliggjord
förvarande	förvarande
grymmare	grymmare
hämtats	hämtats
vattenplanings	vattenplanings
snutits	snutits
grundämnet	grundämnet
svänger	svänger
ambassadsekreteraren	ambassadsekreteraren
stöta	stöta
sjöslag	sjöslag
lagstiftningen	lagstiftningen
sexhörningarnas	sexhörningarnas
sprängmedlen	sprängmedlen
pelarna	pelarna
fakultet	fakultet
doktorsexamen	doktorsexamen
bilägger	bilägger
Sådan	Sådan
beskärda	beskärda
hugga	hugga
ryka	ryka
jagat	jagat
Hul	Hul
biträda	biträda
fatten	fatten
stadgen	stadgen
beskärd	beskärd
dieseln	dieseln
försonas	försonas
arvedelen	arvedelen
hotfulle	hotfulle
Joas	Joas
accelerationens	accelerationens
förehava	förehava
röras	röras
oskadliggjorde	oskadliggjorde
sälje	sälje
oxarnas	oxarnas
förhandlad	förhandlad
diarieförande	diarieförande
tensorer	tensorer
Husas	Husas
avstånds	avstånds
skulptör	skulptör
kriget	kriget
Inga	Inga
voltens	voltens
steka	steka
kämpade	kämpade
plommonen	plommonen
förena	förena
möjliggör	möjliggör
räddare	räddare
vållen	vållen
lysa	lysa
segra	segra
tryckarens	tryckarens
färgbild	färgbild
halvimperials	halvimperials
kommunikations	kommunikations
bränn	bränn
versioner	versioner
stiftas	stiftas
bäste	bäste
Judas	Judas
skymd	skymd
höljda	höljda
Edens	Edens
tyglades	tyglades
utfören	utfören
klädda	klädda
Meribas	Meribas
denna	denna
minimum	minimum
omnämnandenas	omnämnandenas
koncentrerande	koncentrerande
förgörs	förgörs
önskans	önskans
våldsverkare	våldsverkare
antikvarier	antikvarier
chipspåsarnas	chipspåsarnas
tranbärs	tranbärs
repmånaden	repmånaden
beskärt	beskärt
skrämmes	skrämmes
terapeuter	terapeuter
torkarnas	torkarnas
säkrande	säkrande
årors	årors
knäveckets	knäveckets
derivatas	derivatas
substrat	substrat
utfärdas	utfärdas
statsbudgetar	statsbudgetar
borrats	borrats
avlagda	avlagda
tröstade	tröstade
utgjord	utgjord
legitimiteten	legitimiteten
räknade	räknade
gastade	gastade
gräto	gräto
snuten	snuten
förstods	förstods
råd	råd
luftmassan	luftmassan
utfärdar	utfärdar
ringmuskels	ringmuskels
tagen	tagen
vinklades	vinklades
mustasch	mustasch
arkivråden	arkivråden
fogar	fogar
räknen	räknen
sändas	sändas
fördolda	fördolda
självt	självt
sträckt	sträckt
säljare	säljare
berömma	berömma
radavståndet	radavståndet
retstickor	retstickor
David	David
bröades	bröades
Både	Både
fortfare	fortfare
Melek	Melek
filatelisterna	filatelisterna
besegrades	besegrades
tillgängligheten	tillgängligheten
arkivarierna	arkivarierna
notställ	notställ
ansad	ansad
mustascherna	mustascherna
slaktas	slaktas
hållplatsers	hållplatsers
den	den
vilade	vilade
öppnen	öppnen
bromsat	bromsat
barnbördshus	barnbördshus
företaga	företaga
jeeparnas	jeeparnas
arkivskåp	arkivskåp
förenas	förenas
bruse	bruse
bundne	bundne
ringaren	ringaren
ytteröra	ytteröra
påvisat	påvisat
fajtens	fajtens
sabbaterna	sabbaterna
maskrosen	maskrosen
aktivismen	aktivismen
överleva	överleva
låte	låte
Nebo	Nebo
Nilens	Nilens
räknades	räknades
hålla	hålla
korsförhöret	korsförhöret
fjättrade	fjättrade
narkomanens	narkomanens
hinder	hinder
tystad	tystad
oboens	oboens
bryggkaffet	bryggkaffet
höljes	höljes
göra	göra
näpet	näpet
vittnesbörden	vittnesbörden
burna	burna
avhållen	avhållen
jugoslaviskor	jugoslaviskor
ackuschör	ackuschör
lodjurens	lodjurens
styrkes	styrkes
Abrams	Abrams
sans	sans
musikinstrument	musikinstrument
dukade	dukade
antända	antända
kruciverbists	kruciverbists
kulminerar	kulminerar
örtagårdars	örtagårdars
bedrivne	bedrivne
vishets	vishets
klämdagarna	klämdagarna
ripjakts	ripjakts
hjortar	hjortar
substansens	substansens
godtycklige	godtycklige
katalansk	katalansk
laotiskans	laotiskans
benämns	benämns
enar	enar
censors	censors
köksön	köksön
Leas	Leas
bokrisen	bokrisen
rörmokares	rörmokares
bedrövande	bedrövande
befästes	befästes
sedvänjor	sedvänjor
vit	vit
Massas	Massas
draget	draget
uppenbarad	uppenbarad
förutsätts	förutsätts
redigeringskrig	redigeringskrig
sambands	sambands
skött	skött
pennalens	pennalens
uppfödde	uppfödde
vinterdäck	vinterdäck
Ehud	Ehud
täck	täck
gestaltning	gestaltning
stativens	stativens
bägare	bägare
tigits	tigits
bildordbokens	bildordbokens
hörare	hörare
dukat	dukat
snörena	snörena
surjektionen	surjektionen
vedergälla	vedergälla
Sikem	Sikem
skrymtan	skrymtan
smittskyddet	smittskyddet
röra	röra
varen	varen
justitieministrar	justitieministrar
svensexors	svensexors
överlevnad	överlevnad
vattnar	vattnar
domän	domän
städer	städer
korsfäst	korsfäst
företagen	företagen
yrkesutövningen	yrkesutövningen
bjude	bjude
vektorfälts	vektorfälts
utfärdad	utfärdad
lida	lida
övergivna	övergivna
telegrafis	telegrafis
sädesledaren	sädesledaren
länsledningar	länsledningar
eldgaffelns	eldgaffelns
märke	märke
