Hackern	Hackern
Tumult	Tumult
jappten	jappten
tappst	tappst
Emmer	Emmer
verfange	verfange
Geliebten	Geliebten
überdenkend	überdenkend
bummelet	bummelet
Kacke	Kacke
gewöhnt	gewöhnt
klone	klone
Atomphysiker	Atomphysiker
rebellieren	rebellieren
finanzieret	finanzieret
Anrufbeantworter	Anrufbeantworter
klage	klage
Meerschweinchen	Meerschweinchen
predigtest	predigtest
beanspruchest	beanspruchest
Zitronensaft	Zitronensaft
Pianos	Pianos
Vipernatter	Vipernatter
blondieret	blondieret
Artischocken	Artischocken
Herden	Herden
zerrütteten	zerrütteten
lügt	lügt
berücksichtigt	berücksichtigt
säume	säume
beider	beider
Aluminaten	Aluminaten
Für	Für
verdinglichtest	verdinglichtest
enttäuschtest	enttäuschtest
taufte	taufte
dienet	dienet
mogelest	mogelest
Optimisten	Optimisten
ballaste	ballaste
Karikaturistinnen	Karikaturistinnen
Assistentin	Assistentin
beichten	beichten
Playlists	Playlists
Durchbruches	Durchbruches
blaset	blaset
Gitarrenspieler	Gitarrenspieler
wünschst	wünschst
Sanatorien	Sanatorien
sedimentiert	sedimentiert
Deutungen	Deutungen
verabschiedetet	verabschiedetet
Jagdbomber	Jagdbomber
fluktuiert	fluktuiert
Mensch	Mensch
könnte	könnte
Möbiusbänder	Möbiusbänder
verwechseltet	verwechseltet
Knöllchen	Knöllchen
machest	machest
frische	frische
zerstreuten	zerstreuten
Preis	Preis
aufheben	aufheben
assimilierte	assimilierte
Zinkat	Zinkat
beleuchte	beleuchte
Homodimeren	Homodimeren
köderet	köderet
flöteten	flöteten
Rehböcken	Rehböcken
panaschieren	panaschieren
schmuggelte	schmuggelte
Städten	Städten
lackiere	lackiere
Welteninseln	Welteninseln
hantiert	hantiert
schlafe	schlafe
umhüll	umhüll
touchiere	touchiere
kehret	kehret
Eure	Eure
sortierte	sortierte
Dewargefäße	Dewargefäße
Schönrednern	Schönrednern
Hirten	Hirten
Erdkruste	Erdkruste
Bajonette	Bajonette
bemühst	bemühst
krähte	krähte
decket	decket
teilet	teilet
kennst	kennst
globalisieret	globalisieret
erklinge	erklinge
Atommodelle	Atommodelle
Affenbrotbaum	Affenbrotbaum
liebte	liebte
Schreibtischtäter	Schreibtischtäter
kriegte	kriegte
Oxalate	Oxalate
schwebe	schwebe
Reiterschwertern	Reiterschwertern
Trotzkist	Trotzkist
erzeigest	erzeigest
Rheumatismus	Rheumatismus
scheitern	scheitern
parlieren	parlieren
Nervenzellen	Nervenzellen
regierst	regierst
Buchstabe	Buchstabe
nippend	nippend
Schleppern	Schleppern
bereue	bereue
Drohkulisse	Drohkulisse
Buben	Buben
Flamme	Flamme
eiterten	eiterten
erkannten	erkannten
meldet	meldet
Dorsche	Dorsche
Aprikosen	Aprikosen
vermahnen	vermahnen
meinen	meinen
Kohle	Kohle
versuchen	versuchen
seufzt	seufzt
Fett	Fett
Bette	Bette
schmeichelest	schmeichelest
zählend	zählend
rächest	rächest
verblieben	verblieben
hinterzögen	hinterzögen
funktioniertest	funktioniertest
Traubenlesen	Traubenlesen
Erstarren	Erstarren
Minimierung	Minimierung
Zinkionen	Zinkionen
eure	eure
Fetzens	Fetzens
Fremdwort	Fremdwort
schießen	schießen
schluchze	schluchze
Grieche	Grieche
kehren	kehren
Fingerspitze	Fingerspitze
erratet	erratet
Vordenkern	Vordenkern
Geburtsnamen	Geburtsnamen
Klüfte	Klüfte
Trinker	Trinker
zeugen	zeugen
entsetzen	entsetzen
entschleiert	entschleiert
erdachten	erdachten
Silbererze	Silbererze
wache	wache
Lob	Lob
Peptids	Peptids
Buntspechte	Buntspechte
loste	loste
Untiefe	Untiefe
verzehrt	verzehrt
Erbse	Erbse
kaserniert	kaserniert
besichert	besichert
verifizieret	verifizieret
Linke	Linke
willen	willen
Sekretärinnen	Sekretärinnen
glänzt	glänzt
bemerken	bemerken
Monden	Monden
emigriert	emigriert
pendelt	pendelt
amenagier	amenagier
kickst	kickst
wollte	wollte
gähnten	gähnten
knusperten	knusperten
heilte	heilte
ahne	ahne
regierten	regierten
Eselsohren	Eselsohren
Programmiererinnen	Programmiererinnen
triebe	triebe
überwachest	überwachest
Massenanteilen	Massenanteilen
halltet	halltet
beichteten	beichteten
Kernspaltung	Kernspaltung
deutete	deutete
Temperaturanstiege	Temperaturanstiege
klaget	klaget
Festen	Festen
Gigapascaln	Gigapascaln
heiligem	heiligem
betrübte	betrübte
erziehst	erziehst
Eiszapfens	Eiszapfens
fünften	fünften
erfreuen	erfreuen
führst	führst
Kindergeld	Kindergeld
entwendet	entwendet
Alte	Alte
haare	haare
glaubt	glaubt
Bürzel	Bürzel
anderen	anderen
Anfängern	Anfängern
quantisierte	quantisierte
Sitz	Sitz
Flussbett	Flussbett
besäest	besäest
verkauften	verkauften
wegführen	wegführen
holte	holte
Licht	Licht
opfern	opfern
merkte	merkte
zerstreust	zerstreust
stäupt	stäupt
Zeitbomben	Zeitbomben
ernte	ernte
Benzol	Benzol
grienest	grienest
googelest	googelest
versuchest	versuchest
schauspielert	schauspielert
Ängste	Ängste
Weihen	Weihen
grübelten	grübelten
erweckest	erweckest
baggerst	baggerst
Organistin	Organistin
sündigte	sündigte
Sonderbericht	Sonderbericht
murmeln	murmeln
weine	weine
Eines	Eines
Zement	Zement
klappest	klappest
Komponisten	Komponisten
lüge	lüge
Trinken	Trinken
Volkslehren	Volkslehren
zürnest	zürnest
stammeln	stammeln
War	War
verkürztet	verkürztet
krank	krank
allen	allen
vertraute	vertraute
schaffst	schaffst
Zöpfen	Zöpfen
moppst	moppst
kaufet	kaufet
Konfitüre	Konfitüre
imprägnieret	imprägnieret
verrosteten	verrosteten
Seine	Seine
halte	halte
verspäteten	verspäteten
behauptete	behauptete
betätigtet	betätigtet
Sollst	Sollst
verwiesen	verwiesen
zagest	zagest
Freibrief	Freibrief
erweckst	erweckst
Suchanfragen	Suchanfragen
Jungen	Jungen
schlag	schlag
Verdachtes	Verdachtes
Hehlern	Hehlern
recycelten	recycelten
Fischen	Fischen
lebet	lebet
schwelle	schwelle
nahte	nahte
Denkmünze	Denkmünze
Spitzen	Spitzen
bewahrt	bewahrt
härten	härten
einigst	einigst
Extrems	Extrems
verschicket	verschicket
bildest	bildest
Brandbeschleuniger	Brandbeschleuniger
binden	binden
Bausch	Bausch
beschert	beschert
Zwingburgen	Zwingburgen
Fiesling	Fiesling
schöpfen	schöpfen
Prozeduren	Prozeduren
Kräften	Kräften
Pläsier	Pläsier
Flitzer	Flitzer
Sprecher	Sprecher
vermahnten	vermahnten
fertigte	fertigte
Steuerwagens	Steuerwagens
Silbergeschirr	Silbergeschirr
Hochsommern	Hochsommern
Samstagnachmittag	Samstagnachmittag
folge	folge
brauche	brauche
Putschisten	Putschisten
Atemluft	Atemluft
arme	arme
predig	predig
gafften	gafften
negierest	negierest
Drachenblut	Drachenblut
schmetterst	schmetterst
blätteret	blätteret
buddelten	buddelten
kappet	kappet
Strafraum	Strafraum
Klärung	Klärung
feierst	feierst
Wille	Wille
Reinigungsschritten	Reinigungsschritten
bedingst	bedingst
Schneider	Schneider
tränke	tränke
Vorstädten	Vorstädten
spanne	spanne
schnitt	schnitt
kehrte	kehrte
funktionalisiertest	funktionalisiertest
schließe	schließe
manövrieret	manövrieret
vernehmen	vernehmen
seist	seist
Anfechtung	Anfechtung
verprügelte	verprügelte
stillest	stillest
Aha-Erlebnis	Aha-Erlebnis
Referenz	Referenz
Lebenskraft	Lebenskraft
Abkömmling	Abkömmling
Membran	Membran
gewinne	gewinne
verbrauchten	verbrauchten
skypst	skypst
Briketten	Briketten
Ludwigsburger	Ludwigsburger
Holzquirl	Holzquirl
schwebte	schwebte
möpperst	möpperst
Autoklav	Autoklav
Mopps	Mopps
Ruße	Ruße
segeln	segeln
Bilderstürmer	Bilderstürmer
bombardiert	bombardiert
gestalten	gestalten
Massenanteil	Massenanteil
Sphäre	Sphäre
Gummibäumen	Gummibäumen
verziehen	verziehen
enttäuschet	enttäuschet
UND-Gattern	UND-Gattern
bis	bis
erstehst	erstehst
verkleinerest	verkleinerest
wachet	wachet
erhörst	erhörst
Zapfhahn	Zapfhahn
inneren	inneren
Sauberfrau	Sauberfrau
Notärztinnen	Notärztinnen
Krume	Krume
hegt	hegt
scheu	scheu
verdammst	verdammst
Anführern	Anführern
vernichtest	vernichtest
Alibis	Alibis
beten	beten
knufften	knufften
entdeckst	entdeckst
trägst	trägst
heilige	heilige
Leugnungen	Leugnungen
plazierest	plazierest
Elementarzelle	Elementarzelle
lehren	lehren
Kannen	Kannen
koste	koste
Herrn	Herrn
anzögen	anzögen
gräbst	gräbst
verdrängt	verdrängt
setzet	setzet
sezierst	sezierst
vor	vor
fallen	fallen
zirpe	zirpe
Tun	Tun
durfte	durfte
hintertreibt	hintertreibt
Fettsäcken	Fettsäcken
Atmosphäre	Atmosphäre
Kirgisin	Kirgisin
rangierst	rangierst
besitze	besitze
Tintenklecksen	Tintenklecksen
nähte	nähte
Ratet	Ratet
heulte	heulte
heiligest	heiligest
Bittersüß	Bittersüß
touchierte	touchierte
drosselten	drosselten
Seil	Seil
bekriegt	bekriegt
amputiere	amputiere
einerntest	einerntest
Zehen	Zehen
Tukans	Tukans
Essen	Essen
Euphemismen	Euphemismen
colorierten	colorierten
rodete	rodete
lärmte	lärmte
moppet	moppet
Herde	Herde
Golfplätzen	Golfplätzen
ratschlaget	ratschlaget
wende	wende
verkürze	verkürze
strafe	strafe
fritiert	fritiert
Verwaltungsakten	Verwaltungsakten
herrschten	herrschten
Körpergeruches	Körpergeruches
fragen	fragen
Atommassen	Atommassen
verjährest	verjährest
Backpflaumen	Backpflaumen
verhungerte	verhungerte
winkt	winkt
gründen	gründen
trieben	trieben
kommest	kommest
erwürgest	erwürgest
überlebest	überlebest
verschränken	verschränken
grünten	grünten
ausgereckten	ausgereckten
reicht	reicht
Arbeitsbereich	Arbeitsbereich
Einem	Einem
zwingst	zwingst
lavierend	lavierend
Ende	Ende
grünen	grünen
Botokuden	Botokuden
Rekursion	Rekursion
widmeten	widmeten
prostituierte	prostituierte
knistern	knistern
säst	säst
laden	laden
Hast	Hast
ermordet	ermordet
verblutete	verblutete
Begünstigung	Begünstigung
zürnst	zürnst
wehrend	wehrend
Ansteckers	Ansteckers
misstrauen	misstrauen
löst	löst
Stufen	Stufen
weinest	weinest
scheitertet	scheitertet
Brotkästen	Brotkästen
pflügten	pflügten
Unter	Unter
bequemest	bequemest
Erste	Erste
zerbrechest	zerbrechest
verbluten	verbluten
rittest	rittest
verkündigst	verkündigst
Stärket	Stärket
Eissteinen	Eissteinen
Wiederauferstehungen	Wiederauferstehungen
jauchzte	jauchzte
Überziehens	Überziehens
Chlorwasserstoffmolekül	Chlorwasserstoffmolekül
Grufti	Grufti
Pest	Pest
fehlet	fehlet
Laubholz	Laubholz
geliebt	geliebt
Zipfelmützen	Zipfelmützen
schließt	schließt
Montagmittagen	Montagmittagen
Zirkelbeweis	Zirkelbeweis
gedenke	gedenke
Rücktrittbremse	Rücktrittbremse
parliere	parliere
begehrtest	begehrtest
beschwören	beschwören
Wasserbädern	Wasserbädern
nötigte	nötigte
Bächen	Bächen
versteckt	versteckt
anhangen	anhangen
Beziehung	Beziehung
erwähnet	erwähnet
Gesamtmenge	Gesamtmenge
strafend	strafend
Anlass	Anlass
Managementsystemen	Managementsystemen
hängte	hängte
zuppte	zuppte
läutet	läutet
liehe	liehe
diskutiere	diskutiere
weisest	weisest
Sonnenfinsternis	Sonnenfinsternis
Smaragdkehlkolibris	Smaragdkehlkolibris
folgen	folgen
weichest	weichest
nähre	nähre
wehr	wehr
konsumiere	konsumiere
Radiergummis	Radiergummis
löset	löset
Isobar	Isobar
fetten	fetten
weinte	weinte
klagte	klagte
Habt	Habt
jammerte	jammerte
Neumonden	Neumonden
Ruß	Ruß
verdunstet	verdunstet
Ausländern	Ausländern
leid	leid
Eingeweide	Eingeweide
sehet	sehet
stoppten	stoppten
Schlagzeugern	Schlagzeugern
rühmet	rühmet
verarbeite	verarbeite
verzieht	verzieht
entmineralisieret	entmineralisieret
Selbstsicherheit	Selbstsicherheit
wilden	wilden
warne	warne
Langschwanzpinguin	Langschwanzpinguin
Quellfluss	Quellfluss
verschonet	verschonet
Leiche	Leiche
Bazziten	Bazziten
zeug	zeug
Fremden	Fremden
Sekte	Sekte
brandeten	brandeten
Harpune	Harpune
kauerten	kauerten
rüstetet	rüstetet
vermöge	vermöge
fokussieret	fokussieret
Bienenstöcke	Bienenstöcke
Zuschauer	Zuschauer
Barschaften	Barschaften
murmelst	murmelst
aufkommt	aufkommt
Milz	Milz
Maut	Maut
Altären	Altären
feire	feire
Laiben	Laiben
Bergen	Bergen
bekehrt	bekehrt
Scherzen	Scherzen
Name	Name
Buchhalterin	Buchhalterin
Mobilfunknetze	Mobilfunknetze
Marjellchens	Marjellchens
ab	ab
zeugst	zeugst
rauben	rauben
bombardiertet	bombardiertet
Galeeren	Galeeren
tobend	tobend
Arsenbergwerken	Arsenbergwerken
erbaust	erbaust
anfingst	anfingst
lautete	lautete
Arreste	Arreste
lohnten	lohnten
wiederkamen	wiederkamen
Sitzfleisch	Sitzfleisch
pfände	pfände
beschuldigt	beschuldigt
Schrei	Schrei
nähernd	nähernd
Finanzministerium	Finanzministerium
Teekessel	Teekessel
flupptest	flupptest
Leide	Leide
versteckten	versteckten
Oxalaten	Oxalaten
strömte	strömte
Bildschirmfotos	Bildschirmfotos
Kaliumdichromat	Kaliumdichromat
folterte	folterte
verlasset	verlasset
Vorstädte	Vorstädte
Elastomer	Elastomer
Bevölkerungsdichten	Bevölkerungsdichten
übrigbleiben	übrigbleiben
Kohlrübe	Kohlrübe
gedachtest	gedachtest
Penis	Penis
Tatsachenbeschöniger	Tatsachenbeschöniger
verbesserten	verbesserten
späht	späht
Lobgesängen	Lobgesängen
Lüsten	Lüsten
erscheine	erscheine
infizieret	infizieret
absolviere	absolviere
Unglauben	Unglauben
Brüdern	Brüdern
haarten	haarten
Öfchen	Öfchen
stellen	stellen
eingehest	eingehest
standet	standet
Magier	Magier
zerrüttet	zerrüttet
dolmetschst	dolmetschst
strafest	strafest
Metallothionein	Metallothionein
weichen	weichen
predigen	predigen
Somiten	Somiten
Dödeln	Dödeln
faule	faule
ahnten	ahnten
Schanktischen	Schanktischen
Fahrzeugkatalysatoren	Fahrzeugkatalysatoren
entwaffneten	entwaffneten
verfliegest	verfliegest
Höschen	Höschen
Hure	Hure
Aderhäuten	Aderhäuten
Wüsten	Wüsten
regierest	regierest
versteigerest	versteigerest
wisperest	wisperest
fotzt	fotzt
Rückumlaute	Rückumlaute
verifizierten	verifizierten
Hornunges	Hornunges
ausfuhren	ausfuhren
musizieret	musizieret
Stiefmütterchen	Stiefmütterchen
spähet	spähet
Californium	Californium
Büstenhalters	Büstenhalters
Gegenleistungen	Gegenleistungen
Werke	Werke
Waldbränden	Waldbränden
Diäresen	Diäresen
taufst	taufst
entfachten	entfachten
initiieret	initiieret
offenbarten	offenbarten
verkürzten	verkürzten
regelten	regelten
Hanse	Hanse
bricht	bricht
unterwerfe	unterwerfe
prostituieret	prostituieret
Solch	Solch
Brikette	Brikette
schubse	schubse
Gemeinden	Gemeinden
Innenschau	Innenschau
Kopfsalat	Kopfsalat
radierte	radierte
Technetate	Technetate
Juden	Juden
Pis	Pis
Gammastrahl	Gammastrahl
beanspruchte	beanspruchte
lostest	lostest
Blitzableiter	Blitzableiter
Aromastoffe	Aromastoffe
Ringe	Ringe
Schafe	Schafe
erstürmet	erstürmet
dresche	dresche
wischt	wischt
harrten	harrten
Bärte	Bärte
austilgen	austilgen
Wechselstuben	Wechselstuben
plärrt	plärrt
konntest	konntest
lose	lose
explodierst	explodierst
wegen	wegen
Haben	Haben
Heptamolybdat	Heptamolybdat
Kornnattern	Kornnattern
Minimierungen	Minimierungen
unterdrückte	unterdrückte
Donor	Donor
lüftetet	lüftetet
WebHooks	WebHooks
privilegiere	privilegiere
Lehrbücher	Lehrbücher
aufsteht	aufsteht
fluchte	fluchte
irgendeine	irgendeine
Kriegsknechten	Kriegsknechten
Hunde	Hunde
pflanzt	pflanzt
brillierest	brillierest
Lötzinn	Lötzinn
steckte	steckte
Streich	Streich
schreiben	schreiben
Epoxide	Epoxide
Ihr	Ihr
ringelten	ringelten
Piratensendern	Piratensendern
kritzele	kritzele
verwirklicht	verwirklicht
reizt	reizt
Forschung	Forschung
Adelung	Adelung
hängen	hängen
Firnisse	Firnisse
Prostyloi	Prostyloi
appellierte	appellierte
Dorngesträuchen	Dorngesträuchen
beantrage	beantrage
Meldezettel	Meldezettel
Autoklaven	Autoklaven
ausführt	ausführt
Päckchens	Päckchens
Kanzlei	Kanzlei
harmonierest	harmonierest
dirigieret	dirigieret
Kälber	Kälber
erste	erste
bewiesen	bewiesen
annektierten	annektierten
Urbaren	Urbaren
zweiten	zweiten
geahnt	geahnt
Gemeinde	Gemeinde
hegst	hegst
belüftete	belüftete
wichste	wichste
stigmatisierest	stigmatisierest
hure	hure
hell	hell
Forschungen	Forschungen
verdeckt	verdeckt
verbitterest	verbitterest
kühl	kühl
Gesetzen	Gesetzen
Vorstoß	Vorstoß
Blaumeisen	Blaumeisen
Reisebüro	Reisebüro
verladet	verladet
jedem	jedem
hatte	hatte
gedachten	gedachten
Saget	Saget
innere	innere
Weißflügelpinguin	Weißflügelpinguin
Flaschenhälsen	Flaschenhälsen
befehlen	befehlen
Bromidquellen	Bromidquellen
parametrisierte	parametrisierte
Dewargefäß	Dewargefäß
zerstreuet	zerstreuet
verblute	verblute
gelobst	gelobst
Rechten	Rechten
Raucherin	Raucherin
fluppten	fluppten
beschotteret	beschotteret
steigeret	steigeret
Attentäter	Attentäter
bestimmt	bestimmt
frohlockte	frohlockte
hämmerte	hämmerte
streifte	streifte
verlasse	verlasse
behütet	behütet
Glaubst	Glaubst
befördert	befördert
euren	euren
verreisest	verreisest
vertilgst	vertilgst
erlasset	erlasset
neiden	neiden
verformen	verformen
Schwebfliegen	Schwebfliegen
brecht	brecht
Golfplatz	Golfplatz
Schnipsel	Schnipsel
lochtest	lochtest
Schwarzseherin	Schwarzseherin
erforscht	erforscht
Harpunen	Harpunen
markiere	markiere
benütztest	benütztest
schwöret	schwöret
Pforte	Pforte
tyrannisierte	tyrannisierte
Mache	Mache
verforme	verforme
mehr	mehr
Zehnten	Zehnten
Fischotter	Fischotter
wisperten	wisperten
junge	junge
gelobend	gelobend
hassest	hassest
fritierten	fritierten
Kuckucken	Kuckucken
wässerten	wässerten
erlabe	erlabe
polymerisierte	polymerisierte
täuschte	täuschte
feierten	feierten
Angabe	Angabe
Kreise	Kreise
Kanzlerinnen	Kanzlerinnen
benachrichtiget	benachrichtiget
Herr	Herr
Deckenzapfen	Deckenzapfen
schnappet	schnappet
referenziere	referenziere
hydrolysierend	hydrolysierend
Ratsherren	Ratsherren
Laib	Laib
zerbricht	zerbricht
halle	halle
erhebest	erhebest
widmet	widmet
bekannte	bekannte
Gebete	Gebete
Bärenfelle	Bärenfelle
verglühte	verglühte
niemand	niemand
Berichterstattungen	Berichterstattungen
Piratensender	Piratensender
preise	preise
Proton	Proton
erbringst	erbringst
Silberdrähten	Silberdrähten
begrabe	begrabe
scherzt	scherzt
schäumtest	schäumtest
Nadelbäume	Nadelbäume
streutet	streutet
Hälsen	Hälsen
anrichtet	anrichtet
bequemte	bequemte
ehrte	ehrte
Rubinen	Rubinen
sagtest	sagtest
Uterus	Uterus
Schuhen	Schuhen
erbauet	erbauet
Schwächung	Schwächung
lange	lange
verfehle	verfehle
finanzierest	finanzierest
Gangster	Gangster
Blumensträußen	Blumensträußen
Baiser	Baiser
Körpergeruch	Körpergeruch
Eingeweiden	Eingeweiden
Sizilianer	Sizilianer
entkörperlichten	entkörperlichten
Theistin	Theistin
zerbräche	zerbräche
emigrieret	emigrieret
Lammfellhandschuhen	Lammfellhandschuhen
brichst	brichst
Gefäße	Gefäße
aufrichten	aufrichten
Chinakohl	Chinakohl
mikrominiaturisierten	mikrominiaturisierten
Aphasien	Aphasien
Neumonde	Neumonde
verziehe	verziehe
Hacker	Hacker
jaget	jaget
Uteri	Uteri
Stätten	Stätten
Dilettanten	Dilettanten
Anzeichen	Anzeichen
bedenket	bedenket
lodert	lodert
lehrte	lehrte
zeugest	zeugest
narret	narret
Türkinnen	Türkinnen
aber	aber
Verehrer	Verehrer
ratschlagen	ratschlagen
Suchet	Suchet
Samen	Samen
bedrückest	bedrückest
schenkest	schenkest
Übertretung	Übertretung
Irrtümern	Irrtümern
Fußballweltmeisterschaftsqualifikationsspiel	Fußballweltmeisterschaftsqualifikationsspiel
lachen	lachen
Aha-Erlebnisse	Aha-Erlebnisse
Herd	Herd
Gebirge	Gebirge
verselbstständige	verselbstständige
Kerzenfische	Kerzenfische
verhalten	verhalten
koche	koche
Weichseln	Weichseln
Augur	Augur
Meines	Meines
geleiteten	geleiteten
verscheißert	verscheißert
stirbt	stirbt
erbrüte	erbrüte
Bergsteiger	Bergsteiger
flirtest	flirtest
Lehrkörpers	Lehrkörpers
implodier	implodier
lieb	lieb
wehrtest	wehrtest
Wasserbades	Wasserbades
erwachet	erwachet
eng	eng
Kupferkiesen	Kupferkiesen
Zwingburg	Zwingburg
müsse	müsse
durchwachen	durchwachen
moppen	moppen
besänftiget	besänftiget
Zäume	Zäume
vorn	vorn
verführtest	verführtest
Sprachraum	Sprachraum
fabulierte	fabulierte
verkürztest	verkürztest
vergiftet	vergiftet
analysiert	analysiert
Feste	Feste
Abbildern	Abbildern
soll	soll
Pentaboraten	Pentaboraten
Ölspur	Ölspur
diversifiziere	diversifiziere
verkaufe	verkaufe
demütigst	demütigst
Schläfchens	Schläfchens
Weinstöcken	Weinstöcken
gewährtest	gewährtest
fallest	fallest
unterforderten	unterforderten
koordinieret	koordinieret
Kopfverletzungen	Kopfverletzungen
Rhodochrosite	Rhodochrosite
werdet	werdet
unsre	unsre
Premieren	Premieren
malochte	malochte
baue	baue
Haltepunkt	Haltepunkt
ander	ander
Palme	Palme
Huflattich	Huflattich
Königen	Königen
Einheimischen	Einheimischen
Wogen	Wogen
werden	werden
borgte	borgte
reiche	reiche
Gigapascal	Gigapascal
grünest	grünest
speist	speist
Wachtel	Wachtel
Stufe	Stufe
decken	decken
Gefängnisse	Gefängnisse
hebräisch	hebräisch
mästest	mästest
Schnipseln	Schnipseln
zeichnet	zeichnet
Leitkegeln	Leitkegeln
traget	traget
Willen	Willen
kennest	kennest
reiftet	reiftet
Ranzigkeit	Ranzigkeit
verlähmte	verlähmte
Montagmittag	Montagmittag
bekennst	bekennst
süsst	süsst
Beile	Beile
Argyrodite	Argyrodite
Zwergschwan	Zwergschwan
Asthenosphäre	Asthenosphäre
Fallen	Fallen
Kriegsenden	Kriegsenden
lockerte	lockerte
kontaktieret	kontaktieret
Stierkämpfen	Stierkämpfen
grün	grün
überprüfte	überprüfte
verberge	verberge
Transportwegen	Transportwegen
Äthern	Äthern
Roben	Roben
Bruchstriches	Bruchstriches
Nachweisreagenzien	Nachweisreagenzien
Gram	Gram
Ångström	Ångström
Hin	Hin
zeugt	zeugt
Rutheniumkomplexen	Rutheniumkomplexen
vergliche	vergliche
Männlein	Männlein
konvergierest	konvergierest
gründe	gründe
Außenministerien	Außenministerien
besprächen	besprächen
beschuldiget	beschuldiget
Kriegsschauplatz	Kriegsschauplatz
unterbrächen	unterbrächen
steigest	steigest
verringert	verringert
Massagen	Massagen
erhöht	erhöht
Ärgernissen	Ärgernissen
geratest	geratest
verunglimpfen	verunglimpfen
hinterfragst	hinterfragst
leide	leide
Zeitbombe	Zeitbombe
verringeret	verringeret
Fiasko	Fiasko
Fingerhüten	Fingerhüten
Einöden	Einöden
Grönländer	Grönländer
Argyroditen	Argyroditen
Einstufung	Einstufung
weissagst	weissagst
Raten	Raten
grünet	grünet
vergibt	vergibt
Melanteriten	Melanteriten
fern	fern
irrte	irrte
Linguistinnen	Linguistinnen
trompetete	trompetete
umhüllend	umhüllend
Einrad	Einrad
beklagte	beklagte
koordinierte	koordinierte
attestiertet	attestiertet
Beschuldigungen	Beschuldigungen
Filzläusen	Filzläusen
denaturiert	denaturiert
lüftet	lüftet
Milchflasche	Milchflasche
Türmen	Türmen
Leitungswegs	Leitungswegs
Drehtüren	Drehtüren
Vaginen	Vaginen
produzierten	produzierten
Kosten	Kosten
verführe	verführe
aufstehet	aufstehet
der	der
kategorisierst	kategorisierst
Taschendieb	Taschendieb
malt	malt
harrest	harrest
protokollieren	protokollieren
Gegebenheiten	Gegebenheiten
Gerücht	Gerücht
Zerfall	Zerfall
wallfahrten	wallfahrten
Sabbate	Sabbate
hievst	hievst
Freeganer	Freeganer
kehre	kehre
bezahlst	bezahlst
dekorieren	dekorieren
Fällt	Fällt
Meinst	Meinst
nimmt	nimmt
Bajonetten	Bajonetten
deinem	deinem
Käsereiben	Käsereiben
Satzung	Satzung
kämpfte	kämpfte
Perlen	Perlen
Fellachinnen	Fellachinnen
Gaschromatographien	Gaschromatographien
verbärgen	verbärgen
verachtet	verachtet
Buntwaschmittel	Buntwaschmittel
Fülle	Fülle
schöpfest	schöpfest
Alkine	Alkine
idealisierten	idealisierten
Lusitaner	Lusitaner
einigte	einigte
Agoraphobien	Agoraphobien
erlöst	erlöst
Adenosin	Adenosin
schreien	schreien
bemühten	bemühten
Gebote	Gebote
Geschreis	Geschreis
bewahrheitetet	bewahrheitetet
begehr	begehr
verschlimmere	verschlimmere
maximiere	maximiere
Spitze	Spitze
greife	greife
Androiden	Androiden
überfischt	überfischt
grabble	grabble
Pflanzenwachstum	Pflanzenwachstum
widmend	widmend
Argentits	Argentits
respektiere	respektiere
Hälmchen	Hälmchen
Ställen	Ställen
Gedanken	Gedanken
fällen	fällen
harmoniert	harmoniert
unehrt	unehrt
borgst	borgst
verfügten	verfügten
vermögen	vermögen
erkannte	erkannte
schummelst	schummelst
begnadigte	begnadigte
lachte	lachte
verdränget	verdränget
Europameisters	Europameisters
wurdest	wurdest
Buntspechten	Buntspechten
fette	fette
Soge	Soge
erlösen	erlösen
formirte	formirte
andere	andere
instanziier	instanziier
Denn	Denn
Lärchen	Lärchen
Reichweiten	Reichweiten
umbrächten	umbrächten
erwürgten	erwürgten
Radfahrern	Radfahrern
herrschte	herrschte
schreie	schreie
Floß	Floß
Weichloten	Weichloten
hinterlege	hinterlege
verzierten	verzierten
Schlüchten	Schlüchten
Versorgungen	Versorgungen
Brieföffners	Brieföffners
erwachte	erwachte
verfehlten	verfehlten
gute	gute
behütetest	behütetest
übersteht	übersteht
Zehnt	Zehnt
bleibest	bleibest
erfreu	erfreu
Ehren	Ehren
Gewalttätern	Gewalttätern
unterscheide	unterscheide
unsrer	unsrer
Weichlote	Weichlote
Bauwerken	Bauwerken
Arm	Arm
lauschte	lauschte
schütze	schütze
behalte	behalte
konnte	konnte
fügt	fügt
gut	gut
Kakadu	Kakadu
erstehet	erstehet
schmusen	schmusen
besichtigt	besichtigt
Seit	Seit
Schilde	Schilde
Hahnenkämme	Hahnenkämme
verstecken	verstecken
kämpfen	kämpfen
verglühest	verglühest
Wirst	Wirst
Apostel	Apostel
werft	werft
Notständen	Notständen
drifte	drifte
plärrtest	plärrtest
nähret	nähret
unterwerft	unterwerft
Früchte	Früchte
surre	surre
Entsetzt	Entsetzt
Kurkuma	Kurkuma
überdächte	überdächte
verderben	verderben
gepuddelt	gepuddelt
verzögerte	verzögerte
liehen	liehen
Energiespeicher	Energiespeicher
Tübinger	Tübinger
ausgerecktem	ausgerecktem
grübelt	grübelt
Fahlflanken-Ameisenwürgern	Fahlflanken-Ameisenwürgern
sondern	sondern
frohlockten	frohlockten
steiget	steiget
knurrt	knurrt
reichen	reichen
Gehorsam	Gehorsam
errötest	errötest
torpedieret	torpedieret
erzürnst	erzürnst
füsilierten	füsilierten
gehorchst	gehorchst
entflieht	entflieht
ausfuhr	ausfuhr
frikassiert	frikassiert
einst	einst
scheiterest	scheiterest
Ausbeutern	Ausbeutern
Chemikerinnen	Chemikerinnen
Band	Band
Butike	Butike
wechselwirkte	wechselwirkte
überprüftest	überprüftest
Überweisung	Überweisung
zeugten	zeugten
prophezeiet	prophezeiet
webet	webet
Lunisolarkalender	Lunisolarkalender
Hände	Hände
schiebest	schiebest
spracht	spracht
gehörte	gehörte
Leisten	Leisten
impfte	impfte
reagiert	reagiert
stutzt	stutzt
verirrt	verirrt
Ösophagospasmen	Ösophagospasmen
Bund	Bund
Bürzeln	Bürzeln
rechte	rechte
verkriechet	verkriechet
überdenkst	überdenkst
unschuldigen	unschuldigen
pilgert	pilgert
dissentierten	dissentierten
flenstet	flenstet
Haarshampoos	Haarshampoos
Letzten	Letzten
weiche	weiche
scheucht	scheucht
Fanmeilen	Fanmeilen
verfinstere	verfinstere
Flöte	Flöte
blitzet	blitzet
Gläubiger	Gläubiger
Scheißkerl	Scheißkerl
erwischten	erwischten
sichten	sichten
schützt	schützt
pflücktet	pflücktet
wahr	wahr
türmt	türmt
Fußmatten	Fußmatten
Senkung	Senkung
Stätte	Stätte
erhört	erhört
untersagest	untersagest
Fischzucht	Fischzucht
gehorchest	gehorchest
Städte	Städte
wallfahrest	wallfahrest
besprachen	besprachen
Fokusse	Fokusse
inszeniere	inszeniere
Trioxiden	Trioxiden
streite	streite
lostet	lostet
verwerten	verwerten
Reichweite	Reichweite
verwechsele	verwechsele
verkündet	verkündet
Skorpionen	Skorpionen
Riesen	Riesen
Omnibus	Omnibus
Münzsammlung	Münzsammlung
dringen	dringen
kräusle	kräusle
Aachener	Aachener
baten	baten
Strohhälmchen	Strohhälmchen
umarbeitest	umarbeitest
übersehest	übersehest
anrichten	anrichten
freiwilligen	freiwilligen
nähert	nähert
entdecket	entdecket
Gehirnwelle	Gehirnwelle
zentrifugieren	zentrifugieren
Aromastoffen	Aromastoffen
Pi	Pi
inspirierten	inspirierten
bestraft	bestraft
Rückwege	Rückwege
prediget	prediget
Dampfschiffen	Dampfschiffen
Katalanen	Katalanen
trage	trage
Wahn	Wahn
pharyngalisierten	pharyngalisierten
machst	machst
duzet	duzet
gehetzt	gehetzt
Zebrahaies	Zebrahaies
mampfte	mampfte
separieret	separieret
Brötchen	Brötchen
ermordetet	ermordetet
motivierte	motivierte
Briefen	Briefen
begraben	begraben
Schote	Schote
verführten	verführten
filzen	filzen
Uranerz	Uranerz
Blitzen	Blitzen
Zain	Zain
Rücktrittbremsen	Rücktrittbremsen
Korrosionsschutz	Korrosionsschutz
schaust	schaust
dampfst	dampfst
reinstitutionalisiert	reinstitutionalisiert
einführte	einführte
verspäte	verspäte
verwechselst	verwechselst
Teppichen	Teppichen
Klassenzimmer	Klassenzimmer
bediene	bediene
nachwandelte	nachwandelte
aufwacht	aufwacht
raubte	raubte
spezialisiere	spezialisiere
bleiben	bleiben
Schauet	Schauet
eins	eins
bewässern	bewässern
schauen	schauen
erlaubest	erlaubest
Heringen	Heringen
besorgest	besorgest
Generatoren	Generatoren
verunziere	verunziere
präsentiere	präsentiere
wehe	wehe
wälzt	wälzt
Elementen	Elementen
erkälteten	erkälteten
belüftet	belüftet
Hörst	Hörst
setzte	setzte
Fusselbärten	Fusselbärten
Spektralbereich	Spektralbereich
beweist	beweist
grause	grause
Sanatoriums	Sanatoriums
Zähne	Zähne
Iberer	Iberer
Dinge	Dinge
vermischen	vermischen
Herbstwinden	Herbstwinden
Idolatrien	Idolatrien
erschütterte	erschütterte
Eingaben	Eingaben
gedolmetscht	gedolmetscht
Kuttern	Kuttern
Chasaren	Chasaren
Stoffwechselweg	Stoffwechselweg
hydrolysierest	hydrolysierest
Däumlings	Däumlings
Schenke	Schenke
dunkelten	dunkelten
verleumdetest	verleumdetest
erpress	erpress
Adeliepinguins	Adeliepinguins
Landwirte	Landwirte
Menschenhandel	Menschenhandel
substituierten	substituierten
Schneepflügen	Schneepflügen
sterbet	sterbet
Arbeitsleistung	Arbeitsleistung
Kommet	Kommet
Mammut	Mammut
folgtet	folgtet
Fieberanfall	Fieberanfall
hatten	hatten
ungehorsam	ungehorsam
extemporiere	extemporiere
rühmst	rühmst
Begünstigungen	Begünstigungen
Eingabe	Eingabe
Ichs	Ichs
Landwirt	Landwirt
falle	falle
Zunge	Zunge
generiertet	generiertet
gratuliere	gratuliere
kautest	kautest
besitzest	besitzest
bekannt	bekannt
Quatsch	Quatsch
bündelten	bündelten
malochet	malochet
Suche	Suche
benehme	benehme
pulsiert	pulsiert
Frommen	Frommen
Laie	Laie
Sonderberichte	Sonderberichte
entsetzt	entsetzt
zürne	zürne
teilte	teilte
Tatsachenbeschönigern	Tatsachenbeschönigern
Beschleuniger	Beschleuniger
schabst	schabst
nütze	nütze
gewinnet	gewinnet
denen	denen
log	log
scheuchtest	scheuchtest
Großfürsten	Großfürsten
strecke	strecke
überschneidet	überschneidet
Büsche	Büsche
Verkehrsflugzeug	Verkehrsflugzeug
weinen	weinen
Habe	Habe
gabelt	gabelt
bekennt	bekennt
vertilgest	vertilgest
fabulierest	fabulierest
heißt	heißt
Döner	Döner
Polierstählen	Polierstählen
Trägergas	Trägergas
Kruste	Kruste
beanspruchet	beanspruchet
selbst	selbst
Mäuse	Mäuse
überliefere	überliefere
mobilisierten	mobilisierten
Arbeitsgruppen	Arbeitsgruppen
nahe	nahe
vereinbarten	vereinbarten
rännen	rännen
ausgeht	ausgeht
Skorpione	Skorpione
Hehler	Hehler
Füchse	Füchse
schauten	schauten
lavierte	lavierte
kapiert	kapiert
ziehest	ziehest
bleibst	bleibst
Stall	Stall
Bleiglanz	Bleiglanz
brause	brause
Gepäckträgern	Gepäckträgern
Huren	Huren
unehret	unehret
tattre	tattre
ob	ob
weh	weh
Silberdrahts	Silberdrahts
nahest	nahest
Trinkgefäßen	Trinkgefäßen
Ionen	Ionen
Zäumen	Zäumen
begehrend	begehrend
hieltest	hieltest
Halter	Halter
Frettchen	Frettchen
bemächtigte	bemächtigte
fegte	fegte
Aussätzigen	Aussätzigen
unterrichtet	unterrichtet
Gesamtmengen	Gesamtmengen
verwirrte	verwirrte
Fadenlauf	Fadenlauf
reim	reim
Letzte	Letzte
dechiffriere	dechiffriere
fluchet	fluchet
befestigten	befestigten
Obszönität	Obszönität
dürft	dürft
manövrierte	manövrierte
Käsereibe	Käsereibe
solch	solch
Sitzfleisches	Sitzfleisches
Gänge	Gänge
lochten	lochten
Antimusters	Antimusters
Zähnen	Zähnen
Monarchie	Monarchie
Volkslehre	Volkslehre
tagest	tagest
streiten	streiten
toten	toten
Sekten	Sekten
Staatsanleihe	Staatsanleihe
schweigst	schweigst
Garten	Garten
begehrt	begehrt
erlassen	erlassen
destabilisierte	destabilisierte
spaltete	spaltete
Glaubet	Glaubet
Altbau	Altbau
eggte	eggte
Rußen	Rußen
Brieföffner	Brieföffner
erstaunte	erstaunte
platz	platz
liebt	liebt
überqueren	überqueren
schleißt	schleißt
fragest	fragest
klemmen	klemmen
Sinne	Sinne
vertilgten	vertilgten
graben	graben
Stellen	Stellen
sinke	sinke
gebäre	gebäre
Kaktusfeige	Kaktusfeige
Apotheose	Apotheose
kein	kein
Wehe	Wehe
gedächtet	gedächtet
Felsboden	Felsboden
überreichst	überreichst
genieret	genieret
ärgerst	ärgerst
betrieben	betrieben
ausgereckter	ausgereckter
zerstreute	zerstreute
Jüngern	Jüngern
strandeten	strandeten
Regenten	Regenten
begründest	begründest
stoppte	stoppte
Gruftis	Gruftis
punktest	punktest
Gehilfe	Gehilfe
setzt	setzt
Plumpse	Plumpse
Haarverlusten	Haarverlusten
treibest	treibest
hydrogentartrat	hydrogentartrat
erhöhet	erhöhet
kontaktiere	kontaktiere
Flenser	Flenser
Elektrophil	Elektrophil
verschlingt	verschlingt
verwaiset	verwaiset
arrivieren	arrivieren
deponierte	deponierte
widerrufe	widerrufe
Libellen	Libellen
verwirft	verwirft
Erdboden	Erdboden
überreichend	überreichend
Chelatkomplex	Chelatkomplex
hätte	hätte
Recitativen	Recitativen
schau	schau
Türkenbund	Türkenbund
begruben	begruben
pflanzte	pflanzte
Cyanat	Cyanat
Glühwürmchen	Glühwürmchen
Wechselstube	Wechselstube
ladest	ladest
befestigte	befestigte
besprengen	besprengen
Kompassen	Kompassen
Unrecht	Unrecht
Decks	Decks
verpuffe	verpuffe
posiertet	posiertet
pflanzest	pflanzest
Gängen	Gängen
willst	willst
Gläubigern	Gläubigern
Aufsätze	Aufsätze
kram	kram
Kassiteriten	Kassiteriten
Abkömmlingen	Abkömmlingen
föchten	föchten
zerfetzte	zerfetzte
Raute	Raute
prahlte	prahlte
Geigerzähler	Geigerzähler
zählte	zählte
fluppe	fluppe
schlachten	schlachten
babbelst	babbelst
Verdacht	Verdacht
Dachdeckerin	Dachdeckerin
wach	wach
Frieden	Frieden
Danket	Danket
Erdbirnen	Erdbirnen
einer	einer
empört	empört
Sollten	Sollten
gaffest	gaffest
Lenkstange	Lenkstange
überquerst	überquerst
Ringen	Ringen
Oxonium	Oxonium
Dieben	Dieben
konvergiere	konvergiere
strullerst	strullerst
Reststoffen	Reststoffen
puste	puste
kugelten	kugelten
Siglen	Siglen
knüpfen	knüpfen
haarte	haarte
Pflichten	Pflichten
schleim	schleim
injizierest	injizierest
Weiß	Weiß
Erlösungen	Erlösungen
Preisen	Preisen
addieren	addieren
besäet	besäet
geselle	geselle
teile	teile
Nachteile	Nachteile
speichertest	speichertest
Rekursionen	Rekursionen
Komponistinnen	Komponistinnen
verzeichne	verzeichne
vollendest	vollendest
wiederholten	wiederholten
rüste	rüste
punkten	punkten
bezieht	bezieht
schnitten	schnitten
Aufprall	Aufprall
raubest	raubest
vielen	vielen
Schlägst	Schlägst
Wandergewerbe	Wandergewerbe
Anfänger	Anfänger
Hubschrauber	Hubschrauber
schweigen	schweigen
spukest	spukest
kickend	kickend
Zäunen	Zäunen
zürnet	zürnet
Schreiben	Schreiben
vibriere	vibriere
oxidierst	oxidierst
Borkenkäfer	Borkenkäfer
bitte	bitte
straften	straften
Streichen	Streichen
Ärzteblatt	Ärzteblatt
Komponistin	Komponistin
stärket	stärket
Katamaranen	Katamaranen
hinterfragten	hinterfragten
instanziiere	instanziiere
Genkinits	Genkinits
duckt	duckt
Dithiolane	Dithiolane
Türkin	Türkin
anrufen	anrufen
verschränkest	verschränkest
Keiner	Keiner
Steuerwagen	Steuerwagen
alle	alle
Kettenraucher	Kettenraucher
reformierten	reformierten
rekonstruieren	rekonstruieren
Iberers	Iberers
möge	möge
Zeugnissen	Zeugnissen
Braunrallen	Braunrallen
Basilikum	Basilikum
kupieren	kupieren
redetet	redetet
Fäusten	Fäusten
Narkotikum	Narkotikum
kupiert	kupiert
Zöpfe	Zöpfe
besänne	besänne
Älteste	Älteste
jungen	jungen
Lobe	Lobe
Selbstversuchen	Selbstversuchen
Erbsen	Erbsen
massierend	massierend
ersparen	ersparen
Primärenergien	Primärenergien
Machet	Machet
linke	linke
begnügt	begnügt
hetzte	hetzte
heparinisierten	heparinisierten
wispern	wispern
Managementsystem	Managementsystem
Höschens	Höschens
verbluteten	verbluteten
Beobachtungen	Beobachtungen
entgegenkamen	entgegenkamen
kurz	kurz
Zerfällen	Zerfällen
frohlocke	frohlocke
Trinkgefäße	Trinkgefäße
Ausländer	Ausländer
Graben	Graben
möchte	möchte
Trichtern	Trichtern
Gasflasche	Gasflasche
Suchanfrage	Suchanfrage
hadere	hadere
weise	weise
abalienierest	abalienierest
tätowierest	tätowierest
gehet	gehet
Keile	Keile
Naturen	Naturen
Paläste	Paläste
unserem	unserem
balkanisierten	balkanisierten
blockierten	blockierten
lobet	lobet
regen	regen
fritieret	fritieret
Nadel	Nadel
streiften	streiften
hicksest	hicksest
verwirren	verwirren
verseift	verseift
Schlössern	Schlössern
Pfeilen	Pfeilen
jaulst	jaulst
erlöset	erlöset
vertrieben	vertrieben
Metallspiegeln	Metallspiegeln
flambierten	flambierten
Ärzten	Ärzten
stehest	stehest
deponiere	deponiere
Nadelbäumen	Nadelbäumen
Prostylos	Prostylos
Gar	Gar
Dachdecker	Dachdecker
Leid	Leid
Halogenatom	Halogenatom
Feiertagen	Feiertagen
brachen	brachen
umbrächte	umbrächte
stellte	stellte
Weinberge	Weinberge
fressen	fressen
frappiere	frappiere
schwängen	schwängen
vergast	vergast
Tore	Tore
Hornung	Hornung
begrübest	begrübest
frohlockest	frohlockest
interagierte	interagierte
wog	wog
Taschendiebe	Taschendiebe
jemanden	jemanden
predige	predige
Toypudel	Toypudel
boß	boß
fallt	fallt
ertraget	ertraget
Götze	Götze
taten	taten
Bedenken	Bedenken
ein	ein
filzten	filzten
wässerst	wässerst
gestattest	gestattest
Höfe	Höfe
dümpelst	dümpelst
würdest	würdest
desensibilisierte	desensibilisierte
Gaschromatographie	Gaschromatographie
stoßest	stoßest
widerlegest	widerlegest
tabuisierten	tabuisierten
haderte	haderte
Berge	Berge
sehnet	sehnet
Glatteis	Glatteis
Öfchens	Öfchens
vertiefe	vertiefe
Carbids	Carbids
Tust	Tust
zeiget	zeiget
flucht	flucht
deckst	deckst
Schade	Schade
Rubine	Rubine
gehörten	gehörten
schauend	schauend
Akkadierinnen	Akkadierinnen
freuet	freuet
strafte	strafte
bereits	bereits
Gewürze	Gewürze
knistert	knistert
beschwindele	beschwindele
stapelten	stapelten
grübelte	grübelte
Einöde	Einöde
Toren	Toren
bestimmten	bestimmten
stellst	stellst
stäupten	stäupten
kremierten	kremierten
Ärztin	Ärztin
Solcher	Solcher
elften	elften
Flensern	Flensern
plumpse	plumpse
verzweifelten	verzweifelten
Märkte	Märkte
begehrtet	begehrtet
verschafft	verschafft
gelobe	gelobe
Fluoratome	Fluoratome
begliche	begliche
Bombardierungen	Bombardierungen
Würze	Würze
Graphem	Graphem
pulsiere	pulsiere
verleumdete	verleumdete
leertet	leertet
mampfen	mampfen
stillte	stillte
Zäune	Zäune
zeuget	zeuget
überreichen	überreichen
fladerten	fladerten
Entmachtungen	Entmachtungen
bitten	bitten
Regiert	Regiert
Kaufhäuser	Kaufhäuser
entkörperlichte	entkörperlichte
Fluoratomen	Fluoratomen
trinken	trinken
stürzte	stürzte
Stearat	Stearat
Anhänge	Anhänge
sortierest	sortierest
protestierst	protestierst
Füllfederhalter	Füllfederhalter
Prozedur	Prozedur
kabelten	kabelten
Krumen	Krumen
Fluorkohlenwasserstoffe	Fluorkohlenwasserstoffe
verführen	verführen
Reinigungsschrittes	Reinigungsschrittes
Schwermetallion	Schwermetallion
Leuchtstoff	Leuchtstoff
Wandergesellen	Wandergesellen
Unternehmung	Unternehmung
Planern	Planern
beunruhigte	beunruhigte
fingieret	fingieret
Gase	Gase
Kutter	Kutter
vierte	vierte
verewiget	verewiget
spritzet	spritzet
entheiligten	entheiligten
Eine	Eine
Tiefschutzen	Tiefschutzen
sinterte	sinterte
Möbelstoffen	Möbelstoffen
Pausbacken	Pausbacken
reformieren	reformieren
spekulieren	spekulieren
lauft	lauft
Kohlenstoffgehalten	Kohlenstoffgehalten
blockiert	blockiert
helle	helle
bemühet	bemühet
fluppst	fluppst
müssest	müssest
Gelobet	Gelobet
knutschest	knutschest
grien	grien
erschüttere	erschüttere
ihrem	ihrem
brillieret	brillieret
Sabotagen	Sabotagen
vertonet	vertonet
bummeltet	bummeltet
kabelte	kabelte
rüstete	rüstete
gezählt	gezählt
umhüllt	umhüllt
Kompromissen	Kompromissen
fließt	fließt
Zankapfels	Zankapfels
jene	jene
ungeistlichen	ungeistlichen
liebten	liebten
entert	entert
Notstand	Notstand
Fluoratom	Fluoratom
verwechselet	verwechselet
vertilge	vertilge
er	er
Eutern	Eutern
wilde	wilde
erstarrten	erstarrten
Wehklagen	Wehklagen
Bushaltestelle	Bushaltestelle
Teekesseln	Teekesseln
Notärztin	Notärztin
liebst	liebst
transportierte	transportierte
beliefen	beliefen
Arsenit	Arsenit
Maultiere	Maultiere
begrabet	begrabet
Unterseite	Unterseite
Bären	Bären
immunisiere	immunisiere
einführt	einführt
griff	griff
Leichnamen	Leichnamen
Anführer	Anführer
geleite	geleite
Europameistern	Europameistern
werte	werte
heilet	heilet
Ei	Ei
pflanze	pflanze
liste	liste
älteste	älteste
Dattel	Dattel
verzehre	verzehre
wehret	wehret
sponsertest	sponsertest
Werken	Werken
Krustentier	Krustentier
Rufet	Rufet
schaffen	schaffen
obfuskieren	obfuskieren
höhnest	höhnest
Linguist	Linguist
einen	einen
verhörest	verhörest
Tyrannen	Tyrannen
malet	malet
erweckt	erweckt
heben	heben
ritze	ritze
Schneepflug	Schneepflug
bete	bete
Safrane	Safrane
Macht	Macht
flieh	flieh
gezügelt	gezügelt
Ringeltaube	Ringeltaube
Zitronensäften	Zitronensäften
Signalen	Signalen
Weinbergen	Weinbergen
fasset	fasset
Pedanten	Pedanten
grüßte	grüßte
parkierten	parkierten
substituieren	substituieren
Fußmatte	Fußmatte
erwürgtest	erwürgtest
versklavte	versklavte
bedeckest	bedeckest
Tanne	Tanne
Blutgefäß	Blutgefäß
Samarskite	Samarskite
Amokläuferinnen	Amokläuferinnen
anders	anders
Landesverräterinnen	Landesverräterinnen
Kraftfahrzeuges	Kraftfahrzeuges
sabbelten	sabbelten
Laufringe	Laufringe
schlaf	schlaf
rufst	rufst
Theistinnen	Theistinnen
Steuerberater	Steuerberater
Geschichtsbüchern	Geschichtsbüchern
Trockendock	Trockendock
Hummern	Hummern
Böse	Böse
Aspartame	Aspartame
Seiten	Seiten
protokollierst	protokollierst
Mönche	Mönche
Komplexionen	Komplexionen
Fehlen	Fehlen
simulierst	simulierst
kämpfet	kämpfet
Polarisation	Polarisation
Schamentzündungen	Schamentzündungen
amputierten	amputierten
verdrehet	verdrehet
Fetzen	Fetzen
erliegen	erliegen
interpretierten	interpretierten
grünend	grünend
könne	könne
folterst	folterst
Tieren	Tieren
versüßtet	versüßtet
Solche	Solche
Bushaltestellen	Bushaltestellen
wetzte	wetzte
Schatten	Schatten
Kerls	Kerls
generiert	generiert
verbündest	verbündest
wallet	wallet
sollt	sollt
Röcken	Röcken
Ausnahme	Ausnahme
gedenk	gedenk
verzehrst	verzehrst
Trümmersprachen	Trümmersprachen
Abschußring	Abschußring
sorgte	sorgte
Einen	Einen
mopsend	mopsend
hämmerst	hämmerst
dringest	dringest
Berber	Berber
Myriade	Myriade
Adamsapfel	Adamsapfel
schwirrt	schwirrt
zertifiziertest	zertifiziertest
ziehet	ziehet
Vetter	Vetter
Silbererzen	Silbererzen
solchem	solchem
rolltet	rolltet
Kreisen	Kreisen
kategorisierte	kategorisierte
veranstalten	veranstalten
instrumentalisierest	instrumentalisierest
oben	oben
Regenwald	Regenwald
Pfründe	Pfründe
Wimpertierchen	Wimpertierchen
Backenbärten	Backenbärten
begehrst	begehrst
Zirkelschlüssen	Zirkelschlüssen
Cola	Cola
Kompromiss	Kompromiss
überdenkest	überdenkest
stimmen	stimmen
Recitativ	Recitativ
polymerisier	polymerisier
Rhabarber	Rhabarber
brausen	brausen
Magiern	Magiern
auflegte	auflegte
sei	sei
erziehen	erziehen
Beiblätter	Beiblätter
entmineralisierst	entmineralisierst
Marjellchen	Marjellchen
salzen	salzen
Lehnen	Lehnen
bandagiert	bandagiert
Jungfernflug	Jungfernflug
Rehbock	Rehbock
Wunden	Wunden
besorg	besorg
Gewinnungen	Gewinnungen
massakrierten	massakrierten
Achsel	Achsel
Werden	Werden
Lautschriften	Lautschriften
gewinnen	gewinnen
schleiß	schleiß
liebet	liebet
schreckt	schreckt
Edelsteinen	Edelsteinen
Schanktisch	Schanktisch
Erzherzogshüten	Erzherzogshüten
geschlummert	geschlummert
Malen	Malen
lebte	lebte
posierten	posierten
besorgend	besorgend
stille	stille
bekehret	bekehret
Propheten	Propheten
mästet	mästet
schlängelest	schlängelest
Böreks	Böreks
Wollt	Wollt
erwärmst	erwärmst
Basilisk	Basilisk
trefft	trefft
Fortsetzungen	Fortsetzungen
Stör	Stör
Teilen	Teilen
Einzelgänger	Einzelgänger
genehmigt	genehmigt
Nagellackentferner	Nagellackentferner
Regent	Regent
ersparet	ersparet
schnürest	schnürest
Dödel	Dödel
eiterte	eiterte
Nahrungsbestandteilen	Nahrungsbestandteilen
Recht	Recht
Schafen	Schafen
Rutheniumkomplex	Rutheniumkomplex
Flöten	Flöten
Schlaraffenlandes	Schlaraffenlandes
erzeigt	erzeigt
boykottierst	boykottierst
Steuerbord	Steuerbord
verbirgt	verbirgt
fladern	fladern
Banknoten	Banknoten
belauere	belauere
Provinz	Provinz
pilgerte	pilgerte
Zapfhähnen	Zapfhähnen
Gallanen	Gallanen
erzwinget	erzwinget
gelobten	gelobten
Aprikose	Aprikose
geleitest	geleitest
Gut	Gut
Rast	Rast
parametrisierten	parametrisierten
Verwundete	Verwundete
zählet	zählet
zeltest	zeltest
schöpfte	schöpfte
geloben	geloben
beleuchteten	beleuchteten
hupen	hupen
formirend	formirend
Messies	Messies
predigend	predigend
schläfst	schläfst
tage	tage
begrabt	begrabt
Finanzministern	Finanzministern
verachtend	verachtend
Ärgernisse	Ärgernisse
abweichet	abweichet
Langeweile	Langeweile
frevler	frevler
ausziehst	ausziehst
jaule	jaule
Kleinod	Kleinod
Landstreichereien	Landstreichereien
war	war
forschet	forschet
irre	irre
Breiten	Breiten
koexistierten	koexistierten
Ektoplasmen	Ektoplasmen
Pumpellyiten	Pumpellyiten
bollerte	bollerte
achten	achten
Urologe	Urologe
Kunstgeschichte	Kunstgeschichte
repräsentieret	repräsentieret
ausführe	ausführe
griechisch	griechisch
begehrest	begehrest
Petersfisch	Petersfisch
beweisen	beweisen
ruckelst	ruckelst
Spurensicherung	Spurensicherung
Wasserquelle	Wasserquelle
chloroformiere	chloroformiere
Schlepper	Schlepper
läute	läute
maß	maß
widmest	widmest
Kerzenfischen	Kerzenfischen
Fragen	Fragen
handhabt	handhabt
brauchte	brauchte
Laken	Laken
macht	macht
Hainbuche	Hainbuche
schlage	schlage
Rechtsruck	Rechtsruck
Blaumeise	Blaumeise
bessere	bessere
verschont	verschont
begehren	begehren
merket	merket
Sprödmetall	Sprödmetall
Diesen	Diesen
hingehst	hingehst
deklarierten	deklarierten
schummelten	schummelten
kabbelnd	kabbelnd
überweis	überweis
welche	welche
Lusitaners	Lusitaners
labe	labe
fällst	fällst
antworte	antworte
Pfählen	Pfählen
tote	tote
behaltest	behaltest
Eisenkräutern	Eisenkräutern
rächte	rächte
regiertest	regiertest
entkäme	entkäme
knuffend	knuffend
Merkel-Rauten	Merkel-Rauten
ärgernd	ärgernd
wacht	wacht
anrührt	anrührt
ehre	ehre
meines	meines
überschattet	überschattet
Talismanen	Talismanen
Pfunden	Pfunden
erlagst	erlagst
Rundbriefen	Rundbriefen
Falltürme	Falltürme
Blütenachse	Blütenachse
Primatologen	Primatologen
Rutheniumisotopen	Rutheniumisotopen
Anlässe	Anlässe
Ankern	Ankern
Tyrann	Tyrann
Gewürzen	Gewürzen
Abtrünnigen	Abtrünnigen
Mein	Mein
fremden	fremden
verließet	verließet
dirigieren	dirigieren
kasernierte	kasernierte
Deutung	Deutung
überweiset	überweiset
reifen	reifen
entsündigten	entsündigten
Hobby	Hobby
falteten	falteten
Aggressoren	Aggressoren
platzt	platzt
zerbrichst	zerbrichst
betätigest	betätigest
überbewerte	überbewerte
Platte	Platte
malen	malen
Teufel	Teufel
ersten	ersten
ärgertest	ärgertest
klappst	klappst
Gehorcht	Gehorcht
ermahnet	ermahnet
besuche	besuche
verspätete	verspätete
wehen	wehen
beziehen	beziehen
Grizzlybären	Grizzlybären
balkanisierte	balkanisierte
revoltieren	revoltieren
befehlt	befehlt
Meter	Meter
Luftschiff	Luftschiff
Fallturm	Fallturm
Bleigehalt	Bleigehalt
Augen	Augen
gewitterte	gewitterte
reich	reich
bölkte	bölkte
Arsch	Arsch
verantwortet	verantwortet
höbe	höbe
habet	habet
löge	löge
erfreute	erfreute
merken	merken
optimierte	optimierte
Acetaten	Acetaten
sichere	sichere
vertreiben	vertreiben
Schuhe	Schuhe
löse	löse
brauchst	brauchst
dotiere	dotiere
verletzte	verletzte
Aufträgen	Aufträgen
evaluierten	evaluierten
entwickelten	entwickelten
Ahnen	Ahnen
Qualifikationen	Qualifikationen
grabe	grabe
Wiedergutmachung	Wiedergutmachung
verhungert	verhungert
hebräischen	hebräischen
entzögen	entzögen
Bedeutung	Bedeutung
Achatschnecken	Achatschnecken
schmuste	schmuste
Gehorchet	Gehorchet
Beten	Beten
Hode	Hode
verludet	verludet
ringet	ringet
rinnt	rinnt
heiligt	heiligt
verunreinigst	verunreinigst
Shortcut	Shortcut
Biokraftstoff	Biokraftstoff
kugele	kugele
erkennet	erkennet
frevle	frevle
hoben	hoben
parametrisierst	parametrisierst
Nullpunktes	Nullpunktes
Satzungen	Satzungen
setzten	setzten
Ochs	Ochs
rufe	rufe
seinem	seinem
schätzen	schätzen
argumentierten	argumentierten
verewigt	verewigt
Tote	Tote
misstrauet	misstrauet
Sogen	Sogen
verkleinern	verkleinern
Heiden	Heiden
verkapselt	verkapselt
stärken	stärken
ihnen	ihnen
argumentierest	argumentierest
Trümmersprache	Trümmersprache
Maximierung	Maximierung
verunglimpfte	verunglimpfte
beides	beides
Falz	Falz
eskalieret	eskalieret
verdammte	verdammte
säumet	säumet
Sprichwort	Sprichwort
Zeug	Zeug
foppst	foppst
regelet	regelet
tendiertet	tendiertet
verbot	verbot
Rabe	Rabe
Aderhaut	Aderhaut
erwärmet	erwärmet
lehret	lehret
Abschirmung	Abschirmung
hätten	hätten
quantisiere	quantisiere
concessionieren	concessionieren
Videoaufzeichnung	Videoaufzeichnung
Empfängnisverhütungen	Empfängnisverhütungen
Deck	Deck
lesen	lesen
blondierten	blondierten
klonet	klonet
Stiefvater	Stiefvater
sicherst	sicherst
Subspezies	Subspezies
Samarskit	Samarskit
gratuliert	gratuliert
Tretlager	Tretlager
watet	watet
unseren	unseren
Metallothioneinen	Metallothioneinen
Füllet	Füllet
Oberbegriff	Oberbegriff
Präservativen	Präservativen
ansehet	ansehet
Mittelaltermarkt	Mittelaltermarkt
Rinde	Rinde
Katamarane	Katamarane
Seetaucher	Seetaucher
fliehe	fliehe
Ring	Ring
stifte	stifte
Republikflucht	Republikflucht
verzweifelt	verzweifelt
Honigbären	Honigbären
linsten	linsten
flirtete	flirtete
blitze	blitze
verstrahlten	verstrahlten
Gefäßen	Gefäßen
erfüllst	erfüllst
Adamsäpfeln	Adamsäpfeln
dein	dein
grünst	grünst
Ein	Ein
Karern	Karern
entschädiget	entschädiget
Pflanzenstoff	Pflanzenstoff
Kraftfahrzeugen	Kraftfahrzeugen
kaufe	kaufe
ortete	ortete
Tiegel	Tiegel
Ränken	Ränken
Gewicht	Gewicht
begrübe	begrübe
Ihren	Ihren
erwärmten	erwärmten
Binden	Binden
Astats	Astats
tragest	tragest
backt	backt
Operationssaal	Operationssaal
versteckte	versteckte
wirft	wirft
schlachtet	schlachtet
führte	führte
Gespenst	Gespenst
Drache	Drache
überschnitten	überschnitten
lackieren	lackieren
hadertet	hadertet
Dolde	Dolde
Asteroid	Asteroid
Hinterwäldlern	Hinterwäldlern
Trichter	Trichter
schon	schon
Mäppchen	Mäppchen
Linie	Linie
Unwahrheiten	Unwahrheiten
Pfandgeld	Pfandgeld
evakuieret	evakuieret
verwaisten	verwaisten
formulieren	formulieren
Stiefvätern	Stiefvätern
wünschtest	wünschtest
mögest	mögest
deinen	deinen
Hansen	Hansen
reanimierten	reanimierten
sage	sage
Maultieren	Maultieren
Ha	Ha
Organisation	Organisation
wer	wer
bröckelten	bröckelten
heißest	heißest
meißelt	meißelt
Dans	Dans
separieren	separieren
Leuchtkäfern	Leuchtkäfern
abtrünnige	abtrünnige
Kleinoden	Kleinoden
bracht	bracht
losten	losten
Menschen	Menschen
Elektronenschale	Elektronenschale
erst	erst
traueret	traueret
vernickele	vernickele
Tannen	Tannen
Bademäntel	Bademäntel
stapele	stapele
reichet	reichet
Schwermetallionen	Schwermetallionen
Büschen	Büschen
Animation	Animation
gibst	gibst
träumen	träumen
Bettler	Bettler
löstet	löstet
pflanzet	pflanzet
diversifiziert	diversifiziert
wollest	wollest
bröckeln	bröckeln
Sagen	Sagen
Weile	Weile
aktualisiere	aktualisiere
Binde	Binde
Eiland	Eiland
dritten	dritten
Gebot	Gebot
Kardinal	Kardinal
schämest	schämest
Radsatzes	Radsatzes
sortiert	sortiert
Trägerwellen	Trägerwellen
Werdet	Werdet
gewährte	gewährte
winke	winke
rekonstruieret	rekonstruieret
alarmiere	alarmiere
Bienenzüchter	Bienenzüchter
enterten	enterten
Reisebüros	Reisebüros
mischt	mischt
taufet	taufet
Kommst	Kommst
danke	danke
Nehmt	Nehmt
fluppt	fluppt
haltest	haltest
produziert	produziert
entfolgst	entfolgst
erzürnt	erzürnt
unterbewerte	unterbewerte
Diamantringen	Diamantringen
Minischweine	Minischweine
verfolgst	verfolgst
köderte	köderte
segmentiere	segmentiere
Raucherinnen	Raucherinnen
erwärmte	erwärmte
fälle	fälle
Musters	Musters
Herbstwinde	Herbstwinde
henken	henken
Heteroatom	Heteroatom
Schober	Schober
Kronsbeeren	Kronsbeeren
jauchzt	jauchzt
Lehne	Lehne
all	all
Grenzwert	Grenzwert
Flammen	Flammen
verbrauchet	verbrauchet
Knabe	Knabe
massierst	massierst
Blitze	Blitze
fritierst	fritierst
Hypochlorite	Hypochlorite
sezierte	sezierte
ratschlagt	ratschlagt
fahrest	fahrest
Rücktrittes	Rücktrittes
Ackerschachtelhalm	Ackerschachtelhalm
injiziert	injiziert
ausgereckte	ausgereckte
drillte	drillte
lispelt	lispelt
verschaffte	verschaffte
langte	langte
Mikrometern	Mikrometern
Baisers	Baisers
berühret	berühret
chloroformieret	chloroformieret
steckst	steckst
Einbrecher	Einbrecher
schauspieleren	schauspieleren
Riese	Riese
Zeilen	Zeilen
Stadtbezirken	Stadtbezirken
vermahne	vermahne
Mop	Mop
zittere	zittere
gebieten	gebieten
Martyrologien	Martyrologien
dividiert	dividiert
mißversteht	mißversteht
Arresten	Arresten
Farbstoffe	Farbstoffe
Fremde	Fremde
essen	essen
Dezernaten	Dezernaten
essest	essest
Verbindungsdraht	Verbindungsdraht
krösest	krösest
ringele	ringele
Schreiber	Schreiber
bringet	bringet
offenbare	offenbare
Mops	Mops
assimilieret	assimilieret
warntet	warntet
wechselwirkt	wechselwirkt
weist	weist
Puffersystemen	Puffersystemen
Datentypen	Datentypen
Alterität	Alterität
verschärfst	verschärfst
Patres	Patres
verklagst	verklagst
Fussel	Fussel
pflügen	pflügen
habt	habt
urbanisier	urbanisier
entrümpelst	entrümpelst
handhabest	handhabest
äusserst	äusserst
assimilierten	assimilierten
nötig	nötig
Lümmeltüte	Lümmeltüte
konnten	konnten
Fingerhüte	Fingerhüte
reichtest	reichtest
verständige	verständige
geräuchert	geräuchert
Knüppeln	Knüppeln
folg	folg
Früchten	Früchten
letzte	letzte
Leugnung	Leugnung
Ente	Ente
Weiblein	Weiblein
Setzt	Setzt
rechten	rechten
verkröchet	verkröchet
steigen	steigen
Kühen	Kühen
strömt	strömt
maximierten	maximierten
sehn	sehn
Linken	Linken
Hadith	Hadith
dampfte	dampfte
Bademantel	Bademantel
streckst	streckst
wolle	wolle
schreibst	schreibst
Kopfsalaten	Kopfsalaten
Diese	Diese
billigte	billigte
dichten	dichten
Metaphern	Metaphern
wirfst	wirfst
führen	führen
Tischen	Tischen
Bezeugungen	Bezeugungen
Aphasie	Aphasie
Gleitzeiten	Gleitzeiten
Politologe	Politologe
entmineralisierten	entmineralisierten
Herabsetzungen	Herabsetzungen
bekehrte	bekehrte
bedeckst	bedeckst
Toypudeln	Toypudeln
flense	flense
verabschiedeten	verabschiedeten
härte	härte
schwellen	schwellen
durften	durften
Schreibtischtätern	Schreibtischtätern
sterilisiert	sterilisiert
gebot	gebot
meuternd	meuternd
Sage	Sage
Arbeitskreis	Arbeitskreis
Weh	Weh
Metapher	Metapher
Leuchtkäfer	Leuchtkäfer
oxidierte	oxidierte
Uranerzen	Uranerzen
frommen	frommen
zensiere	zensiere
brenne	brenne
Mähnenwolfes	Mähnenwolfes
Besuchen	Besuchen
Reißnagel	Reißnagel
anzeigt	anzeigt
Mittelaltermarktes	Mittelaltermarktes
Feiertage	Feiertage
boykottierten	boykottierten
querte	querte
helfet	helfet
kauern	kauern
zählten	zählten
füsilierte	füsilierte
Abartigkeiten	Abartigkeiten
überweise	überweise
tust	tust
sprachen	sprachen
hydrogentartrate	hydrogentartrate
verallgemeinerst	verallgemeinerst
schneidet	schneidet
Telefonnummer	Telefonnummer
erliegst	erliegst
besehet	besehet
blamierten	blamierten
verboten	verboten
wurstelten	wurstelten
Weg	Weg
bereite	bereite
grünt	grünt
schnappt	schnappt
beteuerest	beteuerest
Tiere	Tiere
bespracht	bespracht
schlaft	schlaft
dunkelt	dunkelt
Freitagnachmittage	Freitagnachmittage
untersagtest	untersagtest
nachwandelst	nachwandelst
Gäste	Gäste
recycele	recycele
Möbiusbändern	Möbiusbändern
addierest	addierest
verliere	verliere
verstehest	verstehest
Briefe	Briefe
knitterte	knitterte
ermordetest	ermordetest
Brauhaus	Brauhaus
Gehörst	Gehörst
keulte	keulte
Rechenbrettern	Rechenbrettern
Pfleglinge	Pfleglinge
aufnahmt	aufnahmt
eigene	eigene
Buchfink	Buchfink
verjährte	verjährte
velarisiert	velarisiert
überreicht	überreicht
außer	außer
besät	besät
tränkten	tränkten
fertige	fertige
Dachdeckerinnen	Dachdeckerinnen
Mutagen	Mutagen
überwiese	überwiese
Beilen	Beilen
dürften	dürften
Entree	Entree
setzest	setzest
verbrauchte	verbrauchte
Gemurmel	Gemurmel
fromme	fromme
Spirale	Spirale
verzweigt	verzweigt
sich	sich
widerriefe	widerriefe
gebäret	gebäret
interagiert	interagiert
Sphären	Sphären
duzen	duzen
Pforten	Pforten
Klappertopf	Klappertopf
grau	grau
Aussätzige	Aussätzige
enträtselten	enträtselten
treibst	treibst
Unwahrheit	Unwahrheit
Serverzugriffen	Serverzugriffen
Dünungen	Dünungen
ratschlagten	ratschlagten
ihren	ihren
Spieße	Spieße
verlöteten	verlöteten
wurdet	wurdet
Heringe	Heringe
Amputierte	Amputierte
holst	holst
Ebenen	Ebenen
privatisiert	privatisiert
erkältete	erkältete
Urbare	Urbare
Plüschtiere	Plüschtiere
Futtermitteln	Futtermitteln
Beine	Beine
observiertest	observiertest
still	still
Taschenwörterbuch	Taschenwörterbuch
säuselest	säuselest
wogen	wogen
verkürzte	verkürzte
Talisman	Talisman
Unterschlagung	Unterschlagung
Traubenlese	Traubenlese
Bonzen	Bonzen
Lazarette	Lazarette
herrschet	herrschet
Unterseiten	Unterseiten
bemerket	bemerket
aasend	aasend
schwangt	schwangt
Gewinnung	Gewinnung
wachen	wachen
verwertete	verwertete
Fahrt	Fahrt
verschickte	verschickte
eingehst	eingehst
erzeigen	erzeigen
stand	stand
begleicht	begleicht
verallgemeinerest	verallgemeinerest
Schau	Schau
Friede	Friede
rühmte	rühmte
Dreieinigkeit	Dreieinigkeit
meinem	meinem
Scheck	Scheck
Membranen	Membranen
bebet	bebet
Decken	Decken
übet	übet
lügen	lügen
Deckenfarbe	Deckenfarbe
verdammen	verdammen
Leichtmetallen	Leichtmetallen
merke	merke
Polizeisprecher	Polizeisprecher
links	links
Ass	Ass
erlabet	erlabet
stimmte	stimmte
Feldzug	Feldzug
versteckst	versteckst
fraget	fraget
widerstanden	widerstanden
stolz	stolz
austilgest	austilgest
Sehnen	Sehnen
trägt	trägt
Einheimische	Einheimische
vermahnet	vermahnet
begräbt	begräbt
Schlaraffenländern	Schlaraffenländern
Carbid	Carbid
Thioester	Thioester
schonte	schonte
Gehirnwellen	Gehirnwellen
Gymnasien	Gymnasien
widerlegte	widerlegte
Dann	Dann
mein	mein
sterilisierte	sterilisierte
Elfen	Elfen
Normdaten	Normdaten
kitzeln	kitzeln
Schlägen	Schlägen
Sternen	Sternen
pflügest	pflügest
Ansteckern	Ansteckern
gerne	gerne
Rufen	Rufen
aufhobt	aufhobt
veranstaltest	veranstaltest
verteidigt	verteidigt
dingte	dingte
verdammet	verdammet
verdeckten	verdeckten
Pudern	Pudern
Omnibusse	Omnibusse
inhalierest	inhalierest
Reststoff	Reststoff
beschrifteten	beschrifteten
beweisest	beweisest
Fledermaus	Fledermaus
steinigst	steinigst
zerrüttete	zerrüttete
gare	gare
googelten	googelten
pfänden	pfänden
charakterisierend	charakterisierend
Dichten	Dichten
Bäche	Bäche
Schnallen	Schnallen
Kohlen	Kohlen
Greyerzern	Greyerzern
halten	halten
kaufst	kaufst
überfischte	überfischte
lockerst	lockerst
schläft	schläft
verlähmt	verlähmt
stelle	stelle
Jude	Jude
Speere	Speere
verfängt	verfängt
stigmatisierst	stigmatisierst
hebe	hebe
scheinest	scheinest
Asylrechten	Asylrechten
Katz-und-Maus-Spiele	Katz-und-Maus-Spiele
Kalb	Kalb
Beiblättern	Beiblättern
Halt	Halt
brennen	brennen
Händen	Händen
Lüste	Lüste
Stechpalmen	Stechpalmen
Gefilde	Gefilde
Füchsen	Füchsen
Gleitzeit	Gleitzeit
liebend	liebend
henket	henket
Scheißkerlen	Scheißkerlen
entgehst	entgehst
Beobachtung	Beobachtung
Bete	Bete
schlafet	schlafet
Hardwareentwicklerin	Hardwareentwicklerin
tyrannisiertest	tyrannisiertest
schämte	schämte
fluppen	fluppen
Denen	Denen
Hinkelstein	Hinkelstein
arbeiten	arbeiten
durchzuck	durchzuck
wähnet	wähnet
Geschrei	Geschrei
befestigt	befestigt
Beinen	Beinen
Physikerinnen	Physikerinnen
besuchen	besuchen
vermagst	vermagst
feiern	feiern
pflügte	pflügte
panaschieret	panaschieret
türmen	türmen
Abschirmungen	Abschirmungen
Anhang	Anhang
zensierten	zensierten
nehmest	nehmest
klicket	klicket
Kontraindikation	Kontraindikation
Abfertigungsschalters	Abfertigungsschalters
verzögerten	verzögerten
Last	Last
Hie	Hie
Kronsbeere	Kronsbeere
erfahrt	erfahrt
wünscht	wünscht
Geldautomaten	Geldautomaten
Technikerinnen	Technikerinnen
Ypecaharallen	Ypecaharallen
schaut	schaut
Kindergeldern	Kindergeldern
Rhabarbern	Rhabarbern
Almanachen	Almanachen
Rückumschlägen	Rückumschlägen
eher	eher
bedürftet	bedürftet
gleite	gleite
lehrest	lehrest
kichert	kichert
Herzchen	Herzchen
Abfertigungsgebäude	Abfertigungsgebäude
verunreinigt	verunreinigt
Organisationen	Organisationen
konvertieren	konvertieren
Ambiguität	Ambiguität
Zankapfel	Zankapfel
knusperst	knusperst
bekennet	bekennet
Lebenskräften	Lebenskräften
Enthärtungen	Enthärtungen
Ablösung	Ablösung
verstecke	verstecke
lauf	lauf
Fluorgehalt	Fluorgehalt
Küstenwachen	Küstenwachen
Flamen	Flamen
Worte	Worte
Augenglases	Augenglases
Borhydride	Borhydride
Leichenschauhäusern	Leichenschauhäusern
Isobars	Isobars
Däumlingen	Däumlingen
schaute	schaute
Fallt	Fallt
täuschet	täuschet
Spannt	Spannt
Pfahl	Pfahl
aufwachte	aufwachte
Küsserei	Küsserei
dritte	dritte
Sportlerin	Sportlerin
erriet	erriet
Seehechte	Seehechte
Abbindebeschleuniger	Abbindebeschleuniger
erntest	erntest
blamierte	blamierte
haste	haste
elfte	elfte
Assistentinnen	Assistentinnen
gefügt	gefügt
verklagt	verklagt
emendieret	emendieret
eurem	eurem
verstanden	verstanden
Trickbetrüger	Trickbetrüger
planschest	planschest
Apportierhund	Apportierhund
Gebeine	Gebeine
glawbte	glawbte
gewitterest	gewitterest
schließen	schließen
bekehrten	bekehrten
unterbewertete	unterbewertete
offenbart	offenbart
zügelten	zügelten
gelangte	gelangte
Loparite	Loparite
frottierten	frottierten
Gebäcken	Gebäcken
Werkzeuge	Werkzeuge
Fiebermitteln	Fiebermitteln
Flame	Flame
trinkest	trinkest
massakrierte	massakrierte
bombardiere	bombardiere
Genie	Genie
Leichname	Leichname
wünsche	wünsche
Drohkulissen	Drohkulissen
gestatteten	gestatteten
Erfahrungen	Erfahrungen
leer	leer
ausgehst	ausgehst
Bilderstürmers	Bilderstürmers
erkennest	erkennest
verlobt	verlobt
bandagierte	bandagierte
Schaffnerinnen	Schaffnerinnen
Tetraiodide	Tetraiodide
Leitungsweg	Leitungsweg
obfuskierten	obfuskierten
Schaden	Schaden
nähet	nähet
Orten	Orten
gehorchten	gehorchten
Heiratsgütern	Heiratsgütern
Schaffnerin	Schaffnerin
verbirgst	verbirgst
Märkten	Märkten
plissieren	plissieren
steinigte	steinigte
Gnaden	Gnaden
Märtyrern	Märtyrern
verschlungen	verschlungen
föhnten	föhnten
verdammt	verdammt
Dich	Dich
schälte	schälte
fragmentiert	fragmentiert
demoralisiere	demoralisiere
Europium	Europium
verurteile	verurteile
Bienenstock	Bienenstock
bezichtigt	bezichtigt
würdet	würdet
aßet	aßet
erntete	erntete
Tritte	Tritte
verbaselt	verbaselt
downloadet	downloadet
klettert	klettert
versüße	versüße
gelobtet	gelobtet
radiertest	radiertest
idealisieret	idealisieret
bollerest	bollerest
Zeithorizonten	Zeithorizonten
Wänden	Wänden
vertagest	vertagest
raffinier	raffinier
gelobte	gelobte
enge	enge
Serverzugriffe	Serverzugriffe
griffe	griffe
diesen	diesen
liebe	liebe
Heide	Heide
Kurkumen	Kurkumen
Blockflöten	Blockflöten
gehöre	gehöre
verseifet	verseifet
linstest	linstest
überstehst	überstehst
Unglaube	Unglaube
More	More
Abkürzungsverzeichnis	Abkürzungsverzeichnis
assimiliertest	assimiliertest
dienest	dienest
Woge	Woge
Beziehungen	Beziehungen
Füllfederhalters	Füllfederhalters
Ausnahmen	Ausnahmen
Monarchien	Monarchien
transportierst	transportierst
Haltepunkten	Haltepunkten
pflegst	pflegst
restaurieret	restaurieret
Testamenten	Testamenten
evaluiert	evaluiert
entständen	entständen
Hüftgelenken	Hüftgelenken
wechseln	wechseln
Funkfeuer	Funkfeuer
Telefonnummern	Telefonnummern
Paradiesäpfeln	Paradiesäpfeln
Tier	Tier
könnt	könnt
Buchstaben	Buchstaben
verkleide	verkleide
Schwestern	Schwestern
Berylle	Berylle
Argentit	Argentit
Anzeichens	Anzeichens
schnelle	schnelle
bedenken	bedenken
erinnre	erinnre
Zeitschlitze	Zeitschlitze
Ionenaustauscher	Ionenaustauscher
Lautwandeln	Lautwandeln
Bäusche	Bäusche
rauschen	rauschen
piesackest	piesackest
exmatrikulierte	exmatrikulierte
partitionierten	partitionierten
Buche	Buche
verklärt	verklärt
Andrologie	Andrologie
drängte	drängte
Küstenwache	Küstenwache
Paralipse	Paralipse
Wahnen	Wahnen
aufrichtest	aufrichtest
drängest	drängest
Stoffwechselwegen	Stoffwechselwegen
drillest	drillest
Abarten	Abarten
Dank	Dank
Freibergits	Freibergits
Brettspiele	Brettspiele
keulst	keulst
Gefängnissen	Gefängnissen
angehöre	angehöre
erstände	erstände
Klappertöpfen	Klappertöpfen
kochte	kochte
konvertiere	konvertiere
Kontrollboxen	Kontrollboxen
könnten	könnten
schnell	schnell
meinte	meinte
vermahnt	vermahnt
Kürass	Kürass
Kautschuken	Kautschuken
Blechen	Blechen
Kardinäle	Kardinäle
schautet	schautet
Saiblingen	Saiblingen
verkleidete	verkleidete
besitzet	besitzet
konnotieret	konnotieret
alarmieren	alarmieren
gewärtigt	gewärtigt
keine	keine
sündigt	sündigt
sponsert	sponsert
wachte	wachte
sterilisierten	sterilisierten
Eisstein	Eisstein
Laubbläsern	Laubbläsern
Den	Den
Schätze	Schätze
besprenget	besprenget
erstaunst	erstaunst
Laufringen	Laufringen
helfest	helfest
Basiliken	Basiliken
reif	reif
schneide	schneide
bequemen	bequemen
spielet	spielet
Fußbodens	Fußbodens
stiften	stiften
Kerfe	Kerfe
Industrienation	Industrienation
Rumänin	Rumänin
meinst	meinst
zürn	zürn
Dochte	Dochte
Pferden	Pferden
bewies	bewies
kabbelet	kabbelet
bequemtet	bequemtet
hänget	hänget
Klüften	Klüften
Kleptokratie	Kleptokratie
tabuisiert	tabuisiert
Amen	Amen
ersparten	ersparten
Welche	Welche
prosteten	prosteten
demütige	demütige
quietsche	quietsche
Stimme	Stimme
Wehklage	Wehklage
Langzeichen	Langzeichen
Gipfeltreffen	Gipfeltreffen
Erstlingen	Erstlingen
Sünders	Sünders
umhüllst	umhüllst
Marokkaners	Marokkaners
addierte	addierte
unterfordern	unterfordern
Brettspielen	Brettspielen
verlaß	verlaß
schnüren	schnüren
gestikulierst	gestikulierst
Wurzelwachstum	Wurzelwachstum
weg	weg
ernten	ernten
auflöste	auflöste
warntest	warntest
preiset	preiset
Fusselbart	Fusselbart
Würfelspiel	Würfelspiel
Atemgas	Atemgas
Kohlenstoffgehalt	Kohlenstoffgehalt
Bande	Bande
nächsten	nächsten
klumpe	klumpe
Wege	Wege
schwenkt	schwenkt
tunet	tunet
globalisier	globalisier
Joche	Joche
Amtsträger	Amtsträger
Vanadaten	Vanadaten
Welpen	Welpen
verschlimmerte	verschlimmerte
aufkäme	aufkäme
fünfte	fünfte
verknüpft	verknüpft
entsetzte	entsetzte
rüstetest	rüstetest
scherze	scherze
Deuterium	Deuterium
wollt	wollt
Elf	Elf
Adler	Adler
kommst	kommst
ihr	ihr
bezichtigten	bezichtigten
tatet	tatet
Carbiden	Carbiden
verprügelet	verprügelet
seine	seine
Crescendos	Crescendos
leihe	leihe
Badezimmer	Badezimmer
mühe	mühe
ärgerte	ärgerte
Nanoteslan	Nanoteslan
beweiset	beweiset
rufen	rufen
Tausche	Tausche
batet	batet
verbasele	verbasele
designierst	designierst
neige	neige
linken	linken
Girls	Girls
Wir	Wir
Ärschen	Ärschen
vertilgen	vertilgen
rammte	rammte
beide	beide
speise	speise
Könige	Könige
respektiert	respektiert
hegten	hegten
verschärftet	verschärftet
kennet	kennet
pressiere	pressiere
knüpfte	knüpfte
wachse	wachse
flötete	flötete
konnotierst	konnotierst
Laien	Laien
Rhodochrositen	Rhodochrositen
Gedächtnisse	Gedächtnisse
Weißt	Weißt
Türkis	Türkis
plumpsten	plumpsten
Gefügen	Gefügen
verdeckst	verdeckst
begrubt	begrubt
Heuhaufen	Heuhaufen
Moren	Moren
losest	losest
Dessous	Dessous
regiere	regiere
Reinstoffen	Reinstoffen
Stücke	Stücke
schnatternd	schnatternd
aufstanden	aufstanden
Metonymie	Metonymie
Fanmeile	Fanmeile
Zeithorizonte	Zeithorizonte
salz	salz
ruhte	ruhte
Darlehen	Darlehen
Reiseleiter	Reiseleiter
speiste	speiste
Schwan	Schwan
Aktienkursen	Aktienkursen
meißeltest	meißeltest
Laubbaum	Laubbaum
schreiet	schreiet
Ställe	Ställe
Gründungsprivilegien	Gründungsprivilegien
schnorrest	schnorrest
mangelte	mangelte
Hochhäuser	Hochhäuser
schauet	schauet
Jochen	Jochen
Märtyrer	Märtyrer
Schulleiterin	Schulleiterin
vermeßest	vermeßest
folgt	folgt
sterbt	sterbt
wichsten	wichsten
Cholesterin	Cholesterin
umkämen	umkämen
Zwetschge	Zwetschge
aßest	aßest
Hirnstämmen	Hirnstämmen
Ausgangssperren	Ausgangssperren
durchläuterte	durchläuterte
holet	holet
Konfitüren	Konfitüren
erzürnet	erzürnet
Retter	Retter
dürfest	dürfest
Landstreicher	Landstreicher
lohnt	lohnt
arm	arm
dividiere	dividiere
funktionierte	funktionierte
beneidete	beneidete
faschieren	faschieren
attestierten	attestierten
notlandet	notlandet
Fahret	Fahret
Klärungen	Klärungen
Sinnen	Sinnen
Diethylether	Diethylether
Schwänzchen	Schwänzchen
wollten	wollten
misstrauest	misstrauest
offenbar	offenbar
zürnten	zürnten
verschreibt	verschreibt
urteilen	urteilen
Sorget	Sorget
verschmelze	verschmelze
krieget	krieget
Schwänzen	Schwänzen
putzte	putzte
Rasterkraftmikroskop	Rasterkraftmikroskop
wähnt	wähnt
beißt	beißt
Füllfedern	Füllfedern
Rücktritt	Rücktritt
dotierst	dotierst
verstrahlet	verstrahlet
Gasgemischen	Gasgemischen
vertäte	vertäte
Halbgott	Halbgott
grüble	grüble
bewiese	bewiese
egge	egge
Eisenkraut	Eisenkraut
Türme	Türme
Asteroide	Asteroide
sintertest	sintertest
Generationen	Generationen
gebet	gebet
brechet	brechet
bleibet	bleibet
leistete	leistete
Efeu	Efeu
spielen	spielen
Kriege	Kriege
zupfte	zupfte
Portal	Portal
Chlorat	Chlorat
Gasgemisch	Gasgemisch
Riegel	Riegel
Autonomien	Autonomien
zuppst	zuppst
Chlorid	Chlorid
verwirrt	verwirrt
Lobgesänge	Lobgesänge
rotten	rotten
Lazarett	Lazarett
überweist	überweist
verstehet	verstehet
ermächtige	ermächtige
Hebet	Hebet
Stadtbezirke	Stadtbezirke
gehört	gehört
Safran	Safran
helft	helft
Besprechungen	Besprechungen
defragmentierest	defragmentierest
pflegte	pflegte
blasen	blasen
Brieftaubenzüchter	Brieftaubenzüchter
Euphemismus	Euphemismus
wärme	wärme
begebe	begebe
füllte	füllte
Futur	Futur
außen	außen
ungefälschter	ungefälschter
dressieret	dressieret
Wanderfalken	Wanderfalken
Weinet	Weinet
predigten	predigten
Blättchen	Blättchen
Mischelement	Mischelement
erstehen	erstehen
Träumer	Träumer
Gegenleistung	Gegenleistung
Impedanz	Impedanz
setztest	setztest
Mutagenen	Mutagenen
wegführe	wegführe
rebelliertet	rebelliertet
beteuerten	beteuerten
haben	haben
Martyrologium	Martyrologium
Euren	Euren
Schnute	Schnute
analysiere	analysiere
weisen	weisen
verziehst	verziehst
Ehre	Ehre
fehlte	fehlte
Gästen	Gästen
Antimustern	Antimustern
Träumers	Träumers
reanimiere	reanimiere
Theologien	Theologien
Deinen	Deinen
Reflexionen	Reflexionen
kehrst	kehrst
Grüßet	Grüßet
Löwe	Löwe
ehrest	ehrest
steig	steig
werfet	werfet
Libelle	Libelle
Urheimaten	Urheimaten
kühle	kühle
Büstenhaltern	Büstenhaltern
möchtest	möchtest
Wespen	Wespen
erfahrest	erfahrest
gravierst	gravierst
beäugst	beäugst
haschiert	haschiert
Fische	Fische
verfolgt	verfolgt
Atommasse	Atommasse
ramme	ramme
rollten	rollten
Technetaten	Technetaten
Fischotters	Fischotters
mangeln	mangeln
fingiere	fingiere
am	am
Stilllegung	Stilllegung
reglementiert	reglementiert
Anarchisten	Anarchisten
trinkst	trinkst
belauerten	belauerten
Auge	Auge
hüpfest	hüpfest
schaffest	schaffest
zuppe	zuppe
Pflanzung	Pflanzung
moppte	moppte
Helden	Helden
schreist	schreist
flitzte	flitzte
austilge	austilge
Shortcuts	Shortcuts
trödele	trödele
evakuierte	evakuierte
Unsere	Unsere
sorget	sorget
schleimte	schleimte
bücktest	bücktest
Pausbacke	Pausbacke
verdrängen	verdrängen
Nachruf	Nachruf
Ausbeuter	Ausbeuter
redete	redete
gönnst	gönnst
wären	wären
Bevölkerungsdichte	Bevölkerungsdichte
fokussierten	fokussierten
belohnten	belohnten
verkündigt	verkündigt
Keine	Keine
gewärtigten	gewärtigten
auszogen	auszogen
Speeren	Speeren
ihn	ihn
Schlager	Schlager
erwache	erwache
Wachet	Wachet
Kalifeldspat	Kalifeldspat
plagest	plagest
restaurierten	restaurierten
Briten	Briten
Fürst	Fürst
Freizeitzentren	Freizeitzentren
Bienen	Bienen
beherrschest	beherrschest
lanciertet	lanciertet
Aase	Aase
Streife	Streife
Maßen	Maßen
piesacken	piesacken
leget	leget
Dominicanerinnen	Dominicanerinnen
Freibergit	Freibergit
wohnet	wohnet
kramten	kramten
zweifeln	zweifeln
anfinge	anfinge
glänzten	glänzten
sedimentieret	sedimentieret
optimiert	optimiert
Honigbär	Honigbär
verdammend	verdammend
verselbständigst	verselbständigst
Päckchen	Päckchen
verdamm	verdamm
jeden	jeden
erhebst	erhebst
entwickele	entwickele
Griechen	Griechen
wehrten	wehrten
verdunsten	verdunsten
heiligte	heiligte
feiere	feiere
notlande	notlande
erobern	erobern
speiest	speiest
verkapselten	verkapselten
downloadete	downloadete
Schreiet	Schreiet
Thioacetal	Thioacetal
Zehe	Zehe
Fetten	Fetten
Suffixen	Suffixen
filtern	filtern
malträtierte	malträtierte
Einwirkungen	Einwirkungen
bimmelten	bimmelten
Mitschuld	Mitschuld
Leichtmetalle	Leichtmetalle
heiß	heiß
verfanget	verfanget
Weihe	Weihe
Maultier	Maultier
mußte	mußte
schlummerte	schlummerte
glaubest	glaubest
Ambiguitäten	Ambiguitäten
liegen	liegen
Weil	Weil
repräsentierten	repräsentierten
jenen	jenen
haltet	haltet
verunglimpftet	verunglimpftet
frikassierend	frikassierend
Abfertigungsschalter	Abfertigungsschalter
sitzt	sitzt
hintertriebe	hintertriebe
Schätzen	Schätzen
initiierten	initiierten
schlabberten	schlabberten
stirbst	stirbst
verdinglichest	verdinglichest
Zainen	Zainen
anruft	anruft
darfst	darfst
unterrichten	unterrichten
Aufpralle	Aufpralle
Röcke	Röcke
häufte	häufte
betrübtet	betrübtet
Grabe	Grabe
verbündet	verbündet
knüpfet	knüpfet
stimmet	stimmet
emendierte	emendierte
werde	werde
vermeße	vermeße
hobt	hobt
anzeige	anzeige
meldeten	meldeten
bat	bat
kooperierst	kooperierst
flambierest	flambierest
Gläubigen	Gläubigen
schätzt	schätzt
versteckend	versteckend
Sippe	Sippe
Laufring	Laufring
sedimentiertet	sedimentiertet
segmentierten	segmentierten
respektierten	respektierten
verfinstert	verfinstert
Streite	Streite
Gedränge	Gedränge
Regierung	Regierung
ausführen	ausführen
stammelest	stammelest
pflücke	pflücke
glaubst	glaubst
Orgel	Orgel
hurst	hurst
WebHook	WebHook
Untern	Untern
Bube	Bube
Lobet	Lobet
sagte	sagte
entzweiest	entzweiest
tiefe	tiefe
Früchtchen	Früchtchen
Arsenbergwerk	Arsenbergwerk
beiden	beiden
tief	tief
legend	legend
schwimmst	schwimmst
erben	erben
Möbelstoff	Möbelstoff
Klauen	Klauen
filzst	filzst
Dein	Dein
gestatte	gestatte
enträtselst	enträtselst
bereitete	bereitete
häufe	häufe
stäupen	stäupen
Zipfelmütze	Zipfelmütze
letzten	letzten
Sachen	Sachen
leiste	leiste
babbeltet	babbeltet
Erstlinge	Erstlinge
Atomphysikern	Atomphysikern
abweichest	abweichest
Gibt	Gibt
driftete	driftete
Privatsachen	Privatsachen
punkteten	punkteten
Stimmen	Stimmen
Falle	Falle
Anachronismen	Anachronismen
egalisiertet	egalisiertet
concessioniert	concessioniert
verbarg	verbarg
Am	Am
lancierst	lancierst
emittiert	emittiert
Solchen	Solchen
Adlerbussard	Adlerbussard
Reliquiar	Reliquiar
kurze	kurze
Locken	Locken
initiierst	initiierst
flitzen	flitzen
dich	dich
Begrenzungen	Begrenzungen
Abflug	Abflug
bejubelst	bejubelst
blenden	blenden
Sprüchen	Sprüchen
Esset	Esset
drängten	drängten
verbraucht	verbraucht
heißet	heißet
heulet	heulet
schwimmen	schwimmen
Herabsetzung	Herabsetzung
Adventskalender	Adventskalender
Tiefen	Tiefen
fallet	fallet
Fanatiker	Fanatiker
dramatisiert	dramatisiert
Farbstoffen	Farbstoffen
lehrst	lehrst
beschlügen	beschlügen
entsetzet	entsetzet
Autokraten	Autokraten
stäupte	stäupte
Halbmonden	Halbmonden
raffiniere	raffiniere
bange	bange
vermag	vermag
Vergrößerungen	Vergrößerungen
Dienstgrade	Dienstgrade
bewässerest	bewässerest
Sexte	Sexte
Sabbatjahre	Sabbatjahre
zuhörte	zuhörte
bauest	bauest
wirst	wirst
Kirchhof	Kirchhof
stellet	stellet
bückest	bückest
gehorchte	gehorchte
kämmtet	kämmtet
entwischtet	entwischtet
Eistaucher	Eistaucher
substituierest	substituierest
bräunst	bräunst
zwänget	zwänget
Auszüge	Auszüge
Freunden	Freunden
reparieret	reparieret
hieltet	hieltet
stiftete	stiftete
erstürmt	erstürmt
lebst	lebst
kaufte	kaufte
blondieren	blondieren
reifte	reifte
Tetraiodiden	Tetraiodiden
Isolatoren	Isolatoren
zentriert	zentriert
Petersfischen	Petersfischen
Knöllchens	Knöllchens
Tübingern	Tübingern
Chlorwasserstoffmoleküls	Chlorwasserstoffmoleküls
Fromme	Fromme
begnadigst	begnadigst
Kernspaltungen	Kernspaltungen
Metallquirle	Metallquirle
ertragen	ertragen
Worten	Worten
könnet	könnet
Führet	Führet
reimte	reimte
gebären	gebären
billige	billige
Ränke	Ränke
Dithiolan	Dithiolan
wünschet	wünschet
Halbmond	Halbmond
hievten	hievten
vermischten	vermischten
Taschenwörterbuches	Taschenwörterbuches
unsres	unsres
musizierte	musizierte
Taufe	Taufe
überfallen	überfallen
kritzelst	kritzelst
dringt	dringt
treffen	treffen
Regieren	Regieren
teilen	teilen
anhanget	anhanget
dressierten	dressierten
begründetest	begründetest
dissentierte	dissentierte
Inder	Inder
flehte	flehte
Küchenmaschine	Küchenmaschine
Pflicht	Pflicht
Gespenstern	Gespenstern
Agoraphobie	Agoraphobie
laut	laut
übte	übte
scheltet	scheltet
Theologie	Theologie
Tollkirschen	Tollkirschen
replizierten	replizierten
feiert	feiert
nehmt	nehmt
Amt	Amt
springst	springst
Höhle	Höhle
Haarverlust	Haarverlust
Stämme	Stämme
protestierest	protestierest
den	den
huren	huren
Gute	Gute
Beteiligten	Beteiligten
Haue	Haue
konstatiertest	konstatiertest
schlafest	schlafest
spiele	spiele
Schlüchte	Schlüchte
Ärzte	Ärzte
verspätest	verspätest
funkelet	funkelet
nagelest	nagelest
betrübten	betrübten
entheilige	entheilige
glaube	glaube
Spende	Spende
Jahr	Jahr
dramatisieren	dramatisieren
füllen	füllen
überführt	überführt
suchen	suchen
Hinterwäldler	Hinterwäldler
Grizzlybär	Grizzlybär
Wembley-Toren	Wembley-Toren
lieget	lieget
sehnte	sehnte
motivierten	motivierten
ehrst	ehrst
Ecken	Ecken
Knaben	Knaben
schlaget	schlaget
zerschlaget	zerschlaget
kritzeln	kritzeln
geraten	geraten
bürsteten	bürsteten
selber	selber
Jahre	Jahre
Thioestere	Thioestere
Heben	Heben
verführest	verführest
besetzest	besetzest
streckte	streckte
spurtest	spurtest
Ölfässern	Ölfässern
reglementierte	reglementierte
Planer	Planer
inspirierest	inspirierest
Gedicht	Gedicht
begäben	begäben
dümpelt	dümpelt
offenbarest	offenbarest
benähmen	benähmen
erlaube	erlaube
Düfte	Düfte
grausten	grausten
faschierst	faschierst
taufe	taufe
jedes	jedes
Lotterien	Lotterien
changiere	changiere
sannen	sannen
Abschiedsbriefe	Abschiedsbriefe
Leuchtstoffen	Leuchtstoffen
Arsenolithen	Arsenolithen
Außenministerium	Außenministerium
Bifurkationen	Bifurkationen
beschlaget	beschlaget
Kochfeldern	Kochfeldern
emailliert	emailliert
denaturierten	denaturierten
legt	legt
Einer	Einer
verstörte	verstörte
murmelten	murmelten
Seelöwen	Seelöwen
Maße	Maße
Rotscheitelreiher	Rotscheitelreiher
bromiertet	bromiertet
frevles	frevles
würde	würde
betrübtest	betrübtest
stürze	stürze
steuerte	steuerte
knacktest	knacktest
beauftragt	beauftragt
Aacheners	Aacheners
Besteck	Besteck
mischst	mischst
zuteilte	zuteilte
gelobet	gelobet
kremieren	kremieren
sprechet	sprechet
Ärztinnen	Ärztinnen
Schlöte	Schlöte
besser	besser
zuppen	zuppen
Milchflaschen	Milchflaschen
reden	reden
sabbre	sabbre
Fallet	Fallet
eingehet	eingehet
Überschüsse	Überschüsse
Essigsäurechloriden	Essigsäurechloriden
Zeitplanes	Zeitplanes
Affenbrotbäumen	Affenbrotbäumen
seit	seit
auflegt	auflegt
observierst	observierst
schicke	schicke
ungehorsame	ungehorsame
liegst	liegst
Kissenschlacht	Kissenschlacht
denn	denn
fasse	fasse
Halsabschneider	Halsabschneider
ersparte	ersparte
Domäne	Domäne
Deine	Deine
zappten	zappten
anzeigte	anzeigte
Nanosatelliten	Nanosatelliten
Vesper	Vesper
verbitterte	verbitterte
anzöge	anzöge
vergaste	vergaste
Frage	Frage
berührt	berührt
warte	warte
sagen	sagen
wehren	wehren
gelang	gelang
erlösest	erlösest
Physikerin	Physikerin
eurer	eurer
Ringeltauben	Ringeltauben
Tasten	Tasten
Epidemien	Epidemien
steuerst	steuerst
endlagerten	endlagerten
Weinstöcke	Weinstöcke
lispelten	lispelten
Campingplätzen	Campingplätzen
egalisierten	egalisierten
schäme	schäme
aufhebest	aufhebest
hineinbrächten	hineinbrächten
aufstand	aufstand
rufest	rufest
emittierte	emittierte
spielte	spielte
Zeitungsenten	Zeitungsenten
emaillieret	emaillieret
überschatteten	überschatteten
fastete	fastete
buddeln	buddeln
Leset	Leset
verdammtet	verdammtet
desertierst	desertierst
quietschest	quietschest
Auszügen	Auszügen
Bromidquelle	Bromidquelle
verlassen	verlassen
unterdrücke	unterdrücke
zürntet	zürntet
Seilen	Seilen
Rauten	Rauten
Leiden	Leiden
saht	saht
vertraget	vertraget
befürchtet	befürchtet
möchtet	möchtet
designiertet	designiertet
NAND-Gatter	NAND-Gatter
protestiere	protestiere
Laubbläser	Laubbläser
Störe	Störe
blitz	blitz
stoße	stoße
Bär	Bär
Stücken	Stücken
gewähret	gewähret
erkanntet	erkanntet
erdacht	erdacht
bewahrst	bewahrst
Rotzinkerzen	Rotzinkerzen
Essigsäurechlorid	Essigsäurechlorid
schwirret	schwirret
Chlorats	Chlorats
verdränge	verdränge
unterbrächest	unterbrächest
Alles	Alles
Kavalier	Kavalier
putzt	putzt
unterstützet	unterstützet
offenbartest	offenbartest
Pinguinen	Pinguinen
Kernladungszahlen	Kernladungszahlen
unterstützten	unterstützten
Sagte	Sagte
urteilte	urteilte
opferte	opferte
wärmet	wärmet
strafst	strafst
hilft	hilft
rufet	rufet
deren	deren
umkäme	umkäme
Prüfbericht	Prüfbericht
Feind	Feind
ausgereckt	ausgereckt
Kontraindikationen	Kontraindikationen
ringe	ringe
Busen	Busen
ehren	ehren
bewahrest	bewahrest
Seetauchers	Seetauchers
bemüht	bemüht
Lesen	Lesen
harrtest	harrtest
amenagierst	amenagierst
schluchzte	schluchzte
entrümpelest	entrümpelest
Tintenfisch	Tintenfisch
Kontrollkästchen	Kontrollkästchen
verzieh	verzieh
verpufftest	verpufftest
Badezimmers	Badezimmers
dürfte	dürfte
Ich	Ich
führest	führest
arbeit	arbeit
lögest	lögest
fehlen	fehlen
übersiehst	übersiehst
sehnst	sehnst
Wirte	Wirte
pendele	pendele
suchte	suchte
dümpelte	dümpelte
frappierte	frappierte
gelangt	gelangt
Krankenscheinen	Krankenscheinen
Katamaran	Katamaran
Schuldner	Schuldner
vierten	vierten
Samstagnachmittagen	Samstagnachmittagen
Erzeugungen	Erzeugungen
Kaufkraft	Kaufkraft
negierte	negierte
unsere	unsere
Wucher	Wucher
Extremen	Extremen
Brüder	Brüder
Meinet	Meinet
kooperierte	kooperierte
speisest	speisest
schaue	schaue
baute	baute
Auguren	Auguren
Herkünften	Herkünften
faltest	faltest
Nährmedien	Nährmedien
Heuschrecken	Heuschrecken
Wehret	Wehret
Selbstversuche	Selbstversuche
Mikrowellenfilter	Mikrowellenfilter
unser	unser
Junge	Junge
verknüpfet	verknüpfet
seines	seines
kitzele	kitzele
glaubtet	glaubtet
steige	steige
stapfst	stapfst
reinige	reinige
Überziehen	Überziehen
gestaltest	gestaltest
meuterest	meuterest
Scherzes	Scherzes
Kristallen	Kristallen
porträtiert	porträtiert
Schläfchen	Schläfchen
Langschwanzpinguinen	Langschwanzpinguinen
klickte	klickte
Herkunft	Herkunft
ältesten	ältesten
Antitranspirante	Antitranspirante
leite	leite
entfachet	entfachet
kollidierten	kollidierten
vergrubt	vergrubt
prangest	prangest
ritzten	ritzten
Temperaturanstieg	Temperaturanstieg
besetzen	besetzen
beleidige	beleidige
parfümierst	parfümierst
warnet	warnet
Rechnung	Rechnung
Kakaos	Kakaos
kramst	kramst
Schlagern	Schlagern
solle	solle
Wachen	Wachen
velarisierend	velarisierend
überstehend	überstehend
Nussknackern	Nussknackern
Halbzeit	Halbzeit
Füllfeder	Füllfeder
Strontiumamalgams	Strontiumamalgams
Acht	Acht
Pfunde	Pfunde
forschen	forschen
Hadithe	Hadithe
wohnte	wohnte
bejubelte	bejubelte
Zeitungsente	Zeitungsente
Nullpunkt	Nullpunkt
imkeret	imkeret
Hinkelsteine	Hinkelsteine
taufen	taufen
langweiltest	langweiltest
blitzt	blitzt
vertreibt	vertreibt
spaltetest	spaltetest
Substanz	Substanz
Gauner	Gauner
möget	möget
Euter	Euter
Wasserquellen	Wasserquellen
verteidigte	verteidigte
Dezernat	Dezernat
diente	diente
Jungfernflüge	Jungfernflüge
ausrufen	ausrufen
verklärest	verklärest
seien	seien
Seines	Seines
zentrierest	zentrierest
verkürzt	verkürzt
stehet	stehet
ermahnt	ermahnt
Kuckucke	Kuckucke
Glauben	Glauben
Trickbetrügern	Trickbetrügern
bewürben	bewürben
bist	bist
leiten	leiten
Dudelsack	Dudelsack
spezialisierst	spezialisierst
Schönredner	Schönredner
Abszisse	Abszisse
Kryostat	Kryostat
grabbelten	grabbelten
Molybdite	Molybdite
referenzierst	referenzierst
beantragt	beantragt
Automatikgetrieben	Automatikgetrieben
Teile	Teile
nachwandeln	nachwandeln
Steuerberatern	Steuerberatern
Kadavergehorsam	Kadavergehorsam
plagen	plagen
spannt	spannt
schauest	schauest
Anmelder	Anmelder
Deinem	Deinem
entwaffnest	entwaffnest
gebt	gebt
härtet	härtet
bereitend	bereitend
vergleichet	vergleichet
transportierten	transportierten
Gewichten	Gewichten
Mopp	Mopp
Flamingo	Flamingo
Feuerteufels	Feuerteufels
wehre	wehre
deaktiviere	deaktiviere
schlängelt	schlängelt
Schild	Schild
seht	seht
hinterlegt	hinterlegt
Arbeitsbereichen	Arbeitsbereichen
halbe	halbe
fastetet	fastetet
ermächtigest	ermächtigest
vereinbaren	vereinbaren
lausche	lausche
Hochsommer	Hochsommer
hasset	hasset
regieren	regieren
prophezeie	prophezeie
dekompilierten	dekompilierten
zelte	zelte
Epiker	Epiker
verachte	verachte
Monate	Monate
Unterwerfungen	Unterwerfungen
tun	tun
fahret	fahret
Ecke	Ecke
Preisanstiegen	Preisanstiegen
Warten	Warten
entzweit	entzweit
rauschte	rauschte
Strahlentierchen	Strahlentierchen
Händedrücken	Händedrücken
eroberte	eroberte
gehörst	gehörst
Druckfehler	Druckfehler
Begrenzung	Begrenzung
Karer	Karer
trompete	trompete
bestellten	bestellten
schmiert	schmiert
zerstreuest	zerstreuest
Gibst	Gibst
pharyngalisierst	pharyngalisierst
ertönst	ertönst
jappen	jappen
Äquatoren	Äquatoren
schimmerst	schimmerst
Ingredienzen	Ingredienzen
Assimilationen	Assimilationen
wild	wild
Schreien	Schreien
Gewalttäter	Gewalttäter
Heiratsgut	Heiratsgut
beklage	beklage
unseres	unseres
schautest	schautest
Vorhäuten	Vorhäuten
entkämen	entkämen
urbanisiert	urbanisiert
Verbindungsdrähten	Verbindungsdrähten
kristallisiertest	kristallisiertest
anzeigest	anzeigest
verhalte	verhalte
Abschreckung	Abschreckung
foppte	foppte
Zapfen	Zapfen
hättest	hättest
glänzte	glänzte
verbündend	verbündend
Insulaner	Insulaner
Mauten	Mauten
Geldautomat	Geldautomat
Gebeinen	Gebeinen
suchet	suchet
Zwergschwanes	Zwergschwanes
Anker	Anker
bedient	bedient
Reinelemente	Reinelemente
schaffet	schaffet
besprichst	besprichst
Adlerbussarden	Adlerbussarden
klappten	klappten
Krieg	Krieg
Bundesgebiet	Bundesgebiet
sponseret	sponseret
nimmst	nimmst
Mönchen	Mönchen
Bleiglanzes	Bleiglanzes
Pläsieren	Pläsieren
Indianern	Indianern
Adhäsionen	Adhäsionen
gibt	gibt
Biokraftstoffes	Biokraftstoffes
Gedrängen	Gedrängen
bräunen	bräunen
zwölfte	zwölfte
frottier	frottier
Jagdhund	Jagdhund
verkündiget	verkündiget
Götzen	Götzen
Provinzen	Provinzen
producieret	producieret
durchwacht	durchwacht
mißverstehet	mißverstehet
Säcken	Säcken
fällte	fällte
Heere	Heere
nötige	nötige
Protonen	Protonen
hilfst	hilfst
Noseanen	Noseanen
Zur-Schau-Stellen	Zur-Schau-Stellen
ehe	ehe
Aerosole	Aerosole
tagten	tagten
backen	backen
schnattert	schnattert
Bauwerke	Bauwerke
setze	setze
Festons	Festons
Kommoden	Kommoden
spaltest	spaltest
zweifel	zweifel
Banketten	Banketten
bestellte	bestellte
sollten	sollten
lösen	lösen
Pferde	Pferde
Setzet	Setzet
Marokkanern	Marokkanern
leere	leere
funkeln	funkeln
Wachteln	Wachteln
Ausbeuterei	Ausbeuterei
schwächend	schwächend
Armband	Armband
spukte	spukte
fabuliere	fabuliere
hättet	hättet
stiegen	stiegen
Fellhandschuh	Fellhandschuh
begebet	begebet
erhebet	erhebet
vernickelte	vernickelte
segelte	segelte
fluktuierte	fluktuierte
Epoxiden	Epoxiden
Suffix	Suffix
wiederkamt	wiederkamt
Spiralen	Spiralen
Basilisken	Basilisken
beißet	beißet
neigest	neigest
Autonomie	Autonomie
ruhest	ruhest
Elstern	Elstern
regeln	regeln
wälzet	wälzet
amenagiere	amenagiere
Prügelstrafen	Prügelstrafen
blitzte	blitzte
Abschreckungen	Abschreckungen
beschottert	beschottert
herrschst	herrschst
Metallspiegel	Metallspiegel
Ölfasses	Ölfasses
habest	habest
zweite	zweite
geschämt	geschämt
Einfältigkeiten	Einfältigkeiten
freiwillige	freiwillige
Löwen	Löwen
Schwächungen	Schwächungen
mineralisierten	mineralisierten
zertifizierst	zertifizierst
Hallelujas	Hallelujas
warst	warst
sonderte	sonderte
Händedruck	Händedruck
filzte	filzte
Bertrandit	Bertrandit
solcher	solcher
gedenkst	gedenkst
griechischen	griechischen
schmuggle	schmuggle
Welchen	Welchen
gedachte	gedachte
begehrte	begehrte
Wembley-Tore	Wembley-Tore
Werte	Werte
Krankenschein	Krankenschein
Kleptokratien	Kleptokratien
äussern	äussern
Donnerstagabenden	Donnerstagabenden
rote	rote
Bundesgebieten	Bundesgebieten
lösten	lösten
fällt	fällt
trotzt	trotzt
mögt	mögt
murmelte	murmelte
betrüben	betrüben
versuchte	versuchte
beherrscht	beherrscht
verderbet	verderbet
beseht	beseht
Bilderstürmereien	Bilderstürmereien
Remis	Remis
fließen	fließen
folgend	folgend
Crescendo	Crescendo
danket	danket
sehest	sehest
Azubi	Azubi
Stärke	Stärke
Nanosatellit	Nanosatellit
streue	streue
bedeckt	bedeckt
verweise	verweise
wurde	wurde
grüne	grüne
demütiget	demütiget
vereinigte	vereinigte
infiziertet	infiziertet
Wären	Wären
verkündige	verkündige
alles	alles
vertagt	vertagt
bürsten	bürsten
Gründungsprivileg	Gründungsprivileg
generalisiere	generalisiere
wallfahrteten	wallfahrteten
eskaliert	eskaliert
sagst	sagst
Türklingeln	Türklingeln
Alten	Alten
surrst	surrst
Überfamilie	Überfamilie
Preisanstieg	Preisanstieg
schlagest	schlagest
stoßet	stoßet
bilden	bilden
suchst	suchst
Füßen	Füßen
Fiebermittel	Fiebermittel
Füchsin	Füchsin
Bärenfellen	Bärenfellen
erforschest	erforschest
Sorge	Sorge
Panzerschreck	Panzerschreck
harren	harren
machet	machet
Monde	Monde
Führe	Führe
Leichenschauhäuser	Leichenschauhäuser
Taube	Taube
zuteil	zuteil
trübe	trübe
löste	löste
grüßten	grüßten
laute	laute
zersetzte	zersetzte
schmeicheln	schmeicheln
Drachen	Drachen
Höret	Höret
sterbest	sterbest
plagte	plagte
pensionierest	pensionierest
Mäusen	Mäusen
schämten	schämten
lebest	lebest
vertilgt	vertilgt
Tische	Tische
Nährmediums	Nährmediums
Spanne	Spanne
sitzest	sitzest
Dominicanerin	Dominicanerin
verständig	verständig
beunruhige	beunruhige
Trübsalen	Trübsalen
Ihre	Ihre
Gallan	Gallan
Kräfte	Kräfte
folgte	folgte
entfolgte	entfolgte
schätze	schätze
flambiert	flambiert
kaufest	kaufest
respektieren	respektieren
gespeist	gespeist
Bildschirmfoto	Bildschirmfoto
schwadroniert	schwadroniert
sitzen	sitzen
Fusseln	Fusseln
Sei	Sei
scheinet	scheinet
spritzt	spritzt
legten	legten
Mähnenwölfen	Mähnenwölfen
dechiffrierend	dechiffrierend
Erfahrung	Erfahrung
Apfelbäume	Apfelbäume
vier	vier
reichte	reichte
liege	liege
bringst	bringst
Anmeldern	Anmeldern
applizirte	applizirte
sinnst	sinnst
zupftet	zupftet
Silbersulfidbelag	Silbersulfidbelag
vermutet	vermutet
wäre	wäre
Wirtschaftswissenschaft	Wirtschaftswissenschaft
Jahren	Jahren
tragen	tragen
verstecktet	verstecktet
zwängtet	zwängtet
Volltreffer	Volltreffer
verbündete	verbündete
erkaltest	erkaltest
begehre	begehre
vermutest	vermutest
lauten	lauten
karikierten	karikierten
Kannst	Kannst
Abschußringe	Abschußringe
Durchbruch	Durchbruch
Playlist	Playlist
Massenarbeitslosigkeit	Massenarbeitslosigkeit
erbest	erbest
revoltierte	revoltierte
Generation	Generation
warnt	warnt
Höhlen	Höhlen
lege	lege
schwadronierten	schwadronierten
Wache	Wache
Fußballweltmeisterschaftsqualifikationsspielen	Fußballweltmeisterschaftsqualifikationsspielen
Excimerlasern	Excimerlasern
Leiste	Leiste
anzeigen	anzeigen
duschten	duschten
quatschen	quatschen
Geschwindigkeitsmesser	Geschwindigkeitsmesser
nähe	nähe
überschattete	überschattete
Mageninhalt	Mageninhalt
Pimmel	Pimmel
räumen	räumen
gebührt	gebührt
dekompiliertest	dekompiliertest
Handbuch	Handbuch
auszögen	auszögen
extemporieret	extemporieret
Pflanzungen	Pflanzungen
Gichten	Gichten
finanziere	finanziere
simuliertet	simuliertet
übrigbleibet	übrigbleibet
glaubend	glaubend
Aerosolen	Aerosolen
betrübe	betrübe
Würzen	Würzen
Tauben	Tauben
schubset	schubset
angehören	angehören
haschieret	haschieret
Säcke	Säcke
Fällen	Fällen
ansehen	ansehen
gedenket	gedenket
Aktienkurs	Aktienkurs
gequasselt	gequasselt
Tintenfische	Tintenfische
gedenkt	gedenkt
Somite	Somite
Rechte	Rechte
Zebrahai	Zebrahai
Inauguration	Inauguration
neigte	neigte
explodierten	explodierten
Heteroatome	Heteroatome
vergibst	vergibst
Sauberfrauen	Sauberfrauen
bündelest	bündelest
thematisierten	thematisierten
Kirgisinnen	Kirgisinnen
konntet	konntet
hingehet	hingehet
Fette	Fette
Kriegsknechte	Kriegsknechte
erzwangt	erzwangt
Abhängen	Abhängen
Abbindebeschleunigern	Abbindebeschleunigern
Streiten	Streiten
gereicht	gereicht
forschte	forschte
Namen	Namen
Schnarchralle	Schnarchralle
betrügen	betrügen
verführte	verführte
eures	eures
Färsen	Färsen
Besprechung	Besprechung
Seehechten	Seehechten
Einfältigkeit	Einfältigkeit
zeichnest	zeichnest
Blicksilber	Blicksilber
Panzerschrecke	Panzerschrecke
untertretet	untertretet
berücksichtiget	berücksichtiget
erstarre	erstarre
werdest	werdest
zuppt	zuppt
tendierst	tendierst
Polizeisprechern	Polizeisprechern
Boten	Boten
verdammten	verdammten
einernten	einernten
beleidigst	beleidigst
Pfeile	Pfeile
konsolidierend	konsolidierend
herrschen	herrschen
nachwandelt	nachwandelt
gehorchet	gehorchet
dingt	dingt
Wolle	Wolle
sündiget	sündiget
durchläutert	durchläutert
Münzsammlungen	Münzsammlungen
liebtet	liebtet
lieben	lieben
nagelte	nagelte
Mäusespeck	Mäusespeck
irgendein	irgendein
fülle	fülle
Leitkegel	Leitkegel
peilst	peilst
überwachten	überwachten
Schamentzündung	Schamentzündung
frisch	frisch
annektierst	annektierst
bewährt	bewährt
baggerte	baggerte
Knüppels	Knüppels
Butzemann	Butzemann
umarmen	umarmen
bewahret	bewahret
bewahrheitete	bewahrheitete
interpretiert	interpretiert
verschmelzen	verschmelzen
hänge	hänge
Galeere	Galeere
Feinde	Feinde
kritzelet	kritzelet
Excimerlaser	Excimerlaser
fladerst	fladerst
bereuest	bereuest
Dorsch	Dorsch
verbündeten	verbündeten
Betten	Betten
Hobbys	Hobbys
Denkmünzen	Denkmünzen
porträtiere	porträtiere
Bombardierung	Bombardierung
dingten	dingten
rebellieret	rebellieret
Robe	Robe
Teilnehmerin	Teilnehmerin
Säuen	Säuen
Briefköpfen	Briefköpfen
Apostels	Apostels
tappten	tappten
Weste	Weste
fresse	fresse
breche	breche
gehören	gehören
Exzentriker	Exzentriker
Aspartamen	Aspartamen
Sprödmetallen	Sprödmetallen
betonierte	betonierte
zwölften	zwölften
einführen	einführen
impfst	impfst
mopst	mopst
manchen	manchen
süsse	süsse
besorgt	besorgt
Schnitzeljagd	Schnitzeljagd
Westen	Westen
Blattgeweben	Blattgeweben
Schwänze	Schwänze
Handbüchern	Handbüchern
Treppen	Treppen
Portale	Portale
springen	springen
Alkali	Alkali
geniertest	geniertest
mehret	mehret
Linguisten	Linguisten
wachset	wachset
Malaysier	Malaysier
Trockendocks	Trockendocks
Bankettes	Bankettes
verzweigst	verzweigst
rundest	rundest
entsetzten	entsetzten
sagest	sagest
Neuigkeiten	Neuigkeiten
legest	legest
erlauben	erlauben
erlöse	erlöse
sticke	sticke
verglichest	verglichest
Ächselchen	Ächselchen
Lichte	Lichte
mikrominiaturisiere	mikrominiaturisiere
mühte	mühte
duschte	duschte
Eiszapfen	Eiszapfen
spannte	spannte
imkernd	imkernd
Philerast	Philerast
Freunde	Freunde
Fellhandschuhen	Fellhandschuhen
loben	loben
laben	laben
klingt	klingt
Held	Held
Zirkelschluss	Zirkelschluss
Ding	Ding
Drillingen	Drillingen
erwachend	erwachend
Vogelscheuche	Vogelscheuche
Gläubige	Gläubige
pressiert	pressiert
inszenierst	inszenierst
Paillette	Paillette
berufe	berufe
halben	halben
Mobilfunknetzen	Mobilfunknetzen
unterwerfest	unterwerfest
Automatikgetriebe	Automatikgetriebe
posierst	posierst
verselbstständigest	verselbstständigest
Kernladungszahl	Kernladungszahl
Nigger	Nigger
zierte	zierte
geknautscht	geknautscht
Schwirrvögel	Schwirrvögel
Male	Male
Politologen	Politologen
Fotosynthese	Fotosynthese
gekröst	gekröst
ritt	ritt
verstörten	verstörten
trotzest	trotzest
Tiefe	Tiefe
rundet	rundet
Fluorkohlenwasserstoff	Fluorkohlenwasserstoff
verflog	verflog
weichet	weichet
reinigst	reinigst
Untier	Untier
Wer	Wer
Treppe	Treppe
verseucht	verseucht
Weinen	Weinen
zentrifugierst	zentrifugierst
Inkarnationen	Inkarnationen
Bis	Bis
besorgten	besorgten
Seile	Seile
trödeltest	trödeltest
betrübst	betrübst
Schaffe	Schaffe
gesagt	gesagt
Hummer	Hummer
funktionalisierte	funktionalisierte
Wadenbeines	Wadenbeines
Bildpunkt	Bildpunkt
fabuliert	fabuliert
Citrat	Citrat
hüpfen	hüpfen
Exilanten	Exilanten
Schnittlauche	Schnittlauche
abziehen	abziehen
Reiterschwert	Reiterschwert
Zeile	Zeile
Donoren	Donoren
ausrufest	ausrufest
rekrutiere	rekrutiere
Kaufhäusern	Kaufhäusern
Steigen	Steigen
reichtet	reichtet
Rückweg	Rückweg
hebet	hebet
Gedächtnissen	Gedächtnissen
Fröschen	Fröschen
verspielte	verspielte
Abnahme	Abnahme
dürfe	dürfe
Gebirgen	Gebirgen
sollst	sollst
hebst	hebst
bekehrst	bekehrst
vertiefet	vertiefet
entgehe	entgehe
Fellachin	Fellachin
Peptid	Peptid
hattest	hattest
häuftet	häuftet
Pflaumen	Pflaumen
Abfertigungsgebäuden	Abfertigungsgebäuden
spalten	spalten
zerbrechen	zerbrechen
schenkst	schenkst
kosten	kosten
folgst	folgst
Alteritäten	Alteritäten
Perle	Perle
Berufe	Berufe
Greyerzer	Greyerzer
Schenken	Schenken
Malaysierin	Malaysierin
Unserer	Unserer
Eilande	Eilande
leuchten	leuchten
zirpen	zirpen
Mischung	Mischung
Überschüssen	Überschüssen
Alkalien	Alkalien
Adelungen	Adelungen
bebten	bebten
tattert	tattert
zerfielen	zerfielen
lögen	lögen
Staatsführungen	Staatsführungen
Blässe	Blässe
kristallisierest	kristallisierest
zähle	zähle
Trotzkisten	Trotzkisten
verunzierte	verunzierte
eggten	eggten
erbet	erbet
gleiche	gleiche
Friesen	Friesen
bereiten	bereiten
Strahlentierchens	Strahlentierchens
parfümierte	parfümierte
Amputierten	Amputierten
Introjektion	Introjektion
stolze	stolze
Kaufleute	Kaufleute
Nachteilen	Nachteilen
Vollkornbrot	Vollkornbrot
fragst	fragst
Tumulten	Tumulten
reichst	reichst
Kerzenlichter	Kerzenlichter
umgaben	umgaben
erliegest	erliegest
kichern	kichern
Denunziationen	Denunziationen
drücken	drücken
Hochzeitstorten	Hochzeitstorten
amenagieren	amenagieren
erniedrigst	erniedrigst
sprüht	sprüht
Ion	Ion
Willst	Willst
Darlegung	Darlegung
regierte	regierte
protestieret	protestieret
Antitranspiranten	Antitranspiranten
begehrten	begehrten
Diebe	Diebe
gelobest	gelobest
läutetet	läutetet
Bildpunkten	Bildpunkten
Kleinodien	Kleinodien
Rückumlauten	Rückumlauten
Selbstversuch	Selbstversuch
Fluorgehalte	Fluorgehalte
neidest	neidest
Besuch	Besuch
wiederholte	wiederholte
Fremdwörter	Fremdwörter
Strontiumamalgamen	Strontiumamalgamen
Dürren	Dürren
endlagern	endlagern
Konzentrate	Konzentrate
Meinem	Meinem
besucht	besucht
Atemlüfte	Atemlüfte
kabelst	kabelst
Borhydrid	Borhydrid
Kassettenrekordern	Kassettenrekordern
kappten	kappten
installierten	installierten
Sucht	Sucht
beläufst	beläufst
wert	wert
Plumpsen	Plumpsen
halbierest	halbierest
deaktivierst	deaktivierst
Hirte	Hirte
beschotterten	beschotterten
bedurftest	bedurftest
suchest	suchest
stimme	stimme
Markise	Markise
stapften	stapften
Leichen	Leichen
substituierend	substituierend
Pflaume	Pflaume
liebest	liebest
formiret	formiret
wohnest	wohnest
Tausch	Tausch
Neuigkeit	Neuigkeit
versagt	versagt
aller	aller
tragt	tragt
jammern	jammern
Empörung	Empörung
vertrage	vertrage
verkündigest	verkündigest
Zahnfleischentzündung	Zahnfleischentzündung
zeugte	zeugte
Brote	Brote
Anwendungsgebiet	Anwendungsgebiet
beäugen	beäugen
Domänen	Domänen
öle	öle
heischten	heischten
anhangt	anhangt
höben	höben
vernichtete	vernichtete
Schobern	Schobern
Chronisten	Chronisten
auszöge	auszöge
Sportlerinnen	Sportlerinnen
kabeln	kabeln
knautsche	knautsche
Heeren	Heeren
speicherten	speicherten
fassest	fassest
Betainen	Betainen
charakterisiert	charakterisiert
enttäusche	enttäusche
beansprucht	beansprucht
schichteten	schichteten
hickste	hickste
Hüllenelektronen	Hüllenelektronen
käbbelte	käbbelte
knackt	knackt
karikieret	karikieret
Nukleinsäuren	Nukleinsäuren
Treibhausgasen	Treibhausgasen
sollte	sollte
Wadenbein	Wadenbein
bölket	bölket
Zeitschlitzen	Zeitschlitzen
Entsetzet	Entsetzet
schickte	schickte
ernteten	ernteten
zersetzet	zersetzet
verkaufst	verkaufst
Trübsale	Trübsale
Hunden	Hunden
erkalten	erkalten
Ältesten	Ältesten
Wühltischen	Wühltischen
beeinflusst	beeinflusst
Kerzenlichtern	Kerzenlichtern
Anhängsel	Anhängsel
verstört	verstört
leset	leset
wehte	wehte
Äther	Äther
vereinigt	vereinigt
imprägniere	imprägniere
auszieht	auszieht
Innenministerien	Innenministerien
Milzen	Milzen
Paragraphenreitern	Paragraphenreitern
tastet	tastet
Schilden	Schilden
denaturierte	denaturierte
grünte	grünte
Same	Same
begnügte	begnügte
Liebchen	Liebchen
hattet	hattet
Wiederbelebung	Wiederbelebung
Äste	Äste
bimmelte	bimmelte
vernehmest	vernehmest
erniedrigt	erniedrigt
hebräische	hebräische
entwischten	entwischten
Radfahrer	Radfahrer
Totenglocke	Totenglocke
Biene	Biene
Anachronismus	Anachronismus
Sprachräumen	Sprachräumen
zeuge	zeuge
Quellflüssen	Quellflüssen
Gasen	Gasen
idealisierest	idealisierest
wünschen	wünschen
klagen	klagen
gewünscht	gewünscht
gelobtest	gelobtest
stützet	stützet
verdeckte	verdeckte
Kupferkiese	Kupferkiese
grauten	grauten
föchte	föchte
Pfarrerinnen	Pfarrerinnen
wehrte	wehrte
gelegt	gelegt
Grenze	Grenze
Senkungen	Senkungen
scheuchen	scheuchen
Anspielungen	Anspielungen
Decket	Decket
ringen	ringen
Kairiner	Kairiner
Molybdit	Molybdit
Seinen	Seinen
Knechte	Knechte
Klaue	Klaue
schimmerest	schimmerest
Flussbetten	Flussbetten
zanket	zanket
Homodimere	Homodimere
ackerest	ackerest
Oheim	Oheim
Charakteristikan	Charakteristikan
Gurten	Gurten
Arsenite	Arsenite
fresset	fresset
Blumenstrauß	Blumenstrauß
seinen	seinen
dürfen	dürfen
Kandidaturen	Kandidaturen
Gesetze	Gesetze
Kürasse	Kürasse
Reliquiare	Reliquiare
funzt	funzt
kürze	kürze
deine	deine
orgelt	orgelt
Gammastrahlen	Gammastrahlen
grüßen	grüßen
erklingt	erklingt
Halsabschneidern	Halsabschneidern
aase	aase
fotzte	fotzte
Achseln	Achseln
Asylrechte	Asylrechte
Rückumschlages	Rückumschlages
Grab	Grab
überführen	überführen
Gefilden	Gefilden
werten	werten
Flöße	Flöße
ärgere	ärgere
Welteninsel	Welteninsel
verlieren	verlieren
jeder	jeder
gewähr	gewähr
heile	heile
Dochten	Dochten
eines	eines
planschtest	planschtest
unschuldige	unschuldige
Einrädern	Einrädern
Sprichwörtern	Sprichwörtern
glawbten	glawbten
beschrifte	beschrifte
meinet	meinet
entwendete	entwendete
Atommodellen	Atommodellen
Pfleglingen	Pfleglingen
Krokus	Krokus
zwang	zwang
weinet	weinet
Negermusik	Negermusik
entgegenkamst	entgegenkamst
handhaben	handhaben
rekrutierest	rekrutierest
Buch	Buch
zerstreut	zerstreut
ihres	ihres
schämet	schämet
jede	jede
predigte	predigte
reagierte	reagierte
Zensus	Zensus
Falzen	Falzen
stützen	stützen
nächste	nächste
Meinen	Meinen
trieb	trieb
trüb	trüb
Android	Android
Hertz	Hertz
Germanisten	Germanisten
Coventrisierung	Coventrisierung
Literaturen	Literaturen
Tollkirsche	Tollkirsche
würden	würden
Abgaskatalysatoren	Abgaskatalysatoren
streute	streute
Blattgewebe	Blattgewebe
Steige	Steige
Flossen	Flossen
Fehden	Fehden
meine	meine
höret	höret
Paradiesapfel	Paradiesapfel
schenken	schenken
vergiften	vergiften
begrub	begrub
gewurstelt	gewurstelt
benachrichtige	benachrichtige
Jünger	Jünger
attackieret	attackieret
schäumt	schäumt
bekannten	bekannten
reizte	reizte
Grabbeltischen	Grabbeltischen
quatschest	quatschest
Aktivist	Aktivist
Rehe	Rehe
missverstände	missverstände
wärst	wärst
Fokus	Fokus
begeben	begeben
skypet	skypet
Toten	Toten
ach	ach
Genetikerin	Genetikerin
prahlet	prahlet
amen	amen
anrichte	anrichte
Rundbriefe	Rundbriefe
Abartigkeit	Abartigkeit
suchten	suchten
reinstitutionalisierten	reinstitutionalisierten
zerreißt	zerreißt
batest	batest
Türkenbünden	Türkenbünden
Erzeugung	Erzeugung
Enden	Enden
zeugtest	zeugtest
Zeugnisse	Zeugnisse
Apfelbäumen	Apfelbäumen
Keilen	Keilen
zeigst	zeigst
speiset	speiset
angehört	angehört
überbewertet	überbewertet
Panamaer	Panamaer
Nehmet	Nehmet
ankerst	ankerst
installiert	installiert
verunglimpfest	verunglimpfest
wünschest	wünschest
leuchtete	leuchtete
Alle	Alle
wahre	wahre
grabest	grabest
Raben	Raben
erbrütet	erbrütet
blitzen	blitzen
babbelt	babbelt
Stempeluhren	Stempeluhren
Drillinge	Drillinge
Lautwandel	Lautwandel
Zwetschgen	Zwetschgen
grüße	grüße
halbierte	halbierte
Muhme	Muhme
wärt	wärt
glaubten	glaubten
Lautschrift	Lautschrift
Halle	Halle
verlaßt	verlaßt
Pinguin	Pinguin
heiligten	heiligten
Desserts	Desserts
ziere	ziere
Sprechers	Sprechers
verkaufte	verkaufte
Telefonverkäufer	Telefonverkäufer
gelobt	gelobt
kriegen	kriegen
Gemüseläden	Gemüseläden
belohnte	belohnte
betreibet	betreibet
deklarierte	deklarierte
versuchet	versuchet
zweifelte	zweifelte
stickt	stickt
Bagger	Bagger
baust	baust
trüge	trüge
Verbrechen	Verbrechen
Muster	Muster
Bleigehalten	Bleigehalten
Kühe	Kühe
erzeigte	erzeigte
produzierest	produzierest
Kerf	Kerf
tut	tut
ankern	ankern
gelangen	gelangen
verbitterten	verbitterten
wechselte	wechselte
pensionierten	pensionierten
Angaben	Angaben
Geschäften	Geschäften
greinen	greinen
hörest	hörest
erhörest	erhörest
Gerichten	Gerichten
sprichst	sprichst
stickten	stickten
sagten	sagten
Sehne	Sehne
befehle	befehle
prostete	prostete
Wiederauferstehung	Wiederauferstehung
Barbareien	Barbareien
Stühle	Stühle
Wert	Wert
zappen	zappen
schenket	schenket
heil	heil
verlautet	verlautet
gebündelt	gebündelt
dehydrierten	dehydrierten
Säue	Säue
ehret	ehret
Palästen	Palästen
Augengläsern	Augengläsern
flehst	flehst
bereitet	bereitet
jagst	jagst
trotze	trotze
klingest	klingest
Füße	Füße
Tintenklecks	Tintenklecks
Gebeten	Gebeten
Feierabende	Feierabende
lösest	lösest
beeindruckt	beeindruckt
auszogst	auszogst
Geschichtsbücher	Geschichtsbücher
blättertet	blättertet
boßte	boßte
Brechnuss	Brechnuss
klemmt	klemmt
destabilisierst	destabilisierst
kreierten	kreierten
Galoppen	Galoppen
gebietet	gebietet
Afrikaner	Afrikaner
brechen	brechen
plissiere	plissiere
Dobermännern	Dobermännern
konstatiere	konstatiere
Gedanke	Gedanke
könnest	könnest
Zahnfleischentzündungen	Zahnfleischentzündungen
schlabbere	schlabbere
lehnte	lehnte
verspielest	verspielest
flirre	flirre
Beschuldigung	Beschuldigung
Kriegen	Kriegen
Frösche	Frösche
Alkin	Alkin
kletteret	kletteret
bescheißt	bescheißt
Anwendungsgebiete	Anwendungsgebiete
besänftigtest	besänftigtest
fertig	fertig
schichtet	schichtet
Stühlen	Stühlen
verseuchen	verseuchen
Judenräte	Judenräte
Klassenzimmern	Klassenzimmern
diskutierst	diskutierst
Rutheniumisotop	Rutheniumisotop
deines	deines
beeindrucket	beeindrucket
keines	keines
Aas	Aas
keinem	keinem
Version	Version
defragmentierten	defragmentierten
Kein	Kein
leiden	leiden
Premierministerinnen	Premierministerinnen
Alibi	Alibi
verkehrte	verkehrte
Kapitalverkehr	Kapitalverkehr
Schicksen	Schicksen
Kalifeldspate	Kalifeldspate
zuhört	zuhört
Randbemerkung	Randbemerkung
Hirt	Hirt
wallte	wallte
verbaseln	verbaseln
stürzen	stürzen
jappte	jappte
Anhängseln	Anhängseln
parkierst	parkierst
foppten	foppten
Hahnenkämmen	Hahnenkämmen
Tukanen	Tukanen
wurden	wurden
narren	narren
Ochse	Ochse
Erzherzogshüte	Erzherzogshüte
Indern	Indern
einem	einem
suche	suche
Strafräume	Strafräume
bezahlest	bezahlest
Teufeln	Teufeln
funzen	funzen
Prophet	Prophet
bauten	bauten
Primärenergie	Primärenergie
glühenden	glühenden
verkriechst	verkriechst
Normdatum	Normdatum
bedrücktest	bedrücktest
Gehilfen	Gehilfen
revoltiert	revoltiert
verantwortetest	verantwortetest
Schal	Schal
liebtest	liebtest
Lärche	Lärche
abzieht	abzieht
Hubschraubern	Hubschraubern
solchen	solchen
erfahret	erfahret
gedurft	gedurft
seufzest	seufzest
bereiteten	bereiteten
verwahret	verwahret
verstehst	verstehst
gedacht	gedacht
Fischer	Fischer
achte	achte
setztet	setztet
gabelst	gabelst
Maxima	Maxima
gedenkest	gedenkest
illustriere	illustriere
Aktenkoffer	Aktenkoffer
vollendete	vollendete
Mageninhalten	Mageninhalten
mogelten	mogelten
solches	solches
verscheißerte	verscheißerte
blast	blast
Banden	Banden
Rotgusses	Rotgusses
stationierten	stationierten
Hurriter	Hurriter
Ackerschachtelhalme	Ackerschachtelhalme
folget	folget
ziert	ziert
mußt	mußt
babbelten	babbelten
bescheiße	bescheiße
versklavt	versklavt
blende	blende
gedenken	gedenken
bewähret	bewähret
feiertest	feiertest
eggt	eggt
laufe	laufe
beschwöre	beschwöre
füllst	füllst
gelost	gelost
gereichte	gereichte
ummantle	ummantle
rodet	rodet
Epidemie	Epidemie
Großstädtern	Großstädtern
gebühren	gebühren
kranken	kranken
sabbelt	sabbelt
Imperialismen	Imperialismen
Halte	Halte
Schotten	Schotten
reparierten	reparierten
Nussknacker	Nussknacker
Orgeln	Orgeln
Kakao	Kakao
ummantelten	ummantelten
fragte	fragte
Meine	Meine
betrübend	betrübend
Fußboden	Fußboden
begrabest	begrabest
heftetest	heftetest
schweiget	schweiget
gehorcht	gehorcht
strafen	strafen
Einsätzen	Einsätzen
säet	säet
weich	weich
Hochhäusern	Hochhäusern
Gegebenheit	Gegebenheit
durchzuckest	durchzuckest
säumen	säumen
bewieset	bewieset
Nanokondensatoren	Nanokondensatoren
Germanist	Germanist
Unterschlagungen	Unterschlagungen
Prüfberichten	Prüfberichten
imitiertet	imitiertet
Garben	Garben
aufrichtet	aufrichtet
Transportweg	Transportweg
mehrte	mehrte
fladerest	fladerest
krähen	krähen
lodertet	lodertet
verkündigten	verkündigten
gedächten	gedächten
lügst	lügst
blase	blase
Küchenmaschinen	Küchenmaschinen
dürftet	dürftet
Operationssälen	Operationssälen
Gemütes	Gemütes
Traggasen	Traggasen
zankte	zankte
Kristalle	Kristalle
Oberlandesgericht	Oberlandesgericht
stärkte	stärkte
plaziert	plaziert
Dingen	Dingen
Feuerteufel	Feuerteufel
attackieren	attackieren
referenzierte	referenzierte
labert	labert
kollidierte	kollidierte
Entrées	Entrées
Hälse	Hälse
bewässertet	bewässertet
Höhe	Höhe
vertonten	vertonten
habe	habe
erzeige	erzeige
welchen	welchen
zürnte	zürnte
Wolfesgrube	Wolfesgrube
Renegaten	Renegaten
eigenen	eigenen
umarbeiten	umarbeiten
glaubte	glaubte
setzen	setzen
stiftest	stiftest
Adeliepinguin	Adeliepinguin
verrostet	verrostet
zerfielest	zerfielest
changieren	changieren
implodiere	implodiere
gönnest	gönnest
Briefwechsel	Briefwechsel
aufhoben	aufhoben
faschieret	faschieret
sitzet	sitzet
beweise	beweise
Konifere	Konifere
Plüschtier	Plüschtier
Grüße	Grüße
Hummel	Hummel
wenden	wenden
verdamme	verdamme
versuche	versuche
herrschest	herrschest
wir	wir
fehle	fehle
Wunde	Wunde
Zeitplan	Zeitplan
Hat	Hat
colorierend	colorierend
Türklingel	Türklingel
desertiertet	desertiertet
Übelkeit	Übelkeit
unserer	unserer
konsolidierest	konsolidierest
Wüste	Wüste
Türkise	Türkise
Maß	Maß
schmuggelest	schmuggelest
Kriegsschauplätze	Kriegsschauplätze
dehydrierte	dehydrierte
Geckos	Geckos
naschten	naschten
Trinket	Trinket
Gummibaumes	Gummibaumes
Rehen	Rehen
Zeitüberschreitung	Zeitüberschreitung
erfüllet	erfüllet
scheuchten	scheuchten
Halbzeiten	Halbzeiten
manche	manche
imitiert	imitiert
Pater	Pater
redetest	redetest
Wissen	Wissen
überlieferten	überlieferten
ausführte	ausführte
lehre	lehre
betreten	betreten
Radsätzen	Radsätzen
Steuerborden	Steuerborden
bemächtigest	bemächtigest
watete	watete
schaffe	schaffe
säusele	säusele
bewässerst	bewässerst
möppertet	möppertet
angehöret	angehöret
Hörspiel	Hörspiel
Minischwein	Minischwein
legte	legte
Gepäckträger	Gepäckträger
Warte	Warte
missversteht	missversteht
grüßest	grüßest
hüte	hüte
verzeigt	verzeigt
verkauft	verkauft
Märchenbuches	Märchenbuches
grüßend	grüßend
kämmt	kämmt
Bazzit	Bazzit
drosselt	drosselt
zerstückt	zerstückt
sorge	sorge
Funkfeuern	Funkfeuern
verkürzest	verkürzest
Bote	Bote
säte	säte
nippst	nippst
gewarnt	gewarnt
Beryll	Beryll
Geschwindigkeitsmessern	Geschwindigkeitsmessern
mache	mache
gesellt	gesellt
aufkämen	aufkämen
dirigiert	dirigiert
Totgeburten	Totgeburten
Geber	Geber
betrüge	betrüge
Füllen	Füllen
verkündigte	verkündigte
fahrt	fahrt
stärke	stärke
verwirkliche	verwirkliche
Massage	Massage
wünschte	wünschte
kauten	kauten
betrete	betrete
Effekten	Effekten
schiesst	schiesst
tobte	tobte
gleitest	gleitest
kapiertet	kapiertet
demütig	demütig
reife	reife
betrübt	betrübt
Diagnostik	Diagnostik
Dunkelkammern	Dunkelkammern
Kompass	Kompass
blamierest	blamierest
Treibhausgase	Treibhausgase
hintertreiben	hintertreiben
Blockflöte	Blockflöte
filteret	filteret
Dürre	Dürre
pressierten	pressierten
entschleieret	entschleieret
vertrauten	vertrauten
Nanotesla	Nanotesla
Renegat	Renegat
Astat	Astat
Mitwisserschaft	Mitwisserschaft
Bettlers	Bettlers
Solches	Solches
Rechnungen	Rechnungen
dringst	dringst
Linien	Linien
Lümmeltüten	Lümmeltüten
Pedant	Pedant
erhöhest	erhöhest
lobte	lobte
Radiergummi	Radiergummi
Futtermittel	Futtermittel
Geflecktheiten	Geflecktheiten
glaubet	glaubet
klumpt	klumpt
Kost	Kost
eingeht	eingeht
Notizen	Notizen
quasselten	quasselten
Darlegungen	Darlegungen
Bestechungsgelder	Bestechungsgelder
Kaufleuten	Kaufleuten
leben	leben
Gaunern	Gaunern
ungefälschtem	ungefälschtem
fistet	fistet
lehnen	lehnen
desensibilisierten	desensibilisierten
Sexten	Sexten
Funktionalität	Funktionalität
heiße	heiße
drückte	drückte
predigt	predigt
Hirnstämme	Hirnstämme
zittertest	zittertest
verdreht	verdreht
betrübest	betrübest
Als	Als
Konzentrat	Konzentrat
Schlagzeuger	Schlagzeuger
Grießen	Grießen
Sichelzellenanämien	Sichelzellenanämien
rede	rede
Bällchen	Bällchen
Vogelscheuchen	Vogelscheuchen
Höhen	Höhen
wohnst	wohnst
Ösophagospasmus	Ösophagospasmus
Galopps	Galopps
schämst	schämst
spricht	spricht
Grenzen	Grenzen
Spießen	Spießen
niemanden	niemanden
speisend	speisend
losen	losen
versagen	versagen
Schnittlauch	Schnittlauch
empörte	empörte
Ölspuren	Ölspuren
Ausstiegstüren	Ausstiegstüren
schmuggele	schmuggele
Abfahrtsliste	Abfahrtsliste
Knechten	Knechten
grüntet	grüntet
Gebern	Gebern
billigen	billigen
Abtrünnige	Abtrünnige
Vordenker	Vordenker
freute	freute
Thioacetalen	Thioacetalen
unterschiede	unterschiede
Seelöwe	Seelöwe
brach	brach
Saiblinge	Saiblinge
binde	binde
Päderast	Päderast
Abhänge	Abhänge
kürzten	kürzten
waren	waren
laufet	laufet
vertuest	vertuest
Irrtumes	Irrtumes
Polierstahl	Polierstahl
ruckeln	ruckeln
Chasar	Chasar
siegte	siegte
Stämmen	Stämmen
Ängsten	Ängsten
scheue	scheue
Collagen	Collagen
kreieren	kreieren
Bestecken	Bestecken
fluchten	fluchten
abtrünnigen	abtrünnigen
produzierte	produzierte
Ach	Ach
träumte	träumte
Dienstgrad	Dienstgrad
Buchhalterinnen	Buchhalterinnen
käbbelnd	käbbelnd
Gehör	Gehör
bewiest	bewiest
läuten	läuten
legen	legen
Wäre	Wäre
Feldbett	Feldbett
hasse	hasse
kommet	kommet
beschottre	beschottre
Wärt	Wärt
harmonierte	harmonierte
punktetest	punktetest
Stilllegungen	Stilllegungen
Aggressor	Aggressor
mobilisieret	mobilisieret
Füchsinnen	Füchsinnen
pflüget	pflüget
lade	lade
versuchtet	versuchtet
reizen	reizen
besicheret	besicheret
blondiert	blondiert
Bruchstrich	Bruchstrich
armen	armen
Puffersystem	Puffersystem
Büchereien	Büchereien
lest	lest
Ärzteblättern	Ärzteblättern
bekotete	bekotete
Klotzes	Klotzes
Pailletten	Pailletten
Lammfellhandschuhs	Lammfellhandschuhs
Alltag	Alltag
reizet	reizet
Gasflaschen	Gasflaschen
Ansichtskarte	Ansichtskarte
motivieren	motivieren
blitztet	blitztet
Jagdhunden	Jagdhunden
Empörungen	Empörungen
zerstückte	zerstückte
erforschet	erforschet
grüßt	grüßt
allem	allem
transportiere	transportiere
Lasten	Lasten
bestimmst	bestimmst
Kautschuke	Kautschuke
föhnest	föhnest
ungeistlich	ungeistlich
Brite	Brite
malten	malten
Stierkämpfe	Stierkämpfe
decke	decke
bestrafe	bestrafe
sündigten	sündigten
entsündigte	entsündigte
benützt	benützt
Zubrötchen	Zubrötchen
tasteten	tasteten
sabbere	sabbere
versteigernd	versteigernd
Krusten	Krusten
Trioxid	Trioxid
mußten	mußten
sagtet	sagtet
spannen	spannen
Koniferen	Koniferen
Monaten	Monaten
nehmet	nehmet
erpresst	erpresst
aufhebt	aufhebt
Deuteriums	Deuteriums
Fahrzeugkatalysator	Fahrzeugkatalysator
umgäben	umgäben
jemand	jemand
malträtiert	malträtiert
zagt	zagt
verlobte	verlobte
schwöllen	schwöllen
Reinelementen	Reinelementen
Flosse	Flosse
schaffte	schaffte
leerst	leerst
verließen	verließen
Quelle	Quelle
führe	führe
umarmet	umarmet
Teppiche	Teppiche
maßen	maßen
Lehrbüchern	Lehrbüchern
Steine	Steine
steigerten	steigerten
Unrechten	Unrechten
duckmäusere	duckmäusere
verzieret	verzieret
prostet	prostet
ärger	ärger
häufen	häufen
verbleibet	verbleibet
Wände	Wände
Messiassen	Messiassen
Mikrometer	Mikrometer
Bluffs	Bluffs
posiert	posiert
träge	träge
verringerten	verringerten
Pardelkatze	Pardelkatze
Ästen	Ästen
Sollte	Sollte
vergrabest	vergrabest
Wiedergutmachungen	Wiedergutmachungen
Gicht	Gicht
entzogen	entzogen
ferne	ferne
versucht	versucht
naschst	naschst
bedürft	bedürft
nützt	nützt
tanzen	tanzen
Ochsen	Ochsen
Gefangene	Gefangene
Schreibern	Schreibern
bestellt	bestellt
klappen	klappen
Höfen	Höfen
saget	saget
schrecken	schrecken
heparinisiere	heparinisiere
gehst	gehst
sedimentierte	sedimentierte
ringst	ringst
Gebäck	Gebäck
koexistierte	koexistierte
schwöre	schwöre
näht	näht
Schwirrvogel	Schwirrvogel
Psi	Psi
vertreibe	vertreibe
Schwester	Schwester
beeinflusste	beeinflusste
höhnte	höhnte
pipettierten	pipettierten
Steinen	Steinen
strandend	strandend
Reinstoff	Reinstoff
regte	regte
reifst	reifst
Taufen	Taufen
Wollte	Wollte
Würfelspiele	Würfelspiele
UND-Gatter	UND-Gatter
räucheret	räucheret
Kaffeelöffel	Kaffeelöffel
Quellen	Quellen
Testamente	Testamente
verwirrest	verwirrest
leistest	leistest
greifen	greifen
Wehr	Wehr
erbringen	erbringen
Reizt	Reizt
schneidend	schneidend
Ebene	Ebene
Genkinit	Genkinit
kürzt	kürzt
hintertrieben	hintertrieben
Bunde	Bunde
Werkzeugen	Werkzeugen
Technetiumatom	Technetiumatom
Ypecaharalle	Ypecaharalle
Kortholt	Kortholt
diese	diese
Berufen	Berufen
auflegst	auflegst
All	All
aufkommen	aufkommen
Fahlflanken-Ameisenwürger	Fahlflanken-Ameisenwürger
konjugiere	konjugiere
Mähnenwolf	Mähnenwolf
Charakteristika	Charakteristika
Gerichte	Gerichte
tat	tat
Nahrungsbestandteil	Nahrungsbestandteil
Einsatz	Einsatz
gleich	gleich
Eins	Eins
rangieret	rangieret
dümpelest	dümpelest
Rosinenkuchenmodell	Rosinenkuchenmodell
Atombomben	Atombomben
glühten	glühten
verkehrten	verkehrten
Abschiedsbrief	Abschiedsbrief
ziehst	ziehst
regieret	regieret
schießt	schießt
lüg	lüg
Palisade	Palisade
kräuselten	kräuselten
harmoniere	harmoniere
verliert	verliert
heftete	heftete
illustriertet	illustriertet
Zwangsarbeiterin	Zwangsarbeiterin
wachsen	wachsen
Dudelsäcken	Dudelsäcken
Malaysierinnen	Malaysierinnen
demütigte	demütigte
Gelobt	Gelobt
präsentier	präsentier
Wisset	Wisset
Kassiterits	Kassiterits
Amnestie	Amnestie
Korrosionsschutzen	Korrosionsschutzen
Spektralbereichen	Spektralbereichen
glauben	glauben
Hirsche	Hirsche
erwähnten	erwähnten
stoßt	stoßt
Geboten	Geboten
ackerst	ackerst
Hirschen	Hirschen
vertrieb	vertrieb
spekuliere	spekuliere
Fermium	Fermium
Remisen	Remisen
strafet	strafet
weissagten	weissagten
machte	machte
Bluff	Bluff
finanziert	finanziert
Tiefschutz	Tiefschutz
Trägergasen	Trägergasen
stürzt	stürzt
raubet	raubet
vergaset	vergaset
geherrscht	geherrscht
verbüßest	verbüßest
begehret	begehret
halt	halt
pustet	pustet
lachet	lachet
Beteiligte	Beteiligte
sorgen	sorgen
versuchst	versuchst
teil	teil
generalisiert	generalisiert
vandalieren	vandalieren
siehst	siehst
sedimentiere	sedimentiere
straftet	straftet
verringertet	verringertet
Rooibos	Rooibos
Tritt	Tritt
Hüfte	Hüfte
brillieren	brillieren
hingeht	hingeht
Sigle	Sigle
pflanzen	pflanzen
glänzen	glänzen
verlautete	verlautete
verselbständigt	verselbständigt
Soll	Soll
höbest	höbest
tobet	tobet
Apportierhunde	Apportierhunde
schöben	schöben
solche	solche
schöpfe	schöpfe
Verwundeten	Verwundeten
Edelsteine	Edelsteine
Gemüt	Gemüt
gewöhnte	gewöhnte
Schneepflüge	Schneepflüge
dekoriere	dekoriere
absolviertet	absolviertet
Verkehrsflugzeuge	Verkehrsflugzeuge
Ersten	Ersten
zerfetzt	zerfetzt
Orte	Orte
Freizeitzentrum	Freizeitzentrum
geboten	geboten
Kerl	Kerl
Märchenbüchern	Märchenbüchern
Ratsherr	Ratsherr
verwirfst	verwirfst
tanze	tanze
Präservativs	Präservativs
christianisiere	christianisiere
Arbeitsunfähigkeit	Arbeitsunfähigkeit
bauet	bauet
überfällst	überfällst
Altäre	Altäre
klöne	klöne
schätzte	schätzte
gedächte	gedächte
erbte	erbte
Butzemänner	Butzemänner
Grabbeltisch	Grabbeltisch
preisen	preisen
Gehorsams	Gehorsams
Werk	Werk
Unternehmensanwendungsintegrationen	Unternehmensanwendungsintegrationen
Metallquirlen	Metallquirlen
gähne	gähne
ratschlagte	ratschlagte
applizirst	applizirst
Buchfinken	Buchfinken
zerrissen	zerrissen
besinnen	besinnen
kostet	kostet
torpediert	torpediert
hupet	hupet
Sorgen	Sorgen
fremde	fremde
Gefangenen	Gefangenen
Großstädter	Großstädter
Indianer	Indianer
Geringschätzung	Geringschätzung
duckmäuseret	duckmäuseret
Katz-und-Maus-Spielen	Katz-und-Maus-Spielen
ölt	ölt
feierte	feierte
Zementen	Zementen
hüten	hüten
greinet	greinet
Abfahrtslisten	Abfahrtslisten
Vergeltungen	Vergeltungen
Otavit	Otavit
warten	warten
unterschieden	unterschieden
Brieftaubenzüchters	Brieftaubenzüchters
Anliegen	Anliegen
beförderet	beförderet
deute	deute
verlötest	verlötest
zerrisset	zerrisset
schlabberte	schlabberte
Würfen	Würfen
legst	legst
Drang	Drang
erzeigten	erzeigten
konsumieren	konsumieren
Hektaren	Hektaren
Noseans	Noseans
stiege	stiege
Klotz	Klotz
drangen	drangen
listeten	listeten
puddelst	puddelst
wart	wart
knurrtet	knurrtet
Geheimdienst	Geheimdienst
leider	leider
Lopariten	Lopariten
Sprüche	Sprüche
Feierabend	Feierabend
anrührte	anrührte
ermordeten	ermordeten
Schlot	Schlot
siegen	siegen
Kassettenrekorder	Kassettenrekorder
Reiseleitern	Reiseleitern
bromiert	bromiert
führet	führet
zerschlagt	zerschlagt
entflöhen	entflöhen
Rechenbrett	Rechenbrett
weinst	weinst
Sündern	Sündern
Vorhäute	Vorhäute
behauptest	behauptest
replizieret	replizieret
Braunralle	Braunralle
betrübet	betrübet
faul	faul
Sabbaten	Sabbaten
Eutektikum	Eutektikum
braust	braust
plissierten	plissierten
Schläge	Schläge
lösend	lösend
langweilst	langweilst
analysierest	analysierest
drängst	drängst
Fettsack	Fettsack
verstand	verstand
ducktest	ducktest
Bebauungsplänen	Bebauungsplänen
Spektroskopie	Spektroskopie
Wegen	Wegen
gern	gern
fastetest	fastetest
Kanzleien	Kanzleien
Asiatin	Asiatin
Bertrandite	Bertrandite
Wehre	Wehre
fegst	fegst
Fettes	Fettes
schwächst	schwächst
räumet	räumet
drücke	drücke
unterwirft	unterwirft
Genies	Genies
Hallen	Hallen
Nukleinsäure	Nukleinsäure
Arme	Arme
Acetat	Acetat
grüßet	grüßet
hastete	hastete
keiner	keiner
Hektare	Hektare
kramen	kramen
Hypochlorit	Hypochlorit
Gurt	Gurt
auflöst	auflöst
Geliebte	Geliebte
Kontaktierungen	Kontaktierungen
schmettern	schmettern
tätowiertet	tätowiertet
kurbelte	kurbelte
Oberlippe	Oberlippe
eine	eine
Paragraphenreiter	Paragraphenreiter
querest	querest
Heuschrecke	Heuschrecke
ruhe	ruhe
fistete	fistete
schnorrtet	schnorrtet
dankte	dankte
keinen	keinen
erkundigte	erkundigte
knutschst	knutschst
scheiterst	scheiterst
Schaffet	Schaffet
fragmentierst	fragmentierst
scheinen	scheinen
Lehrkörpern	Lehrkörpern
berufen	berufen
Geflecktheit	Geflecktheit
Coventrisierungen	Coventrisierungen
trauerten	trauerten
vibrierend	vibrierend
webte	webte
Abkürzungsverzeichnisse	Abkürzungsverzeichnisse
Brechnüssen	Brechnüssen
trügen	trügen
gravierten	gravierten
Grieße	Grieße
tatteret	tatteret
sieht	sieht
Abbild	Abbild
formulierst	formulierst
zähltet	zähltet
prangte	prangte
vandaliere	vandaliere
Entmachtung	Entmachtung
analysieret	analysieret
Kleinode	Kleinode
arrivierst	arrivierst
schenke	schenke
Reizen	Reizen
verhören	verhören
untertreten	untertreten
exmatrikuliertet	exmatrikuliertet
lös	lös
Otaviten	Otaviten
privilegierst	privilegierst
Judenrat	Judenrat
brandet	brandet
Finanzminister	Finanzminister
tagen	tagen
Armen	Armen
Atombombe	Atombombe
verurteilen	verurteilen
streuen	streuen
glühende	glühende
bang	bang
Numerus	Numerus
ermutigte	ermutigte
Schauen	Schauen
Spielen	Spielen
Aktivisten	Aktivisten
hinterzöge	hinterzöge
Kehre	Kehre
aufrichte	aufrichte
Videoaufzeichnungen	Videoaufzeichnungen
rebelliere	rebelliere
Gerät	Gerät
strecken	strecken
Halogenatomen	Halogenatomen
Firnis	Firnis
Referenzen	Referenzen
bündelet	bündelet
Mischelementen	Mischelementen
schmierte	schmierte
Schickse	Schickse
versuchten	versuchten
lobe	lobe
Zeugen	Zeugen
Aller	Aller
entschädigte	entschädigte
höbet	höbet
Markisen	Markisen
sinkest	sinkest
Verselbstständigung	Verselbstständigung
Gässchen	Gässchen
reizest	reizest
verletzt	verletzt
Finanzministerien	Finanzministerien
verführt	verführt
lang	lang
verwahrst	verwahrst
viele	viele
bezahlt	bezahlt
Tut	Tut
Stärkungsmittel	Stärkungsmittel
hantierte	hantierte
sucht	sucht
Anfechtungen	Anfechtungen
Almanache	Almanache
privatisierest	privatisierest
deckte	deckte
Sabbatjahr	Sabbatjahr
Dorngesträuch	Dorngesträuch
klönen	klönen
Geschäfte	Geschäfte
Polyphosphat	Polyphosphat
gestikuliere	gestikuliere
regiert	regiert
thematisierte	thematisierte
beneidest	beneidest
löstest	löstest
Sonnenfinsternissen	Sonnenfinsternissen
Entsetzen	Entsetzen
Freitagnachmittagen	Freitagnachmittagen
entsündigen	entsündigen
Broten	Broten
verzeichnete	verzeichnete
Malaysiers	Malaysiers
weichst	weichst
entmineralisieren	entmineralisieren
Schneidern	Schneidern
zieren	zieren
Rotzinkerz	Rotzinkerz
entstände	entstände
Druckfehlern	Druckfehlern
Bist	Bist
erinnerest	erinnerest
Pentaborat	Pentaborat
Aufsätzen	Aufsätzen
fluche	fluche
Waren	Waren
speisen	speisen
aufnahmen	aufnahmen
geleitet	geleitet
Schwärmereien	Schwärmereien
Elementarzellen	Elementarzellen
Fäuste	Fäuste
wehrt	wehrt
Sterne	Sterne
bekriegtet	bekriegtet
Rotgüssen	Rotgüssen
Wühltische	Wühltische
addieret	addieret
appellierst	appellierst
abalieniertest	abalieniertest
denaturieret	denaturieret
möchten	möchten
Abnahmen	Abnahmen
hineinbrächte	hineinbrächte
besichtiget	besichtiget
sahet	sahet
Substanzen	Substanzen
Düften	Düften
ihre	ihre
verwahrt	verwahrt
Friedensforscherinnen	Friedensforscherinnen
Puder	Puder
malträtiere	malträtiere
Atemgasen	Atemgasen
erscheinest	erscheinest
Cyclodextrinen	Cyclodextrinen
widerstand	widerstand
sprecht	sprecht
peiltest	peiltest
ermutigt	ermutigt
inhalier	inhalier
bedingten	bedingten
Effekt	Effekt
bewerbet	bewerbet
Kehret	Kehret
sprühend	sprühend
Halleluja	Halleluja
strullerte	strullerte
drescht	drescht
Campingplatzes	Campingplatzes
Bleche	Bleche
verbaselte	verbaselte
schaben	schaben
sagt	sagt
Großfürst	Großfürst
griffen	griffen
Trübsal	Trübsal
bescherten	bescherten
stürzest	stürzest
Geräte	Geräte
Verwaltungsakte	Verwaltungsakte
zürntest	zürntest
erfüllt	erfüllt
überweisend	überweisend
erntet	erntet
Signal	Signal
kürzest	kürzest
beschlug	beschlug
