Bosra	Bosra
bereda	bereda
bevarade	bevarade
läggen	läggen
Kanaan	Kanaan
kor	kor
jämnas	jämnas
borttappade	borttappade
upphäves	upphäves
träd	träd
tänka	tänka
Vilket	Vilket
tyg	tyg
frälse	frälse
skäres	skäres
förehaves	förehaves
mala	mala
Balak	Balak
förlitar	förlitar
täckte	täckte
Iskariots	Iskariots
Moabs	Moabs
syndarna	syndarna
förmörkade	förmörkade
utvaldas	utvaldas
förste	förste
kärve	kärve
tvagna	tvagna
skrymtarna	skrymtarna
följe	följe
murare	murare
främmandes	främmandes
svansarna	svansarna
klädd	klädd
omgiven	omgiven
förlöst	förlöst
nära	nära
man	man
gräto	gräto
lägge	lägge
lutade	lutade
Jeriko	Jeriko
berövade	berövade
kullar	kullar
föröke	föröke
längs	längs
förlåta	förlåta
fåren	fåren
skadade	skadade
än	än
Jairs	Jairs
stadiers	stadiers
Brödet	Brödet
döva	döva
Baal	Baal
Hanan	Hanan
överdragen	överdragen
förliten	förliten
förlitade	förlitade
utfärdades	utfärdades
Persiens	Persiens
Labans	Labans
räddades	räddades
vredes	vredes
utsprida	utsprida
Asas	Asas
dragare	dragare
borgen	borgen
vädurens	vädurens
gjordes	gjordes
dövas	dövas
välva	välva
Heles	Heles
taga	taga
upptändas	upptändas
upptänts	upptänts
Lovat	Lovat
beskäres	beskäres
minska	minska
övriga	övriga
anden	anden
förena	förena
skuggade	skuggade
yngste	yngste
give	give
hat	hat
avla	avla
stupa	stupa
läger	läger
svävande	svävande
huggna	huggna
väta	väta
betalen	betalen
tunga	tunga
utdelade	utdelade
tåga	tåga
tröstade	tröstade
mana	mana
värma	värma
åkerstycke	åkerstycke
snara	snara
lägg	lägg
Ordet	Ordet
fruktan	fruktan
utdelat	utdelat
biträde	biträde
segrar	segrar
bit	bit
tillredda	tillredda
blotta	blotta
korn	korn
Sikem	Sikem
hyllade	hyllade
kastade	kastade
uppväcken	uppväcken
betrodda	betrodda
upplagt	upplagt
lår	lår
samlen	samlen
vinna	vinna
räta	räta
överfalla	överfalla
klipper	klipper
vederkvickt	vederkvickt
vilddjuret	vilddjuret
Elia	Elia
förstöra	förstöra
fången	fången
föda	föda
Nilens	Nilens
Salems	Salems
agat	agat
beredda	beredda
sjukt	sjukt
förgjorda	förgjorda
stjälen	stjälen
tillhöra	tillhöra
rista	rista
låge	låge
anfalla	anfalla
svalkas	svalkas
Dina	Dina
vitt	vitt
Amminadabs	Amminadabs
hörsammades	hörsammades
fostrade	fostrade
fullbordade	fullbordade
dragen	dragen
fattas	fattas
antändas	antändas
aga	aga
Kedar	Kedar
nedgjorde	nedgjorde
vändas	vändas
säljen	säljen
glädes	glädes
skänke	skänke
tvagen	tvagen
förtälj	förtälj
Jotams	Jotams
gömmas	gömmas
mat	mat
svala	svala
penningar	penningar
upploppet	upploppet
förstöres	förstöres
bygga	bygga
Sköt	Sköt
lamms	lamms
bosätta	bosätta
falla	falla
avsats	avsats
budbärare	budbärare
sväljen	sväljen
Satan	Satan
etiopier	etiopier
rötter	rötter
Arba	Arba
betade	betade
utföre	utföre
värmen	värmen
hjärta	hjärta
spik	spik
utforskade	utforskade
hyst	hyst
befälhavare	befälhavare
knyta	knyta
höljda	höljda
förströdda	förströdda
fare	fare
insatt	insatt
sänka	sänka
gripna	gripna
allting	allting
Balaks	Balaks
förlik	förlik
lögnprofeternas	lögnprofeternas
draga	draga
maka	maka
sätet	sätet
Laban	Laban
bönerna	bönerna
besatte	besatte
brända	brända
fördömen	fördömen
budordet	budordet
funna	funna
fördömd	fördömd
fogades	fogades
gömmes	gömmes
avskära	avskära
Beten	Beten
Allt	Allt
Råd	Råd
korsar	korsar
Bara	Bara
Samaria	Samaria
Nebajot	Nebajot
lösas	lösas
torka	torka
handlar	handlar
öppnas	öppnas
Jafets	Jafets
hugges	hugges
utstöta	utstöta
spännen	spännen
firade	firade
förföljda	förföljda
betydande	betydande
våldföra	våldföra
Ögat	Ögat
läge	läge
vållade	vållade
pelare	pelare
det	det
området	området
Högstes	Högstes
räddade	räddade
huvud	huvud
göras	göras
oftare	oftare
låta	låta
höjd	höjd
bitarna	bitarna
vid	vid
Judeens	Judeens
försonade	försonade
ödmjukade	ödmjukade
försvarare	försvarare
uppbygga	uppbygga
förvarades	förvarades
Sin	Sin
förnimmen	förnimmen
rannsaken	rannsaken
Bela	Bela
hållna	hållna
kort	kort
övermodet	övermodet
HERRENs	HERRENs
armen	armen
Hagars	Hagars
förhärligade	förhärligade
omringades	omringades
Isebels	Isebels
vandrade	vandrade
förstörde	förstörde
betäcka	betäcka
bevekande	bevekande
träffades	träffades
Nebo	Nebo
trätt	trätt
tjänarna	tjänarna
nästa	nästa
stenröset	stenröset
förlåte	förlåte
kränkt	kränkt
Anaks	Anaks
anställa	anställa
Landet	Landet
dräpt	dräpt
stycken	stycken
förhindrade	förhindrade
Merari	Merari
säga	säga
flotta	flotta
täcktes	täcktes
antända	antända
upplåtna	upplåtna
betänken	betänken
fördriva	fördriva
vittnesbörd	vittnesbörd
annan	annan
varde	varde
plågade	plågade
budens	budens
vätt	vätt
stickas	stickas
åter	åter
Svärdet	Svärdet
backar	backar
rest	rest
säte	säte
Ut	Ut
frågade	frågade
Edom	Edom
födda	födda
förbund	förbund
bestänka	bestänka
bon	bon
visade	visade
göden	göden
täckta	täckta
ställda	ställda
De	De
stadier	stadier
store	store
slaktades	slaktades
Leas	Leas
snår	snår
försonas	försonas
betrycktas	betrycktas
förlika	förlika
spottade	spottade
dyrkades	dyrkades
innan	innan
Natans	Natans
bägare	bägare
skurna	skurna
Jesaja	Jesaja
släktet	släktet
Lud	Lud
uppfyllda	uppfyllda
trängd	trängd
uppsökte	uppsökte
fjättrade	fjättrade
tages	tages
sådan	sådan
Geras	Geras
blive	blive
dröj	dröj
Amon	Amon
löst	löst
bespejare	bespejare
brunnarna	brunnarna
Ingen	Ingen
ytterst	ytterst
Goa	Goa
hållen	hållen
uttåget	uttåget
renade	renade
plats	plats
utför	utför
förlösa	förlösa
efterföljd	efterföljd
sprida	sprida
mätten	mätten
ökades	ökades
blotten	blotten
såddes	såddes
sådda	sådda
sakens	sakens
visas	visas
hålla	hålla
klädde	klädde
Lea	Lea
Sur	Sur
tillträde	tillträde
lycka	lycka
mönstrade	mönstrade
sakerna	sakerna
sova	sova
vrides	vrides
upptagna	upptagna
bortförde	bortförde
Jonatans	Jonatans
utkräva	utkräva
flyge	flyge
fruktade	fruktade
sås	sås
lägges	lägges
travarna	travarna
näst	näst
Josefs	Josefs
hövdingdömen	hövdingdömen
kon	kon
Jabin	Jabin
dennas	dennas
upprättades	upprättades
daglönares	daglönares
Ruben	Ruben
nitälsken	nitälsken
Sådana	Sådana
väns	väns
ingångens	ingångens
uppfödde	uppfödde
Israels	Israels
hinder	hinder
berömt	berömt
Bosras	Bosras
träta	träta
drog	drog
ofta	ofta
pålägges	pålägges
upptagen	upptagen
fälla	fälla
stärken	stärken
uppförd	uppförd
väljen	väljen
springande	springande
förrådshuset	förrådshuset
utgöres	utgöres
vanära	vanära
drivas	drivas
förtryckare	förtryckare
korsfästes	korsfästes
bränna	bränna
vässer	vässer
David	David
avbärgad	avbärgad
upphöjde	upphöjde
rädd	rädd
budet	budet
stenhuggarna	stenhuggarna
fött	fött
lamm	lamm
binda	binda
släkte	släkte
uppbygges	uppbygges
bäre	bäre
plågas	plågas
bevarades	bevarades
rättas	rättas
Hiskias	Hiskias
uppfylles	uppfylles
torg	torg
förskräckt	förskräckt
Mahalalel	Mahalalel
namnet	namnet
talades	talades
upprörd	upprörd
Sådant	Sådant
synd	synd
betänkt	betänkt
fogade	fogade
sträcka	sträcka
sålde	sålde
axet	axet
Johannes	Johannes
fria	fria
väges	väges
Ner	Ner
finnes	finnes
tagen	tagen
huvudet	huvudet
molnet	molnet
broders	broders
sångarna	sångarna
kränka	kränka
hindrade	hindrade
uträckt	uträckt
bäckarna	bäckarna
jämna	jämna
skjuten	skjuten
förbyta	förbyta
övertäckt	övertäckt
spott	spott
skrapade	skrapade
dräpes	dräpes
förleda	förleda
fördöma	fördöma
drives	drives
tvaget	tvaget
Dans	Dans
fostrare	fostrare
stiga	stiga
uppföda	uppföda
tillreds	tillreds
gripa	gripa
soven	soven
blinda	blinda
göres	göres
förkunnare	förkunnare
Sjustjärnorna	Sjustjärnorna
Antikrists	Antikrists
mörka	mörka
smida	smida
klövs	klövs
Sebaot	Sebaot
mätte	mätte
fångade	fångade
betänka	betänka
tryggade	tryggade
sålda	sålda
Båda	Båda
slösade	slösade
tryckes	tryckes
Akbors	Akbors
öken	öken
resas	resas
upptecknades	upptecknades
löpa	löpa
erövrare	erövrare
betrycktes	betrycktes
efterföljare	efterföljare
Leviatans	Leviatans
Asien	Asien
gäckas	gäckas
vänd	vänd
utsända	utsända
förordnades	förordnades
rovet	rovet
steka	steka
den	den
förblive	förblive
Vars	Vars
stupade	stupade
följda	följda
make	make
sons	sons
brinnande	brinnande
beskära	beskära
orterna	orterna
skarpa	skarpa
ryggas	ryggas
vakade	vakade
skänka	skänka
tak	tak
beträda	beträda
sträva	sträva
utrotades	utrotades
Johanan	Johanan
sina	sina
bjuda	bjuda
Amaleks	Amaleks
borrade	borrade
trängde	trängde
tycke	tycke
undersökt	undersökt
Elieser	Elieser
rötterna	rötterna
Efrons	Efrons
förordnade	förordnade
väva	väva
helgades	helgades
födes	födes
Husen	Husen
svarade	svarade
bete	bete
fördrivna	fördrivna
höjen	höjen
röres	röres
gladas	gladas
valla	valla
upplösa	upplösa
styre	styre
läka	läka
knyte	knyte
omkommo	omkommo
handla	handla
råds	råds
gapet	gapet
korset	korset
ställd	ställd
uppdrag	uppdrag
kärl	kärl
skål	skål
tycka	tycka
bot	bot
tillgiva	tillgiva
skuldoffersväduren	skuldoffersväduren
verket	verket
anletes	anletes
Benjamin	Benjamin
dricka	dricka
Jonatan	Jonatan
ammade	ammade
hjälpt	hjälpt
ingångarna	ingångarna
ringa	ringa
glänsande	glänsande
uträcken	uträcken
drype	drype
förunne	förunne
bortkastade	bortkastade
inbärgade	inbärgade
Son	Son
ek	ek
skrymtan	skrymtan
erövrade	erövrade
ristade	ristade
höjes	höjes
trälarbetet	trälarbetet
upptages	upptages
kasten	kasten
lever	lever
förlåtna	förlåtna
Serubbabel	Serubbabel
fylla	fylla
sälja	sälja
bohag	bohag
hämnas	hämnas
rättfärdigas	rättfärdigas
utbyta	utbyta
någon	någon
Edens	Edens
Vilken	Vilken
näpst	näpst
tusental	tusental
Kemuels	Kemuels
mätt	mätt
drömmar	drömmar
flyttade	flyttade
Meribas	Meribas
förleder	förleder
axens	axens
dödas	dödas
träffas	träffas
vreden	vreden
Abias	Abias
orena	orena
övrigt	övrigt
förvaltade	förvaltade
Lot	Lot
skrymtare	skrymtare
rört	rört
uppfylle	uppfylle
byggnadsverk	byggnadsverk
vända	vända
köpebrevet	köpebrevet
havande	havande
förstånd	förstånd
uppenbara	uppenbara
oren	oren
stärka	stärka
Nebajots	Nebajots
pressar	pressar
bevare	bevare
utkräves	utkräves
Lammet	Lammet
utsträckt	utsträckt
Bröder	Bröder
klagade	klagade
snärjda	snärjda
snåret	snåret
Ned	Ned
renas	renas
första	första
stänger	stänger
betänk	betänk
förökade	förökade
Lotan	Lotan
palatset	palatset
bröllop	bröllop
boks	boks
förbränna	förbränna
kramades	kramades
stigen	stigen
moderliv	moderliv
utföres	utföres
vänt	vänt
formade	formade
viljes	viljes
Arabiens	Arabiens
stört	stört
Bekers	Bekers
frätas	frätas
hövdingdömet	hövdingdömet
sko	sko
nät	nät
städer	städer
dammarna	dammarna
hemsöka	hemsöka
kröna	kröna
vederkvicka	vederkvicka
krönt	krönt
Jasons	Jasons
behövande	behövande
byar	byar
uträcka	uträcka
ämnade	ämnade
förtälja	förtälja
syns	syns
fälles	fälles
fullborde	fullborde
valv	valv
tiger	tiger
uppväcka	uppväcka
drypa	drypa
utsatta	utsatta
Melek	Melek
klädda	klädda
uppläsa	uppläsa
Assyrien	Assyrien
upplagda	upplagda
Sanna	Sanna
Sems	Sems
utvalda	utvalda
årens	årens
upptändes	upptändes
släppa	släppa
fråga	fråga
logarna	logarna
påbudet	påbudet
frågen	frågen
åt	åt
upptänden	upptänden
vindarna	vindarna
buds	buds
Ren	Ren
fyllt	fyllt
synds	synds
upplysa	upplysa
sans	sans
Judeen	Judeen
skattmästarna	skattmästarna
tillsätta	tillsätta
stötes	stötes
arbete	arbete
leden	leden
sky	sky
bud	bud
sättes	sättes
fostrades	fostrades
dån	dån
förrättade	förrättade
Sered	Sered
vara	vara
gudsfruktans	gudsfruktans
förtorkades	förtorkades
skildes	skildes
droge	droge
undantagen	undantagen
trampas	trampas
läsen	läsen
stjärntydare	stjärntydare
följeslagare	följeslagare
äktenskapsbrottet	äktenskapsbrottet
mången	mången
släcka	släcka
Adas	Adas
libyerna	libyerna
göda	göda
tända	tända
förenade	förenade
flöge	flöge
utsändes	utsändes
gödda	gödda
hälsa	hälsa
Denna	Denna
sändebudet	sändebudet
ställa	ställa
Gad	Gad
nödgas	nödgas
gods	gods
hurudant	hurudant
gudsfruktan	gudsfruktan
förgäte	förgäte
Visar	Visar
Jesajas	Jesajas
intaga	intaga
frukte	frukte
Våra	Våra
andas	andas
fläkt	fläkt
stjärntydarna	stjärntydarna
vattnade	vattnade
utgjuta	utgjuta
upplöses	upplöses
äldstes	äldstes
spenabarn	spenabarn
Sina	Sina
utsatte	utsatte
styra	styra
Gode	Gode
sårade	sårade
skylde	skylde
viskas	viskas
Undan	Undan
beträden	beträden
bön	bön
brunnens	brunnens
lider	lider
predikade	predikade
Kain	Kain
mödat	mödat
mottages	mottages
utspridde	utspridde
manade	manade
släppe	släppe
siare	siare
ring	ring
Lemek	Lemek
tusentals	tusentals
Naftali	Naftali
upplåta	upplåta
värme	värme
bärande	bärande
Taga	Taga
tillspillogiven	tillspillogiven
Jerusalem	Jerusalem
egyptierna	egyptierna
trygga	trygga
översta	översta
gäckade	gäckade
vete	vete
stormades	stormades
styckade	styckade
överlämnade	överlämnade
Vid	Vid
Alls	Alls
gräns	gräns
förbjudes	förbjudes
bortförd	bortförd
stickade	stickade
damm	damm
sökte	sökte
betryckte	betryckte
byta	byta
Et	Et
sändebud	sändebud
hoppade	hoppade
gångar	gångar
tändas	tändas
ryckes	ryckes
fräta	fräta
gören	gören
Joram	Joram
uppenbarades	uppenbarades
ära	ära
dödade	dödade
tillspillogivna	tillspillogivna
bjödo	bjödo
oss	oss
Jakob	Jakob
vilkas	vilkas
känden	känden
utrotade	utrotade
närande	närande
höj	höj
äta	äta
Simon	Simon
nätet	nätet
Sjustjärnornas	Sjustjärnornas
företagen	företagen
Talar	Talar
invånare	invånare
Syriens	Syriens
beseglades	beseglades
ringe	ringe
djuret	djuret
utsätta	utsätta
vilken	vilken
våldsverkares	våldsverkares
bröllopet	bröllopet
Eliesers	Eliesers
Nebos	Nebos
fikonträd	fikonträd
viken	viken
Saras	Saras
renades	renades
Samuels	Samuels
bruke	bruke
hölje	hölje
bin	bin
uppväckt	uppväckt
förstören	förstören
förfara	förfara
övermod	övermod
förlike	förlike
Lamm	Lamm
klappade	klappade
verke	verke
driven	driven
brännes	brännes
bägarna	bägarna
dolda	dolda
blottade	blottade
stänka	stänka
resande	resande
Samuel	Samuel
brännsår	brännsår
svänga	svänga
bjudna	bjudna
smädare	smädare
skålarna	skålarna
jämte	jämte
inviga	inviga
uträcker	uträcker
Simmas	Simmas
Gudarna	Gudarna
dukade	dukade
lugnade	lugnade
Maria	Maria
spände	spände
Gehenna	Gehenna
pluggarna	pluggarna
visen	visen
saknas	saknas
bäres	bäres
Serubbabels	Serubbabels
avskilde	avskilde
föra	föra
satte	satte
folket	folket
talen	talen
stilla	stilla
Susan	Susan
somt	somt
Seirs	Seirs
drivna	drivna
förtäljen	förtäljen
förstörda	förstörda
säljare	säljare
sågade	sågade
Ners	Ners
rådde	rådde
förskingrade	förskingrade
räcken	räcken
stjäl	stjäl
fördärven	fördärven
nästas	nästas
ut	ut
gifte	gifte
Efraim	Efraim
Vilka	Vilka
vakttornet	vakttornet
förutbestämde	förutbestämde
Jeremias	Jeremias
Orions	Orions
blåst	blåst
Joabs	Joabs
skyarna	skyarna
Meleks	Meleks
etiopierna	etiopierna
fjättrar	fjättrar
Kabul	Kabul
Abrahams	Abrahams
hjärtat	hjärtat
dömen	dömen
välj	välj
frambäres	frambäres
utsläcka	utsläcka
brunne	brunne
borgare	borgare
själva	själva
utpantning	utpantning
fatet	fatet
Omar	Omar
hör	hör
spenabarnet	spenabarnet
förrättades	förrättades
marker	marker
låga	låga
vandrarna	vandrarna
avlämnade	avlämnade
skrivare	skrivare
penningarna	penningarna
sväljt	sväljt
Faraos	Faraos
bortryckta	bortryckta
dammet	dammet
ändamål	ändamål
Massas	Massas
Noas	Noas
fästes	fästes
Ahabs	Ahabs
arks	arks
vårdar	vårdar
inställde	inställde
förda	förda
upplopp	upplopp
nederlaget	nederlaget
konungadöme	konungadöme
beta	beta
Anatots	Anatots
lidande	lidande
Asaf	Asaf
ort	ort
hoppas	hoppas
synderna	synderna
försörjare	försörjare
järn	järn
mördade	mördade
vässt	vässt
slickade	slickade
omstörtade	omstörtade
återstodo	återstodo
fiskade	fiskade
uppfyll	uppfyll
ögat	ögat
tjänen	tjänen
upphöjen	upphöjen
stängda	stängda
trängt	trängt
Soan	Soan
ena	ena
silverbägarna	silverbägarna
förökades	förökades
stillas	stillas
inbärgen	inbärgen
upphöjd	upphöjd
fältet	fältet
slaktdjuret	slaktdjuret
förskingrades	förskingrades
tröstar	tröstar
Beta	Beta
viska	viska
druckna	druckna
gripen	gripen
uppenbaras	uppenbaras
fällda	fällda
sista	sista
befästa	befästa
avmätt	avmätt
anfallen	anfallen
bunden	bunden
tagna	tagna
rövade	rövade
bruset	bruset
väcka	väcka
Job	Job
snöret	snöret
inrättade	inrättade
fetmas	fetmas
Rabbas	Rabbas
kokte	kokte
märkt	märkt
beröven	beröven
sann	sann
lärde	lärde
silverbägare	silverbägare
rädda	rädda
rena	rena
fordras	fordras
Man	Man
eder	eder
Jeremia	Jeremia
uppstånden	uppstånden
firades	firades
förunnade	förunnade
stärkt	stärkt
vakttorn	vakttorn
allt	allt
hälsade	hälsade
fallen	fallen
utgjutna	utgjutna
överdragna	överdragna
avbärgat	avbärgat
kärlet	kärlet
annat	annat
Isaks	Isaks
skäras	skäras
förtäljes	förtäljes
Mahalalels	Mahalalels
Abimelek	Abimelek
svävade	svävade
Rådet	Rådet
Mose	Mose
förtär	förtär
backarna	backarna
sköta	sköta
torkade	torkade
tjäne	tjäne
inhägnad	inhägnad
Rubens	Rubens
springa	springa
moder	moder
Hanok	Hanok
Sisaks	Sisaks
garn	garn
ända	ända
utslag	utslag
förfares	förfares
eländet	eländet
värde	värde
frambära	frambära
dömes	dömes
son	son
ledas	ledas
talade	talade
uppslukades	uppslukades
upptecknade	upptecknade
vållen	vållen
övergiven	övergiven
levande	levande
fyll	fyll
hämtade	hämtade
stillades	stillades
grunden	grunden
fötterna	fötterna
Efron	Efron
beställt	beställt
vett	vett
Milka	Milka
förbudet	förbudet
ringare	ringare
förlåten	förlåten
moderssköte	moderssköte
förslaget	förslaget
bräderna	bräderna
saker	saker
blindas	blindas
linda	linda
dolde	dolde
födde	födde
äldste	äldste
stötte	stötte
Jorams	Jorams
menen	menen
avsatt	avsatt
skådade	skådade
dräpa	dräpa
omgiva	omgiva
fördolda	fördolda
krossades	krossades
tiggare	tiggare
folk	folk
brinna	brinna
Davids	Davids
Libanon	Libanon
resa	resa
bundna	bundna
Asa	Asa
Natan	Natan
fällas	fällas
upprätta	upprätta
berömde	berömde
hala	hala
Abirams	Abirams
hennes	hennes
upptänd	upptänd
modersskötet	modersskötet
avmäta	avmäta
befälhavarna	befälhavarna
utplånade	utplånade
fullbordan	fullbordan
din	din
förgjorde	förgjorde
tyckes	tyckes
avbärga	avbärga
hölja	hölja
utrote	utrote
visar	visar
Johanna	Johanna
Resa	Resa
äras	äras
mött	mött
förundran	förundran
Marias	Marias
sitter	sitter
smälta	smälta
åka	åka
odjuret	odjuret
yttersta	yttersta
dragna	dragna
snöre	snöre
skydda	skydda
hemsökes	hemsökes
försvunno	försvunno
bevis	bevis
göra	göra
ödelägga	ödelägga
fullbordades	fullbordades
giva	giva
omgivna	omgivna
både	både
horn	horn
sänkas	sänkas
överstes	överstes
Lus	Lus
Tala	Tala
vädurarna	vädurarna
eds	eds
undantagna	undantagna
budbärarna	budbärarna
laga	laga
vittnade	vittnade
brev	brev
förkunnen	förkunnen
föröken	föröken
förbytt	förbytt
betyda	betyda
fäste	fäste
valvet	valvet
löses	löses
palats	palats
ledda	ledda
hurudana	hurudana
vaka	vaka
Husas	Husas
beskärt	beskärt
ax	ax
betryckta	betryckta
satta	satta
fiskare	fiskare
tjänade	tjänade
ställde	ställde
vita	vita
sådant	sådant
blygs	blygs
klagorop	klagorop
snart	snart
offrades	offrades
brytes	brytes
lära	lära
köpa	köpa
längtan	längtan
dödades	dödades
tystade	tystade
fast	fast
borttagen	borttagen
djur	djur
upphöjt	upphöjt
avlat	avlat
nedbrytes	nedbrytes
stänga	stänga
tänke	tänke
vallar	vallar
slagna	slagna
Abia	Abia
prisen	prisen
fetma	fetma
blåses	blåses
fat	fat
avstånd	avstånd
kokt	kokt
Sauls	Sauls
Joab	Joab
ordspråket	ordspråket
mödar	mödar
förfölja	förfölja
slösare	slösare
uppröres	uppröres
utsläckes	utsläckes
drages	drages
våldet	våldet
säkra	säkra
Gilead	Gilead
köpt	köpt
Jedutuns	Jedutuns
vann	vann
antalet	antalet
budord	budord
byggnadsverket	byggnadsverket
nymånadsdagen	nymånadsdagen
gångerna	gångerna
tjäna	tjäna
sårande	sårande
avståndet	avståndet
åkerstycken	åkerstycken
bindes	bindes
bortföra	bortföra
avlämnades	avlämnades
bestänkt	bestänkt
täcka	täcka
skriva	skriva
kallade	kallade
förhindrades	förhindrades
ordspråk	ordspråk
förgör	förgör
Hebrons	Hebrons
Elisa	Elisa
slån	slån
Esau	Esau
Ada	Ada
mods	mods
moln	moln
Gehennas	Gehennas
Ute	Ute
tillreda	tillreda
jämt	jämt
öga	öga
städerna	städerna
rykande	rykande
ben	ben
Amons	Amons
valkare	valkare
omvända	omvända
intagen	intagen
Saul	Saul
göre	göre
nederlag	nederlag
Samarias	Samarias
log	log
stenröse	stenröse
aktade	aktade
läsa	läsa
böjd	böjd
Diana	Diana
mördare	mördare
inhägnade	inhägnade
pelarna	pelarna
stinkande	stinkande
bästa	bästa
hurudan	hurudan
Talen	Talen
gräte	gräte
blott	blott
råd	råd
sträckt	sträckt
vette	vette
rykte	rykte
växe	växe
väckt	väckt
fläka	fläka
avvändes	avvändes
Dan	Dan
kysst	kysst
Baraks	Baraks
skada	skada
fårs	fårs
vanna	vanna
förfäras	förfäras
gör	gör
föröda	föröda
flögo	flögo
fyllen	fyllen
sticka	sticka
fördärv	fördärv
välvt	välvt
Berea	Berea
tågade	tågade
försvunna	försvunna
Kedars	Kedars
våra	våra
blodbad	blodbad
föres	föres
gripes	gripes
förgöres	förgöres
vant	vant
klagoropet	klagoropet
Hesron	Hesron
strutsarna	strutsarna
utvalde	utvalde
Kains	Kains
skiften	skiften
Egyptens	Egyptens
sitta	sitta
seendes	seendes
förlikt	förlikt
platserna	platserna
bedraga	bedraga
gjuta	gjuta
San	San
henne	henne
fylld	fylld
dräpe	dräpe
spikarna	spikarna
året	året
Land	Land
helas	helas
lyftes	lyftes
vrida	vrida
slitna	slitna
Nilen	Nilen
rövare	rövare
hava	hava
tankar	tankar
förföljare	förföljare
löftet	löftet
förstörs	förstörs
förvandlades	förvandlades
retade	retade
förbundet	förbundet
väckes	väckes
uträckte	uträckte
slunga	slunga
höres	höres
Arbas	Arbas
rev	rev
omfånget	omfånget
Sådan	Sådan
lyckas	lyckas
rygga	rygga
stänkt	stänkt
maakatéer	maakatéer
bedrives	bedrives
tillfrisknade	tillfrisknade
Allas	Allas
bestämde	bestämde
kyssa	kyssa
tysta	tysta
förtryck	förtryck
förbytes	förbytes
Akbor	Akbor
försvarade	försvarade
frälsare	frälsare
gästabudet	gästabudet
uppföra	uppföra
Aras	Aras
samme	samme
dröjen	dröjen
ende	ende
Meraris	Meraris
svans	svans
Sköna	Sköna
de	de
ägare	ägare
församlas	församlas
förgätna	förgätna
spridda	spridda
anklagen	anklagen
våldföres	våldföres
rike	rike
Jerikos	Jerikos
Manasse	Manasse
hon	hon
skilde	skilde
sjuke	sjuke
Libanons	Libanons
Den	Den
släkterna	släkterna
slås	slås
grannarna	grannarna
förtorkade	förtorkade
brus	brus
vårdare	vårdare
mätta	mätta
tränges	tränges
ha	ha
bakhållet	bakhållet
samtycka	samtycka
gileaditen	gileaditen
modet	modet
förståndet	förståndet
flottar	flottar
förgjordes	förgjordes
dryck	dryck
våld	våld
pressade	pressade
anställd	anställd
skäl	skäl
Salman	Salman
säljes	säljes
Gats	Gats
överdraga	överdraga
skrämmes	skrämmes
förbud	förbud
bröderna	bröderna
lidandet	lidandet
bortkastad	bortkastad
invigda	invigda
förbliva	förbliva
bältet	bältet
flyttades	flyttades
Efraims	Efraims
prisade	prisade
märka	märka
gode	gode
åkerstycket	åkerstycket
övrigas	övrigas
död	död
korsfästa	korsfästa
allas	allas
Joktans	Joktans
blodbadet	blodbadet
kriget	kriget
störes	störes
Ai	Ai
lidandes	lidandes
lama	lama
revo	revo
upphäven	upphäven
Jo	Jo
bäckens	bäckens
nitälskan	nitälskan
dyrkar	dyrkar
borgar	borgar
veta	veta
klappa	klappa
bosätten	bosätten
döma	döma
anskaffades	anskaffades
bjude	bjude
Edoms	Edoms
smälte	smälte
loven	loven
drabbades	drabbades
ringar	ringar
rikes	rikes
döpa	döpa
järnet	järnet
rov	rov
brevet	brevet
drive	drive
No	No
sköljes	sköljes
föreläses	föreläses
Jona	Jona
luta	luta
tage	tage
invig	invig
någons	någons
segrare	segrare
fördragen	fördragen
Folket	Folket
komma	komma
viskade	viskade
utsättes	utsättes
daglönare	daglönare
markens	markens
nämnes	nämnes
Tres	Tres
klagande	klagande
tänken	tänken
stycke	stycke
rörde	rörde
förskräckte	förskräckte
såld	såld
Onan	Onan
förtryckes	förtryckes
åten	åten
drage	drage
förfärade	förfärade
Hesrons	Hesrons
ed	ed
Dianas	Dianas
arv	arv
dess	dess
svin	svin
ålägges	ålägges
Kemuel	Kemuel
nedgjorda	nedgjorda
lämnades	lämnades
undersöka	undersöka
sanna	sanna
Syrien	Syrien
läst	läst
Kanaans	Kanaans
minskade	minskade
invånares	invånares
styrka	styrka
hålen	hålen
Kabuls	Kabuls
Eva	Eva
rådande	rådande
vetekorn	vetekorn
gileaditernas	gileaditernas
retas	retas
hus	hus
Hagar	Hagar
huset	huset
blyges	blyges
svalka	svalka
lyte	lyte
hjulet	hjulet
omskära	omskära
Jabins	Jabins
nämnde	nämnde
bara	bara
givna	givna
ekar	ekar
hylla	hylla
samma	samma
siste	siste
håla	håla
antändes	antändes
utplånades	utplånades
skälet	skälet
gud	gud
förkunnade	förkunnade
sälj	sälj
skjuta	skjuta
anklagare	anklagare
förtrycken	förtrycken
jagades	jagades
skifte	skifte
bedragare	bedragare
Hanes	Hanes
Farao	Farao
ihågkomma	ihågkomma
säges	säges
Jair	Jair
deltagande	deltagande
vägs	vägs
samlas	samlas
altaret	altaret
Akan	Akan
skänk	skänk
döpes	döpes
inbärga	inbärga
ringarna	ringarna
styrkas	styrkas
vana	vana
säg	säg
helgade	helgade
byggda	byggda
fikonträdet	fikonträdet
tillhörande	tillhörande
lagade	lagade
skåden	skåden
frambär	frambär
betäckt	betäckt
fortfara	fortfara
Denne	Denne
benet	benet
arbetare	arbetare
Anak	Anak
under	under
övergåve	övergåve
ansedde	ansedde
amma	amma
Judas	Judas
mottaga	mottaga
Orion	Orion
Dessa	Dessa
förrådshus	förrådshus
förra	förra
föreläsa	föreläsa
kos	kos
född	född
Betuel	Betuel
skilda	skilda
avsöndrade	avsöndrade
namns	namns
fört	fört
Sera	Sera
halt	halt
skapades	skapades
Assur	Assur
korsfästas	korsfästas
oxens	oxens
bohaget	bohaget
Babel	Babel
låte	låte
slaktet	slaktet
förres	förres
malen	malen
Tabors	Tabors
förbjuda	förbjuda
omsluten	omsluten
vetekornet	vetekornet
inträde	inträde
skrivna	skrivna
låret	låret
frälsa	frälsa
Het	Het
Tagen	Tagen
biträda	biträda
avskäres	avskäres
tillträda	tillträda
förströdde	förströdde
stige	stige
borrar	borrar
Salomo	Salomo
rikt	rikt
sovo	sovo
Melkisedeks	Melkisedeks
Assurs	Assurs
koret	koret
tackade	tackade
möta	möta
bade	bade
uppfört	uppfört
tänk	tänk
byten	byten
nästen	nästen
räddas	räddas
användes	användes
hembära	hembära
sena	sena
Leviatan	Leviatan
vedergälle	vedergälle
gileadit	gileadit
Babels	Babels
vändes	vändes
Hasor	Hasor
omkomma	omkomma
Juda	Juda
förkunnades	förkunnades
Jerusalems	Jerusalems
uppfyllen	uppfyllen
uppgiven	uppgiven
täckes	täckes
smädade	smädade
efterfölja	efterfölja
Res	Res
länge	länge
Aran	Aran
Moab	Moab
räknade	räknade
Jedutun	Jedutun
Benjamins	Benjamins
invigen	invigen
brödet	brödet
mjölet	mjölet
Hiskia	Hiskia
finne	finne
åte	åte
uppfylla	uppfylla
funno	funno
utföra	utföra
arglistigt	arglistigt
våldsverkare	våldsverkare
Alexander	Alexander
gjutes	gjutes
fästa	fästa
uppenbarade	uppenbarade
stekt	stekt
bevaren	bevaren
Sikems	Sikems
behållna	behållna
enas	enas
handlade	handlade
hörsammade	hörsammade
spejare	spejare
Ismaels	Ismaels
öra	öra
styrkes	styrkes
Rahabs	Rahabs
värden	värden
togs	togs
Berit	Berit
täckas	täckas
område	område
förras	förras
minne	minne
räckas	räckas
kors	kors
Ett	Ett
rättfärdiga	rättfärdiga
kommande	kommande
Urias	Urias
förlitat	förlitat
församlade	församlade
Arabien	Arabien
behållare	behållare
arvet	arvet
uppläst	uppläst
Falla	Falla
påskalamm	påskalamm
Sara	Sara
blåsa	blåsa
slags	slags
rycka	rycka
funnes	funnes
Amminadab	Amminadab
arms	arms
hornet	hornet
döda	döda
Vårt	Vårt
blåste	blåste
fots	fots
bredd	bredd
faders	faders
slaktade	slaktade
Tro	Tro
skilt	skilt
döm	döm
slungade	slungade
förblivande	förblivande
Beria	Beria
befästas	befästas
täcke	täcke
Salome	Salome
tabernakel	tabernakel
Högste	Högste
pålägga	pålägga
liden	liden
fyllde	fyllde
lame	lame
känd	känd
sin	sin
Jafet	Jafet
synas	synas
Akajas	Akajas
Ussia	Ussia
uppbyggda	uppbyggda
ställt	ställt
beskärd	beskärd
dessas	dessas
förgörare	förgörare
jagade	jagade
rycke	rycke
omsnärjt	omsnärjt
ryka	ryka
upphöja	upphöja
släktens	släktens
inne	inne
Om	Om
stormade	stormade
fotbladet	fotbladet
läkt	läkt
rullas	rullas
förstör	förstör
Rehabeams	Rehabeams
böjes	böjes
Elias	Elias
utbyte	utbyte
smide	smide
blinde	blinde
genomsöka	genomsöka
Mas	Mas
strävade	strävade
fördömde	fördömde
tabernakels	tabernakels
förnimma	förnimma
oxarna	oxarna
drabbade	drabbade
Abel	Abel
Hets	Hets
sådana	sådana
upprört	upprört
båda	båda
domarna	domarna
Susa	Susa
Hebron	Hebron
utsläckt	utsläckt
förtrycka	förtrycka
Antikrist	Antikrist
Det	Det
förutbestämt	förutbestämt
Sadok	Sadok
duga	duga
tiga	tiga
behöves	behöves
lysande	lysande
brännande	brännande
ökade	ökade
avskilda	avskilda
lovade	lovade
hjälpa	hjälpa
ingen	ingen
skyddade	skyddade
vårt	vårt
födas	födas
falle	falle
förtära	förtära
hämtades	hämtades
Sutelas	Sutelas
dödsrike	dödsrike
tog	tog
lida	lida
drömma	drömma
Hanna	Hanna
förlite	förlite
veten	veten
beseglade	beseglade
stode	stode
Melkisedek	Melkisedek
slaktdjur	slaktdjur
tillfrisknat	tillfrisknat
spjutet	spjutet
tyget	tyget
slakt	slakt
råder	råder
lärd	lärd
Ono	Ono
alls	alls
lånade	lånade
råda	råda
stod	stod
Obed	Obed
råkade	råkade
snärjas	snärjas
Isak	Isak
smältes	smältes
arglistig	arglistig
stadgas	stadgas
uppgives	uppgives
tornet	tornet
skarpt	skarpt
lindade	lindade
uddar	uddar
Ars	Ars
höra	höra
udd	udd
släta	släta
slagen	slagen
omstörtades	omstörtades
övertäcka	övertäcka
nämnda	nämnda
hals	hals
mättas	mättas
gudarna	gudarna
mödade	mödade
var	var
uppsatta	uppsatta
beten	beten
sjuka	sjuka
Gud	Gud
mördande	mördande
stadgen	stadgen
lägga	lägga
utfärdade	utfärdade
dessa	dessa
stengolvet	stengolvet
komme	komme
bekännare	bekännare
Dess	Dess
inbyggare	inbyggare
fördraga	fördraga
jubelår	jubelår
konungadömet	konungadömet
anskaffade	anskaffade
gap	gap
uppgiva	uppgiva
tårarna	tårarna
bära	bära
läras	läras
stallet	stallet
betrodde	betrodde
maakatéerna	maakatéerna
påbud	påbud
Milkas	Milkas
fält	fält
berget	berget
Hanoks	Hanoks
upprättade	upprättade
omsnärjde	omsnärjde
fordran	fordran
uppförde	uppförde
bälte	bälte
tränga	tränga
Vare	Vare
strida	strida
förmörkades	förmörkades
löpare	löpare
rövar	rövar
bedrage	bedrage
Aven	Aven
Både	Både
bespejade	bespejade
Hebers	Hebers
bunde	bunde
Isebel	Isebel
fatten	fatten
Ande	Ande
Datans	Datans
ödmjuka	ödmjuka
förskräckes	förskräckes
hållare	hållare
förstörd	förstörd
lämnade	lämnade
garnet	garnet
skänkt	skänkt
belopp	belopp
grunda	grunda
hos	hos
altare	altare
vind	vind
mista	mista
mötes	mötes
Gileads	Gileads
Mana	Mana
seende	seende
brodern	brodern
bars	bars
fästas	fästas
smältas	smältas
samtycke	samtycke
arbetade	arbetade
plågades	plågades
höre	höre
funne	funne
brännsåret	brännsåret
åts	åts
manas	manas
dia	dia
förehaven	förehaven
inrättades	inrättades
anställde	anställde
befäl	befäl
vilka	vilka
Anatot	Anatot
räknades	räknades
burna	burna
förlita	förlita
vin	vin
utstakat	utstakat
Datan	Datan
Sereds	Sereds
dyrkade	dyrkade
trycka	trycka
granne	granne
förundrade	förundrade
alltings	alltings
struts	struts
Berias	Berias
Tabor	Tabor
arglistighet	arglistighet
grav	grav
Loven	Loven
hembäre	hembäre
väckas	väckas
röras	röras
anklagades	anklagades
förundren	förundren
Jotam	Jotam
stenhuggare	stenhuggare
markerna	markerna
Rebeckas	Rebeckas
manades	manades
tröstare	tröstare
lärare	lärare
Svärd	Svärd
Barak	Barak
friköpa	friköpa
maakatéernas	maakatéernas
uppbådade	uppbådade
berg	berg
vätas	vätas
vedergälla	vedergälla
inbärgar	inbärgar
verkade	verkade
Hulda	Hulda
kallas	kallas
äppelträd	äppelträd
agas	agas
svarande	svarande
köpebrev	köpebrev
bärare	bärare
höljas	höljas
söks	söks
öre	öre
valkares	valkares
inmönstrade	inmönstrade
äga	äga
påskalammet	påskalammet
kullarna	kullarna
vaken	vaken
Assyriens	Assyriens
bytt	bytt
skylt	skylt
Asafs	Asafs
Fadern	Fadern
Varde	Varde
utbredde	utbredde
uppgivna	uppgivna
sätta	sätta
moderlivet	moderlivet
gränserna	gränserna
sport	sport
antal	antal
skrapa	skrapa
Anas	Anas
Ain	Ain
ställen	ställen
uträckas	uträckas
till	till
spotten	spotten
säge	säge
Joa	Joa
stöta	stöta
släkt	släkt
förvarade	förvarade
förödda	förödda
besöka	besöka
vittne	vittne
sov	sov
tänkt	tänkt
Ehud	Ehud
denne	denne
ålägga	ålägga
ost	ost
Maas	Maas
Rebecka	Rebecka
såge	såge
varen	varen
märke	märke
utroten	utroten
blottas	blottas
stadga	stadga
omfång	omfång
bekänna	bekänna
utlysa	utlysa
böjde	böjde
bliva	bliva
bygges	bygges
fordren	fordren
Gamaliels	Gamaliels
äktenskapsbrott	äktenskapsbrott
Absaloms	Absaloms
beredd	beredd
Salem	Salem
Ais	Ais
Naftalis	Naftalis
kramade	kramade
förtäres	förtäres
Uris	Uris
höje	höje
sköte	sköte
blottades	blottades
övergåvo	övergåvo
utsträcka	utsträcka
hjärtas	hjärtas
dräp	dräp
Jereds	Jereds
Manasses	Manasses
smides	smides
barn	barn
vit	vit
insatte	insatte
skiftade	skiftade
inmönstrades	inmönstrades
ene	ene
armes	armes
helade	helade
binde	binde
inställa	inställa
höljes	höljes
fattade	fattade
många	många
förstes	förstes
ansikte	ansikte
lyfta	lyfta
främmande	främmande
uppsöka	uppsöka
bortförda	bortförda
säkras	säkras
omsnärjer	omsnärjer
fördömda	fördömda
omsluta	omsluta
anställda	anställda
vilen	vilen
enda	enda
förbrännes	förbrännes
behövs	behövs
bedriva	bedriva
fören	fören
Abraham	Abraham
upplöst	upplöst
hacka	hacka
dåd	dåd
fördrives	fördrives
beskärda	beskärda
använda	använda
släckt	släckt
loge	loge
mjöl	mjöl
inbyggares	inbyggares
bruse	bruse
livs	livs
sports	sports
Haso	Haso
undan	undan
fyllas	fyllas
gömma	gömma
Joktan	Joktan
stoderna	stoderna
åker	åker
minnes	minnes
dödsriket	dödsriket
öppnade	öppnade
stillade	stillade
avhållen	avhållen
slita	slita
sabbat	sabbat
kläde	kläde
anlete	anlete
gjorda	gjorda
utrönt	utrönt
besökt	besökt
kända	kända
förhärligen	förhärligen
köpare	köpare
Bered	Bered
vinn	vinn
avbärgade	avbärgade
skattmästare	skattmästare
vet	vet
ringas	ringas
denna	denna
Jered	Jered
blygas	blygas
faste	faste
Hans	Hans
betale	betale
borttaga	borttaga
skära	skära
inbärgat	inbärgat
uppdraget	uppdraget
deltaga	deltaga
uppståndna	uppståndna
klöv	klöv
Simma	Simma
leven	leven
vittnesbördet	vittnesbördet
bitens	bitens
års	års
övergiva	övergiva
sida	sida
sliten	sliten
vrede	vrede
dina	dina
lärt	lärt
lytt	lytt
skapade	skapade
armod	armod
täckt	täckt
dröja	dröja
kastades	kastades
siares	siares
Akaja	Akaja
vilddjur	vilddjur
dricke	dricke
sjunge	sjunge
egyptiers	egyptiers
hörn	hörn
våldsverkarna	våldsverkarna
Akas	Akas
tankarna	tankarna
Lemeks	Lemeks
lögnprofeterna	lögnprofeterna
utpantat	utpantat
sångerna	sångerna
frambären	frambären
rätas	rätas
Betuels	Betuels
Bileams	Bileams
utstakade	utstakade
mäta	mäta
taket	taket
ens	ens
strålande	strålande
inträda	inträda
förjagade	förjagade
sänkt	sänkt
stengolv	stengolv
gemak	gemak
näpsa	näpsa
vise	vise
ute	ute
Helt	Helt
Aner	Aner
bevise	bevise
behöva	behöva
lyftas	lyftas
fördärvade	fördärvade
gileaditerna	gileaditerna
mark	mark
trälarbete	trälarbete
rörande	rörande
uppsatte	uppsatte
förtryckt	förtryckt
nymånadsdagar	nymånadsdagar
kalla	kalla
sändes	sändes
bakhåll	bakhåll
mönstrades	mönstrades
nedbryta	nedbryta
utfören	utfören
offrade	offrade
öppnades	öppnades
Hul	Hul
bjudes	bjudes
edens	edens
badade	badade
kärvarna	kärvarna
hörda	hörda
förtärda	förtärda
Esters	Esters
Aten	Aten
försörja	försörja
bindas	bindas
vingar	vingar
utbreda	utbreda
såren	såren
Jakobs	Jakobs
betryckt	betryckt
tillsättes	tillsättes
viljen	viljen
hålles	hålles
skuren	skuren
Resen	Resen
sto	sto
arme	arme
Asiens	Asiens
plåga	plåga
sen	sen
bortfört	bortfört
Tamars	Tamars
Eder	Eder
Ana	Ana
Sem	Sem
beskärde	beskärde
Uria	Uria
Abiram	Abiram
Bileam	Bileam
arglistige	arglistige
upphäva	upphäva
predikat	predikat
upptänt	upptänt
vila	vila
anstiftades	anstiftades
Elisas	Elisas
Gat	Gat
bedragna	bedragna
utlyst	utlyst
utslaget	utslaget
betar	betar
dom	dom
Ard	Ard
fara	fara
drogs	drogs
stall	stall
Seras	Seras
armodet	armodet
krossade	krossade
vika	vika
upptage	upptage
HERREN	HERREN
dukat	dukat
menade	menade
fördärvades	fördärvades
varandras	varandras
Lots	Lots
utforsken	utforsken
löpen	löpen
beviset	beviset
Esaus	Esaus
predikare	predikare
svinet	svinet
öst	öst
murbruk	murbruk
råka	råka
fadern	fadern
jublen	jublen
hot	hot
avvända	avvända
svängde	svängde
kände	kände
uppfödd	uppfödd
ämne	ämne
bäste	bäste
torn	torn
klippa	klippa
flyga	flyga
spridde	spridde
Ehuds	Ehuds
stor	stor
kläda	kläda
ätes	ätes
Dennes	Dennes
libyer	libyer
jublande	jublande
överlämnades	överlämnades
slätt	slätt
rannsakade	rannsakade
Abimeleks	Abimeleks
näste	näste
grumlen	grumlen
Gads	Gads
Faders	Faders
hjälpare	hjälpare
Elis	Elis
läkare	läkare
ansedda	ansedda
omgives	omgives
skugga	skugga
styrkt	styrkt
tigga	tigga
självt	självt
löfte	löfte
murar	murar
vedergäll	vedergäll
sjunga	sjunga
Massa	Massa
före	före
följande	följande
Johanans	Johanans
planterade	planterade
rulla	rulla
lagen	lagen
saknade	saknade
strålade	strålade
gjutna	gjutna
förvaltare	förvaltare
stinka	stinka
agade	agade
spjut	spjut
hörsamma	hörsamma
Beker	Beker
Evad	Evad
tills	tills
hämnare	hämnare
sköten	sköten
talar	talar
försåt	försåt
förslag	förslag
Ord	Ord
uppresa	uppresa
kännes	kännes
springare	springare
huggen	huggen
breda	breda
Heber	Heber
grumlade	grumlade
länder	länder
Sisak	Sisak
förjagades	förjagades
planteren	planteren
Abrams	Abrams
fortfarande	fortfarande
upphöjda	upphöjda
då	då
spänna	spänna
mörker	mörker
fot	fot
förehava	förehava
lånen	lånen
besatta	besatta
marks	marks
känna	känna
avhålle	avhålle
sökt	sökt
uppslukade	uppslukade
förödande	förödande
bortrycktes	bortrycktes
återstod	återstod
rädes	rädes
Sutela	Sutela
Att	Att
ödelägges	ödelägges
lammet	lammet
städ	städ
gravarna	gravarna
stjäle	stjäle
sända	sända
bräde	bräde
driva	driva
gifta	gifta
brändes	brändes
Moses	Moses
släckes	släckes
bok	bok
upplyste	upplyste
trampa	trampa
fyllda	fyllda
given	given
Baals	Baals
sådanas	sådanas
användas	användas
namn	namn
vars	vars
Abram	Abram
bådas	bådas
ösa	ösa
aktades	aktades
Iskariot	Iskariot
like	like
trampade	trampade
Rahab	Rahab
Seir	Seir
vilade	vilade
anförda	anförda
spända	spända
Vin	Vin
tryckte	tryckte
Persien	Persien
Inga	Inga
stores	stores
ansiktes	ansiktes
stänkes	stänkes
fördärvet	fördärvet
Surs	Surs
bevisade	bevisade
plugg	plugg
snärja	snärja
störste	störste
bestämda	bestämda
lösa	lösa
miste	miste
avsöndrades	avsöndrades
Abels	Abels
Gamaliel	Gamaliel
ihågkommen	ihågkommen
Sadoks	Sadoks
fortfare	fortfare
lärda	lärda
givare	givare
slites	slites
upprest	upprest
hindarna	hindarna
Belas	Belas
lända	lända
uttåg	uttåg
lika	lika
skrämma	skrämma
övergive	övergive
överfallen	överfallen
böjt	böjt
fördolde	fördolde
hemsökt	hemsökt
Ismael	Ismael
Hela	Hela
inbärgning	inbärgning
Obeds	Obeds
öppnen	öppnen
Rehabeam	Rehabeam
stött	stött
Vaken	Vaken
Joas	Joas
Ahab	Ahab
träda	träda
behålla	behålla
sålden	sålden
Jason	Jason
varandra	varandra
jubelåret	jubelåret
livet	livet
bröder	bröder
bytte	bytte
äppelträdet	äppelträdet
möte	möte
vilket	vilket
hörare	hörare
Lod	Lod
Tamar	Tamar
förtrycktas	förtrycktas
ändamålet	ändamålet
rätta	rätta
vis	vis
upplåten	upplåten
beloppet	beloppet
utbredda	utbredda
Gera	Gera
utstött	utstött
inga	inga
Bera	Bera
Tre	Tre
klövarna	klövarna
bjöden	bjöden
orenen	orenen
äte	äte
lösen	lösen
hindrades	hindrades
yngstes	yngstes
Stället	Stället
Din	Din
dryckerna	dryckerna
utröna	utröna
omskäres	omskäres
Simons	Simons
Nea	Nea
korna	korna
nymånadsdag	nymånadsdag
Ava	Ava
gästabud	gästabud
föden	föden
vida	vida
Salma	Salma
vare	vare
anföra	anföra
avfalla	avfalla
skrymtade	skrymtade
siktades	siktades
räcka	räcka
Absalom	Absalom
nödgade	nödgade
avsatserna	avsatserna
upptaga	upptaga
travare	travare
lames	lames
fattades	fattades
fotblad	fotblad
berömda	berömda
störstes	störstes
vikt	vikt
slicke	slicke
följeslagares	följeslagares
gileaditer	gileaditer
räckt	räckt
Ussias	Ussias
förvandlade	förvandlade
borttappat	borttappat
omvände	omvände
Alexanders	Alexanders
Rabba	Rabba
skött	skött
företaga	företaga
förgäta	förgäta
gånge	gånge
följd	följd
mångas	mångas
skilts	skilts
Josef	Josef
vingarna	vingarna
växt	växt
sken	sken
lugna	lugna
korer	korer
Under	Under
svälja	svälja
röra	röra
falls	falls
dräpen	dräpen
genomsökt	genomsökt
strids	strids
fallna	fallna
förödes	förödes
beställa	beställa
lovar	lovar
buren	buren
försåtet	försåtet
fatte	fatte
omringade	omringade
dennes	dennes
odjur	odjur
bespejen	bespejen
räknen	räknen
sikte	sikte
format	format
sån	sån
fiskar	fiskar
sälje	sälje
fattat	fattat
görare	görare
övergivna	övergivna
bryta	bryta
Barn	Barn
befälet	befälet
elände	elände
gräten	gräten
tjänare	tjänare
Sebaots	Sebaots
byarna	byarna
Satans	Satans
hackade	hackade
stjäla	stjäla
enes	enes
sändas	sändas
gläds	gläds
kallades	kallades
vakar	vakar
Egypten	Egypten
skapare	skapare
Meriba	Meriba
stadgar	stadgar
dugande	dugande
söka	söka
avfallna	avfallna
brukade	brukade
förgöra	förgöra
betänkte	betänkte
böja	böja
bevekt	bevekt
spejade	spejade
vände	vände
läs	läs
avsatte	avsatte
dömda	dömda
döpt	döpt
domar	domar
ödmjukas	ödmjukas
glänsa	glänsa
fördärvare	fördärvare
visa	visa
juble	juble
Abida	Abida
friköpt	friköpt
vävda	vävda
krig	krig
utgöra	utgöra
lysa	lysa
utbytte	utbytte
torget	torget
bortkastat	bortkastat
upptända	upptända
Noa	Noa
hälsades	hälsades
glada	glada
Amalek	Amalek
hjul	hjul
släppt	släppt
läses	läses
hela	hela
hören	hören
år	år
Visa	Visa
förstörare	förstörare
mister	mister
kläder	kläder
Vakna	Vakna
förtryckta	förtryckta
som	som
anstiftade	anstiftade
förskräcka	förskräcka
koken	koken
hysa	hysa
tår	tår
murbruket	murbruket
avhålla	avhålla
Sans	Sans
svalt	svalt
gives	gives
utgjutes	utgjutes
täckts	täckts
Fallen	Fallen
döme	döme
Ställ	Ställ
tungas	tungas
Folk	Folk
beredde	beredde
Guds	Guds
skölja	skölja
Jobs	Jobs
Ester	Ester
vandren	vandren
hugga	hugga
vetet	vetet
förre	förre
anförare	anförare
vattnas	vattnas
friade	friade
dödande	dödande
uppbådades	uppbådades
tillgiven	tillgiven
drucken	drucken
hövdingdöme	hövdingdöme
samlades	samlades
koka	koka
tacka	tacka
renat	renat
ark	ark
leva	leva
vanärade	vanärade
Nod	Nod
förtäre	förtäre
avfallen	avfallen
sabbaterna	sabbaterna
anklagade	anklagade
Israel	Israel
vävare	vävare
gemaket	gemaket
längten	längten
predikades	predikades
skuldoffersvädur	skuldoffersvädur
Öga	Öga
tillredes	tillredes
