поступить	поступить
молили	молили
оцепенением	оцепенением
знакомые	знакомые
вступился	вступился
исчислить	исчислить
дворах	дворах
объявила	объявила
злом	злом
оробели	оробели
нечистых	нечистых
отыщи	отыщи
саранча	саранча
бесславием	бесславием
утру	утру
белым	белым
научи	научи
посох	посох
правосудием	правосудием
ввело	ввело
дворами	дворами
Духе	Духе
объяснили	объяснили
пролить	пролить
возлюбленном	возлюбленном
Нем	Нем
сладкою	сладкою
разбит	разбит
люди	люди
встречу	встречу
поношением	поношением
отводит	отводит
тельца	тельца
узнаем	узнаем
испытанных	испытанных
одолели	одолели
одолеть	одолеть
воспели	воспели
орудием	орудием
родным	родным
проводит	проводит
засевайте	засевайте
худо	худо
пригласили	пригласили
простертая	простертая
требовать	требовать
выполняйте	выполняйте
домой	домой
поглотить	поглотить
простить	простить
испеки	испеки
отходила	отходила
уходит	уходит
каждой	каждой
изрекали	изрекали
пиши	пиши
определили	определили
вмещала	вмещала
восполнить	восполнить
померк	померк
Силом	Силом
вся	вся
подули	подули
животного	животного
принужден	принужден
дщери	дщери
написанные	написанные
обратить	обратить
исполнить	исполнить
доставить	доставить
пред	пред
главного	главного
сними	сними
сладкие	сладкие
нерадит	нерадит
объясним	объясним
выполнить	выполнить
предали	предали
избрать	избрать
положите	положите
станом	станом
морем	морем
траву	траву
вымерли	вымерли
вспомните	вспомните
проходила	проходила
подняло	подняло
одет	одет
нечестием	нечестием
обгорело	обгорело
оскверните	оскверните
учите	учите
велишь	велишь
всякой	всякой
семи	семи
убеди	убеди
глазом	глазом
иссохли	иссохли
разбился	разбился
мести	мести
опротивело	опротивело
пьяные	пьяные
бедных	бедных
предсказывали	предсказывали
сирота	сирота
котором	котором
навык	навык
немногие	немногие
поразить	поразить
внимать	внимать
обновить	обновить
города	города
смешанная	смешанная
ходи	ходи
оказывай	оказывай
правою	правою
объяснить	объяснить
запрудите	запрудите
преследовала	преследовала
какою	какою
возлюбила	возлюбила
утих	утих
отважился	отважился
оставили	оставили
обещать	обещать
сходит	сходит
растворила	растворила
выдавай	выдавай
всю	всю
левши	левши
бока	бока
раздирайте	раздирайте
Тысяча	Тысяча
осенила	осенила
новых	новых
почиет	почиет
заключен	заключен
срамить	срамить
убитых	убитых
копить	копить
пронзила	пронзила
защищать	защищать
вывело	вывело
оставить	оставить
славословить	славословить
Он	Он
мытаря	мытаря
проклят	проклят
тельцам	тельцам
овце	овце
занято	занято
назидается	назидается
плачем	плачем
унизили	унизили
тысяченачальниками	тысяченачальниками
иссохло	иссохло
оказывать	оказывать
сказывала	сказывала
доставляй	доставляй
вредили	вредили
уразумел	уразумел
потонули	потонули
собрали	собрали
избранный	избранный
уцелел	уцелел
лиц	лиц
сии	сии
которых	которых
мертвою	мертвою
странствующий	странствующий
обе	обе
находила	находила
выстрелили	выстрелили
сбить	сбить
огорчить	огорчить
зла	зла
погрешили	погрешили
поступите	поступите
человеческою	человеческою
главы	главы
приветствуют	приветствуют
преклонился	преклонился
нечистота	нечистота
всходить	всходить
удали	удали
неверующая	неверующая
твердых	твердых
почетном	почетном
возлюбленные	возлюбленные
выходили	выходили
произноси	произноси
объявить	объявить
представляй	представляй
желчи	желчи
мешке	мешке
мной	мной
вытащили	вытащили
вело	вело
питать	питать
проклятую	проклятую
новое	новое
пищи	пищи
скакать	скакать
которую	которую
гвозди	гвозди
вложи	вложи
владычествовать	владычествовать
хром	хром
плену	плену
кадила	кадила
возлюби	возлюби
имеет	имеет
беззаконием	беззаконием
пока	пока
жилищам	жилищам
убить	убить
населенного	населенного
последовало	последовало
подтверди	подтверди
святая	святая
обесчестили	обесчестили
рули	рули
чтобы	чтобы
взывайте	взывайте
зле	зле
погрешите	погрешите
налагала	налагала
жемчугом	жемчугом
согласного	согласного
тысяченачальников	тысяченачальников
родных	родных
Раба	Раба
поднятых	поднятых
разбросайте	разбросайте
напасти	напасти
утопать	утопать
приучили	приучили
строить	строить
восстать	восстать
большою	большою
наследуйте	наследуйте
распознаем	распознаем
спустился	спустился
золотого	золотого
неверен	неверен
одержимого	одержимого
жало	жало
заплатите	заплатите
тельцами	тельцами
обличить	обличить
мутите	мутите
соорудить	соорудить
открыть	открыть
второго	второго
последовала	последовала
Приветствует	Приветствует
никакою	никакою
Дан	Дан
целовала	целовала
наклонили	наклонили
призванных	призванных
сруби	сруби
покрыла	покрыла
крестишь	крестишь
камнем	камнем
мешка	мешка
избить	избить
чтить	чтить
говорили	говорили
меха	меха
строишь	строишь
видим	видим
вспомнили	вспомнили
вскормила	вскормила
населенный	населенный
наступив	наступив
благе	благе
понесло	понесло
странствуйте	странствуйте
возвращен	возвращен
жертвах	жертвах
умышляли	умышляли
кончился	кончился
грешили	грешили
выводит	выводит
обольстила	обольстила
искушай	искушай
пересчитай	пересчитай
сводом	сводом
созвали	созвали
теми	теми
удалился	удалился
вопроси	вопроси
невежд	невежд
пьяных	пьяных
больным	больным
прославлять	прославлять
засыпали	засыпали
благословили	благословили
сестре	сестре
призрак	призрак
переходили	переходили
Христу	Христу
слышим	слышим
приготовить	приготовить
написать	написать
терафима	терафима
красив	красив
побили	побили
отпирали	отпирали
уговаривать	уговаривать
заклятое	заклятое
томить	томить
составлять	составлять
бедный	бедный
подкрепили	подкрепили
оказывали	оказывали
мал	мал
желающий	желающий
лгите	лгите
святые	святые
отнятых	отнятых
служите	служите
смирен	смирен
мечи	мечи
затворив	затворив
учить	учить
крыле	крыле
самым	самым
побила	побила
научите	научите
преуспевать	преуспевать
наполнила	наполнила
саранчою	саранчою
судили	судили
выказала	выказала
страх	страх
она	она
соблазнили	соблазнили
стеснен	стеснен
образует	образует
отправился	отправился
учи	учи
унизить	унизить
сатаны	сатаны
написали	написали
уверен	уверен
тысяченачальнику	тысяченачальнику
уходи	уходи
любимую	любимую
прославили	прославили
соблюдали	соблюдали
самые	самые
самую	самую
змею	змею
людях	людях
молодых	молодых
гордою	гордою
палить	палить
остановила	остановила
служили	служили
вечера	вечера
рабе	рабе
думать	думать
молчали	молчали
животное	животное
сострадать	сострадать
страхом	страхом
искушали	искушали
наши	наши
заставили	заставили
кричите	кричите
кадили	кадили
уменьши	уменьши
привели	привели
запри	запри
вспомни	вспомни
вспоминай	вспоминай
вложить	вложить
чьем	чьем
благоговеть	благоговеть
больного	больного
выполним	выполним
золоте	золоте
убитою	убитою
нечист	нечист
проток	проток
унывали	унывали
восклицать	восклицать
удалили	удалили
точила	точила
был	был
умер	умер
огорчили	огорчили
рассудить	рассудить
сосчитайте	сосчитайте
судив	судив
любили	любили
сделай	сделай
пророчеством	пророчеством
Твоем	Твоем
поступали	поступали
спрятала	спрятала
воздала	воздала
отважен	отважен
каждого	каждого
приняты	приняты
женщиной	женщиной
человекоубийц	человекоубийц
тьмою	тьмою
Который	Который
по	по
изнеженную	изнеженную
отнесла	отнесла
прислуги	прислуги
реке	реке
Силу	Силу
хочу	хочу
построить	построить
читали	читали
ожесточите	ожесточите
письме	письме
овладели	овладели
произошло	произошло
одолело	одолело
разрешить	разрешить
стражи	стражи
навыком	навыком
заколают	заколают
пар	пар
заставить	заставить
умалился	умалился
Какой	Какой
этом	этом
вышли	вышли
крестить	крестить
Матери	Матери
Одного	Одного
спрашивать	спрашивать
роптать	роптать
отправить	отправить
обложи	обложи
вашу	вашу
силу	силу
подходить	подходить
камня	камня
смертные	смертные
напасть	напасть
возвратился	возвратился
выть	выть
бабкам	бабкам
исцеляйте	исцеляйте
победили	победили
хотят	хотят
приклонили	приклонили
обвинить	обвинить
возлегли	возлегли
делить	делить
язык	язык
челе	челе
отнеси	отнеси
вознегодовали	вознегодовали
творить	творить
познаете	познаете
перемените	перемените
отступали	отступали
продать	продать
исходила	исходила
пророчествуй	пророчествуй
собою	собою
Будь	Будь
посвятили	посвятили
осади	осади
перейдем	перейдем
замер	замер
исцеляла	исцеляла
спешит	спешит
потускли	потускли
отдай	отдай
старейшинах	старейшинах
оцепенении	оцепенении
страже	страже
обмануть	обмануть
чудным	чудным
молился	молился
мечом	мечом
сопровождали	сопровождали
устранили	устранили
войске	войске
тверд	тверд
тестом	тестом
вострепетал	вострепетал
цвет	цвет
проводят	проводят
вводить	вводить
променяли	променяли
отпускать	отпускать
преданный	преданный
считает	считает
сохраняла	сохраняла
сокрушить	сокрушить
рассудили	рассудили
всякое	всякое
разговаривают	разговаривают
словом	словом
велико	велико
излить	излить
выбросить	выбросить
трубили	трубили
хромые	хромые
ночное	ночное
разрушили	разрушили
воду	воду
взирали	взирали
благо	благо
позавидовал	позавидовал
женщиною	женщиною
доносили	доносили
тайна	тайна
смутить	смутить
возросли	возросли
сей	сей
воспламенили	воспламенили
смертным	смертным
слезу	слезу
восклицайте	восклицайте
духи	духи
замолчи	замолчи
прибавлять	прибавлять
посмеянием	посмеянием
скрепите	скрепите
обозреть	обозреть
убийце	убийце
наняли	наняли
большого	большого
моли	моли
родословных	родословных
враждовали	враждовали
уразумейте	уразумейте
четвертою	четвертою
тайны	тайны
поместила	поместила
давир	давир
трогать	трогать
Святых	Святых
разбили	разбили
потекло	потекло
какое	какое
слушающий	слушающий
давиром	давиром
спросите	спросите
благодарить	благодарить
спустила	спустила
губить	губить
скакали	скакали
Даном	Даном
целовали	целовали
ожили	ожили
молока	молока
звезд	звезд
чинили	чинили
жабы	жабы
избранное	избранное
поговорить	поговорить
жала	жала
наполнили	наполнили
первым	первым
пели	пели
запрет	запрет
самом	самом
отлучить	отлучить
испытанный	испытанный
вторым	вторым
притворы	притворы
условие	условие
помышляли	помышляли
преступить	преступить
цвете	цвете
отложите	отложите
привалили	привалили
умножили	умножили
могло	могло
приняли	приняли
произвело	произвело
страсть	страсть
заколал	заколал
совратить	совратить
содержали	содержали
избранных	избранных
соляным	соляным
узнаю	узнаю
сухие	сухие
противостать	противостать
отцов	отцов
разным	разным
зиму	зиму
принесли	принесли
посвящать	посвящать
приклонить	приклонить
терпим	терпим
бывшую	бывшую
прекрати	прекрати
упился	упился
темным	темным
строим	строим
уподобить	уподобить
поцелуй	поцелуй
Пила	Пила
возвести	возвести
отними	отними
сухою	сухою
ворону	ворону
удерживай	удерживай
стану	стану
одушевленных	одушевленных
дома	дома
научили	научили
испекла	испекла
составить	составить
больных	больных
язвы	язвы
раздавить	раздавить
выслушали	выслушали
истощила	истощила
положен	положен
изблюет	изблюет
числом	числом
поднят	поднят
доводить	доводить
благи	благи
скрытые	скрытые
написанное	написанное
отсчитайте	отсчитайте
привезла	привезла
променяй	променяй
нагой	нагой
захватили	захватили
строила	строила
любимый	любимый
голов	голов
вносите	вносите
духовных	духовных
засохла	засохла
несмысленным	несмысленным
опустошен	опустошен
узнает	узнает
Бога	Бога
заменили	заменили
покрывал	покрывал
снискать	снискать
дохну	дохну
возбудить	возбудить
отдайте	отдайте
богатый	богатый
выносили	выносили
котлом	котлом
победит	победит
благовестием	благовестием
оба	оба
превозносили	превозносили
испекли	испекли
фараоном	фараоном
Возьму	Возьму
извратить	извратить
зданием	зданием
совершить	совершить
похорони	похорони
века	века
жребием	жребием
захватить	захватить
произошли	произошли
Сам	Сам
чье	чье
они	они
божествах	божествах
вноси	вноси
уведомили	уведомили
усилили	усилили
пили	пили
ненавидели	ненавидели
откажет	откажет
сироте	сироте
небольшую	небольшую
немало	немало
начинали	начинали
благословляйте	благословляйте
об	об
держи	держи
уповайте	уповайте
ставили	ставили
научился	научился
рубите	рубите
прям	прям
возьми	возьми
сатаною	сатаною
Можете	Можете
царя	царя
каждый	каждый
отказывал	отказывал
убитые	убитые
аспидом	аспидом
убегу	убегу
начать	начать
обрати	обрати
опьянейте	опьянейте
упали	упали
нечистые	нечистые
обратите	обратите
пути	пути
утверди	утверди
Израилеву	Израилеву
Тобой	Тобой
перебило	перебило
почитай	почитай
вела	вела
заходят	заходят
скрытых	скрытых
онемеют	онемеют
приносите	приносите
провожали	провожали
объяви	объяви
разить	разить
всякую	всякую
забыли	забыли
падали	падали
любила	любила
протяни	протяни
гуслистов	гуслистов
покрывали	покрывали
приноси	приноси
меньшие	меньшие
превозносить	превозносить
сделать	сделать
вымерла	вымерла
беременную	беременную
чужой	чужой
губили	губили
воспитывали	воспитывали
возвеличить	возвеличить
воронам	воронам
поникло	поникло
покрой	покрой
утвердить	утвердить
пощадили	пощадили
проповедуйте	проповедуйте
владычествовали	владычествовали
убийца	убийца
половину	половину
похоронили	похоронили
глухой	глухой
уговаривали	уговаривали
выбежал	выбежал
осадить	осадить
спросили	спросили
счет	счет
рыдали	рыдали
уподобился	уподобился
обвязывать	обвязывать
пасли	пасли
уснул	уснул
находить	находить
принимала	принимала
подняла	подняла
уду	уду
живым	живым
платить	платить
мало	мало
благ	благ
черный	черный
молите	молите
разделите	разделите
кормите	кормите
напоили	напоили
опусти	опусти
очистили	очистили
сади	сади
вынеси	вынеси
снимали	снимали
отпирать	отпирать
рождать	рождать
прочитай	прочитай
минуло	минуло
направился	направился
проводив	проводив
разрывают	разрывают
скрывать	скрывать
бейте	бейте
дало	дало
прилагай	прилагай
слушала	слушала
твоем	твоем
воспламенился	воспламенился
блуждать	блуждать
исцели	исцели
ожесточился	ожесточился
белом	белом
требуйте	требуйте
похороните	похороните
приветствовали	приветствовали
богатым	богатым
удалить	удалить
добычу	добычу
вскричал	вскричал
образ	образ
давали	давали
выкупи	выкупи
доброю	доброю
отняты	отняты
переспим	переспим
может	может
выходим	выходим
прости	прости
сокрытую	сокрытую
ними	ними
грешить	грешить
жертву	жертву
окончить	окончить
областеначальника	областеначальника
который	который
лично	лично
скованного	скованного
жил	жил
извести	извести
выходила	выходила
растерзать	растерзать
лицом	лицом
благоговели	благоговели
предавайте	предавайте
обручу	обручу
сторожу	сторожу
сокрытые	сокрытые
обгорели	обгорели
судить	судить
уповали	уповали
простился	простился
родословные	родословные
несмысленный	несмысленный
встревожили	встревожили
наложить	наложить
известить	известить
придворных	придворных
просить	просить
язве	язве
наскучили	наскучили
хоронили	хоронили
воспрепятствовали	воспрепятствовали
отягощать	отягощать
соделались	соделались
Приветствуй	Приветствуй
знаком	знаком
согрешите	согрешите
ободрился	ободрился
святого	святого
обратила	обратила
потаенные	потаенные
помышляйте	помышляйте
натянули	натянули
сокруши	сокруши
избранного	избранного
восстало	восстало
построила	построила
другом	другом
нечиста	нечиста
долги	долги
исчисли	исчисли
Самого	Самого
доказали	доказали
заключите	заключите
потерпела	потерпела
ходу	ходу
населенные	населенные
стражу	стражу
скала	скала
вкусите	вкусите
пропали	пропали
погребен	погребен
строят	строят
сходила	сходила
жабами	жабами
благовествуй	благовествуй
худ	худ
подчинен	подчинен
вымыли	вымыли
повторите	повторите
празднуй	празднуй
ступите	ступите
предшествовали	предшествовали
заплати	заплати
блага	блага
богом	богом
вина	вина
Стану	Стану
развязала	развязала
саранчи	саранчи
простерла	простерла
побить	побить
отягощай	отягощай
отлучите	отлучите
осквернили	осквернили
собранным	собранным
поднимите	поднимите
смешанный	смешанный
предложи	предложи
возложить	возложить
отменить	отменить
протоки	протоки
Свою	Свою
вили	вили
Духа	Духа
превозносился	превозносился
возлюбленных	возлюбленных
иных	иных
успокоили	успокоили
манна	манна
вымыла	вымыла
поникли	поникли
провожу	провожу
показали	показали
освятили	освятили
получили	получили
проходит	проходит
признали	признали
влекли	влекли
лукавый	лукавый
Царя	Царя
колене	колене
умоляли	умоляли
растили	растили
доставляла	доставляла
поступили	поступили
обличи	обличи
каждая	каждая
жару	жару
иного	иного
сироты	сироты
божества	божества
Иудину	Иудину
досадовали	досадовали
избирай	избирай
летали	летали
сознаю	сознаю
строите	строите
страсти	страсти
разбила	разбила
прожил	прожил
слепых	слепых
возьмем	возьмем
скрепить	скрепить
иные	иные
отмени	отмени
увещевать	увещевать
захотела	захотела
привить	привить
найди	найди
соединился	соединился
увеличили	увеличили
избило	избило
помет	помет
права	права
отказывай	отказывай
мне	мне
подносят	подносят
находит	находит
изливали	изливали
изгнали	изгнали
вкусили	вкусили
жила	жила
река	река
соделать	соделать
чудные	чудные
половины	половины
взяла	взяла
ставила	ставила
зеленых	зеленых
разрушить	разрушить
пропало	пропало
одетый	одетый
приветствовал	приветствовал
написала	написала
преступлении	преступлении
померкли	померкли
наступили	наступили
своди	своди
сейте	сейте
сделала	сделала
созывать	созывать
умерщвляй	умерщвляй
иная	иная
управлять	управлять
блудила	блудила
сохранить	сохранить
сделайте	сделайте
лгали	лгали
рой	рой
выстроили	выстроили
Тобою	Тобою
исследовали	исследовали
прикрепили	прикрепили
послужив	послужив
Начало	Начало
пророчестве	пророчестве
сатану	сатану
медлите	медлите
выберем	выберем
упоминайте	упоминайте
человеческую	человеческую
отвела	отвела
мечу	мечу
хвали	хвали
второе	второе
высохли	высохли
услышите	услышите
запустении	запустении
уничижали	уничижали
щади	щади
вешали	вешали
забытых	забытых
разорите	разорите
носильщиков	носильщиков
возлюбленным	возлюбленным
преследовать	преследовать
одинокую	одинокую
положи	положи
взяли	взяли
принимать	принимать
вознеси	вознеси
безумных	безумных
какая	какая
разгласите	разгласите
жившая	жившая
бесславии	бесславии
путем	путем
принесем	принесем
левый	левый
раскрытую	раскрытую
чудных	чудных
образе	образе
наполните	наполните
лишить	лишить
повисла	повисла
окончили	окончили
тысяче	тысяче
сверх	сверх
лукавых	лукавых
бросали	бросали
воспой	воспой
отходили	отходили
самый	самый
будут	будут
ехидны	ехидны
молодого	молодого
сердечной	сердечной
сохраняйте	сохраняйте
затворите	затворите
покрывало	покрывало
садили	садили
избивать	избивать
змеи	змеи
вводили	вводили
богов	богов
своротить	своротить
слушали	слушали
Сеном	Сеном
внутреннем	внутреннем
избивали	избивали
чужд	чужд
похитила	похитила
топтали	топтали
делали	делали
оказать	оказать
жаб	жаб
Явился	Явился
разбогатеть	разбогатеть
право	право
Сене	Сене
великую	великую
пощади	пощади
ворона	ворона
сразился	сразился
нарекла	нарекла
огорчали	огорчали
заколи	заколи
послужили	послужили
посвяти	посвяти
живою	живою
молодым	молодым
молодой	молодой
правых	правых
истребила	истребила
красного	красного
Которой	Которой
рак	рак
терафимы	терафимы
видите	видите
честные	честные
пара	пара
обратился	обратился
приведи	приведи
прокаженным	прокаженным
убогого	убогого
порядка	порядка
сковали	сковали
иною	иною
спрашивали	спрашивали
Рабы	Рабы
кончен	кончен
замечать	замечать
обнови	обнови
выломать	выломать
кому	кому
взяло	взяло
принято	принято
гола	гола
стоите	стоите
разводное	разводное
умертвить	умертвить
всяком	всяком
приклони	приклони
опьянел	опьянел
Христов	Христов
превознесли	превознесли
удерживать	удерживать
перебить	перебить
ступили	ступили
отходят	отходят
защити	защити
богах	богах
ревнуйте	ревнуйте
препроводить	препроводить
сем	сем
взглянули	взглянули
страшилищ	страшилищ
правым	правым
созывайте	созывайте
пьяный	пьяный
нага	нага
соединить	соединить
развалиною	развалиною
страдали	страдали
выбежали	выбежали
закрою	закрою
саранче	саранче
открой	открой
пребыли	пребыли
вороные	вороные
рассеянным	рассеянным
свету	свету
оробел	оробел
подними	подними
оскудела	оскудела
имуществом	имуществом
Лазарь	Лазарь
богами	богами
сторож	сторож
снегом	снегом
преследуйте	преследуйте
носить	носить
граду	граду
коленом	коленом
другое	другое
устрашился	устрашился
приведем	приведем
жилища	жилища
дала	дала
воспитывайте	воспитывайте
входили	входили
ослабели	ослабели
могли	могли
рассеките	рассеките
посетить	посетить
выкупите	выкупите
снабдили	снабдили
большую	большую
платите	платите
умолять	умолять
оскорбляли	оскорбляли
явили	явили
мала	мала
поступив	поступив
чужды	чужды
простертою	простертою
приобрели	приобрели
жребии	жребии
находился	находился
позвать	позвать
написал	написал
показывай	показывай
соорудили	соорудили
забирали	забирали
литого	литого
судился	судился
отводили	отводили
Сила	Сила
убогие	убогие
отдали	отдали
оказала	оказала
переноси	переноси
богатого	богатого
производите	производите
слепого	слепого
пострадал	пострадал
скрытое	скрытое
нечистой	нечистой
Израилевой	Израилевой
Стань	Стань
повороти	повороти
простерли	простерли
самое	самое
вопрошать	вопрошать
другие	другие
добыче	добыче
выливай	выливай
царю	царю
пребыл	пребыл
исправили	исправили
гуслиста	гуслиста
подвигли	подвигли
схватила	схватила
погуби	погуби
твердое	твердое
Мою	Мою
спали	спали
мухе	мухе
пояса	пояса
презирать	презирать
желчь	желчь
мужчины	мужчины
продали	продали
раскрытая	раскрытая
язвах	язвах
Своем	Своем
пробыла	пробыла
поворотить	поворотить
тени	тени
носите	носите
расположен	расположен
утомленного	утомленного
поправили	поправили
нарушить	нарушить
Слушайте	Слушайте
лицах	лицах
ободри	ободри
невеждам	невеждам
растянули	растянули
полагали	полагали
видимо	видимо
осквернился	осквернился
выводили	выводили
Котором	Котором
склонился	склонился
встретился	встретился
свои	свои
пол	пол
закрыли	закрыли
срубите	срубите
письмом	письмом
язв	язв
постигли	постигли
благочестии	благочестии
забытая	забытая
спорили	спорили
предавали	предавали
растаяли	растаяли
ослабеть	ослабеть
свитке	свитке
умножился	умножился
трогай	трогай
споры	споры
потерпели	потерпели
нечистым	нечистым
устав	устав
пострадать	пострадать
изменишь	изменишь
языческой	языческой
колет	колет
отгадали	отгадали
порядку	порядку
торжествуйте	торжествуйте
помогали	помогали
добром	добром
моря	моря
наставили	наставили
чьи	чьи
провозгласи	провозгласи
обольстить	обольстить
немых	немых
ином	ином
возьмете	возьмете
стоят	стоят
наушника	наушника
обгорела	обгорела
умилостивить	умилостивить
городом	городом
проходите	проходите
простираешь	простираешь
купили	купили
накормить	накормить
преподала	преподала
молодые	молодые
временные	временные
меньше	меньше
неправы	неправы
притвору	притвору
искушайте	искушайте
получали	получали
засохли	засохли
попросите	попросите
узнайте	узнайте
оставляли	оставляли
хвалить	хвалить
излился	излился
чадо	чадо
научен	научен
четвертой	четвертой
порти	порти
исследуй	исследуй
наливала	наливала
жившую	жившую
большом	большом
пожелали	пожелали
поднятою	поднятою
превратился	превратился
пища	пища
раздражали	раздражали
поднято	поднято
изделием	изделием
умножила	умножила
Велика	Велика
располагая	располагая
знакомых	знакомых
матерь	матерь
раздражен	раздражен
находят	находят
посылали	посылали
познала	познала
вопросить	вопросить
допускала	допускала
увели	увели
выдавали	выдавали
Был	Был
беременною	беременною
уведомить	уведомить
слове	слове
отнесли	отнесли
началом	началом
ходить	ходить
месте	месте
стоим	стоим
охраняйте	охраняйте
ждали	ждали
отделите	отделите
сохранили	сохранили
чья	чья
давира	давира
имущество	имущество
воззовем	воззовем
завещевает	завещевает
строили	строили
домом	домом
исполняйте	исполняйте
будете	будете
душа	душа
вкусить	вкусить
обветшала	обветшала
выкопали	выкопали
тысяч	тысяч
Галилейскую	Галилейскую
пребывали	пребывали
серебром	серебром
образую	образую
всем	всем
окружите	окружите
превратить	превратить
сказывайте	сказывайте
Боге	Боге
убитый	убитый
нехороша	нехороша
Христом	Христом
получите	получите
поразите	поразите
празднуйте	празднуйте
прибыл	прибыл
вспомнила	вспомнила
познаешь	познаешь
умертвила	умертвила
стражами	стражами
святым	святым
большой	большой
кидаре	кидаре
заговорит	заговорит
глядеть	глядеть
поешь	поешь
необрезанное	необрезанное
вороны	вороны
внутри	внутри
преданным	преданным
предложила	предложила
поправить	поправить
посрамить	посрамить
исправляли	исправляли
творите	творите
искушать	искушать
связанные	связанные
образу	образу
помните	помните
Богами	Богами
смел	смел
своротила	своротила
ненадежное	ненадежное
питай	питай
возлагать	возлагать
огорчился	огорчился
пожирали	пожирали
распознает	распознает
пас	пас
возвратить	возвратить
принимай	принимай
ввели	ввели
посохом	посохом
поядать	поядать
управляющий	управляющий
передвигает	передвигает
возгласите	возгласите
самая	самая
тайною	тайною
вопрошающий	вопрошающий
гумне	гумне
допустили	допустили
посвящали	посвящали
язвам	язвам
очисти	очисти
смешанною	смешанною
пернатые	пернатые
исходили	исходили
золотой	золотой
надел	надел
варите	варите
стерегла	стерегла
закрой	закрой
думали	думали
скал	скал
родить	родить
сложить	сложить
отдало	отдало
послужить	послужить
дворе	дворе
Самой	Самой
начал	начал
последуйте	последуйте
отправляли	отправляли
исполнила	исполнила
избавился	избавился
областеначальником	областеначальником
Дух	Дух
успокоился	успокоился
Духу	Духу
храни	храни
скверною	скверною
развратили	развратили
жары	жары
согрешить	согрешить
переносят	переносят
внимали	внимали
согласился	согласился
ненавидела	ненавидела
возливала	возливала
отвален	отвален
родили	родили
расслабленного	расслабленного
изменить	изменить
шестом	шестом
предложили	предложили
бедным	бедным
юношах	юношах
второй	второй
стоит	стоит
изумили	изумили
прославляй	прославляй
преследуй	преследуй
оном	оном
предложить	предложить
сбереги	сбереги
онемело	онемело
открывать	открывать
развалинами	развалинами
низринут	низринут
почитает	почитает
пребывать	пребывать
мучился	мучился
выходите	выходите
возделывать	возделывать
которою	которою
возьмешь	возьмешь
аспида	аспида
венцом	венцом
наполняло	наполняло
даровала	даровала
обнажен	обнажен
ожидали	ожидали
завтрашнем	завтрашнем
вскорми	вскорми
покрыло	покрыло
черным	черным
грешите	грешите
схватите	схватите
старою	старою
поднять	поднять
терпи	терпи
отпустила	отпустила
возбуди	возбуди
связанного	связанного
скалу	скалу
была	была
возлюбленною	возлюбленною
слушать	слушать
требуй	требуй
какого	какого
поникла	поникла
веке	веке
сосчитали	сосчитали
тысячам	тысячам
оказывайте	оказывайте
хоронить	хоронить
подбирай	подбирай
скот	скот
показывали	показывали
девяносто	девяносто
выпросили	выпросили
проходи	проходи
приводили	приводили
вес	вес
пристал	пристал
желать	желать
прочитайте	прочитайте
Бог	Бог
постыди	постыди
исцелился	исцелился
творила	творила
страшить	страшить
упоены	упоены
эту	эту
возвестила	возвестила
Галилейской	Галилейской
минует	минует
дать	дать
кропили	кропили
прокаженные	прокаженные
челах	челах
теле	теле
продолжай	продолжай
чудовища	чудовища
расположили	расположили
согласные	согласные
опротивел	опротивел
узнают	узнают
носился	носился
уразуметь	уразуметь
замолчу	замолчу
затрепетали	затрепетали
мирен	мирен
овладел	овладел
возложите	возложите
создать	создать
духа	духа
возлюбите	возлюбите
нынешнему	нынешнему
Она	Она
чтили	чтили
желала	желала
исцелить	исцелить
впала	впала
поддерживать	поддерживать
левою	левою
объявили	объявили
оживляй	оживляй
божество	божество
обвязывай	обвязывай
любимая	любимая
посвятила	посвятила
пропасти	пропасти
ваши	ваши
приклонился	приклонился
приветствовала	приветствовала
фараонов	фараонов
дороге	дороге
Божию	Божию
засыпать	засыпать
разделила	разделила
вдовою	вдовою
Моя	Моя
выведи	выведи
пустую	пустую
одела	одела
лесу	лесу
отпустим	отпустим
доходила	доходила
прикрепи	прикрепи
очистите	очистите
взыскать	взыскать
выведите	выведите
пожелал	пожелал
погреби	погреби
преданного	преданного
признает	признает
детях	детях
дай	дай
пострадали	пострадали
жертвою	жертвою
иное	иное
раздражите	раздражите
несмысленного	несмысленного
потерянною	потерянною
дали	дали
ударить	ударить
умерло	умерло
соверши	соверши
изменила	изменила
освятите	освятите
пух	пух
града	града
удерживайте	удерживайте
почитайте	почитайте
расслабленный	расслабленный
любимых	любимых
назидать	назидать
корму	корму
просили	просили
напали	напали
разграбили	разграбили
божеству	божеству
хочет	хочет
овнами	овнами
возбудили	возбудили
одну	одну
кормили	кормили
вылитая	вылитая
птичку	птичку
первое	первое
золото	золото
переходишь	переходишь
воплю	воплю
услышали	услышали
сказывали	сказывали
Можешь	Можешь
пленным	пленным
мысли	мысли
немым	немым
воздай	воздай
любимы	любимы
страдать	страдать
сотвори	сотвори
дух	дух
считают	считают
овцою	овцою
призванным	призванным
заплатили	заплатили
поставила	поставила
семейством	семейством
живая	живая
Моем	Моем
затрубите	затрубите
пухла	пухла
принимайте	принимайте
звать	звать
рои	рои
берет	берет
протянут	протянут
приучила	приучила
убедили	убедили
видимою	видимою
учили	учили
лицу	лицу
верхом	верхом
Богов	Богов
принята	принята
сими	сими
человекоубийца	человекоубийца
поцелую	поцелую
навести	навести
стояли	стояли
рака	рака
имеющий	имеющий
спасу	спасу
считать	считать
приготовился	приготовился
одру	одру
очищен	очищен
скрывала	скрывала
имели	имели
разводить	разводить
голодный	голодный
управляй	управляй
подходите	подходите
пола	пола
наушник	наушник
хотим	хотим
возвратите	возвратите
Богу	Богу
округа	округа
человеческой	человеческой
открыла	открыла
отвратили	отвратили
сироту	сироту
разделился	разделился
протоках	протоках
провозгласите	провозгласите
отврати	отврати
Твою	Твою
строит	строит
бы	бы
встали	встали
налетели	налетели
препроводили	препроводили
раздражили	раздражили
наскучил	наскучил
укрепить	укрепить
смертный	смертный
склонили	склонили
подтвердить	подтвердить
кончили	кончили
блуди	блуди
погубите	погубите
изменит	изменит
славословили	славословили
поручали	поручали
подражать	подражать
красоты	красоты
блудодействуете	блудодействуете
хулили	хулили
вознегодовал	вознегодовал
поручи	поручи
беременной	беременной
честным	честным
смутился	смутился
велик	велик
столпе	столпе
обманывай	обманывай
возвестится	возвестится
выгнали	выгнали
отвозят	отвозят
Реву	Реву
почетных	почетных
Тем	Тем
скале	скале
молотить	молотить
держите	держите
уцелело	уцелело
весах	весах
воскликнул	воскликнул
Одно	Одно
строился	строился
лукавого	лукавого
обходить	обходить
дети	дети
нерадите	нерадите
наследуешь	наследуешь
приветствуете	приветствуете
отступите	отступите
тленным	тленным
освободить	освободить
плечом	плечом
отходить	отходить
похулили	похулили
окропили	окропили
гусеница	гусеница
нехорошо	нехорошо
каждых	каждых
надевать	надевать
венце	венце
порядке	порядке
поднята	поднята
сделанной	сделанной
сотворила	сотворила
поговорив	поговорив
голубой	голубой
отпускайте	отпускайте
Самом	Самом
следовали	следовали
мехе	мехе
голодным	голодным
встретила	встретила
выслали	выслали
оплакивала	оплакивала
приносили	приносили
прозрели	прозрели
обитали	обитали
дерзновении	дерзновении
рога	рога
переходит	переходит
откормленный	откормленный
Благо	Благо
назидая	назидая
возвестим	возвестим
лесом	лесом
отправляйте	отправляйте
уменьшить	уменьшить
обличились	обличились
тверды	тверды
утвердился	утвердился
братьям	братьям
тьме	тьме
просты	просты
глухою	глухою
которой	которой
Самый	Самый
восстали	восстали
раздражить	раздражить
зеленого	зеленого
соделаю	соделаю
доходили	доходили
пленные	пленные
среды	среды
снискала	снискала
напоены	напоены
Мой	Мой
святых	святых
воздали	воздали
разбогател	разбогател
другая	другая
носила	носила
обманули	обманули
рождали	рождали
умножали	умножали
чью	чью
овладейте	овладейте
простертой	простертой
напоен	напоен
прозрел	прозрел
горькая	горькая
питали	питали
утомили	утомили
жемчуга	жемчуга
разбудили	разбудили
купи	купи
покоился	покоился
хочешь	хочешь
поверить	поверить
раба	раба
тленного	тленного
принуждали	принуждали
литых	литых
вперед	вперед
восстал	восстал
разговаривал	разговаривал
Сию	Сию
собирай	собирай
печь	печь
обладать	обладать
твоя	твоя
освети	освети
красный	красный
моя	моя
возросло	возросло
утихло	утихло
хромой	хромой
превознесем	превознесем
Всем	Всем
Самая	Самая
веса	веса
ищем	ищем
изгонять	изгонять
воевать	воевать
малом	малом
получить	получить
льстили	льстили
совершила	совершила
возлегло	возлегло
води	води
прославить	прославить
мутить	мутить
другою	другою
боком	боком
сверкали	сверкали
взывали	взывали
отплыли	отплыли
решали	решали
Которым	Которым
ваш	ваш
исходят	исходят
смотрите	смотрите
благовествуйте	благовествуйте
рассказывай	рассказывай
выговорить	выговорить
выдайте	выдайте
прибыли	прибыли
глухие	глухие
Знайте	Знайте
весами	весами
смешанные	смешанные
толкали	толкали
достать	достать
блаженного	блаженного
проклятых	проклятых
укрепи	укрепи
светить	светить
смущали	смущали
читай	читай
уступили	уступили
выходит	выходит
множеством	множеством
столе	столе
благословила	благословила
воплем	воплем
служить	служить
сторожа	сторожа
намерены	намерены
распростерли	распростерли
избранные	избранные
восходите	восходите
осквернила	осквернила
даем	даем
рабы	рабы
нашу	нашу
накорми	накорми
пугал	пугал
манны	манны
повторился	повторился
даровать	даровать
надеть	надеть
перехватите	перехватите
спешите	спешите
цветами	цветами
вскричали	вскричали
козлов	козлов
научить	научить
огорчен	огорчен
потекли	потекли
чудное	чудное
Велики	Велики
отсчитать	отсчитать
терпите	терпите
умалить	умалить
несмысленные	несмысленные
молоке	молоке
составили	составили
сотворите	сотворите
Хочешь	Хочешь
замечайте	замечайте
времени	времени
пчеле	пчеле
Было	Было
снохи	снохи
истребить	истребить
горд	горд
бросила	бросила
одною	одною
вооружите	вооружите
засевай	засевай
ваше	ваше
выстрели	выстрели
творили	творили
напоминай	напоминай
есть	есть
Мною	Мною
Возлюбленном	Возлюбленном
сбили	сбили
Духом	Духом
унывать	унывать
голове	голове
держу	держу
слепым	слепым
собрать	собрать
жилищах	жилищах
окропи	окропи
возвеличился	возвеличился
разбудила	разбудила
завладели	завладели
выносит	выносит
се	се
сатана	сатана
буду	буду
приветствуй	приветствуй
кровопролитии	кровопролитии
осквернить	осквернить
счету	счету
взывать	взывать
переходите	переходите
открытый	открытый
госпоже	госпоже
обманывайте	обманывайте
бедного	бедного
выи	выи
погрязли	погрязли
заключила	заключила
трубите	трубите
бабке	бабке
подумал	подумал
внутреннему	внутреннему
схоронить	схоронить
приходите	приходите
постановить	постановить
покрыли	покрыли
лице	лице
налагайте	налагайте
горькие	горькие
каждое	каждое
мыслите	мыслите
утешился	утешился
простирали	простирали
затворили	затворили
волах	волах
Сделай	Сделай
никакое	никакое
звезде	звезде
которые	которые
подкрепи	подкрепи
внутрь	внутрь
немалую	немалую
прельстить	прельстить
звезды	звезды
самой	самой
желай	желай
ослабевать	ослабевать
переносить	переносить
нехороши	нехороши
проходили	проходили
помнить	помнить
одетым	одетым
узнай	узнай
глазу	глазу
беременные	беременные
немые	немые
приветствуйте	приветствуйте
манною	манною
втором	втором
приложился	приложился
козлам	козлам
составляли	составляли
пленили	пленили
беременным	беременным
бить	бить
страшился	страшился
перехватили	перехватили
главу	главу
возненавидели	возненавидели
рассудите	рассудите
говорить	говорить
утомленный	утомленный
овладеть	овладеть
пило	пило
целое	целое
духам	духам
Которого	Которого
известили	известили
сказать	сказать
развратился	развратился
кропить	кропить
издерживали	издерживали
сложи	сложи
отдели	отдели
труби	труби
бел	бел
отлучился	отлучился
сам	сам
рыдать	рыдать
отдать	отдать
разложите	разложите
Вся	Вся
находим	находим
поставить	поставить
возвестили	возвестили
призванный	призванный
попускаете	попускаете
остановили	остановили
свободные	свободные
звала	звала
изгоняли	изгоняли
хотела	хотела
презирайте	презирайте
хромого	хромого
обличать	обличать
неправ	неправ
стерегли	стерегли
восполнили	восполнили
налагай	налагай
благословляли	благословляли
невежды	невежды
возрос	возрос
богатые	богатые
виден	виден
рубили	рубили
Твой	Твой
благодарите	благодарите
налетело	налетело
умерли	умерли
помогите	помогите
исполняй	исполняй
убийцу	убийцу
предшествовать	предшествовать
оплакивали	оплакивали
бесславить	бесславить
этой	этой
допускали	допускали
искали	искали
выходить	выходить
Возлюбленного	Возлюбленного
берегу	берегу
взять	взять
пою	пою
сами	сами
сирот	сирот
доносят	доносят
созрели	созрели
посетили	посетили
облегчи	облегчи
допустила	допустила
влезли	влезли
образуем	образуем
опустошили	опустошили
образа	образа
малы	малы
слез	слез
телом	телом
возлюбленный	возлюбленный
черви	черви
упросила	упросила
располагает	располагает
ставить	ставить
понесли	понесли
предавать	предавать
обладайте	обладайте
гуслист	гуслист
переправился	переправился
легли	легли
почитаю	почитаю
рассеянный	рассеянный
это	это
приходили	приходили
дереве	дереве
соделали	соделали
козлами	козлами
поноси	поноси
нашли	нашли
покрою	покрою
проводить	проводить
почтили	почтили
повредили	повредили
долга	долга
отослали	отослали
вывезли	вывезли
произнесли	произнесли
позвала	позвала
давить	давить
внушить	внушить
призывали	призывали
управляли	управляли
развей	развей
страха	страха
расположите	расположите
разрушен	разрушен
соблюдите	соблюдите
растянула	растянула
веруйте	веруйте
покровом	покровом
имеете	имеете
признаешь	признаешь
умышлять	умышлять
столах	столах
душе	душе
кричали	кричали
отвратить	отвратить
возлюбили	возлюбили
ждите	ждите
похитили	похитили
подстерегать	подстерегать
утомился	утомился
обо	обо
уходите	уходите
отнятого	отнятого
рыдайте	рыдайте
объясни	объясни
убитого	убитого
познают	познают
забыла	забыла
яви	яви
литые	литые
приносить	приносить
местом	местом
первом	первом
считай	считай
святом	святом
бесчестили	бесчестили
наклони	наклони
отделили	отделили
Святого	Святого
пропасть	пропасть
одре	одре
разделить	разделить
второю	второю
забирать	забирать
овнов	овнов
набрала	набрала
можешь	можешь
села	села
возбудите	возбудите
смели	смели
заграждай	заграждай
изгоняйте	изгоняйте
рассказывали	рассказывали
открытую	открытую
жернов	жернов
горькую	горькую
проклинайте	проклинайте
воспылал	воспылал
снохе	снохе
желало	желало
тысяча	тысяча
обитая	обитая
узнать	узнать
переменить	переменить
оставляй	оставляй
возмутился	возмутился
печи	печи
вопрошали	вопрошали
нем	нем
воссиять	воссиять
помета	помета
ослабевайте	ослабевайте
ревнуй	ревнуй
ударила	ударила
явился	явился
страж	страж
смешанной	смешанной
сожги	сожги
избили	избили
заразы	заразы
жертв	жертв
камнях	камнях
старейшины	старейшины
поя	поя
Киса	Киса
встревожился	встревожился
наследует	наследует
верующий	верующий
красоту	красоту
черные	черные
сила	сила
издерживать	издерживать
выводи	выводи
зарыдали	зарыдали
Рев	Рев
тельцу	тельцу
преступили	преступили
были	были
производили	производили
осадили	осадили
признают	признают
избавляйте	избавляйте
отсеки	отсеки
бросился	бросился
простирала	простирала
твори	твори
восхотел	восхотел
фараону	фараону
бесчести	бесчести
Нему	Нему
входите	входите
известила	известила
любим	любим
возносили	возносили
спорите	спорите
новом	новом
Христа	Христа
дайте	дайте
как	как
эти	эти
согрешали	согрешали
обнажи	обнажи
благую	благую
теснить	теснить
исполним	исполним
держали	держали
образовала	образовала
возлег	возлег
судите	судите
звездам	звездам
восстанови	восстанови
превозмогла	превозмогла
Божием	Божием
построили	построили
отходит	отходит
возноси	возноси
постигла	постигла
умилостивился	умилостивился
выбери	выбери
соблазнить	соблазнить
ослабело	ослабело
обрезывали	обрезывали
дорогой	дорогой
Благ	Благ
пронзить	пронзить
освятить	освятить
покрывать	покрывать
возмутить	возмутить
уснули	уснули
подарили	подарили
вину	вину
пророчествуйте	пророчествуйте
тысяченачальник	тысяченачальник
ослепить	ослепить
откормленных	откормленных
кидары	кидары
выказать	выказать
условии	условии
почитать	почитать
утром	утром
воронов	воронов
заговоришь	заговоришь
Теми	Теми
тверди	тверди
прекратился	прекратился
теста	теста
слепые	слепые
похоронить	похоронить
возвестите	возвестите
спрятать	спрятать
наполняла	наполняла
тысяченачальники	тысяченачальники
считайте	считайте
били	били
летите	летите
одолела	одолела
помилуйте	помилуйте
поддерживала	поддерживала
помилуй	помилуй
устремили	устремили
пару	пару
белые	белые
блаженным	блаженным
вине	вине
Хочет	Хочет
любимым	любимым
нарушили	нарушили
рад	рад
освяти	освяти
юноше	юноше
жали	жали
ели	ели
другой	другой
Господню	Господню
ночных	ночных
сходишь	сходишь
истребите	истребите
головою	головою
содержите	содержите
истукану	истукану
добыча	добыча
замолчали	замолчали
богу	богу
откройте	откройте
затворить	затворить
шестой	шестой
нагою	нагою
бесчестите	бесчестите
преуспевайте	преуспевайте
принесла	принесла
сходи	сходи
сокрой	сокрой
сердечные	сердечные
уразумели	уразумели
проводили	проводили
малым	малым
бесноватых	бесноватых
простертым	простертым
хромым	хромым
нового	нового
ничтожества	ничтожества
отнятое	отнятое
умоляла	умоляла
спаси	спаси
почитал	почитал
спешить	спешить
узнаете	узнаете
бесноватым	бесноватым
выслать	выслать
возненавидела	возненавидела
свитком	свитком
вывези	вывези
упоминать	упоминать
Какое	Какое
правосудии	правосудии
смешанного	смешанного
звезду	звезду
лесах	лесах
старое	старое
изреки	изреки
жертвами	жертвами
святой	святой
принадлежащие	принадлежащие
расположился	расположился
увещевали	увещевали
множестве	множестве
разгласили	разгласили
замерло	замерло
жив	жив
продолжали	продолжали
презирали	презирали
ожить	ожить
освободился	освободился
замышляй	замышляй
нечисты	нечисты
духовным	духовным
отяготить	отяготить
паре	паре
исполнили	исполнили
переносит	переносит
соблюди	соблюди
варить	варить
похитить	похитить
подул	подул
ела	ела
отягощали	отягощали
преступлением	преступлением
обгорелою	обгорелою
каков	каков
умерщвляйте	умерщвляйте
отнят	отнят
сходим	сходим
каждые	каждые
разорили	разорили
будешь	будешь
благословите	благословите
столп	столп
озере	озере
любить	любить
называйте	называйте
доставляло	доставляло
начерпали	начерпали
могла	могла
посадите	посадите
пойте	пойте
стеснили	стеснили
утихли	утихли
тысяченачальника	тысяченачальника
напился	напился
страхе	страхе
раздавали	раздавали
живых	живых
отвори	отвори
пейте	пейте
обольстили	обольстили
отдала	отдала
целого	целого
точиле	точиле
вышло	вышло
сказывать	сказывать
подкрепите	подкрепите
попроси	попроси
наполни	наполни
открытою	открытою
реки	реки
собирать	собирать
областеначальников	областеначальников
собой	собой
положить	положить
возносить	возносить
ожил	ожил
полагать	полагать
пожалело	пожалело
сходить	сходить
Святом	Святом
превозмогли	превозмогли
сказывай	сказывай
мертво	мертво
сказали	сказали
слепой	слепой
проводите	проводите
немноги	немноги
последовали	последовали
землетрясением	землетрясением
Иудин	Иудин
переходят	переходят
слушало	слушало
променять	променять
братьями	братьями
Жертвы	Жертвы
пусти	пусти
счетом	счетом
поддерживайте	поддерживайте
отрезать	отрезать
открывали	открывали
вылитых	вылитых
камни	камни
сели	сели
красота	красота
исправить	исправить
орудии	орудии
проклятые	проклятые
запрудили	запрудили
хотел	хотел
разреши	разреши
поядающий	поядающий
томился	томился
возливай	возливай
нехорош	нехорош
землетрясении	землетрясении
Одни	Одни
сожгли	сожгли
мною	мною
вспоминали	вспоминали
сделали	сделали
пой	пой
зелени	зелени
Будет	Будет
жилы	жилы
какую	какую
животных	животных
похвалить	похвалить
деревом	деревом
градом	градом
говорила	говорила
переходи	переходи
языку	языку
души	души
утре	утре
Господнем	Господнем
нарекли	нарекли
Мать	Мать
временное	временное
приготовила	приготовила
покройте	покройте
доводит	доводит
растерзали	растерзали
берег	берег
среду	среду
согрешили	согрешили
лукавым	лукавым
омыли	омыли
поднял	поднял
вступили	вступили
немногое	немногое
твердой	твердой
граде	граде
теснился	теснился
удивлении	удивлении
первые	первые
выбросили	выбросили
познай	познай
уничижила	уничижила
погребали	погребали
восхвалили	восхвалили
царски	царски
сердечною	сердечною
решите	решите
помни	помни
испытанного	испытанного
котлов	котлов
бил	бил
заколения	заколения
оказали	оказали
одетые	одетые
блаженных	блаженных
определить	определить
омыть	омыть
золотою	золотою
одержимых	одержимых
распростерла	распростерла
приехали	приехали
заразою	заразою
святою	святою
подтвердили	подтвердили
переспит	переспит
гумном	гумном
отвратите	отвратите
мешки	мешки
сосчитать	сосчитать
неверные	неверные
осмоли	осмоли
избавлять	избавлять
ночевать	ночевать
избирать	избирать
бывшая	бывшая
неверных	неверных
взял	взял
снимите	снимите
нынешнем	нынешнем
Яви	Яви
сверху	сверху
прославился	прославился
отцах	отцах
иссох	иссох
семь	семь
отвалят	отвалят
возносите	возносите
признайте	признайте
добре	добре
устрашили	устрашили
водить	водить
наполнился	наполнился
говори	говори
исчислите	исчислите
покрывала	покрывала
хранить	хранить
войска	войска
остановить	остановить
свободным	свободным
проклятого	проклятого
преподали	преподали
червь	червь
пила	пила
дорогою	дорогою
учился	учился
чужую	чужую
низринь	низринь
призванные	призванные
ком	ком
изнеженных	изнеженных
выбросите	выбросите
змей	змей
неверным	неверным
черпать	черпать
поносить	поносить
богатых	богатых
иным	иным
ожесточи	ожесточи
имеем	имеем
полагай	полагай
совершился	совершился
прибыла	прибыла
медлить	медлить
духом	духом
принятые	принятые
благочестием	благочестием
припали	припали
Душа	Душа
толки	толки
пленных	пленных
приехал	приехал
овну	овну
пожалел	пожалел
случая	случая
низложи	низложи
подкрепить	подкрепить
придворным	придворным
узнаешь	узнаешь
жертвам	жертвам
утешить	утешить
выговори	выговори
познает	познает
провозгласить	провозгласить
птичкою	птичкою
исходит	исходит
жертвы	жертвы
посвящай	посвящай
кидара	кидара
тверда	тверда
принеси	принеси
защитить	защитить
погряз	погряз
выходишь	выходишь
злою	злою
вечере	вечере
пересчитайте	пересчитайте
перестал	перестал
вечером	вечером
большая	большая
сожигают	сожигают
молодая	молодая
накормили	накормили
хулите	хулите
садить	садить
будь	будь
чину	чину
перейди	перейди
одушевленное	одушевленное
затыкает	затыкает
Марком	Марком
счете	счете
призывать	призывать
успокоить	успокоить
взглянул	взглянул
Сделали	Сделали
темных	темных
желали	желали
вносить	вносить
тысячу	тысячу
еси	еси
потонуло	потонуло
отнято	отнято
попускаешь	попускаешь
берем	берем
целовать	целовать
призвала	призвала
новые	новые
заняты	заняты
бесноватые	бесноватые
ослабела	ослабела
рогом	рогом
выломали	выломали
каждую	каждую
окружить	окружить
нанять	нанять
внуши	внуши
представлять	представлять
притворился	притворился
воспылали	воспылали
твердые	твердые
воспойте	воспойте
заколали	заколали
да	да
всякою	всякою
имело	имело
Будете	Будете
Цари	Цари
подражайте	подражайте
сострадали	сострадали
сделанный	сделанный
соедини	соедини
внукам	внукам
носили	носили
прямых	прямых
брить	брить
исследуйте	исследуйте
привился	привился
хвалился	хвалился
старых	старых
обещали	обещали
повторили	повторили
тьму	тьму
вопить	вопить
покрова	покрова
приложите	приложите
возьму	возьму
Души	Души
Марка	Марка
изливай	изливай
отрезал	отрезал
провозгласили	провозгласили
иной	иной
заклятого	заклятого
возвысить	возвысить
снисходите	снисходите
очищали	очищали
восхотели	восхотели
сокрытой	сокрытой
сухую	сухую
воссияло	воссияло
поддерживали	поддерживали
сходите	сходите
оставится	оставится
завещевайте	завещевайте
подпал	подпал
называть	называть
прокаженных	прокаженных
глядела	глядела
возливайте	возливайте
прилагайте	прилагайте
случай	случай
гусеницы	гусеницы
помнила	помнила
могу	могу
убийцы	убийцы
злодейством	злодейством
обесчестить	обесчестить
трава	трава
постигло	постигло
спасали	спасали
смертного	смертного
страшным	страшным
пожалели	пожалели
высох	высох
кормить	кормить
возвращали	возвращали
скрывайте	скрывайте
уставом	уставом
открытого	открытого
поселился	поселился
развалинам	развалинам
обложили	обложили
превозносите	превозносите
простите	простите
настаивали	настаивали
откормленного	откормленного
соделается	соделается
имеешь	имеешь
любимой	любимой
вводите	вводите
служанке	служанке
выросло	выросло
припал	припал
смотри	смотри
спрашивай	спрашивай
последовать	последовать
лица	лица
завладеть	завладеть
жили	жили
камню	камню
возложила	возложила
крылом	крылом
пленный	пленный
рождала	рождала
посрами	посрами
славила	славила
жилищу	жилищу
козлу	козлу
отпустите	отпустите
украсила	украсила
чем	чем
отправили	отправили
пасть	пасть
пьяного	пьяного
пригласите	пригласите
начала	начала
язва	язва
нам	нам
вороной	вороной
Вил	Вил
мертвый	мертвый
небом	небом
простирай	простирай
наливай	наливай
награбили	награбили
освободи	освободи
растить	растить
прямою	прямою
согрешив	согрешив
одни	одни
порази	порази
укрепите	укрепите
поглотили	поглотили
главным	главным
языков	языков
жилищами	жилищами
воспрепятствовал	воспрепятствовал
блудить	блудить
поглотила	поглотила
засохло	засохло
девяноста	девяноста
Мало	Мало
впал	впал
блаженный	блаженный
проклинай	проклинай
малого	малого
создали	создали
приносила	приносила
новым	новым
поехали	поехали
разбогатели	разбогатели
рабах	рабах
мучить	мучить
стояла	стояла
твари	твари
уповать	уповать
хромых	хромых
продолжало	продолжало
воззови	воззови
видали	видали
истребили	истребили
Моисееву	Моисееву
добра	добра
слушай	слушай
выслушайте	выслушайте
бери	бери
срамили	срамили
отяжелело	отяжелело
онемеешь	онемеешь
скрывай	скрывай
изменили	изменили
снега	снега
худом	худом
язычески	язычески
удалите	удалите
похвалился	похвалился
Свой	Свой
растила	растила
чести	чести
совершите	совершите
пали	пали
невежда	невежда
два	два
утвердили	утвердили
дщерь	дщерь
просила	просила
изгнать	изгнать
подбирать	подбирать
убедила	убедила
птенцах	птенцах
достаем	достаем
гусенице	гусенице
показывать	показывать
посвятить	посвятить
сторожам	сторожам
свободного	свободного
живом	живом
влез	влез
положили	положили
тому	тому
Какая	Какая
открывайте	открывайте
выносите	выносите
выпросился	выпросился
вторых	вторых
Богом	Богом
служи	служи
неради	неради
жернова	жернова
затворила	затворила
отделить	отделить
воздайте	воздайте
сажали	сажали
дрогнули	дрогнули
открыли	открыли
рассеянного	рассеянного
нечестии	нечестии
внука	внука
скотом	скотом
благодарили	благодарили
прямым	прямым
сковать	сковать
страшные	страшные
изделии	изделии
головами	головами
узнали	узнали
рассказывайте	рассказывайте
больные	больные
ожесточили	ожесточили
отпусти	отпусти
возмутили	возмутили
обещал	обещал
разбросали	разбросали
исследовать	исследовать
белою	белою
пробыл	пробыл
отнимали	отнимали
постанови	постанови
укрепляй	укрепляй
исправлять	исправлять
зимой	зимой
Может	Может
брак	брак
посылала	посылала
тьмы	тьмы
кормила	кормила
Силе	Силе
принесло	принесло
стояло	стояло
сатане	сатане
подпали	подпали
зарыдал	зарыдал
родился	родился
Будут	Будут
заходить	заходить
удержали	удержали
отложили	отложили
сему	сему
нечистою	нечистою
значила	значила
трое	трое
меча	меча
посрамился	посрамился
эта	эта
налагать	налагать
явить	явить
значить	значить
каждою	каждою
беременных	беременных
завладейте	завладейте
соделай	соделай
посвятите	посвятите
развели	развели
точило	точило
исполнился	исполнился
аспиды	аспиды
вы	вы
разные	разные
Дине	Дине
заграждали	заграждали
откажу	откажу
сожигай	сожигай
схватили	схватили
вели	вели
сказало	сказало
оставила	оставила
молодую	молодую
пьяным	пьяным
реши	реши
гвоздем	гвоздем
Матерь	Матерь
обрели	обрели
сокрыт	сокрыт
избрала	избрала
животным	животным
красные	красные
умертви	умертви
опустошить	опустошить
изменился	изменился
мой	мой
жабам	жабам
вмещать	вмещать
языке	языке
разодрали	разодрали
мертвых	мертвых
стену	стену
пребывайте	пребывайте
смирите	смирите
жди	жди
литое	литое
привезли	привезли
возвысили	возвысили
выстроился	выстроился
выпали	выпали
ворон	ворон
областеначальники	областеначальники
исполни	исполни
скованный	скованный
сухая	сухая
Словом	Словом
сим	сим
усилился	усилился
он	он
сохрани	сохрани
змея	змея
снегу	снегу
возопил	возопил
числе	числе
приклоните	приклоните
поспешите	поспешите
переночевать	переночевать
разрывал	разрывал
молотили	молотили
отведите	отведите
купить	купить
уступи	уступи
варили	варили
награбило	награбило
белы	белы
самою	самою
ночевали	ночевали
возливать	возливать
отяготили	отяготили
каждым	каждым
умертвите	умертвите
спит	спит
поручили	поручили
бога	бога
приступали	приступали
петля	петля
обозрели	обозрели
пройду	пройду
воскликнули	воскликнули
колу	колу
до	до
двое	двое
падите	падите
сделанным	сделанным
очистился	очистился
охраняй	охраняй
бог	бог
отвозили	отвозили
золота	золота
бедные	бедные
обманула	обманула
укрепили	укрепили
соделает	соделает
решился	решился
почерпнула	почерпнула
отгадать	отгадать
совершили	совершили
Мал	Мал
оскудели	оскудели
избрали	избрали
свободных	свободных
травы	травы
продолжала	продолжала
мстите	мстите
окончила	окончила
свободный	свободный
укрепляли	укрепляли
привела	привела
шипа	шипа
приводить	приводить
мех	мех
Соляной	Соляной
вывез	вывез
вопили	вопили
твою	твою
Христе	Христе
призвали	призвали
помышлять	помышлять
распознать	распознать
чад	чад
хотите	хотите
пролили	пролили
велите	велите
завтрашнему	завтрашнему
полюбила	полюбила
необрезан	необрезан
простирал	простирал
собирала	собирала
произносить	произносить
духе	духе
почитают	почитают
плече	плече
набрать	набрать
говорите	говорите
обирай	обирай
никакого	никакого
скрепился	скрепился
рубить	рубить
сию	сию
столпом	столпом
даруешь	даруешь
настаивал	настаивал
разорить	разорить
козлы	козлы
убитой	убитой
леса	леса
садился	садился
полированной	полированной
начинайте	начинайте
познаем	познаем
сказала	сказала
пьяною	пьяною
чему	чему
впереди	впереди
осветила	осветила
медлили	медлили
вооружился	вооружился
жило	жило
оживлять	оживлять
принять	принять
предавала	предавала
зло	зло
фараон	фараон
войском	войском
теснили	теснили
облегчить	облегчить
небольшой	небольшой
наложили	наложили
лев	лев
жабах	жабах
поехал	поехал
отнимите	отнимите
отрезали	отрезали
приняла	приняла
можете	можете
кидар	кидар
противоречили	противоречили
сверкающий	сверкающий
пожирать	пожирать
напоминайте	напоминайте
выслушать	выслушать
вытащить	вытащить
требовали	требовали
дрогнуло	дрогнуло
удивлением	удивлением
Приветствуйте	Приветствуйте
правый	правый
счета	счета
воспитывала	воспитывала
матерях	матерях
ослепила	ослепила
допускать	допускать
наступить	наступить
устроен	устроен
начале	начале
вложили	вложили
подносили	подносили
личном	личном
упросить	упросить
богам	богам
насади	насади
обирал	обирал
кадить	кадить
обществом	обществом
подняты	подняты
поясом	поясом
славили	славили
восемь	восемь
начали	начали
жилищ	жилищ
сопровождать	сопровождать
живой	живой
протоками	протоками
прямой	прямой
окружила	окружила
подносить	подносить
тень	тень
созвать	созвать
умирать	умирать
почетного	почетного
пылу	пылу
пары	пары
купите	купите
бросить	бросить
ней	ней
написанного	написанного
нечистоте	нечистоте
безумные	безумные
вступали	вступали
сладкого	сладкого
язву	язву
сестры	сестры
прикрепила	прикрепила
воспела	воспела
поставили	поставили
главных	главных
отпустили	отпустили
глаза	глаза
пленила	пленила
затрепетал	затрепетал
потаенных	потаенных
нею	нею
поносили	поносили
влекла	влекла
благословляй	благословляй
завещеваю	завещеваю
приобрела	приобрела
сложили	сложили
одинокая	одинокая
произнеси	произнеси
познайте	познайте
унизился	унизился
молоком	молоком
осудить	осудить
вытащи	вытащи
блудодействуя	блудодействуя
меньшая	меньшая
восстановите	восстановите
беременная	беременная
служанкою	служанкою
имущества	имущества
наг	наг
твердую	твердую
малое	малое
легкие	легкие
рулем	рулем
Слушай	Слушай
Кис	Кис
внушили	внушили
приложили	приложили
затыкали	затыкали
сама	сама
Велик	Велик
Тысячу	Тысячу
лукавые	лукавые
стражам	стражам
тысяченачальникам	тысяченачальникам
приступили	приступили
отяжелели	отяжелели
вознесли	вознесли
возложи	возложи
выросли	выросли
приступив	приступив
скверны	скверны
умертвили	умертвили
замедли	замедли
погубить	погубить
малых	малых
нами	нами
укрепился	укрепился
пишем	пишем
встретили	встретили
рабу	рабу
заграждать	заграждать
бросили	бросили
навестить	навестить
мстили	мстили
возлюбленного	возлюбленного
уходили	уходили
раздирающий	раздирающий
посадили	посадили
проклятою	проклятою
доводите	доводите
искала	искала
носильщиками	носильщиками
избранным	избранным
охраняющий	охраняющий
великою	великою
утвердите	утвердите
смирить	смирить
выкопай	выкопай
нему	нему
открыт	открыт
возложили	возложили
нечистоту	нечистоту
устроила	устроила
направили	направили
слеп	слеп
встал	встал
противостал	противостал
растворить	растворить
светили	светили
привалите	привалите
благословить	благословить
поношении	поношении
утопает	утопает
осудили	осудили
Сии	Сии
роптали	роптали
беззаконии	беззаконии
немой	немой
заплатить	заплатить
ничтожество	ничтожество
выводить	выводить
языком	языком
обитаем	обитаем
соделала	соделала
скалами	скалами
приготовили	приготовили
петь	петь
тельцов	тельцов
расположи	расположи
обветшали	обветшали
щадите	щадите
простертого	простертого
немого	немого
избавили	избавили
сидеть	сидеть
подкрепился	подкрепился
сразила	сразила
озером	озером
потаенном	потаенном
половине	половине
твердою	твердою
неверующие	неверующие
царскою	царскою
первых	первых
нашла	нашла
отсчитай	отсчитай
покоить	покоить
расслабленным	расслабленным
льстить	льстить
заходит	заходит
противоречить	противоречить
призывайте	призывайте
возлагали	возлагали
цели	цели
Буду	Буду
удержи	удержи
объявите	объявите
выдать	выдать
град	град
спорить	спорить
отправлять	отправлять
обложила	обложила
Моисеевой	Моисеевой
потаенного	потаенного
покров	покров
Соляную	Соляную
Вила	Вила
устроить	устроить
горькой	горькой
схватить	схватить
увещевай	увещевай
срывай	срывай
обратили	обратили
рабою	рабою
затрубили	затрубили
родят	родят
передвигай	передвигай
погубили	погубили
малые	малые
вступите	вступите
разит	разит
подчинился	подчинился
напоминать	напоминать
малый	малый
вопросите	вопросите
глядели	глядели
ожидать	ожидать
принят	принят
наступите	наступите
хотели	хотели
внимайте	внимайте
петли	петли
приступить	приступить
твердая	твердая
любите	любите
пить	пить
получила	получила
ночного	ночного
отягощала	отягощала
вил	вил
кадите	кадите
спроси	спроси
открытое	открытое
благослови	благослови
нареки	нареки
вывели	вывели
найдем	найдем
бела	бела
козлом	козлом
входить	входить
аспидов	аспидов
голодного	голодного
спросить	спросить
лишен	лишен
собирали	собирали
половинах	половинах
спустили	спустили
чудовище	чудовище
оно	оно
отослать	отослать
извратили	извратили
гордо	гордо
Моисеевым	Моисеевым
доли	доли
быть	быть
свекровь	свекровь
хвалите	хвалите
берега	берега
поверили	поверили
силе	силе
верха	верха
произносили	произносили
поразила	поразила
начало	начало
Приветствуют	Приветствуют
досадовать	досадовать
позавидовали	позавидовали
располагал	располагал
скоту	скоту
прочитать	прочитать
укреплять	укреплять
посети	посети
чтите	чтите
убили	убили
постыдить	постыдить
открытым	открытым
обгорел	обгорел
могут	могут
принадлежащую	принадлежащую
ненадежно	ненадежно
проходят	проходят
легкое	легкое
поем	поем
обвини	обвини
смешанное	смешанное
среди	среди
обществе	обществе
отступить	отступить
закрыла	закрыла
сознает	сознает
поразили	поразили
почиешь	почиешь
вином	вином
худа	худа
чужого	чужого
правого	правого
заключить	заключить
верху	верху
сосчитай	сосчитай
завладел	завладел
страшное	страшное
пернатых	пернатых
Твои	Твои
наполняйте	наполняйте
собранные	собранные
душу	душу
владеть	владеть
тесните	тесните
сидели	сидели
изнеженная	изнеженная
каком	каком
отплыл	отплыл
отступили	отступили
назидайте	назидайте
прямые	прямые
обходите	обходите
жертва	жертва
исследовал	исследовал
исчислили	исчислили
век	век
украсить	украсить
подбирала	подбирала
мою	мою
заколите	заколите
принимали	принимали
утомленных	утомленных
одетого	одетого
пристали	пристали
матери	матери
духовные	духовные
откормленные	откормленные
отвели	отвели
представляла	представляла
искало	искало
соляною	соляною
тварь	тварь
изумился	изумился
славить	славить
Возьмет	Возьмет
выдай	выдай
раздирать	раздирать
выдавать	выдавать
стоишь	стоишь
дерзновением	дерзновением
искусили	искусили
вдовы	вдовы
развязать	развязать
ходите	ходите
твои	твои
смирился	смирился
сделало	сделало
старого	старого
защищайте	защищайте
голою	голою
соделал	соделал
показать	показать
посмеянии	посмеянии
всякого	всякого
стража	стража
пил	пил
отыщите	отыщите
пронзили	пронзили
низложить	низложить
убийц	убийц
брака	брака
прислугу	прислугу
полюби	полюби
саранчу	саранчу
птенцов	птенцов
сажен	сажен
другую	другую
подвиг	подвиг
царях	царях
уходить	уходить
столом	столом
било	било
убит	убит
язвою	язвою
берете	берете
вызывающий	вызывающий
простирать	простирать
восходить	восходить
пожалеть	пожалеть
унывайте	унывайте
доходит	доходит
одинокою	одинокою
умирали	умирали
спросила	спросила
признаю	признаю
истукан	истукан
истощился	истощился
заходи	заходи
отведи	отведи
привозить	привозить
заключи	заключи
было	было
злодействе	злодействе
разграбить	разграбить
птичка	птичка
возлюбленную	возлюбленную
дал	дал
мог	мог
сохранился	сохранился
мертвого	мертвого
извратила	извратила
звездах	звездах
называй	называй
нашем	нашем
начинай	начинай
червю	червю
белого	белого
привозили	привозили
захотели	захотели
слушайте	слушайте
уходят	уходят
возвратили	возвратили
преклонили	преклонили
пчелы	пчелы
красоте	красоте
превратили	превратили
совершали	совершали
тысячами	тысячами
намерен	намерен
Жертва	Жертва
голодные	голодные
точил	точил
восхвалите	восхвалите
твой	твой
портить	портить
думайте	думайте
горькою	горькою
другого	другого
Твоя	Твоя
никакая	никакая
открывай	открывай
торжествующий	торжествующий
никакой	никакой
белых	белых
окружили	окружили
выстроить	выстроить
разных	разных
разговаривать	разговаривать
возвысился	возвысился
утешали	утешали
поспешив	поспешив
стереги	стереги
Свои	Свои
ходили	ходили
увела	увела
лег	лег
моем	моем
помнили	помнили
встать	встать
всходили	всходили
Лазаря	Лазаря
возливали	возливали
низкою	низкою
восстановим	восстановим
возлагай	возлагай
сокрушен	сокрушен
заменим	заменим
сходили	сходили
считаете	считаете
левша	левша
посылайте	посылайте
святую	святую
переменили	переменили
влекло	влекло
занятые	занятые
пухли	пухли
снабди	снабди
смело	смело
половиною	половиною
сокройте	сокройте
мучили	мучили
восклицали	восклицали
изливайте	изливайте
сокрушите	сокрушите
вырос	вырос
языческую	языческую
торжествуй	торжествуй
познать	познать
сберегите	сберегите
надели	надели
благословлять	благословлять
сухой	сухой
духами	духами
простираете	простираете
окончи	окончи
сокрытый	сокрытый
само	само
прельстился	прельстился
лишили	лишили
отворить	отворить
сел	сел
верх	верх
аспид	аспид
вредить	вредить
выливайте	выливайте
удила	удила
приветствующий	приветствующий
похули	похули
смири	смири
обручился	обручился
глухого	глухого
Оно	Оно
страху	страху
произвела	произвела
низком	низком
взглянуть	взглянуть
Дина	Дина
разрешите	разрешите
остановился	остановился
ваша	ваша
копали	копали
замышляли	замышляли
округ	округ
восстановили	восстановили
сия	сия
владейте	владейте
срубить	срубить
скалах	скалах
отворили	отворили
выкупить	выкупить
сожигает	сожигает
правые	правые
отступив	отступив
заключили	заключили
твердом	твердом
возвестить	возвестить
предсказывайте	предсказывайте
враждовать	враждовать
имейте	имейте
блуждали	блуждали
твердым	твердым
скрытая	скрытая
сокрушили	сокрушили
ночные	ночные
Сия	Сия
направить	направить
подстерегали	подстерегали
устраните	устраните
даруй	даруй
собранный	собранный
которым	которым
роду	роду
люби	люби
напоила	напоила
цари	цари
прилагать	прилагать
бабки	бабки
познали	познали
мертвые	мертвые
набрали	набрали
ослепили	ослепили
самых	самых
обирать	обирать
ввела	ввела
три	три
рассуди	рассуди
срубили	срубили
захватила	захватила
родишь	родишь
наш	наш
можем	можем
просите	просите
полы	полы
оскорблять	оскорблять
будем	будем
разложили	разложили
целом	целом
выходи	выходи
госпожи	госпожи
расслабленных	расслабленных
благом	благом
весом	весом
стенали	стенали
умножить	умножить
имея	имея
простирает	простирает
ехидна	ехидна
Начала	Начала
посадить	посадить
первого	первого
спрятали	спрятали
будет	будет
больше	больше
живого	живого
отпустить	отпустить
оных	оных
убийством	убийством
мучила	мучила
убегали	убегали
добыч	добыч
чужие	чужие
выпало	выпало
Слове	Слове
главные	главные
превозмогло	превозмогло
вопросили	вопросили
схоронили	схоронили
восстановить	восстановить
наклонился	наклонился
выходят	выходят
знакомого	знакомого
отличить	отличить
пристало	пристало
поводом	поводом
признать	признать
воле	воле
положила	положила
подарила	подарила
которое	которое
вари	вари
отделен	отделен
убила	убила
доказать	доказать
Возлюбленный	Возлюбленный
одели	одели
воевали	воевали
вступить	вступить
призраку	призраку
чтоб	чтоб
перестать	перестать
потерянной	потерянной
проси	проси
очистим	очистим
жертве	жертве
какой	какой
избранная	избранная
чужом	чужом
суди	суди
прожили	прожили
полу	полу
составился	составился
переночевали	переночевали
скоте	скоте
кидару	кидару
открытых	открытых
какие	какие
обитать	обитать
пыли	пыли
голодных	голодных
почерпнули	почерпнули
мытарь	мытарь
откажи	откажи
семействе	семействе
повод	повод
произносила	произносила
позвали	позвали
хулить	хулить
поступи	поступи
развалинах	развалинах
родит	родит
целые	целые
считал	считал
устремился	устремился
поселить	поселить
приняло	приняло
головах	головах
известите	известите
Адам	Адам
козлах	козлах
собирайте	собирайте
целых	целых
Мои	Мои
онемел	онемел
пожирала	пожирала
избирали	избирали
налагали	налагали
любимое	любимое
служила	служила
сердечным	сердечным
пустою	пустою
приводите	приводите
ищи	ищи
Аду	Аду
спите	спите
всякая	всякая
Знаем	Знаем
возопили	возопили
своем	своем
чужою	чужою
образовали	образовали
почитаете	почитаете
разори	разори
здании	здании
страшилищем	страшилищем
рождайте	рождайте
белый	белый
благовестить	благовестить
посылать	посылать
купила	купила
черпали	черпали
двором	двором
полированную	полированную
чужое	чужое
воздать	воздать
изнеженный	изнеженный
новой	новой
пробыть	пробыть
останови	останови
насадила	насадила
голубого	голубого
находили	находили
похвалили	похвалили
образом	образом
молила	молила
красных	красных
осмолила	осмолила
переходить	переходить
проходишь	проходишь
смешанных	смешанных
разбудить	разбудить
перебили	перебили
срывали	срывали
прибавляй	прибавляй
затворит	затворит
страшных	страшных
истреби	истреби
Иудиной	Иудиной
призвать	призвать
разделили	разделили
рассеянных	рассеянных
удерживали	удерживали
созрела	созрела
открытом	открытом
одержимый	одержимый
увеличился	увеличился
топтать	топтать
выгнать	выгнать
терафим	терафим
поднимали	поднимали
мстить	мстить
читать	читать
отнята	отнята
следующему	следующему
молоти	молоти
крестит	крестит
твердо	твердо
каждом	каждом
вин	вин
звезда	звезда
уверить	уверить
заколать	заколать
убийстве	убийстве
вспоминать	вспоминать
черных	черных
подняли	подняли
областеначальникам	областеначальникам
устроили	устроили
наполняй	наполняй
изливать	изливать
горды	горды
чада	чада
молчите	молчите
встречали	встречали
сохраните	сохраните
произвели	произвели
подражали	подражали
переправили	переправили
Как	Как
половина	половина
Царю	Царю
тьма	тьма
жилами	жилами
возлюбленной	возлюбленной
наставить	наставить
увеличить	увеличить
подумали	подумали
производить	производить
вешать	вешать
цвета	цвета
Дину	Дину
натянуть	натянуть
платили	платили
которого	которого
небе	небе
избранной	избранной
отличен	отличен
обрела	обрела
шипов	шипов
открытой	открытой
пугать	пугать
переносим	переносим
четвертую	четвертую
привалив	привалив
бесноватого	бесноватого
ним	ним
бесчестить	бесчестить
животные	животные
весу	весу
морю	морю
искусить	искусить
траве	траве
расслабленные	расслабленные
Святым	Святым
пригласи	пригласи
почтить	почтить
называли	называли
следовать	следовать
брали	брали
Мне	Мне
оставлять	оставлять
пролился	пролился
имеют	имеют
преподать	преподать
самого	самого
возьмут	возьмут
головы	головы
поместить	поместить
возгласи	возгласи
раздели	раздели
пройди	пройди
замедлить	замедлить
преследовали	преследовали
убитым	убитым
лицо	лицо
живые	живые
тысячи	тысячи
почти	почти
серебре	серебре
потускло	потускло
Моисеевы	Моисеевы
растаяло	растаяло
перестали	перестали
следующем	следующем
вызывали	вызывали
последуй	последуй
родила	родила
выполняла	выполняла
шести	шести
возьмет	возьмет
страдающий	страдающий
духов	духов
проклинали	проклинали
наги	наги
храните	храните
негодовании	негодовании
повис	повис
надевай	надевай
разодрала	разодрала
опустили	опустили
если	если
продай	продай
мои	мои
весе	весе
разговаривали	разговаривали
подумайте	подумайте
усилить	усилить
познаю	познаю
лишился	лишился
Они	Они
сходят	сходят
отстали	отстали
делили	делили
рассекали	рассекали
возврати	возврати
победить	победить
старые	старые
плачу	плачу
отличился	отличился
вострепетали	вострепетали
запустением	запустением
светила	светила
трубить	трубить
велят	велят
очистить	очистить
сладкое	сладкое
снисходить	снисходить
негодованием	негодованием
кровопролитием	кровопролитием
поселили	поселили
наполнить	наполнить
необрезанные	необрезанные
отложи	отложи
осени	осени
избавить	избавить
искать	искать
проходить	проходить
выкупали	выкупали
выслушай	выслушай
считаешь	считаешь
отстать	отстать
долгом	долгом
узнала	узнала
омывать	омывать
звали	звали
золотом	золотом
мужчинах	мужчинах
одержимая	одержимая
отложился	отложился
блудодействуешь	блудодействуешь
поручен	поручен
прославляли	прославляли
упоена	упоена
язвами	язвами
умоляй	умоляй
отходите	отходите
садите	садите
приложить	приложить
блудили	блудили
написанных	написанных
спешила	спешила
достали	достали
проклинать	проклинать
устранить	устранить
тысячах	тысячах
мухи	мухи
похоронен	похоронен
вынесли	вынесли
фараона	фараона
великой	великой
пробыли	пробыли
доставили	доставили
смущен	смущен
почитали	почитали
лицами	лицами
свекрови	свекрови
страшного	страшного
постиг	постиг
управляем	управляем
черного	черного
наложите	наложите
плату	плату
отделился	отделился
срывать	срывать
взирать	взирать
проповедуй	проповедуй
совратили	совратили
целую	целую
крестился	крестился
палит	палит
взыскали	взыскали
дохни	дохни
исполните	исполните
открыто	открыто
покой	покой
этого	этого
отвалит	отвалит
начерпала	начерпала
жилой	жилой
обрезывай	обрезывай
внуки	внуки
мертвым	мертвым
духу	духу
окружали	окружали
добро	добро
встретить	встретить
молодом	молодом
изблюешь	изблюешь
повредить	повредить
отсек	отсек
которая	которая
фараоне	фараоне
благодарив	благодарив
чужая	чужая
первою	первою
две	две
ради	ради
произносите	произносите
умирающий	умирающий
омывали	омывали
возделывали	возделывали
расти	расти
миру	миру
предавай	предавай
слышали	слышали
поручился	поручился
Пи	Пи
разбить	разбить
обходили	обходили
напоить	напоить
восемью	восемью
хранили	хранили
