hringar	hringar
hefðarsætin	hefðarsætin
hatursins	hatursins
leyndarinnar	leyndarinnar
rithöfundurinn	rithöfundurinn
dramb	dramb
lastmæltu	lastmæltu
völd	völd
spáðu	spáðu
stundu	stundu
markgreifanna	markgreifanna
missið	missið
þökkunum	þökkunum
nöðru	nöðru
vanadíns	vanadíns
veittuð	veittuð
tóninum	tóninum
máluðum	máluðum
hinir	hinir
stöðunum	stöðunum
berast	berast
leiða	leiða
skírt	skírt
skýrum	skýrum
skipsins	skipsins
Annað	Annað
bullið	bullið
skylduð	skylduð
sagt	sagt
skipti	skipti
hluta	hluta
jafnað	jafnað
tíðir	tíðir
mínar	mínar
enga	enga
klæðir	klæðir
kjaltan	kjaltan
kryddi	kryddi
æxlanirnar	æxlanirnar
áfrýjuninni	áfrýjuninni
hengduð	hengduð
skyti	skyti
ná	ná
líkt	líkt
sumir	sumir
vel	vel
hætta	hætta
skip	skip
félagum	félagum
Hin	Hin
minnandi	minnandi
sjálfsmorðs	sjálfsmorðs
allt	allt
dögunum	dögunum
bæru	bæru
kenndina	kenndina
skytuð	skytuð
þrengingin	þrengingin
færir	færir
sjálfur	sjálfur
Eruð	Eruð
færði	færði
prúttar	prúttar
kökukeflið	kökukeflið
minnt	minnt
óskir	óskir
kjarnakorn	kjarnakorn
rithöfundum	rithöfundum
meira	meira
vald	vald
Enginn	Enginn
als	als
dæmast	dæmast
herpir	herpir
lofuðum	lofuðum
færðuð	færðuð
greinisins	greinisins
alur	alur
gríska	gríska
annan	annan
skyldu	skyldu
málaði	málaði
leita	leita
færanna	færanna
báðir	báðir
lærandi	lærandi
sónatína	sónatína
göfga	göfga
krælandi	krælandi
styrki	styrki
dæma	dæma
verið	verið
strikin	strikin
voruð	voruð
flettir	flettir
félaganna	félaganna
þrem	þrem
vara	vara
hötuðu	hötuðu
störf	störf
mala	mala
græddi	græddi
málið	málið
málandi	málandi
hryggðir	hryggðir
klippti	klippti
þinni	þinni
komast	komast
skytum	skytum
látna	látna
öðluðumst	öðluðumst
liðum	liðum
hneigðuð	hneigðuð
bærum	bærum
framan	framan
köstum	köstum
tjörnum	tjörnum
skjóta	skjóta
kalksteinn	kalksteinn
hryggi	hryggi
þarfaþingið	þarfaþingið
hvílist	hvílist
blóðfrumu	blóðfrumu
anda	anda
fiskinn	fiskinn
síðu	síðu
Allur	Allur
velji	velji
boði	boði
forsælu	forsælu
yrðu	yrðu
fyrstur	fyrstur
dauða	dauða
komna	komna
fisksins	fisksins
hlutarins	hlutarins
félag	félag
fóðrunum	fóðrunum
hryggðu	hryggðu
stóru	stóru
bíóinu	bíóinu
sendi	sendi
velur	velur
verði	verði
stjórnuðu	stjórnuðu
söfnum	söfnum
þvost	þvost
líkist	líkist
lítið	lítið
sjálfstraust	sjálfstraust
sóla	sóla
öll	öll
vorum	vorum
hvor	hvor
tíðum	tíðum
skýrið	skýrið
læra	læra
boðið	boðið
nokkru	nokkru
lengur	lengur
samkundustjóra	samkundustjóra
áttunda	áttunda
flokkar	flokkar
folunum	folunum
kastað	kastað
hagnýtti	hagnýtti
neinir	neinir
étið	étið
sjálfstraustið	sjálfstraustið
hinu	hinu
notaðir	notaðir
notar	notar
reyndu	reyndu
hafna	hafna
styrkja	styrkja
Mun	Mun
hötuðum	hötuðum
borði	borði
alla	alla
Eru	Eru
öllum	öllum
ritum	ritum
styrkjandi	styrkjandi
væru	væru
þessir	þessir
klæddir	klæddir
gætt	gætt
efldu	efldu
lauk	lauk
lífvarðarins	lífvarðarins
dáðu	dáðu
póker	póker
minn	minn
greinarnir	greinarnir
misgjörða	misgjörða
fylltu	fylltu
met	met
umkringja	umkringja
ráð	ráð
Krists	Krists
kenndin	kenndin
líkur	líkur
lífvörðurinn	lífvörðurinn
Hvert	Hvert
hlátur	hlátur
hvílíka	hvílíka
mínum	mínum
freista	freista
hræddi	hræddi
smalahundur	smalahundur
næsta	næsta
notuðum	notuðum
éti	éti
öðlast	öðlast
piparinn	piparinn
þessa	þessa
öxla	öxla
félaganum	félaganum
lofa	lofa
fjarlægir	fjarlægir
færa	færa
fylltuð	fylltuð
bundna	bundna
fjarlægt	fjarlægt
dissar	dissar
kanti	kanti
ruslinu	ruslinu
sköpum	sköpum
æptir	æptir
látum	látum
misstuð	misstuð
skalt	skalt
fiskana	fiskana
bols	bols
skjótt	skjótt
þarfaþing	þarfaþing
leynið	leynið
loft	loft
drekkja	drekkja
þriðja	þriðja
fljótt	fljótt
samboðna	samboðna
testósterónið	testósterónið
hina	hina
gefið	gefið
jóna	jóna
stóra	stóra
jafnir	jafnir
brekkusóley	brekkusóley
hugtaks	hugtaks
hef	hef
göfgar	göfgar
lærður	lærður
flokks	flokks
gjaldi	gjaldi
framar	framar
treysti	treysti
samkundustjórinn	samkundustjórinn
kjarnakorni	kjarnakorni
klætt	klætt
teiknið	teiknið
leysti	leysti
zetu	zetu
guðspjallamaðurinn	guðspjallamaðurinn
neytt	neytt
vanheilagan	vanheilagan
Hvorn	Hvorn
kastandi	kastandi
grasafræðin	grasafræðin
málir	málir
hin	hin
belgi	belgi
safni	safni
sjöundi	sjöundi
korpöndunum	korpöndunum
mynstur	mynstur
samboðinn	samboðinn
sendu	sendu
Suma	Suma
leiðin	leiðin
fyllið	fyllið
áttundi	áttundi
sumum	sumum
mín	mín
einhvern	einhvern
lastmæli	lastmæli
engan	engan
rottuna	rottuna
heiðagæsum	heiðagæsum
málaðir	málaðir
trúna	trúna
æxlununum	æxlununum
ríki	ríki
syndga	syndga
kvæntur	kvæntur
þolinu	þolinu
trú	trú
færðu	færðu
skytir	skytir
bifaði	bifaði
höfði	höfði
hvílast	hvílast
lénið	lénið
höfum	höfum
skýrði	skýrði
hreyfi	hreyfi
óperuhúsið	óperuhúsið
perlunum	perlunum
ráðunum	ráðunum
smalahundurinn	smalahundurinn
klædda	klædda
ríkdóms	ríkdóms
tilreiknast	tilreiknast
þvo	þvo
oft	oft
gæti	gæti
knýði	knýði
kölluðu	kölluðu
flokkum	flokkum
jafnt	jafnt
dáð	dáð
klæð	klæð
máluðu	máluðu
tjarnar	tjarnar
sín	sín
kylfurnar	kylfurnar
horfðu	horfðu
horn	horn
ranns	ranns
uppvekur	uppvekur
gyldir	gyldir
snúið	snúið
Nakson	Nakson
skírandi	skírandi
fyllir	fyllir
fljótið	fljótið
dagurinn	dagurinn
sjálfan	sjálfan
hórkarl	hórkarl
vökunum	vökunum
búninganna	búninganna
þínu	þínu
bygg	bygg
treyst	treyst
hjartarsalt	hjartarsalt
fjórði	fjórði
fýrum	fýrum
leiðast	leiðast
klæðum	klæðum
klæðandi	klæðandi
kastir	kastir
guði	guði
neins	neins
skil	skil
bolir	bolir
lokum	lokum
kostuðu	kostuðu
skapinu	skapinu
hvíl	hvíl
vanheilagur	vanheilagur
skaflinn	skaflinn
skýrðuð	skýrðuð
Kristi	Kristi
æðahnútarnir	æðahnútarnir
jörðina	jörðina
bifa	bifa
lofi	lofi
hagann	hagann
hengið	hengið
verð	verð
hópum	hópum
körtunnar	körtunnar
munum	munum
dansaði	dansaði
söndunum	söndunum
vissir	vissir
óska	óska
sjálfstraustsins	sjálfstraustsins
horna	horna
einhver	einhver
göfguðu	göfguðu
færist	færist
allir	allir
glatt	glatt
mestur	mestur
hefjið	hefjið
klæðin	klæðin
brjóstbeinið	brjóstbeinið
hryggdýrin	hryggdýrin
skreytti	skreytti
ráðin	ráðin
minntir	minntir
notuðuð	notuðuð
dána	dána
sygjum	sygjum
huldir	huldir
slyppu	slyppu
klæði	klæði
getur	getur
gyldu	gyldu
mínir	mínir
kalksteininum	kalksteininum
skipi	skipi
svengdin	svengdin
hirðana	hirðana
slíkar	slíkar
dans	dans
reyni	reyni
eyddi	eyddi
Fyrst	Fyrst
neinu	neinu
brennu	brennu
sölum	sölum
hennar	hennar
deyðast	deyðast
vakir	vakir
vegasalt	vegasalt
lessa	lessa
hlutunum	hlutunum
reiði	reiði
spillti	spillti
Þess	Þess
þótt	þótt
sósublettanna	sósublettanna
leyfunum	leyfunum
vönduðuð	vönduðuð
hvílíkar	hvílíkar
gervitungls	gervitungls
sumu	sumu
vanheilagt	vanheilagt
eyrað	eyrað
elsku	elsku
einstaklingurinn	einstaklingurinn
breyttu	breyttu
háls	háls
spörfugl	spörfugl
óhamingjunni	óhamingjunni
veitti	veitti
byggja	byggja
brennur	brennur
hengdir	hengdir
heitir	heitir
báðar	báðar
ríbónúkleasann	ríbónúkleasann
Skyldu	Skyldu
Mæli	Mæli
korpönd	korpönd
hugi	hugi
hirða	hirða
Alls	Alls
sagna	sagna
byggi	byggi
skilaði	skilaði
reynir	reynir
værir	værir
kross	kross
dæmin	dæmin
körtum	körtum
hlátri	hlátri
fæddu	fæddu
hafs	hafs
japanskan	japanskan
fundunum	fundunum
spektu	spektu
ríkt	ríkt
skaut	skaut
vafa	vafa
greinanna	greinanna
vissa	vissa
sættir	sættir
minnum	minnum
Fyrsti	Fyrsti
jónirnar	jónirnar
stundina	stundina
fjöldanum	fjöldanum
Hverja	Hverja
glerhaf	glerhaf
einstaklinginn	einstaklinginn
of	of
rita	rita
opið	opið
fórnum	fórnum
skuluð	skuluð
kær	kær
undan	undan
drýgði	drýgði
fleygt	fleygt
útlisti	útlisti
leitast	leitast
félagi	félagi
spjótkast	spjótkast
gefinn	gefinn
safnað	safnað
leyfa	leyfa
engar	engar
slíkt	slíkt
hórkarla	hórkarla
gjaldir	gjaldir
Sumir	Sumir
vambirnar	vambirnar
slíkir	slíkir
ræða	ræða
myrti	myrti
endurnýjuðuð	endurnýjuðuð
leit	leit
köstuðum	köstuðum
saknir	saknir
einum	einum
breidd	breidd
síst	síst
syndgað	syndgað
komst	komst
Allt	Allt
eyranu	eyranu
misstum	misstum
samkundustjóri	samkundustjóri
færu	færu
gaggaði	gaggaði
afrit	afrit
vanadíni	vanadíni
trúa	trúa
málað	málað
gafflana	gafflana
hrasar	hrasar
byggðu	byggðu
yrðum	yrðum
staða	staða
víka	víka
greini	greini
Líkt	Líkt
kafði	kafði
skýri	skýri
færum	færum
kosti	kosti
gess	gess
bólstraskýs	bólstraskýs
sekt	sekt
deyðið	deyðið
hljómlist	hljómlist
lærðuð	lærðuð
mest	mest
hneigið	hneigið
áfrýjunar	áfrýjunar
bóndi	bóndi
engir	engir
vitrað	vitrað
ofar	ofar
flettuð	flettuð
Hafið	Hafið
raulið	raulið
fórnið	fórnið
leiðir	leiðir
byggðum	byggðum
var	var
vísur	vísur
naðranna	naðranna
svæfi	svæfi
skildist	skildist
skýrandi	skýrandi
mörkin	mörkin
alls	alls
tali	tali
kyssi	kyssi
hefjum	hefjum
þessi	þessi
kasta	kasta
múslimarnir	múslimarnir
skírðuð	skírðuð
stær	stær
gætu	gætu
enginn	enginn
væri	væri
krossanna	krossanna
leitt	leitt
ungmennis	ungmennis
eigin	eigin
tilreiknar	tilreiknar
dygðina	dygðina
Munu	Munu
hvílu	hvílu
höfunum	höfunum
lofaðir	lofaðir
sölurnar	sölurnar
konu	konu
gefast	gefast
sjálfsmorðið	sjálfsmorðið
gættir	gættir
freistið	freistið
skerma	skerma
hræddum	hræddum
byggðuð	byggðuð
ríktu	ríktu
fyrsti	fyrsti
horft	horft
höndlað	höndlað
fylli	fylli
stundanna	stundanna
Fyrstur	Fyrstur
færi	færi
munt	munt
leyfinu	leyfinu
Anna	Anna
dansa	dansa
gjalda	gjalda
órétti	órétti
fyrsta	fyrsta
Verið	Verið
sjálfir	sjálfir
staðinn	staðinn
ilmjurtunum	ilmjurtunum
Hafði	Hafði
birta	birta
átu	átu
skammir	skammir
káetu	káetu
skrifað	skrifað
flokkarnir	flokkarnir
verðinu	verðinu
krydda	krydda
fiska	fiska
borðið	borðið
styrktir	styrktir
nokkurs	nokkurs
þekktur	þekktur
fjórir	fjórir
mesta	mesta
þols	þols
munu	munu
hlutanna	hlutanna
drekkir	drekkir
sá	sá
eigist	eigist
ilmjurtir	ilmjurtir
fýri	fýri
minntum	minntum
óskuðu	óskuðu
áhugamálið	áhugamálið
óréttinn	óréttinn
Þessu	Þessu
æðahnúta	æðahnúta
skíðaði	skíðaði
labbið	labbið
skjótast	skjótast
hrætt	hrætt
óhamingju	óhamingju
fældir	fældir
prúttandi	prúttandi
Hinar	Hinar
viðræða	viðræða
skjallið	skjallið
slíkan	slíkan
eigi	eigi
Slíkt	Slíkt
hæðir	hæðir
brunann	brunann
kastið	kastið
minnstur	minnstur
engjum	engjum
spektan	spektan
ráðanna	ráðanna
definite	definite
æxlun	æxlun
þóttist	þóttist
fórnfært	fórnfært
fundið	fundið
guðinn	guðinn
styrkir	styrkir
fisk	fisk
leysir	leysir
konuna	konuna
girninu	girninu
þeirra	þeirra
klippi	klippi
voru	voru
staðurinn	staðurinn
þína	þína
guðspjallamenn	guðspjallamenn
sparkar	sparkar
reyndi	reyndi
dryn	dryn
guð	guð
flokkur	flokkur
annað	annað
girni	girni
flesta	flesta
drepur	drepur
skipinu	skipinu
styrktum	styrktum
furunum	furunum
lýst	lýst
stóðuð	stóðuð
málum	málum
skyldi	skyldi
þessar	þessar
vestrar	vestrar
minnast	minnast
hópinn	hópinn
lagt	lagt
kasti	kasti
hætt	hætt
saltkjöt	saltkjöt
síið	síið
klædduð	klædduð
kastaði	kastaði
kjöltu	kjöltu
velþóknanlegur	velþóknanlegur
sektir	sektir
báðum	báðum
nekt	nekt
lærði	lærði
skreyta	skreyta
iðnað	iðnað
settur	settur
leysast	leysast
byggt	byggt
eflduð	eflduð
dansinn	dansinn
nokkrir	nokkrir
Mannssoninn	Mannssoninn
drekktum	drekktum
pókersins	pókersins
glóbrystingurinn	glóbrystingurinn
send	send
Hvern	Hvern
metinu	metinu
guðum	guðum
tjöldunum	tjöldunum
tind	tind
göfguðuð	göfguðuð
allan	allan
skipin	skipin
Allan	Allan
tilreiknað	tilreiknað
sendum	sendum
valdi	valdi
hins	hins
leyndum	leyndum
hafi	hafi
hryggjum	hryggjum
sumt	sumt
hvílt	hvílt
missum	missum
líkinu	líkinu
treystu	treystu
skír	skír
perlanna	perlanna
þreytst	þreytst
varirnar	varirnar
skrifaði	skrifaði
fletti	fletti
guðir	guðir
skýrt	skýrt
eitur	eitur
dæmanna	dæmanna
selleríið	selleríið
kvöldunum	kvöldunum
styrkið	styrkið
skækjum	skækjum
minnið	minnið
þjást	þjást
ljóðlistin	ljóðlistin
safnandi	safnandi
skytu	skytu
efla	efla
snúi	snúi
neinn	neinn
hópur	hópur
framlengdi	framlengdi
gengi	gengi
drolls	drolls
metum	metum
stund	stund
vígvelli	vígvelli
flöguna	flöguna
varir	varir
síðar	síðar
sögn	sögn
slíka	slíka
skýra	skýra
safnaði	safnaði
kvars	kvars
gættu	gættu
fjarveru	fjarveru
borðaðir	borðaðir
djúpt	djúpt
veldu	veldu
félögin	félögin
stjórnandi	stjórnandi
hafsins	hafsins
bifar	bifar
óskaði	óskaði
byggjandi	byggjandi
tengisagna	tengisagna
vestrinn	vestrinn
lagði	lagði
saurgað	saurgað
sérhvern	sérhvern
dæmi	dæmi
sinn	sinn
klæða	klæða
leynduð	leynduð
sérhverja	sérhverja
étum	étum
andaði	andaði
safnaðir	safnaðir
kostaði	kostaði
sleik	sleik
gætið	gætið
prúttuðuð	prúttuðuð
reyndur	reyndur
drekk	drekk
spilltur	spilltur
handbolta	handbolta
uppvekja	uppvekja
vörum	vörum
gengið	gengið
eyrunum	eyrunum
þinna	þinna
skafls	skafls
hringaðir	hringaðir
hafa	hafa
notið	notið
móðunni	móðunni
Kristur	Kristur
stórhertoginn	stórhertoginn
hengdu	hengdu
saurgi	saurgi
senda	senda
greinirinn	greinirinn
vonin	vonin
sendir	sendir
leyfðu	leyfðu
belgir	belgir
færð	færð
notað	notað
akra	akra
félagsins	félagsins
gegnt	gegnt
vökina	vökina
hlutirnir	hlutirnir
ríbónúkleösunum	ríbónúkleösunum
æðikolls	æðikolls
Mælir	Mælir
fyrstu	fyrstu
vakar	vakar
hryggja	hryggja
lessan	lessan
liðsins	liðsins
staði	staði
klúðrir	klúðrir
ert	ert
sums	sums
fiskum	fiskum
látið	látið
þrengingu	þrengingu
Krist	Krist
ungmenni	ungmenni
ökrunum	ökrunum
sjötti	sjötti
þínum	þínum
langað	langað
reynd	reynd
sólunum	sólunum
birtur	birtur
borðar	borðar
valið	valið
fleygi	fleygi
bögum	bögum
smalahundum	smalahundum
testósteróns	testósteróns
breiddi	breiddi
selduð	selduð
lifandann	lifandann
vök	vök
félagshyggju	félagshyggju
brekkusnigli	brekkusnigli
vonunum	vonunum
setta	setta
svæfði	svæfði
fórnuðu	fórnuðu
haginn	haginn
gerast	gerast
haga	haga
pipars	pipars
kennd	kennd
fjórum	fjórum
kökukefli	kökukefli
metanna	metanna
góm	góm
Skyldum	Skyldum
klæddu	klæddu
borða	borða
eitt	eitt
yrði	yrði
komum	komum
hálsum	hálsum
byggð	byggð
flaga	flaga
drunið	drunið
stóð	stóð
styrktuð	styrktuð
sandinn	sandinn
klæðið	klæðið
undur	undur
skipaði	skipaði
mörkunum	mörkunum
markið	markið
efli	efli
skrifir	skrifir
stundinni	stundinni
frumvörpum	frumvörpum
Fyrir	Fyrir
minnst	minnst
flettið	flettið
fórnfæra	fórnfæra
seldur	seldur
víst	víst
raustum	raustum
hrifsuðuð	hrifsuðuð
fyrstir	fyrstir
smóka	smóka
drollinu	drollinu
mets	mets
akur	akur
tónninn	tónninn
Slíkar	Slíkar
hræddir	hræddir
skýrðum	skýrðum
byggði	byggði
gættum	gættum
hengdum	hengdum
meðal	meðal
kjörinn	kjörinn
prútta	prútta
kalli	kalli
borðaði	borðaði
einhverja	einhverja
æxlunina	æxlunina
möluðuð	möluðuð
gaffallinn	gaffallinn
eruð	eruð
byggir	byggir
höfðu	höfðu
deyðir	deyðir
þinnar	þinnar
minnsta	minnsta
sé	sé
leyndin	leyndin
furunni	furunni
sigurinn	sigurinn
flett	flett
kosta	kosta
færðir	færðir
syndgum	syndgum
káetan	káetan
annast	annast
skjótir	skjótir
fæddi	fæddi
dæmdu	dæmdu
berst	berst
íveru	íveru
krossfesti	krossfesti
tilreiknuð	tilreiknuð
lokið	lokið
hafið	hafið
völdunum	völdunum
skulum	skulum
áhugamáli	áhugamáli
skjalla	skjalla
hornið	hornið
sendið	sendið
myrtu	myrtu
breytt	breytt
æpa	æpa
blindum	blindum
fyrstum	fyrstum
metið	metið
ræðu	ræðu
þol	þol
æðarkónginn	æðarkónginn
lengi	lengi
starfið	starfið
meti	meti
lið	lið
lofandi	lofandi
vökin	vökin
leyndir	leyndir
hafanna	hafanna
sendur	sendur
nokkrar	nokkrar
boðin	boðin
blóðfrumunum	blóðfrumunum
Ert	Ert
neyðið	neyðið
Þessir	Þessir
gætum	gætum
tengisagnirnar	tengisagnirnar
heim	heim
skal	skal
síðast	síðast
treystir	treystir
hefðarsæti	hefðarsæti
ákæra	ákæra
sína	sína
siða	siða
skírði	skírði
svæfið	svæfið
koma	koma
fylla	fylla
fundanna	fundanna
ást	ást
flestir	flestir
svengd	svengd
öxli	öxli
rannana	rannana
sérhver	sérhver
vömbin	vömbin
skyldum	skyldum
eru	eru
spá	spá
auki	auki
þönkum	þönkum
helgast	helgast
knýir	knýir
þægindi	þægindi
heyrðum	heyrðum
ris	ris
hryggðuð	hryggðuð
minni	minni
ali	ali
drýgi	drýgi
bíóið	bíóið
værum	værum
Það	Það
græddur	græddur
skírðir	skírðir
kæru	kæru
kostum	kostum
undirfylkingu	undirfylkingu
grísku	grísku
sést	sést
köfðu	köfðu
skapanna	skapanna
flokkurinn	flokkurinn
henni	henni
fenguð	fenguð
bullinu	bullinu
einu	einu
eina	eina
líka	líka
fiskur	fiskur
postuladóm	postuladóm
postuladóms	postuladóms
heima	heima
krældi	krældi
vissuð	vissuð
skýtur	skýtur
vallarmiðju	vallarmiðju
líkum	líkum
sleiksins	sleiksins
hinum	hinum
missi	missi
rósemi	rósemi
skírir	skírir
brjóstbeins	brjóstbeins
skiptir	skiptir
kysstu	kysstu
styrkti	styrkti
eyddist	eyddist
eyra	eyra
lifnaður	lifnaður
net	net
kring	kring
fiskar	fiskar
óperuhúsa	óperuhúsa
skilin	skilin
gull	gull
Alla	Alla
styrkjum	styrkjum
sérhvert	sérhvert
kaupunum	kaupunum
missirinn	missirinn
herpi	herpi
slíkum	slíkum
tiggja	tiggja
vor	vor
hreyfir	hreyfir
lastmælir	lastmælir
míns	míns
klæddi	klæddi
strika	strika
sala	sala
ofan	ofan
keypti	keypti
fórnir	fórnir
fyllti	fyllti
gengist	gengist
lofaði	lofaði
glatast	glatast
skulu	skulu
nota	nota
ritaði	ritaði
undir	undir
verðin	verðin
blindir	blindir
mína	mína
sjötta	sjötta
Erum	Erum
krakkið	krakkið
treysta	treysta
hafir	hafir
heiðagæs	heiðagæs
gegnum	gegnum
verðs	verðs
skýrir	skýrir
reið	reið
stundir	stundir
náðu	náðu
reiðin	reiðin
haft	haft
Haf	Haf
stundarinnar	stundarinnar
bólstraskýjum	bólstraskýjum
lifanda	lifanda
fengin	fengin
slíku	slíku
flokkunum	flokkunum
skips	skips
þekktuð	þekktuð
fjórðu	fjórðu
fullnast	fullnast
verðið	verðið
dygðarinnar	dygðarinnar
valdið	valdið
útlista	útlista
dæmið	dæmið
væruð	væruð
vanheilagir	vanheilagir
mættum	mættum
vísu	vísu
fyll	fyll
mættuð	mættuð
er	er
þín	þín
höndli	höndli
ákærðu	ákærðu
Naksons	Naksons
slepp	slepp
upplestra	upplestra
starf	starf
verða	verða
markgreifa	markgreifa
breytum	breytum
neitt	neitt
fisks	fisks
myndaði	myndaði
reyndir	reyndir
bætti	bætti
þremur	þremur
labba	labba
hliðin	hliðin
séu	séu
þínar	þínar
minntuð	minntuð
hinar	hinar
flokksins	flokksins
styrkt	styrkt
tálvon	tálvon
vísurnar	vísurnar
minna	minna
drottnaðir	drottnaðir
lík	lík
skýt	skýt
grasafræði	grasafræði
skipa	skipa
skækjan	skækjan
kylfu	kylfu
hornsins	hornsins
sent	sent
farsíma	farsíma
ges	ges
umkringdum	umkringdum
skilinn	skilinn
sinna	sinna
líki	líki
leitaði	leitaði
rek	rek
bliku	bliku
þekkt	þekkt
leynir	leynir
nokkrum	nokkrum
móðunum	móðunum
sakna	sakna
auka	auka
fullnuð	fullnuð
gætti	gætti
næst	næst
kastaðir	kastaðir
snæris	snæris
siðaði	siðaði
Hvor	Hvor
missti	missti
neyðir	neyðir
hryggt	hryggt
fjóra	fjóra
báða	báða
húsfrúrnar	húsfrúrnar
hryggir	hryggir
hættu	hættu
þökkum	þökkum
félaga	félaga
skrifar	skrifar
missir	missir
hræðið	hræðið
minnanna	minnanna
fundinn	fundinn
lærir	lærir
hrifsaðir	hrifsaðir
leyfis	leyfis
skýrðu	skýrðu
þriðju	þriðju
hengjum	hengjum
helga	helga
fæst	fæst
metast	metast
spáð	spáð
fyllandi	fyllandi
skrifum	skrifum
söfnuðuð	söfnuðuð
skýr	skýr
skipunum	skipunum
fundi	fundi
reynið	reynið
berklanna	berklanna
safnar	safnar
senduð	senduð
kært	kært
sónatínan	sónatínan
karakterinn	karakterinn
mætti	mætti
skrifuðu	skrifuðu
neytti	neytti
sinni	sinni
horfði	horfði
fylgdist	fylgdist
berð	berð
snerist	snerist
inn	inn
hvorum	hvorum
ölum	ölum
vitru	vitru
framlengdu	framlengdu
vísa	vísa
engin	engin
fær	fær
japönskunni	japönskunni
skírið	skírið
drekki	drekki
svæfðuð	svæfðuð
snæri	snæri
hefjir	hefjir
eldpipar	eldpipar
hryggdýrið	hryggdýrið
ákæru	ákæru
stærið	stærið
færis	færis
yrðuð	yrðuð
skírðum	skírðum
rétti	rétti
síðasta	síðasta
nokkur	nokkur
langt	langt
endurnýjum	endurnýjum
folann	folann
komist	komist
neitaði	neitaði
sneri	sneri
reiðum	reiðum
fyllt	fyllt
hugtak	hugtak
gerðu	gerðu
skíða	skíða
heita	heita
rekur	rekur
stunda	stunda
klæddum	klæddum
kantinn	kantinn
dæmdur	dæmdur
kallað	kallað
þolið	þolið
hornum	hornum
Þau	Þau
lýsti	lýsti
eyru	eyru
skrifuðum	skrifuðum
tala	tala
slík	slík
hræðum	hræðum
gjörðu	gjörðu
köstuðuð	köstuðuð
gaggið	gaggið
hefur	hefur
skjótum	skjótum
samkundustjórunum	samkundustjórunum
skýrðir	skýrðir
byggðir	byggðir
lastmæla	lastmæla
sjálfu	sjálfu
þess	þess
iðnaður	iðnaður
öllu	öllu
kostandi	kostandi
óskar	óskar
líkið	líkið
einræktað	einræktað
nei	nei
allar	allar
liðanna	liðanna
þægindum	þægindum
sendandi	sendandi
skildum	skildum
flokkana	flokkana
verðsins	verðsins
tappatogara	tappatogara
hóp	hóp
allur	allur
akursins	akursins
klúðraðir	klúðraðir
réttur	réttur
liðið	liðið
Þessa	Þessa
leynum	leynum
huga	huga
múslima	múslima
kysstir	kysstir
mál	mál
köstuðu	köstuðu
fundum	fundum
handboltanum	handboltanum
byggið	byggið
hagnýta	hagnýta
sektuðu	sektuðu
smalahundana	smalahundana
máli	máli
dæmdir	dæmdir
lifnaði	lifnaði
lýsið	lýsið
öskra	öskra
dáið	dáið
safna	safna
elskaði	elskaði
skutuð	skutuð
Lík	Lík
stórhertoga	stórhertoga
kjörið	kjörið
iðnanna	iðnanna
æðarkóngarnir	æðarkóngarnir
rusls	rusls
leitum	leitum
ríkdóminn	ríkdóminn
minnunum	minnunum
vegasalta	vegasalta
undu	undu
hryggði	hryggði
fylgdum	fylgdum
upplestrar	upplestrar
gyldi	gyldi
þolað	þolað
opna	opna
hvorir	hvorir
gjaldið	gjaldið
guðina	guðina
sjálft	sjálft
vitrunum	vitrunum
fældu	fældu
Er	Er
boða	boða
kallir	kallir
dæmdum	dæmdum
ráðsins	ráðsins
hálsinum	hálsinum
sigur	sigur
skipt	skipt
mundum	mundum
leyndu	leyndu
hafði	hafði
velþóknanleg	velþóknanleg
klædd	klædd
jafnast	jafnast
gjöri	gjöri
vanda	vanda
skutum	skutum
hreppa	hreppa
drekktu	drekktu
köntunum	köntunum
dauðinn	dauðinn
tappatogarana	tappatogarana
blinda	blinda
þínir	þínir
þessu	þessu
dissið	dissið
mynstrið	mynstrið
glóbrystinginn	glóbrystinginn
leyfi	leyfi
hefðu	hefðu
kyssið	kyssið
þíns	þíns
beði	beði
meðalið	meðalið
þjáist	þjáist
munduð	munduð
jafna	jafna
dæmt	dæmt
gervitunglinu	gervitunglinu
líkin	líkin
skyldir	skyldir
fóður	fóður
engu	engu
ráðast	ráðast
ráða	ráða
brekkusnigla	brekkusnigla
glerhafið	glerhafið
skammar	skammar
reiðir	reiðir
líkunum	líkunum
farsímar	farsímar
bundið	bundið
Þessi	Þessi
málar	málar
öðlist	öðlist
drepir	drepir
lénin	lénin
fyllum	fyllum
slíkur	slíkur
endurnýjuðu	endurnýjuðu
skamma	skamma
laukst	laukst
flettum	flettum
misgjörðin	misgjörðin
muni	muni
Mannssonur	Mannssonur
hross	hross
misst	misst
fjöldann	fjöldann
teiknaði	teiknaði
grískuna	grískuna
greininum	greininum
þótti	þótti
skrifið	skrifið
húsfrúna	húsfrúna
höf	höf
smókinn	smókinn
Mannssonurinn	Mannssonurinn
vísum	vísum
greinis	greinis
fylltum	fylltum
hatur	hatur
skrifi	skrifi
minntu	minntu
þeirri	þeirri
ljóðlista	ljóðlista
liði	liði
þekkti	þekkti
fæðu	fæðu
búninginn	búninginn
komu	komu
sleðum	sleðum
sig	sig
þakkirnar	þakkirnar
galt	galt
kvarsinu	kvarsinu
sósubletturinn	sósubletturinn
skrifuðuð	skrifuðuð
græði	græði
bættist	bættist
misstir	misstir
fleygði	fleygði
spörfuglar	spörfuglar
styrktu	styrktu
leyfið	leyfið
haf	haf
klæðinu	klæðinu
meir	meir
síðastir	síðastir
hylja	hylja
grískunni	grískunni
greinum	greinum
tréblásturshljóðfæris	tréblásturshljóðfæris
græðið	græðið
skrifa	skrifa
fundin	fundin
iðnunum	iðnunum
sætti	sætti
fiskanna	fiskanna
reka	reka
sættið	sættið
krossfestu	krossfestu
sást	sást
Allir	Allir
klæðast	klæðast
fært	fært
þreytast	þreytast
vafann	vafann
hliðið	hliðið
vonirnar	vonirnar
græðum	græðum
Engum	Engum
kærðu	kærðu
flokkinn	flokkinn
þanka	þanka
vakirnar	vakirnar
rauluðuð	rauluðuð
safnið	safnið
andast	andast
kæra	kæra
Verði	Verði
greina	greina
sess	sess
geta	geta
spjótkastinu	spjótkastinu
mínu	mínu
Hef	Hef
þessum	þessum
minnti	minnti
leyn	leyn
hvílíks	hvílíks
kringum	kringum
byggðin	byggðin
nefndur	nefndur
kvæntist	kvæntist
viki	viki
gæta	gæta
þakka	þakka
kaupi	kaupi
tálvonin	tálvonin
tindana	tindana
sum	sum
líks	líks
hvort	hvort
krossfestuð	krossfestuð
skjóti	skjóti
bændurnir	bændurnir
næstur	næstur
spörkum	spörkum
skipið	skipið
berklar	berklar
græddum	græddum
drambið	drambið
suguð	suguð
leyndi	leyndi
eigur	eigur
mála	mála
metin	metin
síðastur	síðastur
flokk	flokk
undirfylkinganna	undirfylkinganna
frumvörpunum	frumvörpunum
eignina	eignina
skírðu	skírðu
hjartarsaltið	hjartarsaltið
ráðið	ráðið
flokknum	flokknum
keyptu	keyptu
skjótandi	skjótandi
suma	suma
myndið	myndið
afritunum	afritunum
vörina	vörina
nokkra	nokkra
lýsir	lýsir
æðardúninn	æðardúninn
bumbubúa	bumbubúa
boðaði	boðaði
séum	séum
baginn	baginn
flæmingja	flæmingja
beð	beð
skækjur	skækjur
sekta	sekta
þreytum	þreytum
nefnda	nefnda
æðardúni	æðardúni
heitt	heitt
máluðuð	máluðuð
treystuð	treystuð
byggjum	byggjum
hneigir	hneigir
kærir	kærir
eign	eign
leyfanna	leyfanna
raustar	raustar
lítt	lítt
heyrðuð	heyrðuð
gómunum	gómunum
inni	inni
flokkanna	flokkanna
notaði	notaði
sleða	sleða
hrösuðum	hrösuðum
Hvort	Hvort
minnir	minnir
hryggið	hryggið
hengdi	hengdi
búnings	búnings
fylltir	fylltir
umfjöllun	umfjöllun
jarða	jarða
leyst	leyst
stært	stært
meta	meta
sinnar	sinnar
lastmælin	lastmælin
sleppir	sleppir
sjöunda	sjöunda
Enga	Enga
skermurinn	skermurinn
missis	missis
varna	varna
talast	talast
skíri	skíri
Hinir	Hinir
risa	risa
kastar	kastar
tréblásturshljóðfærið	tréblásturshljóðfærið
gullið	gullið
djúp	djúp
líksins	líksins
högum	högum
bumbubúum	bumbubúum
flokki	flokki
flokka	flokka
engum	engum
flettu	flettu
Hefur	Hefur
öðlaðist	öðlaðist
neitað	neitað
drottnið	drottnið
