grumlade	grumlade
öppnade	öppnade
lösts	lösts
fördömda	fördömda
ställd	ställd
kuf	kuf
maakatéernas	maakatéernas
tagen	tagen
märkt	märkt
hotfull	hotfull
fungerade	fungerade
X-kromosomens	X-kromosomens
dräpes	dräpes
avfalla	avfalla
frossare	frossare
stött	stött
slipas	slipas
bombarderats	bombarderats
retronymens	retronymens
skilde	skilde
läsa	läsa
deltaga	deltaga
silverbägare	silverbägare
ute	ute
höjd	höjd
vädurarna	vädurarna
musikallåtar	musikallåtar
dräpen	dräpen
lösas	lösas
stötes	stötes
styrka	styrka
beaktandeleds	beaktandeleds
vett	vett
lyte	lyte
fästande	fästande
Serubbabels	Serubbabels
bara	bara
inhägnade	inhägnade
kartografisk	kartografisk
webbplats	webbplats
masochisten	masochisten
Lemek	Lemek
glänsande	glänsande
frågade	frågade
kufarna	kufarna
sändas	sändas
svängts	svängts
meterna	meterna
lama	lama
vattnades	vattnades
samlas	samlas
underskrifts	underskrifts
tjänen	tjänen
bit	bit
viktige	viktige
rört	rört
ställda	ställda
spritt	spritt
stötte	stötte
ena	ena
agitatorer	agitatorer
vin	vin
vävstolens	vävstolens
Hiskias	Hiskias
söka	söka
örfilarna	örfilarna
klövens	klövens
övriga	övriga
rycke	rycke
drages	drages
köpare	köpare
Ehud	Ehud
fogas	fogas
Sutela	Sutela
fatten	fatten
påbudet	påbudet
anfalla	anfalla
skapare	skapare
Falla	Falla
nymånadsdagen	nymånadsdagen
bränna	bränna
förtövades	förtövades
oskadliggjorde	oskadliggjorde
Gode	Gode
koncentrerande	koncentrerande
epitet	epitet
konungadömes	konungadömes
vänd	vänd
Amaleks	Amaleks
skrivare	skrivare
dömes	dömes
frisörers	frisörers
åt	åt
släktes	släktes
Ute	Ute
städer	städer
kokande	kokande
yttersta	yttersta
eskimåernas	eskimåernas
smide	smide
gören	gören
utforskade	utforskade
uppfylles	uppfylles
Ahabs	Ahabs
sälj	sälj
fattar	fattar
invigen	invigen
sen	sen
förtär	förtär
korn	korn
stadiers	stadiers
Absaloms	Absaloms
förgöres	förgöres
hennes	hennes
styrkes	styrkes
Judeens	Judeens
veten	veten
åtnjutas	åtnjutas
taga	taga
våldsverkarna	våldsverkarna
Rahab	Rahab
förlåten	förlåten
antänt	antänt
Lots	Lots
isotonens	isotonens
plats	plats
frukte	frukte
Melkisedeks	Melkisedeks
släkterna	släkterna
snöre	snöre
byggda	byggda
avskilda	avskilda
dugande	dugande
utspelad	utspelad
bytte	bytte
frälse	frälse
Ars	Ars
sköter	sköter
enar	enar
frambären	frambären
då	då
Orions	Orions
sliten	sliten
vet	vet
klövarna	klövarna
Saul	Saul
bergochdalbanorna	bergochdalbanorna
docerade	docerade
vilddjurs	vilddjurs
fotgängaren	fotgängaren
leden	leden
färgbildernas	färgbildernas
juble	juble
fästena	fästena
fästes	fästes
enda	enda
utbytte	utbytte
vinterdäckets	vinterdäckets
öga	öga
ha	ha
fästenas	fästenas
förtryckt	förtryckt
förenklad	förenklad
fungerar	fungerar
hörare	hörare
täcken	täcken
örfilarnas	örfilarnas
blygs	blygs
lånen	lånen
snökedjorna	snökedjorna
visade	visade
äppelträds	äppelträds
spännen	spännen
bältes	bältes
såren	såren
talats	talats
förmörkat	förmörkat
vittnesbördets	vittnesbördets
upplåten	upplåten
avhärvlade	avhärvlade
Tres	Tres
Susa	Susa
Baraks	Baraks
åklagar	åklagar
vit	vit
rörde	rörde
utpantat	utpantat
rådande	rådande
åkerstycke	åkerstycke
anklagare	anklagare
omsluten	omsluten
nämna	nämna
beskäres	beskäres
svalt	svalt
konungadömens	konungadömens
beskärt	beskärt
betyda	betyda
sådant	sådant
efterfölja	efterfölja
lögnprofeternas	lögnprofeternas
upptändes	upptändes
fatte	fatte
rev	rev
vakansers	vakansers
förenklats	förenklats
skapades	skapades
förlikt	förlikt
barrskog	barrskog
daggkåpan	daggkåpan
erövrade	erövrade
slutlige	slutlige
antända	antända
vreden	vreden
uträcka	uträcka
borrats	borrats
ringar	ringar
Judas	Judas
uppenbarande	uppenbarande
påbudens	påbudens
Jona	Jona
ripjaktens	ripjaktens
doktriners	doktriners
förtryckas	förtryckas
tystad	tystad
författningen	författningen
jagat	jagat
satsa	satsa
säkrar	säkrar
Ahab	Ahab
fyllen	fyllen
fackverket	fackverket
inhägnad	inhägnad
Brödet	Brödet
hoppas	hoppas
sådanas	sådanas
biträde	biträde
höjes	höjes
katalanske	katalanske
spejare	spejare
ringe	ringe
består	består
genomsöka	genomsöka
födda	födda
tillgängliggjord	tillgängliggjord
fakultetsnämnden	fakultetsnämnden
Adas	Adas
blygas	blygas
omgivna	omgivna
Kemuels	Kemuels
Sjustjärnorna	Sjustjärnorna
Lotan	Lotan
pack	pack
dal	dal
fallen	fallen
byten	byten
gileadit	gileadit
huggen	huggen
eforn	eforn
upphävande	upphävande
Sanna	Sanna
blottats	blottats
skörten	skörten
minnes	minnes
berömma	berömma
planteren	planteren
förföljare	förföljare
väljarnas	väljarnas
sköts	sköts
rövare	rövare
stjäle	stjäle
trampade	trampade
lagades	lagades
brandväggar	brandväggar
Ismaels	Ismaels
förmörka	förmörka
försonas	försonas
fällas	fällas
funnes	funnes
kvaddar	kvaddar
gripes	gripes
skapade	skapade
Tabors	Tabors
Balak	Balak
sexpacks	sexpacks
ödmjuke	ödmjuke
förlett	förlett
kokar	kokar
lösare	lösare
Efraim	Efraim
dyrkade	dyrkade
blidkad	blidkad
Nilens	Nilens
klappa	klappa
massakerns	massakerns
ballonger	ballonger
utför	utför
tillgängliggörs	tillgängliggörs
förda	förda
åtalas	åtalas
hindarna	hindarna
dyrkad	dyrkad
föra	föra
döpa	döpa
renad	renad
överfalla	överfalla
repmånader	repmånader
packets	packets
dennas	dennas
mista	mista
Melkisedek	Melkisedek
uträckt	uträckt
Josef	Josef
slitna	slitna
Babels	Babels
tillfrisknade	tillfrisknade
bevisade	bevisade
mark	mark
elverken	elverken
hemsöka	hemsöka
bunden	bunden
Abia	Abia
granden	granden
berömts	berömts
blidkas	blidkas
korsfästes	korsfästes
använde	använde
förstes	förstes
fiskare	fiskare
vände	vände
krigarna	krigarna
fiskas	fiskas
höres	höres
fördrives	fördrives
rövade	rövade
kände	kände
Beten	Beten
byråkratiske	byråkratiske
yngste	yngste
rots	rots
frambär	frambär
vilken	vilken
referera	referera
gemak	gemak
mötas	mötas
besöka	besöka
kläder	kläder
nejlikan	nejlikan
bevaras	bevaras
upphäver	upphäver
givet	givet
gestaltningars	gestaltningars
Abimelek	Abimelek
vävstol	vävstol
Vilket	Vilket
höljas	höljas
Libanon	Libanon
läser	läser
masochists	masochists
använt	använt
kirrade	kirrade
vise	vise
gripna	gripna
Assyriens	Assyriens
nämnda	nämnda
rådde	rådde
Joa	Joa
atomfysik	atomfysik
gripa	gripa
hugga	hugga
tågades	tågades
barn	barn
förgiftade	förgiftade
siares	siares
tjänare	tjänare
resas	resas
glädjas	glädjas
väljares	väljares
avbärgat	avbärgat
skänk	skänk
Den	Den
tjänade	tjänade
överlevnad	överlevnad
räknade	räknade
mister	mister
koret	koret
förståndet	förståndet
andas	andas
blottade	blottade
Ande	Ande
snörens	snörens
sökts	sökts
bundne	bundne
skildes	skildes
mät	mät
domänerna	domänerna
släktet	släktet
mätta	mätta
omnämnandenas	omnämnandenas
flygas	flygas
korsordet	korsordet
hjälpt	hjälpt
Amminadabs	Amminadabs
fakulteternas	fakulteternas
Efraims	Efraims
skrymtade	skrymtade
man	man
behöva	behöva
sans	sans
blinda	blinda
behövande	behövande
beställde	beställde
beaktandeledens	beaktandeledens
X-kromosom	X-kromosom
handlägg	handlägg
Sikems	Sikems
specialtecken	specialtecken
firas	firas
dråp	dråp
bon	bon
Ehuds	Ehuds
uppfyllen	uppfyllen
efterföljd	efterföljd
föda	föda
satsar	satsar
resecheckens	resecheckens
värme	värme
förbliva	förbliva
Baals	Baals
tala	tala
Fadern	Fadern
bot	bot
namnars	namnars
terroriserande	terroriserande
utgjorde	utgjorde
förgätna	förgätna
utgörande	utgörande
låta	låta
doktrins	doktrins
korsfästs	korsfästs
Massa	Massa
rovets	rovets
bakhåll	bakhåll
synderna	synderna
utfördes	utfördes
förkunnats	förkunnats
stjärntydare	stjärntydare
fruktan	fruktan
dräpa	dräpa
tillredes	tillredes
fördöma	fördöma
radavståndets	radavståndets
givna	givna
bjöden	bjöden
ökades	ökades
varulvs	varulvs
sändande	sändande
fylla	fylla
siktades	siktades
påbuden	påbuden
födes	födes
twittras	twittras
ratificerades	ratificerades
participet	participet
odjurs	odjurs
utpantning	utpantning
arglistigt	arglistigt
svänger	svänger
fostrare	fostrare
Syriens	Syriens
alls	alls
avskilde	avskilde
beställda	beställda
tänkt	tänkt
resande	resande
vittnesbörd	vittnesbörd
biträda	biträda
köpt	köpt
leva	leva
självt	självt
ledas	ledas
bovs	bovs
flädermärgskulors	flädermärgskulors
vette	vette
uddar	uddar
predikare	predikare
bunde	bunde
renades	renades
fördrivna	fördrivna
förtryckts	förtryckts
lägsta	lägsta
resecheckars	resecheckars
överlevnaden	överlevnaden
offras	offras
ponerar	ponerar
korsfäst	korsfäst
vattenkonsts	vattenkonsts
skörtet	skörtet
räknen	räknen
ställa	ställa
koka	koka
konsekventa	konsekventa
citrusfrukters	citrusfrukters
hotfulle	hotfulle
vaken	vaken
Joas	Joas
Rehabeam	Rehabeam
mötes	mötes
förunnade	förunnade
blottar	blottar
sköta	sköta
drängs	drängs
höljda	höljda
badade	badade
svavelväte	svavelväte
planterade	planterade
San	San
klöven	klöven
hållna	hållna
räcken	räcken
galleriorna	galleriorna
kära	kära
rikes	rikes
låge	låge
Ismael	Ismael
bespejare	bespejare
Milka	Milka
Rehabeams	Rehabeams
färgad	färgad
tillträde	tillträde
väns	väns
vikt	vikt
gånge	gånge
förblive	förblive
stänger	stänger
Arba	Arba
Gamaliel	Gamaliel
funna	funna
Sisak	Sisak
Abimeleks	Abimeleks
vilade	vilade
Edom	Edom
platserna	platserna
store	store
fattas	fattas
talat	talat
allmänspråklige	allmänspråklige
Man	Man
Dessa	Dessa
glänsa	glänsa
Taga	Taga
Jair	Jair
deltagande	deltagande
räknades	räknades
utkom	utkom
mopps	mopps
levande	levande
översta	översta
omsluta	omsluta
ledda	ledda
bigamis	bigamis
Öga	Öga
grossen	grossen
Et	Et
preliminär	preliminär
benämnande	benämnande
anställdes	anställdes
Sadok	Sadok
sändes	sändes
spotten	spotten
mätt	mätt
ringarna	ringarna
gripen	gripen
hemsökt	hemsökt
Faders	Faders
piercingars	piercingars
trängd	trängd
tvagna	tvagna
bordas	bordas
förvarade	förvarade
röra	röra
skotskt	skotskt
Bara	Bara
bespejade	bespejade
nästen	nästen
fetmas	fetmas
fördömd	fördömd
kyssa	kyssa
slakta	slakta
Melek	Melek
dragare	dragare
Simmas	Simmas
drivas	drivas
borgen	borgen
lågt	lågt
levererade	levererade
utfärdar	utfärdar
sjungits	sjungits
avståndet	avståndet
förkunnade	förkunnade
tröghet	tröghet
förvarande	förvarande
fiskades	fiskades
Vaken	Vaken
bjudna	bjudna
böjd	böjd
halt	halt
sandas	sandas
betryckta	betryckta
vädurs	vädurs
flyge	flyge
konverterad	konverterad
ponerad	ponerad
skulptörs	skulptörs
förhindra	förhindra
gömmas	gömmas
talande	talande
gemaket	gemaket
Saras	Saras
metern	metern
bärande	bärande
fackverk	fackverk
patrullerats	patrullerats
golfklubbens	golfklubbens
ungkarl	ungkarl
betydande	betydande
beskyddarens	beskyddarens
handläggas	handläggas
utbyte	utbyte
läge	läge
ansikte	ansikte
snöret	snöret
färgbild	färgbild
vis	vis
utsläckes	utsläckes
blåhaken	blåhaken
fästas	fästas
jublande	jublande
vitt	vitt
stötande	stötande
årorna	årorna
anklagar	anklagar
sken	sken
skrymtan	skrymtan
uppföra	uppföra
hurudan	hurudan
fattade	fattade
koffertarna	koffertarna
verke	verke
byråkratiskt	byråkratiskt
modet	modet
drogens	drogens
upphöjd	upphöjd
hållare	hållare
än	än
liden	liden
lärare	lärare
fotgängarna	fotgängarna
Tagen	Tagen
löst	löst
förströdde	förströdde
murarnas	murarnas
Noas	Noas
Det	Det
avfallna	avfallna
vant	vant
malen	malen
undantaget	undantaget
Massas	Massas
borrar	borrar
varulvarna	varulvarna
beställs	beställs
arglistighet	arglistighet
säker	säker
hämnare	hämnare
skifte	skifte
vika	vika
dennes	dennes
revo	revo
preliminärskattens	preliminärskattens
borgarens	borgarens
ungkarlens	ungkarlens
bin	bin
upplöser	upplöser
burna	burna
uppfylla	uppfylla
redigeringskrig	redigeringskrig
stjärten	stjärten
lidandet	lidandet
öst	öst
Persien	Persien
lögnprofeterna	lögnprofeterna
Diana	Diana
omsnärjde	omsnärjde
Jafets	Jafets
växe	växe
duka	duka
värden	värden
säljen	säljen
upphöjde	upphöjde
synd	synd
Jafet	Jafet
gladd	gladd
blåhakarna	blåhakarna
Libanons	Libanons
undersökande	undersökande
upptages	upptages
mysande	mysande
uppfyll	uppfyll
tåga	tåga
visen	visen
skänke	skänke
upptagnast	upptagnast
utroten	utroten
döva	döva
öppnas	öppnas
jagas	jagas
Simma	Simma
löses	löses
stärkt	stärkt
förtryckes	förtryckes
Tabor	Tabor
gångar	gångar
intaga	intaga
vävare	vävare
Högste	Högste
blottades	blottades
faste	faste
kinesens	kinesens
sökas	sökas
släktets	släktets
bränns	bränns
vinge	vinge
förfölja	förfölja
Aner	Aner
slunga	slunga
befästes	befästes
beställa	beställa
Ada	Ada
nämner	nämner
tillfrisknat	tillfrisknat
dragna	dragna
fordren	fordren
undersöka	undersöka
leverera	leverera
fira	fira
Salomo	Salomo
påbuds	påbuds
synas	synas
åka	åka
förkunnat	förkunnat
förtära	förtära
egyptologins	egyptologins
bordat	bordat
söks	söks
enes	enes
följe	följe
Aras	Aras
förstörd	förstörd
läger	läger
ändligdimensionellt	ändligdimensionellt
roten	roten
altruisters	altruisters
dråparna	dråparna
läkare	läkare
dyrkas	dyrkas
dukat	dukat
tröstare	tröstare
blotta	blotta
hemsökes	hemsökes
hacka	hacka
kommuteras	kommuteras
Vid	Vid
duad	duad
ymnighets	ymnighets
vars	vars
altares	altares
Tro	Tro
Ai	Ai
mods	mods
utgjordes	utgjordes
Abram	Abram
fetma	fetma
snar	snar
upphöjt	upphöjt
ring	ring
kanslisekreterare	kanslisekreterare
företagen	företagen
uppfylls	uppfylls
historiska	historiska
dräps	dräps
Vin	Vin
förmörkades	förmörkades
byttornas	byttornas
framsäten	framsäten
togs	togs
Rahabs	Rahabs
vridas	vridas
årens	årens
säkrades	säkrades
löpen	löpen
uppenbarat	uppenbarat
tyngste	tyngste
inbärgade	inbärgade
samfund	samfund
upptage	upptage
hålles	hålles
kastades	kastades
före	före
röres	röres
anklagats	anklagats
Ava	Ava
tryckarens	tryckarens
Sera	Sera
vålds	vålds
lägga	lägga
sänds	sänds
omgiven	omgiven
genomsökt	genomsökt
trycka	trycka
fatet	fatet
gäckas	gäckas
säkrande	säkrande
konverteras	konverteras
Gilead	Gilead
visa	visa
vittnesbörden	vittnesbörden
upptänden	upptänden
trycker	trycker
upphöja	upphöja
huggna	huggna
falla	falla
dräpe	dräpe
redaktionssekreteraren	redaktionssekreteraren
blinde	blinde
duga	duga
Davids	Davids
förtäre	förtäre
invig	invig
sexhörningarnas	sexhörningarnas
sänka	sänka
tänke	tänke
bereds	bereds
yngstes	yngstes
äppelträden	äppelträden
förgöras	förgöras
bönerna	bönerna
trädstammen	trädstammen
stängda	stängda
avmätt	avmätt
musikallåt	musikallåt
vises	vises
snökedja	snökedja
Lot	Lot
talen	talen
skilda	skilda
våldsverkares	våldsverkares
spårade	spårade
namne	namne
hyresvärden	hyresvärden
indiskans	indiskans
silverbägarna	silverbägarna
uppbygges	uppbygges
golfklubbs	golfklubbs
duande	duande
skiften	skiften
markens	markens
Assyrien	Assyrien
dragen	dragen
hämtar	hämtar
Jason	Jason
stores	stores
lidandes	lidandes
väta	väta
fäst	fäst
uppfyller	uppfyller
uppfört	uppfört
fäste	fäste
dröjen	dröjen
läras	läras
hugges	hugges
vedergäll	vedergäll
kokat	kokat
Hesron	Hesron
syndarna	syndarna
fortfara	fortfara
vårdar	vårdar
formeln	formeln
övertäckt	övertäckt
frisörens	frisörens
talas	talas
assisterade	assisterade
terapeuts	terapeuts
hörn	hörn
mötts	mötts
höljets	höljets
refererande	refererande
vilkas	vilkas
Persiens	Persiens
polarforsknings	polarforsknings
Manasse	Manasse
tjäna	tjäna
sko	sko
täckte	täckte
dån	dån
vida	vida
arglistig	arglistig
oftare	oftare
bedraga	bedraga
modets	modets
avstånds	avstånds
alkoholism	alkoholism
smälte	smälte
efor	efor
läka	läka
täcke	täcke
Vakna	Vakna
åten	åten
Assurs	Assurs
stjärtars	stjärtars
Amalek	Amalek
förläts	förläts
spanjorers	spanjorers
väcka	väcka
webbplatser	webbplatser
de	de
förvånas	förvånas
bestå	bestå
skuldoffersväduren	skuldoffersväduren
förehaves	förehaves
Hela	Hela
betecknat	betecknat
Jairs	Jairs
fästens	fästens
Anas	Anas
vishets	vishets
dröja	dröja
behöves	behöves
agitatorns	agitatorns
åker	åker
det	det
egyptierna	egyptierna
höghjuling	höghjuling
noggrant	noggrant
besegrades	besegrades
bältena	bältena
vrida	vrida
kirrande	kirrande
övrigt	övrigt
förgörs	förgörs
beskrivningsspråk	beskrivningsspråk
hinder	hinder
twittrande	twittrande
tänkte	tänkte
skötte	skötte
arglistige	arglistige
Meleks	Meleks
stadgen	stadgen
flädermärgskulornas	flädermärgskulornas
utplånades	utplånades
nejlikornas	nejlikornas
sänd	sänd
korsfästande	korsfästande
boks	boks
vann	vann
Ain	Ain
ställde	ställde
åter	åter
omgiva	omgiva
Gileads	Gileads
bundna	bundna
förkunnen	förkunnen
sakerna	sakerna
antänd	antänd
sköten	sköten
ytterst	ytterst
den	den
återstodo	återstodo
knäveckets	knäveckets
frossa	frossa
kines	kines
tig	tig
sovo	sovo
antropologins	antropologins
nästa	nästa
skåden	skåden
yla	yla
följda	följda
retstickor	retstickor
Akan	Akan
tänker	tänker
släkte	släkte
viken	viken
fjättras	fjättras
upphöjen	upphöjen
berömde	berömde
bjödo	bjödo
brukade	brukade
Betuel	Betuel
uppbyggda	uppbyggda
mött	mött
anställa	anställa
sina	sina
gross	gross
Seras	Seras
värmen	värmen
borgaren	borgaren
döve	döve
förgäte	förgäte
barrskogar	barrskogar
fakultet	fakultet
skött	skött
korniskan	korniskan
Geras	Geras
förkunnades	förkunnades
bruset	bruset
oskadliggör	oskadliggör
väduren	väduren
talade	talade
ringas	ringas
omnämnandes	omnämnandes
drives	drives
skådade	skådade
Ut	Ut
trampas	trampas
bade	bade
tryckas	tryckas
sov	sov
höj	höj
citrusfrukten	citrusfrukten
förståndets	förståndets
cabbars	cabbars
slites	slites
Milkas	Milkas
våldsverkare	våldsverkare
budens	budens
funno	funno
vandren	vandren
fördömen	fördömen
isters	isters
patrullerar	patrullerar
åts	åts
stärka	stärka
förnimmande	förnimmande
halsband	halsband
svälja	svälja
Aran	Aran
driven	driven
höre	höre
Maria	Maria
växt	växt
behövs	behövs
Gad	Gad
bedragare	bedragare
Jasons	Jasons
tänken	tänken
låter	låter
sanna	sanna
utfärdad	utfärdad
Judeen	Judeen
rättfärdiga	rättfärdiga
No	No
blotten	blotten
förgjort	förgjort
lösaste	lösaste
förlika	förlika
bevise	bevise
David	David
predikades	predikades
offrade	offrade
brinnande	brinnande
Anatot	Anatot
känden	känden
sedens	sedens
kysst	kysst
Uris	Uris
upptagen	upptagen
massakern	massakern
beskyddare	beskyddare
Barn	Barn
tjäne	tjäne
anklagade	anklagade
fyllas	fyllas
ihågkomma	ihågkomma
uppenbaras	uppenbaras
förökade	förökade
räcka	räcka
tröstar	tröstar
terapeuter	terapeuter
omdefinierande	omdefinierande
lärt	lärt
fattat	fattat
given	given
Amminadab	Amminadab
stjäl	stjäl
läses	läses
upphäven	upphäven
Anaks	Anaks
ytterörats	ytterörats
täckta	täckta
Res	Res
lästes	lästes
rov	rov
Kain	Kain
bud	bud
ända	ända
arbetskamrat	arbetskamrat
under	under
mala	mala
hoppade	hoppade
födas	födas
Sered	Sered
göres	göres
korsfästa	korsfästa
kemikaliens	kemikaliens
läggen	läggen
oxar	oxar
frågen	frågen
omkomma	omkomma
villkor	villkor
Ais	Ais
rättfärdigas	rättfärdigas
vakade	vakade
egyptologis	egyptologis
anklagen	anklagen
gallerior	gallerior
Abiram	Abiram
lärda	lärda
klämdagarna	klämdagarna
företaga	företaga
Dianas	Dianas
mat	mat
bered	bered
tigits	tigits
vattna	vattna
Dess	Dess
beskärd	beskärd
klädda	klädda
förledets	förledets
ställen	ställen
Lemeks	Lemeks
blåst	blåst
fyllde	fyllde
tröstas	tröstas
omsnärjer	omsnärjer
röva	röva
utföra	utföra
hackade	hackade
gäckade	gäckade
äte	äte
Asafs	Asafs
Iskariot	Iskariot
muskedundren	muskedundren
verkade	verkade
cabbarna	cabbarna
fortfare	fortfare
anställs	anställs
tryckt	tryckt
tjugofemöringens	tjugofemöringens
frambäres	frambäres
rädd	rädd
sakens	sakens
rättfärdigade	rättfärdigade
förspel	förspel
avmäta	avmäta
udd	udd
åttondelars	åttondelars
allas	allas
kvantifierade	kvantifierade
Vilka	Vilka
Serubbabel	Serubbabel
ofta	ofta
rätt	rätt
sann	sann
Abels	Abels
lida	lida
loven	loven
Heles	Heles
Syrien	Syrien
vinterdäck	vinterdäck
fött	fött
öppnen	öppnen
täcktes	täcktes
uppfyllda	uppfyllda
drängen	drängen
böja	böja
spott	spott
upplösande	upplösande
befästa	befästa
hör	hör
omvände	omvände
åttondelar	åttondelar
Hasor	Hasor
slungade	slungade
fruktade	fruktade
senare	senare
koffertarnas	koffertarnas
Mahalalel	Mahalalel
bruke	bruke
omvända	omvända
stinka	stinka
stärken	stärken
hon	hon
utfärdades	utfärdades
smida	smida
Eva	Eva
dessa	dessa
stöts	stöts
ändligdimensionelle	ändligdimensionelle
sin	sin
driva	driva
moder	moder
spände	spände
täcka	täcka
bedrage	bedrage
tystande	tystande
tillträda	tillträda
behållare	behållare
förvånade	förvånade
anfallen	anfallen
borras	borras
skuldoffersvädur	skuldoffersvädur
omgives	omgives
lägge	lägge
valrossars	valrossars
Naftali	Naftali
gifte	gifte
släktena	släktena
sporde	sporde
klämdagar	klämdagar
hören	hören
Baal	Baal
dräpas	dräpas
fallna	fallna
samtycke	samtycke
log	log
flyttas	flyttas
läs	läs
mötande	mötande
hämtats	hämtats
draget	draget
lamans	lamans
förtrycka	förtrycka
Vars	Vars
förvarar	förvarar
handlade	handlade
sköt	sköt
drage	drage
undervattensbåts	undervattensbåts
kläde	kläde
dyrkades	dyrkades
förgjorde	förgjorde
som	som
rykte	rykte
tage	tage
äldste	äldste
förkunnas	förkunnas
våld	våld
murarens	murarens
uppställa	uppställa
ingen	ingen
dödande	dödande
Abel	Abel
minska	minska
Mana	Mana
determinant	determinant
använd	använd
rövande	rövande
retades	retades
hurudana	hurudana
noggranne	noggranne
utsträck	utsträck
inrätta	inrätta
Akas	Akas
vanna	vanna
sköte	sköte
Tamar	Tamar
besök	besök
förlåta	förlåta
odjuret	odjuret
Högstes	Högstes
rövas	rövas
äppelträdet	äppelträdet
isotoner	isotoner
Sereds	Sereds
signera	signera
stickade	stickade
omkommo	omkommo
förtälj	förtälj
spejade	spejade
framsäte	framsäte
beskrivningsspråken	beskrivningsspråken
torkade	torkade
antände	antände
varde	varde
sitt	sitt
utlysa	utlysa
slipat	slipat
brassat	brassat
ymnighetens	ymnighetens
uppläst	uppläst
förmörkade	förmörkade
förnimma	förnimma
styrkt	styrkt
Sadoks	Sadoks
vätas	vätas
uppväcka	uppväcka
Fallen	Fallen
årors	årors
myste	myste
Resen	Resen
uppväcken	uppväcken
åklagande	åklagande
bombarderades	bombarderades
retsticka	retsticka
miste	miste
tjänarna	tjänarna
födde	födde
Mahalalels	Mahalalels
svängande	svängande
upplåta	upplåta
Bosras	Bosras
höra	höra
vädur	vädur
oxens	oxens
klätt	klätt
stinkande	stinkande
röras	röras
förgätas	förgätas
vektorfälts	vektorfälts
utrotades	utrotades
värde	värde
rätas	rätas
nymånadsdagar	nymånadsdagar
förhindrats	förhindrats
arbetare	arbetare
sålde	sålde
murares	murares
repmånaden	repmånaden
handläggs	handläggs
bäres	bäres
vävda	vävda
öken	öken
svängdes	svängdes
Jabin	Jabin
radavståndet	radavståndet
åran	åran
odjur	odjur
småviltet	småviltet
skulptör	skulptör
marks	marks
spridd	spridd
utlyst	utlyst
sandades	sandades
fjättrade	fjättrade
förtryckare	förtryckare
övertäcka	övertäcka
gifts	gifts
busschaufförs	busschaufförs
klövs	klövs
förtäljen	förtäljen
tigga	tigga
lägg	lägg
förste	förste
förgätit	förgätit
bjude	bjude
buren	buren
dräpt	dräpt
Denne	Denne
clowneri	clowneri
tigs	tigs
användande	användande
renar	renar
fylld	fylld
Berias	Berias
siste	siste
Jorams	Jorams
tillredda	tillredda
lever	lever
preliminäre	preliminäre
arbetskamraterna	arbetskamraterna
lika	lika
forskningsbiblioteks	forskningsbiblioteks
förgörare	förgörare
ihågkommen	ihågkommen
radian	radian
fat	fat
Kains	Kains
rovs	rovs
utsändande	utsändande
brinna	brinna
trädstammens	trädstammens
dräptes	dräptes
korer	korer
ösa	ösa
arbete	arbete
massförstörelsevapen	massförstörelsevapen
Jabins	Jabins
sådan	sådan
mätten	mätten
Joram	Joram
förgör	förgör
kompilerats	kompilerats
upplösa	upplösa
eolsharpor	eolsharpor
Iskariots	Iskariots
Sara	Sara
Orion	Orion
determinanter	determinanter
förlike	förlike
tog	tog
upplöst	upplöst
föres	föres
Tre	Tre
mången	mången
signerade	signerade
anklagades	anklagades
källingen	källingen
förströdda	förströdda
faktisk	faktisk
rödhakars	rödhakars
tryckande	tryckande
snören	snören
Bröder	Bröder
fångenskapens	fångenskapens
Gera	Gera
bovarna	bovarna
anställas	anställas
utsändas	utsändas
småvilts	småvilts
släkten	släkten
fordras	fordras
fören	fören
ambassadsekreterares	ambassadsekreterares
sökte	sökte
kommuterar	kommuterar
fogat	fogat
fångenskaps	fångenskaps
fogad	fogad
bespejen	bespejen
upplåtna	upplåtna
skriva	skriva
hons	hons
kartografiska	kartografiska
spanjors	spanjors
tungt	tungt
åkerstycket	åkerstycket
Beria	Beria
hat	hat
görare	görare
lös	lös
känd	känd
förvaltare	förvaltare
bortförd	bortförd
kokte	kokte
jämte	jämte
enas	enas
Ren	Ren
skrymtarna	skrymtarna
försona	försona
föröken	föröken
sväng	sväng
snörena	snörena
tjugofemöringarna	tjugofemöringarna
Gads	Gads
träta	träta
kort	kort
Abirams	Abirams
alkoholismens	alkoholismens
förunne	förunne
väckas	väckas
oxe	oxe
tvaget	tvaget
första	första
veta	veta
Sjustjärnornas	Sjustjärnornas
odjurets	odjurets
städerna	städerna
Ett	Ett
bränn	bränn
avhärvlat	avhärvlat
överfallen	överfallen
fortfarande	fortfarande
själva	själva
namnens	namnens
din	din
utsläckt	utsläckt
ödmjuka	ödmjuka
epitetet	epitetet
bytt	bytt
talades	talades
vilket	vilket
Marias	Marias
Sikem	Sikem
efterföljare	efterföljare
busschaufförerna	busschaufförerna
öppna	öppna
rötternas	rötternas
tv:n	tv:n
mös	mös
tryckte	tryckte
hala	hala
dövt	dövt
uträckas	uträckas
snöres	snöres
befästas	befästas
påves	påves
redaktionssekreterarnas	redaktionssekreterarnas
assisterad	assisterad
äldstes	äldstes
utföras	utföras
Evad	Evad
gräten	gräten
förfors	förfors
utfärdat	utfärdat
undersökt	undersökt
upprört	upprört
rot	rot
synds	synds
grundämnet	grundämnet
upptagna	upptagna
åtalar	åtalar
Jo	Jo
vandrarna	vandrarna
renade	renade
sexpacket	sexpacket
konsekvente	konsekvente
bältens	bältens
infiltreras	infiltreras
Natans	Natans
betäckas	betäckas
atomfysikens	atomfysikens
benämns	benämns
rödhaken	rödhaken
Assur	Assur
ut	ut
ringare	ringare
kokades	kokades
oxarna	oxarna
Goa	Goa
drogerna	drogerna
förras	förras
öppnat	öppnat
bärare	bärare
sälja	sälja
specialtecknets	specialtecknets
förra	förra
beröm	beröm
koken	koken
överstes	överstes
fälles	fälles
skötet	skötet
mana	mana
fördömde	fördömde
indiskorna	indiskorna
Jered	Jered
sådana	sådana
Susan	Susan
vana	vana
Jereds	Jereds
grumlen	grumlen
tryckarna	tryckarna
kompilerar	kompilerar
inrättat	inrättat
Uria	Uria
uppställde	uppställde
tågade	tågade
stöttes	stöttes
hyresvärd	hyresvärd
dalarna	dalarna
vedergälle	vedergälle
oxarnas	oxarnas
avbärga	avbärga
förödes	förödes
låga	låga
märka	märka
kristadelfians	kristadelfians
uppenbarad	uppenbarad
döma	döma
tillhöra	tillhöra
stjärntydarna	stjärntydarna
laman	laman
Varde	Varde
Elis	Elis
räckt	räckt
samlen	samlen
antänder	antänder
domänens	domänens
buds	buds
förena	förena
kokade	kokade
underskriften	underskriften
sökt	sökt
nästes	nästes
fast	fast
Guds	Guds
bevare	bevare
altarets	altarets
rike	rike
ryckes	ryckes
tiggare	tiggare
ställt	ställt
beredda	beredda
like	like
tillreda	tillreda
minne	minne
släkt	släkt
sjungs	sjungs
kvantiteter	kvantiteter
döpt	döpt
förstöra	förstöra
redigeringskrigs	redigeringskrigs
pennalens	pennalens
Josefs	Josefs
korsord	korsord
siare	siare
Om	Om
retronym	retronym
ripjakts	ripjakts
täckt	täckt
Absalom	Absalom
undantagna	undantagna
förfars	förfars
försonats	försonats
beskärde	beskärde
bevarades	bevarades
Jonatans	Jonatans
utsträcker	utsträcker
beröms	beröms
berömmande	berömmande
somt	somt
villkoren	villkoren
nyanseras	nyanseras
befäst	befäst
såpbubblors	såpbubblors
stärkas	stärkas
bryggkaffets	bryggkaffets
murare	murare
sänkt	sänkt
borgare	borgare
kröner	kröner
minskar	minskar
altaret	altaret
öppnats	öppnats
bältets	bältets
flyttats	flyttats
Arabiens	Arabiens
följd	följd
Omar	Omar
förgiftad	förgiftad
vete	vete
bryggkaffet	bryggkaffet
skänkt	skänkt
Alls	Alls
bevaren	bevaren
koncentrera	koncentrera
Betuels	Betuels
avgudens	avgudens
förgöra	förgöra
utsträckt	utsträckt
utforsken	utforsken
jämt	jämt
rädes	rädes
född	född
upplys	upplys
formas	formas
fattades	fattades
sjunge	sjunge
kokt	kokt
döme	döme
Hiskia	Hiskia
Dennes	Dennes
lovar	lovar
Abias	Abias
förtövande	förtövande
oxen	oxen
fyllda	fyllda
upphävdes	upphävdes
anklagas	anklagas
beta	beta
henne	henne
bergochdalbanors	bergochdalbanors
besegra	besegra
clowneriet	clowneriet
suddar	suddar
Gud	Gud
betrycktes	betrycktes
nämnes	nämnes
klöv	klöv
sårande	sårande
cypriotiskas	cypriotiskas
tågas	tågas
möts	möts
Hesrons	Hesrons
upphäva	upphäva
Arabien	Arabien
sornas	sornas
förkunnar	förkunnar
förtrycker	förtrycker
förenar	förenar
federationer	federationer
bakgrundsstrålnings	bakgrundsstrålnings
tillhörande	tillhörande
räckas	räckas
dragne	dragne
öre	öre
minskade	minskade
katalansk	katalansk
göras	göras
lärde	lärde
förtäres	förtäres
Bosra	Bosra
ratificera	ratificera
hörda	hörda
dödas	dödas
stupa	stupa
Babel	Babel
kokas	kokas
upplösas	upplösas
handlägga	handlägga
många	många
svepande	svepande
nymånadsdag	nymånadsdag
brassades	brassades
Ard	Ard
trätt	trätt
antändande	antändande
Naftalis	Naftalis
fria	fria
dess	dess
flyga	flyga
upptagnare	upptagnare
Husen	Husen
tillgodogöra	tillgodogöra
svala	svala
säkrast	säkrast
utplånande	utplånande
sänt	sänt
årornas	årornas
Nilen	Nilen
Arbas	Arbas
uppfylle	uppfylle
Datan	Datan
råder	råder
bekänna	bekänna
tystades	tystades
vattnar	vattnar
Ögat	Ögat
fällda	fällda
markerna	markerna
vårdare	vårdare
falls	falls
såld	såld
snarast	snarast
formande	formande
klädde	klädde
kor	kor
lånade	lånade
bok	bok
Anak	Anak
förenklar	förenklar
ökade	ökade
tågats	tågats
svavelvätes	svavelvätes
maakatéer	maakatéer
förehava	förehava
Samarias	Samarias
bordlägga	bordlägga
föden	föden
stötas	stötas
berömda	berömda
oren	oren
pennalen	pennalen
Gamaliels	Gamaliels
förtryck	förtryck
gräto	gräto
agas	agas
utgöra	utgöra
pärmars	pärmars
rörande	rörande
lösande	lösande
embarkeringskort	embarkeringskort
erövrare	erövrare
förmörkas	förmörkas
sexhörningars	sexhörningars
märke	märke
klädd	klädd
pingis	pingis
bortfört	bortfört
inbärgen	inbärgen
sista	sista
hjälpa	hjälpa
hålen	hålen
bedragna	bedragna
Lod	Lod
fatta	fatta
besatte	besatte
sjunga	sjunga
lames	lames
orenen	orenen
hölje	hölje
eskimåer	eskimåer
hållen	hållen
utfören	utfören
kända	kända
upphöjda	upphöjda
varen	varen
behållna	behållna
byttan	byttan
vattenkonster	vattenkonster
preliminärskatt	preliminärskatt
möta	möta
dukade	dukade
ens	ens
Aven	Aven
Asaf	Asaf
utkommen	utkommen
mördade	mördade
svepts	svepts
övrigas	övrigas
Lus	Lus
färgat	färgat
utsträcks	utsträcks
beredde	beredde
löste	löste
Ana	Ana
son	son
flyttar	flyttar
lära	lära
Hanoks	Hanoks
löse	löse
stärk	stärk
beställt	beställt
bete	bete
dukades	dukades
byrådirektör	byrådirektör
vilka	vilka
gifta	gifta
Vilken	Vilken
öppnande	öppnande
falle	falle
tagna	tagna
fostrade	fostrade
vilddjur	vilddjur
lame	lame
förlik	förlik
Denna	Denna
vid	vid
satt	satt
Sans	Sans
utsträcka	utsträcka
Natan	Natan
frälsa	frälsa
spåra	spåra
stadier	stadier
stadgas	stadgas
använda	använda
bordläggande	bordläggande
täckts	täckts
skrymtare	skrymtare
vridande	vridande
Juda	Juda
De	De
blåses	blåses
Hanok	Hanok
vishet	vishet
brandväggarnas	brandväggarnas
omsnärjt	omsnärjt
bön	bön
stjälen	stjälen
upplyses	upplyses
trängt	trängt
avbärgad	avbärgad
lösen	lösen
ax	ax
saknas	saknas
ende	ende
qvadrater	qvadrater
kilarna	kilarna
Rebecka	Rebecka
Helt	Helt
intagen	intagen
tegs	tegs
beskärda	beskärda
dräp	dräp
gömmes	gömmes
bruse	bruse
stekt	stekt
egyptier	egyptier
kors	kors
rycka	rycka
Sisaks	Sisaks
give	give
vita	vita
lysa	lysa
tillreds	tillreds
utrotade	utrotade
berömt	berömt
fint	fint
möttes	möttes
anden	anden
blindas	blindas
bäre	bäre
blottande	blottande
vare	vare
döm	döm
lider	lider
kvaddas	kvaddas
betecknad	betecknad
anställd	anställd
Dan	Dan
rykande	rykande
åra	åra
moppen	moppen
avbärgade	avbärgade
ansiktes	ansiktes
förvaltade	förvaltade
vilddjuret	vilddjuret
pärms	pärms
löpa	löpa
Mas	Mas
äta	äta
borgar	borgar
Haso	Haso
docerande	docerande
uppenbarades	uppenbarades
förkunnare	förkunnare
bokrisen	bokrisen
såpbubblorna	såpbubblorna
krig	krig
hämnas	hämnas
säljs	säljs
käre	käre
förtärda	förtärda
vila	vila
ambassadsekreterarnas	ambassadsekreterarnas
löpare	löpare
infiltrerades	infiltrerades
bevis	bevis
gives	gives
undan	undan
arbetade	arbetade
förödda	förödda
rötterna	rötterna
frambära	frambära
ringaren	ringaren
ödmjuk	ödmjuk
sudda	sudda
höje	höje
agade	agade
bereder	bereder
kristadelfianernas	kristadelfianernas
påvars	påvars
oxars	oxars
qvadrats	qvadrats
åte	åte
antropologin	antropologin
samfunds	samfunds
fordran	fordran
knäveck	knäveck
historisk	historisk
friat	friat
källingars	källingars
dyrkande	dyrkande
sänkas	sänkas
forskningsbibliotek	forskningsbibliotek
Jonatan	Jonatan
bekännare	bekännare
funne	funne
besatta	besatta
lägges	lägges
spänna	spänna
sänts	sänts
bakhålls	bakhålls
klappade	klappade
finna	finna
stöta	stöta
Maas	Maas
återstod	återstod
gileaditen	gileaditen
fötterna	fötterna
piercings	piercings
mäta	mäta
borra	borra
inrättande	inrättande
lovade	lovade
Samaria	Samaria
släktens	släktens
räddare	räddare
valrossar	valrossar
altruisternas	altruisternas
upprörd	upprörd
hjälpare	hjälpare
oxes	oxes
kvantifiera	kvantifiera
Anatots	Anatots
tänka	tänka
slaktas	slaktas
Beta	Beta
sticka	sticka
utfärdas	utfärdas
visars	visars
förenas	förenas
torka	torka
förstören	förstören
seds	seds
korna	korna
öppnades	öppnades
uppläsa	uppläsa
förlät	förlät
grundämne	grundämne
avfallen	avfallen
utgjord	utgjord
ytteröra	ytteröra
stupade	stupade
höghjulingarna	höghjulingarna
fullborde	fullborde
Husas	Husas
församla	församla
holonymens	holonymens
mördare	mördare
Rebeckas	Rebeckas
Resa	Resa
trycks	trycks
utplåna	utplåna
sök	sök
dina	dina
hämta	hämta
radianer	radianer
läsen	läsen
tillgodogör	tillgodogör
öra	öra
inga	inga
betäck	betäck
förtrycken	förtrycken
renat	renat
håla	håla
bjudes	bjudes
massförstörelsevapens	massförstörelsevapens
smältas	smältas
lösa	lösa
möte	möte
mäter	mäter
undantagen	undantagen
bevarad	bevarad
eolsharpors	eolsharpors
ögat	ögat
gestaltning	gestaltning
Barak	Barak
beten	beten
skotsk	skotsk
åtnjuta	åtnjuta
Edoms	Edoms
blottas	blottas
Kemuel	Kemuel
undervattensbåtars	undervattensbåtars
blottat	blottat
fiskade	fiskade
stjäla	stjäla
byttor	byttor
Balaks	Balaks
fullbordan	fullbordan
förblivande	förblivande
vara	vara
kasten	kasten
cypriotiska	cypriotiska
möers	möers
rötter	rötter
bokriser	bokriser
halsbanden	halsbanden
förleder	förleder
året	året
sväljen	sväljen
lagats	lagats
Allas	Allas
steka	steka
uppenbara	uppenbara
påbud	påbud
Sauls	Sauls
upptaga	upptaga
fyllt	fyllt
betade	betade
Datans	Datans
Manasses	Manasses
anklaga	anklaga
reta	reta
logarna	logarna
lysande	lysande
samtycka	samtycka
byrådirektörer	byrådirektörer
Abrams	Abrams
ene	ene
läst	läst
upptagne	upptagne
lagade	lagade
lidande	lidande
holonym	holonym
väva	väva
förföljda	förföljda
Sutelas	Sutelas
bygges	bygges
förlåte	förlåte
renas	renas
täck	täck
strålen	strålen
vredes	vredes
Dans	Dans
flugits	flugits
Elia	Elia
uddarna	uddarna
particips	particips
rädda	rädda
firad	firad
vingarnas	vingarnas
Lud	Lud
värma	värma
grandets	grandets
saknade	saknade
lärd	lärd
ylande	ylande
lytt	lytt
sikte	sikte
höljes	höljes
Tamars	Tamars
används	används
Allt	Allt
upptänd	upptänd
uddens	uddens
Salome	Salome
kriget	kriget
viktiga	viktiga
