kvällstidningarnas	kvällstidningarnas
utgörande	utgörande
muggar	muggar
Ard	Ard
rättfärdigade	rättfärdigade
kartografiska	kartografiska
Lemeks	Lemeks
limpan	limpan
mötas	mötas
pråmar	pråmar
vattnades	vattnades
versioner	versioner
intaga	intaga
åter	åter
svindeln	svindeln
åkerstycket	åkerstycket
uppväcka	uppväcka
tillhöra	tillhöra
kvantifierar	kvantifierar
åskvädrens	åskvädrens
flyttas	flyttas
skymmas	skymmas
avhärvlat	avhärvlat
frisörers	frisörers
Ai	Ai
möttes	möttes
signera	signera
Arabiens	Arabiens
fälles	fälles
uträcka	uträcka
förståndets	förståndets
talade	talade
renar	renar
seds	seds
rumänen	rumänen
smaragders	smaragders
koncentrera	koncentrera
leva	leva
bevarad	bevarad
lägg	lägg
stötas	stötas
gripen	gripen
klöven	klöven
handlägga	handlägga
bordas	bordas
västlig	västlig
lärde	lärde
betade	betade
drives	drives
stöttes	stöttes
bespejen	bespejen
vingarnas	vingarnas
tyngste	tyngste
kapitalisterna	kapitalisterna
släktet	släktet
förtära	förtära
avbärga	avbärga
vana	vana
berömda	berömda
hållare	hållare
jublande	jublande
omnämnandenas	omnämnandenas
snar	snar
släktets	släktets
mysteriums	mysteriums
Allas	Allas
färgad	färgad
skånks	skånks
ene	ene
fjortondel	fjortondel
den	den
torkade	torkade
anställdes	anställdes
snökedja	snökedja
uppfyllen	uppfyllen
förkunnade	förkunnade
leden	leden
gileadit	gileadit
ställen	ställen
taga	taga
ena	ena
inga	inga
första	första
krig	krig
radavståndet	radavståndet
bast	bast
grandets	grandets
tv:n	tv:n
paketerar	paketerar
mysterier	mysterier
chipspåsars	chipspåsars
såpbubblorna	såpbubblorna
myste	myste
pärmars	pärmars
redaktionssekreteraren	redaktionssekreteraren
cabbars	cabbars
stött	stött
kroppsvätskors	kroppsvätskors
halsbanden	halsbanden
skiften	skiften
berömt	berömt
lösaste	lösaste
Hasor	Hasor
klappa	klappa
förra	förra
rike	rike
sälj	sälj
inhägnad	inhägnad
klädd	klädd
anglicismen	anglicismen
vävstolens	vävstolens
upphäver	upphäver
tagna	tagna
bordläggande	bordläggande
öknamn	öknamn
vika	vika
skörtet	skörtet
Eva	Eva
bin	bin
gifta	gifta
sprängmedel	sprängmedel
Uris	Uris
eolsharpor	eolsharpor
avstånds	avstånds
döpa	döpa
avfallna	avfallna
vilddjuret	vilddjuret
efor	efor
tagen	tagen
göras	göras
ledarsidorna	ledarsidorna
äldste	äldste
katalansk	katalansk
noggranne	noggranne
arkeologens	arkeologens
blödd	blödd
yla	yla
överdomstolen	överdomstolen
avgudens	avgudens
ospontant	ospontant
Naftalis	Naftalis
Josef	Josef
kanslisekreterare	kanslisekreterare
befordrans	befordrans
äppelträdet	äppelträdet
medelhavs	medelhavs
förvaltade	förvaltade
bereds	bereds
upphäven	upphäven
styrkes	styrkes
arglistige	arglistige
altaret	altaret
väljarnas	väljarnas
sanera	sanera
kulminerar	kulminerar
radavståndets	radavståndets
yngstes	yngstes
visheten	visheten
förgiftade	förgiftade
renat	renat
vålds	vålds
gemak	gemak
alkoholismens	alkoholismens
omsnärjt	omsnärjt
byråkratiske	byråkratiske
antändande	antändande
upphävdes	upphävdes
determinant	determinant
åklagar	åklagar
lärda	lärda
anrättningars	anrättningars
infogade	infogade
utbytte	utbytte
Ars	Ars
sköter	sköter
Högste	Högste
moppen	moppen
oxen	oxen
betyda	betyda
oxe	oxe
levande	levande
dräp	dräp
brunbjörnar	brunbjörnar
förgöra	förgöra
utkom	utkom
förnimma	förnimma
Simma	Simma
nästen	nästen
Elis	Elis
utforsken	utforsken
luftmassan	luftmassan
tvillingar	tvillingar
fortfara	fortfara
Nilen	Nilen
Kemuels	Kemuels
vilde	vilde
jagas	jagas
fattas	fattas
offras	offras
blåhakarna	blåhakarna
svepts	svepts
utsträck	utsträck
skådade	skådade
sväng	sväng
Sanna	Sanna
orenen	orenen
rov	rov
löjtnantens	löjtnantens
slagverkaren	slagverkaren
korna	korna
tillfrisknade	tillfrisknade
utfärdar	utfärdar
betryckta	betryckta
kompilerar	kompilerar
lånade	lånade
Tre	Tre
rådande	rådande
formas	formas
upptagnare	upptagnare
enar	enar
sedvänja	sedvänja
restaurerades	restaurerades
bergochdalbanorna	bergochdalbanorna
Natans	Natans
levererade	levererade
uppenbarad	uppenbarad
ax	ax
åra	åra
vandren	vandren
vedergäll	vedergäll
draget	draget
besök	besök
kommunikationers	kommunikationers
X-kromosom	X-kromosom
yngste	yngste
bältena	bältena
Joas	Joas
spott	spott
plommons	plommons
surdegen	surdegen
födde	födde
bäres	bäres
dragare	dragare
hålles	hålles
homograferna	homograferna
årorna	årorna
Absalom	Absalom
erövrade	erövrade
påves	påves
viktiga	viktiga
barn	barn
tillkommelsen	tillkommelsen
departementschefens	departementschefens
koffertarnas	koffertarnas
värme	värme
Dess	Dess
upptagen	upptagen
tillgänglighet	tillgänglighet
Simmas	Simmas
mötts	mötts
stridsmedels	stridsmedels
fullborde	fullborde
vet	vet
sköt	sköt
förenas	förenas
deklarera	deklarera
viktige	viktige
upptaga	upptaga
mårkorna	mårkorna
Datans	Datans
gäspar	gäspar
sjöds	sjöds
förstes	förstes
nagellackets	nagellackets
particips	particips
handlägg	handlägg
sjudande	sjudande
juble	juble
äggula	äggula
överlevnad	överlevnad
byrådirektörer	byrådirektörer
Jo	Jo
tigs	tigs
förtrycken	förtrycken
bevisade	bevisade
bestämmande	bestämmande
vilkas	vilkas
ringas	ringas
Gilead	Gilead
Abimelek	Abimelek
Allt	Allt
duka	duka
Ande	Ande
uddens	uddens
omnämnandes	omnämnandes
bryggkaffets	bryggkaffets
Gode	Gode
förehaves	förehaves
Aner	Aner
altares	altares
ändligdimensionelle	ändligdimensionelle
fatten	fatten
kristadelfians	kristadelfians
annex	annex
örtagårdar	örtagårdar
rötternas	rötternas
näpna	näpna
Hiskia	Hiskia
David	David
borrar	borrar
åte	åte
förtäre	förtäre
Hela	Hela
dominerad	dominerad
förödda	förödda
översta	översta
Assurs	Assurs
kröner	kröner
högskolestyrelses	högskolestyrelses
förgätit	förgätit
Abiram	Abiram
tillgängliggjord	tillgängliggjord
duad	duad
tyglas	tyglas
dräpas	dräpas
utfördes	utfördes
granden	granden
allegorier	allegorier
leksakerna	leksakerna
assisterad	assisterad
tystad	tystad
bekänna	bekänna
förhindrats	förhindrats
lånen	lånen
ässen	ässen
hurudana	hurudana
mårkor	mårkor
flugits	flugits
gestaltning	gestaltning
blygs	blygs
oxarna	oxarna
undersökt	undersökt
Jorams	Jorams
fästens	fästens
chiffers	chiffers
gestaltningars	gestaltningars
samtycke	samtycke
Iskariots	Iskariots
medelhavet	medelhavet
mana	mana
Ismael	Ismael
besöka	besöka
byråkratiskt	byråkratiskt
notställens	notställens
eolsharpors	eolsharpors
infogad	infogad
befästas	befästas
bekännare	bekännare
sliten	sliten
utvandrande	utvandrande
diskuterats	diskuterats
oskadliggör	oskadliggör
blinde	blinde
behövs	behövs
utforskade	utforskade
Gileads	Gileads
cykelhandlares	cykelhandlares
systerson	systerson
sitt	sitt
befäst	befäst
dyrkade	dyrkade
vakade	vakade
böja	böja
butikskedjor	butikskedjor
Husen	Husen
räkornas	räkornas
avmäta	avmäta
nertiders	nertiders
Taga	Taga
historiska	historiska
sänt	sänt
piercingars	piercingars
agitatorns	agitatorns
altruisternas	altruisternas
indoktrinerings	indoktrinerings
deklarerar	deklarerar
hat	hat
flunsornas	flunsornas
Serubbabels	Serubbabels
nyanseras	nyanseras
grundämne	grundämne
terrorismens	terrorismens
procentenheten	procentenheten
utfärdad	utfärdad
halsband	halsband
vattenkonsts	vattenkonsts
repmånader	repmånader
mister	mister
bereder	bereder
lama	lama
Hiskias	Hiskias
rökrutor	rökrutor
rödhaken	rödhaken
förtrycker	förtrycker
märka	märka
rättfärdiga	rättfärdiga
säkrast	säkrast
specialtecknets	specialtecknets
Salomo	Salomo
fiskade	fiskade
Beria	Beria
utgiftstaken	utgiftstaken
förena	förena
öknamnens	öknamnens
upptäcks	upptäcks
vitt	vitt
märkt	märkt
dyrkande	dyrkande
sidensvans	sidensvans
invig	invig
höje	höje
höjes	höjes
sy	sy
omsluten	omsluten
Guds	Guds
våld	våld
uppfylls	uppfylls
föden	föden
slakta	slakta
Samarias	Samarias
födda	födda
ugglas	ugglas
omdefinierar	omdefinierar
arrestera	arrestera
samvetena	samvetena
fanfaronaders	fanfaronaders
stöts	stöts
protestera	protestera
Mana	Mana
tanzanier	tanzanier
ändligdimensionellt	ändligdimensionellt
blottar	blottar
rustningarnas	rustningarnas
indiskorna	indiskorna
Jair	Jair
Tabors	Tabors
bade	bade
ökades	ökades
trängt	trängt
Dan	Dan
fällda	fällda
frambäres	frambäres
mördade	mördade
torts	torts
fatet	fatet
skuldoffersväduren	skuldoffersväduren
vridande	vridande
varen	varen
Abia	Abia
formande	formande
Tro	Tro
Tamars	Tamars
lägges	lägges
förläts	förläts
patrullerar	patrullerar
slutlige	slutlige
Vid	Vid
obegränsae	obegränsae
Anatot	Anatot
konvoluts	konvoluts
fästes	fästes
färgbildernas	färgbildernas
utlysa	utlysa
föres	föres
fallen	fallen
förvarar	förvarar
insamlande	insamlande
antropologin	antropologin
brassades	brassades
koffert	koffert
övriga	övriga
malen	malen
lidande	lidande
uddar	uddar
sänds	sänds
åtnjuta	åtnjuta
kraftkabeln	kraftkabeln
stärk	stärk
beskärt	beskärt
renad	renad
gömmas	gömmas
tegs	tegs
Anas	Anas
skåden	skåden
mät	mät
förehava	förehava
trugad	trugad
altruistiskt	altruistiskt
retronym	retronym
väns	väns
döme	döme
bunden	bunden
qvadrats	qvadrats
uträckas	uträckas
förtryckes	förtryckes
ambassadsekreterarnas	ambassadsekreterarnas
antikvarien	antikvarien
förenklad	förenklad
stjärten	stjärten
vinterdäck	vinterdäck
konverteras	konverteras
ballongpelare	ballongpelare
förhindra	förhindra
gräten	gräten
Ada	Ada
Abimeleks	Abimeleks
fogad	fogad
utgöra	utgöra
fogas	fogas
försonats	försonats
sista	sista
bridges	bridges
skänk	skänk
svängts	svängts
hyresvärden	hyresvärden
socialförsäkringsministers	socialförsäkringsministers
berömmande	berömmande
arbetssätts	arbetssätts
bokriser	bokriser
flyga	flyga
bordat	bordat
koncentrationerna	koncentrationerna
räddare	räddare
korsfästa	korsfästa
assisterar	assisterar
fetmas	fetmas
stärkas	stärkas
federationer	federationer
musikinstruments	musikinstruments
patrullerats	patrullerats
docerande	docerande
äppelträds	äppelträds
veta	veta
sikte	sikte
fakultetsnämnden	fakultetsnämnden
förkunnen	förkunnen
ösa	ösa
kufarna	kufarna
görare	görare
föda	föda
närstående	närstående
drängs	drängs
visa	visa
rättvisans	rättvisans
kirrade	kirrade
lodjuret	lodjuret
Hesron	Hesron
lever	lever
löpen	löpen
öppnande	öppnande
bytte	bytte
ässets	ässets
glädjas	glädjas
citronsyrans	citronsyrans
energifrågor	energifrågor
kroppsvätskans	kroppsvätskans
lysa	lysa
resecheckens	resecheckens
förtövades	förtövades
betrycktes	betrycktes
förlåten	förlåten
upplösande	upplösande
åran	åran
ventilens	ventilens
gripes	gripes
förgör	förgör
ödmjuke	ödmjuke
efterföljare	efterföljare
Jairs	Jairs
stadgas	stadgas
dövt	dövt
galningen	galningen
agade	agade
betecknad	betecknad
flädermärgskulornas	flädermärgskulornas
senare	senare
clowneri	clowneri
vakansers	vakansers
utfören	utfören
konungadömens	konungadömens
anklagade	anklagade
bedragare	bedragare
arkivariens	arkivariens
basketbollar	basketbollar
beskrivningsspråk	beskrivningsspråk
buren	buren
tillhörande	tillhörande
interagerade	interagerade
homografens	homografens
betäckas	betäckas
förlåta	förlåta
halvimperialen	halvimperialen
minnes	minnes
debattörerna	debattörerna
Elia	Elia
arkeologen	arkeologen
förtär	förtär
mäter	mäter
muskedundren	muskedundren
användande	användande
antimaterian	antimaterian
falsifierad	falsifierad
utföras	utföras
tatuerares	tatuerares
sann	sann
uppfyller	uppfyller
tillgodogöra	tillgodogöra
altarets	altarets
busschaufförs	busschaufförs
riksantikvarien	riksantikvarien
fattat	fattat
juices	juices
upplösa	upplösa
dräptes	dräptes
vishet	vishet
retirerat	retirerat
paketera	paketera
plats	plats
Persiens	Persiens
trofastheten	trofastheten
murares	murares
öre	öre
gifte	gifte
anställas	anställas
fira	fira
tvillings	tvillings
täcka	täcka
anställs	anställs
fördöma	fördöma
omgiven	omgiven
åts	åts
ytterörats	ytterörats
retirera	retirera
frågen	frågen
författningen	författningen
lös	lös
doktrins	doktrins
sökas	sökas
vädurs	vädurs
musikinstrument	musikinstrument
uppenbarades	uppenbarades
infiltrerades	infiltrerades
gångar	gångar
Heles	Heles
valrossar	valrossar
pråmars	pråmars
jämte	jämte
rustningars	rustningars
bovarna	bovarna
ut	ut
initiativtagarna	initiativtagarna
tystande	tystande
porträtterad	porträtterad
vävstol	vävstol
fiskades	fiskades
badade	badade
dyrkas	dyrkas
flyttar	flyttar
citrusfrukten	citrusfrukten
bespejare	bespejare
läser	läser
Orion	Orion
justitiekanslerns	justitiekanslerns
huggna	huggna
ambassadsekreterares	ambassadsekreterares
beställda	beställda
dal	dal
biträda	biträda
avfalla	avfalla
butikskedja	butikskedja
fackverk	fackverk
platserna	platserna
namnars	namnars
minimera	minimera
debattörer	debattörer
intellektuellt	intellektuellt
provisorierna	provisorierna
tillträda	tillträda
Dans	Dans
Lemek	Lemek
stötte	stötte
täckt	täckt
Assyrien	Assyrien
tyglades	tyglades
återbesök	återbesök
antända	antända
mött	mött
klädde	klädde
lösen	lösen
kulminera	kulminera
flädermärgskulors	flädermärgskulors
än	än
loven	loven
bäre	bäre
mods	mods
burna	burna
fördömen	fördömen
blottas	blottas
sjöslagen	sjöslagen
Faders	Faders
musikallåt	musikallåt
växt	växt
golfklubbens	golfklubbens
tänka	tänka
hons	hons
give	give
kines	kines
röras	röras
klöv	klöv
sprängmedlen	sprängmedlen
bronsmedaljs	bronsmedaljs
äggulor	äggulor
utrotade	utrotade
tänkt	tänkt
jagat	jagat
friat	friat
närståendes	närståendes
hoppas	hoppas
bergochdalbanors	bergochdalbanors
löjtnanten	löjtnanten
gasta	gasta
uppmanande	uppmanande
systematiseras	systematiseras
fyllt	fyllt
utbuden	utbuden
Falla	Falla
resande	resande
asbestens	asbestens
doktriners	doktriners
trängd	trängd
överblickas	överblickas
arbetskamraterna	arbetskamraterna
radiostationen	radiostationen
Maas	Maas
siktades	siktades
meterna	meterna
påvars	påvars
mandatet	mandatet
avbildades	avbildades
årors	årors
rökrutas	rökrutas
lägge	lägge
upptagne	upptagne
lagstiftningens	lagstiftningens
dennas	dennas
byråassistenterna	byråassistenterna
ende	ende
höra	höra
Arbas	Arbas
beskärda	beskärda
webbplatser	webbplatser
släkt	släkt
fästas	fästas
vilt	vilt
Mas	Mas
duetts	duetts
känd	känd
koffertarna	koffertarna
nymånadsdag	nymånadsdag
dörjande	dörjande
legitimiteten	legitimiteten
saknas	saknas
odjurs	odjurs
nyktre	nyktre
ås	ås
gören	gören
vrida	vrida
kokat	kokat
snökedjorna	snökedjorna
upplåtna	upplåtna
genomsöka	genomsöka
bränn	bränn
utspelad	utspelad
chilenarens	chilenarens
Ahab	Ahab
lytt	lytt
grundämnet	grundämnet
sälja	sälja
spenderar	spenderar
församla	församla
tröstar	tröstar
steningen	steningen
utpantat	utpantat
trofasthet	trofasthet
forskningsbiblioteks	forskningsbiblioteks
hörn	hörn
sin	sin
planteren	planteren
beskäres	beskäres
Sikem	Sikem
konverterad	konverterad
kemikaliens	kemikaliens
sålde	sålde
borras	borras
inrätta	inrätta
fast	fast
svängande	svängande
smälte	smälte
bered	bered
förtryckare	förtryckare
uppställa	uppställa
predikare	predikare
namnens	namnens
stjärntydare	stjärntydare
träta	träta
bildsidan	bildsidan
fordren	fordren
försona	försona
berömma	berömma
Gamaliels	Gamaliels
dalarna	dalarna
Edoms	Edoms
trädstammens	trädstammens
våldsverkarna	våldsverkarna
albanskas	albanskas
Vakna	Vakna
defenestrerat	defenestrerat
episteln	episteln
behövande	behövande
tungt	tungt
skjul	skjul
rumäner	rumäner
chilenares	chilenares
kvantifiera	kvantifiera
samlen	samlen
Massas	Massas
rövade	rövade
varulvarna	varulvarna
vanna	vanna
fjättrade	fjättrade
ospontane	ospontane
tage	tage
snödroppens	snödroppens
ofta	ofta
äppelträden	äppelträden
bevare	bevare
argentinskans	argentinskans
Uria	Uria
utsändande	utsändande
slites	slites
polarforsknings	polarforsknings
De	De
väcka	väcka
rannsakas	rannsakas
cichliders	cichliders
terroristen	terroristen
chipspåsarnas	chipspåsarnas
sedeslöshetens	sedeslöshetens
kort	kort
dina	dina
eforn	eforn
mätt	mätt
laotiskans	laotiskans
kolumnbredder	kolumnbredder
Lots	Lots
rymdfysikens	rymdfysikens
Lotan	Lotan
vandrarna	vandrarna
långtradaren	långtradaren
kokade	kokade
givet	givet
bevarades	bevarades
son	son
busschaufförerna	busschaufförerna
radiostationens	radiostationens
kronologiska	kronologiska
malströmmar	malströmmar
specialtecken	specialtecken
Adas	Adas
tordes	tordes
Noas	Noas
vishets	vishets
Jona	Jona
befästes	befästes
samfunds	samfunds
siste	siste
gemaket	gemaket
löste	löste
nejets	nejets
antänt	antänt
No	No
glåpords	glåpords
hjälpare	hjälpare
ställt	ställt
dräpen	dräpen
behöves	behöves
spåra	spåra
odjurets	odjurets
hon	hon
kofferts	kofferts
infiltreras	infiltreras
epitetet	epitetet
täcktes	täcktes
fingeravtryckets	fingeravtryckets
undan	undan
plommon	plommon
utgiftstakets	utgiftstakets
antimaterias	antimaterias
sök	sök
bärare	bärare
Massa	Massa
anklagas	anklagas
tänker	tänker
arrendes	arrendes
sjungits	sjungits
talas	talas
kexet	kexet
oftare	oftare
tryckande	tryckande
terroriserande	terroriserande
byggda	byggda
fornengelskan	fornengelskan
ylande	ylande
öra	öra
faktisk	faktisk
dörjade	dörjade
förlik	förlik
bovs	bovs
murarnas	murarnas
Vilka	Vilka
Melkisedeks	Melkisedeks
tillgängliggörs	tillgängliggörs
vinterdäckets	vinterdäckets
fäst	fäst
släktena	släktena
födes	födes
vilade	vilade
bestå	bestå
ihågkomma	ihågkomma
dyrkades	dyrkades
inrättande	inrättande
satsa	satsa
insamlade	insamlade
sädesledaren	sädesledaren
Ehuds	Ehuds
bagatells	bagatells
galningars	galningars
participet	participet
varulvs	varulvs
preciseras	preciseras
lägga	lägga
hållen	hållen
cykelpumparna	cykelpumparna
överdomstols	överdomstols
skörten	skörten
vars	vars
örfilarnas	örfilarnas
vredes	vredes
används	används
falla	falla
överlevnaden	överlevnaden
murare	murare
surdegarna	surdegarna
örfilarna	örfilarna
förvarande	förvarande
spritt	spritt
uteslöts	uteslöts
oxes	oxes
ring	ring
förgjorde	förgjorde
kristadelfianernas	kristadelfianernas
kommutatorn	kommutatorn
anställa	anställa
löpa	löpa
ovanorna	ovanorna
sexpacket	sexpacket
resas	resas
översedd	översedd
kommuteras	kommuteras
dräpes	dräpes
Amminadab	Amminadab
utgjorde	utgjorde
snuten	snuten
sandades	sandades
Ain	Ain
förkunnats	förkunnats
värma	värma
snöres	snöres
läroverket	läroverket
vare	vare
förmörkas	förmörkas
näpet	näpet
fakultet	fakultet
beskrivningsspråken	beskrivningsspråken
blottats	blottats
intagen	intagen
förtryckas	förtryckas
tröghet	tröghet
epitet	epitet
barrskog	barrskog
upptage	upptage
matchen	matchen
uppenbarat	uppenbarat
moppar	moppar
Akan	Akan
Abirams	Abirams
fördrives	fördrives
behöva	behöva
referera	referera
uppmana	uppmana
förökade	förökade
skildes	skildes
rötter	rötter
räckt	räckt
årornas	årornas
clowneriet	clowneriet
mögs	mögs
samtycka	samtycka
åttiondelarna	åttiondelarna
Melkisedek	Melkisedek
korniskan	korniskan
täck	täck
manlige	manlige
gripa	gripa
man	man
dyrkad	dyrkad
fagottisten	fagottisten
beten	beten
varierades	varierades
ratificerades	ratificerades
täckta	täckta
glänsa	glänsa
ryggsims	ryggsims
mittpunkten	mittpunkten
upptagna	upptagna
upptagnast	upptagnast
läras	läras
silverbägare	silverbägare
länsledningar	länsledningar
terapeuter	terapeuter
porträtterade	porträtterade
lavarnas	lavarnas
borstars	borstars
Arabien	Arabien
förenar	förenar
fattade	fattade
modet	modet
anglicism	anglicism
vreden	vreden
Libanon	Libanon
skulptörs	skulptörs
maakatéer	maakatéer
Hanok	Hanok
antropologins	antropologins
omvända	omvända
renade	renade
förtrycka	förtrycka
läs	läs
Kemuel	Kemuel
klövarna	klövarna
malströmmarna	malströmmarna
omgives	omgives
systersonen	systersonen
spanjors	spanjors
upphöjda	upphöjda
tjänen	tjänen
betäck	betäck
lysande	lysande
löse	löse
Diana	Diana
rådde	rådde
spejade	spejade
ytteröra	ytteröra
renas	renas
undersöka	undersöka
repmånaden	repmånaden
aktivismen	aktivismen
korsfästes	korsfästes
höljets	höljets
kysst	kysst
klämdagar	klämdagar
öppna	öppna
samfund	samfund
tanzanierna	tanzanierna
kokosnötters	kokosnötters
förståndet	förståndet
följd	följd
given	given
förspel	förspel
ringar	ringar
mötande	mötande
manliga	manliga
kommutatorns	kommutatorns
deltagande	deltagande
utbytes	utbytes
stupa	stupa
varieras	varieras
svastikornas	svastikornas
tillreds	tillreds
bruset	bruset
hålen	hålen
släkterna	släkterna
rots	rots
retstickor	retstickor
invigen	invigen
vete	vete
masochisten	masochisten
utbudet	utbudet
byten	byten
befästa	befästa
delgrupp	delgrupp
bastet	bastet
undantagna	undantagna
isotoner	isotoner
Joram	Joram
spridd	spridd
förleder	förleder
noggrant	noggrant
manchesters	manchesters
rövare	rövare
rot	rot
grumlen	grumlen
krondikena	krondikena
hören	hören
fiskas	fiskas
flunsors	flunsors
basketbollarnas	basketbollarnas
oren	oren
hörare	hörare
embarkeringskort	embarkeringskort
oändlig	oändlig
Denne	Denne
kokar	kokar
fallerar	fallerar
smaragden	smaragden
Abram	Abram
förgörare	förgörare
Abrams	Abrams
leverera	leverera
öppnat	öppnat
tjänarna	tjänarna
snigelns	snigelns
väljares	väljares
föröken	föröken
tryckt	tryckt
sådanas	sådanas
Fadern	Fadern
utfärdades	utfärdades
förenklar	förenklar
äldstes	äldstes
krockars	krockars
kloner	kloner
golfklubbs	golfklubbs
inägas	inägas
öken	öken
delade	delade
skänke	skänke
enas	enas
göres	göres
mitokondriers	mitokondriers
preciserade	preciserade
fagotts	fagotts
planterade	planterade
åklagande	åklagande
Anatots	Anatots
ställde	ställde
nämna	nämna
notställ	notställ
Samaria	Samaria
brandväggar	brandväggar
enes	enes
tillgodogör	tillgodogör
joden	joden
omvände	omvände
består	består
skotskt	skotskt
Rebecka	Rebecka
arkivarierna	arkivarierna
kraftkabels	kraftkabels
upptäckte	upptäckte
länsledningens	länsledningens
bokrisen	bokrisen
sökt	sökt
fruktade	fruktade
hämtats	hämtats
nagellacker	nagellacker
centralafrikan	centralafrikan
möta	möta
dragne	dragne
stativens	stativens
uppväcken	uppväcken
bagateller	bagateller
mördare	mördare
blotten	blotten
fanfaronads	fanfaronads
slidans	slidans
gömmes	gömmes
omdefinierades	omdefinierades
fören	fören
dråp	dråp
rättvisan	rättvisan
vida	vida
lovade	lovade
beskyddarens	beskyddarens
vise	vise
gräto	gräto
vila	vila
möers	möers
forskningsbibliotek	forskningsbibliotek
förvaltare	förvaltare
sexpacks	sexpacks
preliminärskattens	preliminärskattens
klämdagarna	klämdagarna
lagades	lagades
fyllde	fyllde
defenestrerad	defenestrerad
antänder	antänder
ratificera	ratificera
slipas	slipas
inhägnade	inhägnade
frambär	frambär
omsluta	omsluta
embarkeringskortens	embarkeringskortens
laman	laman
dunstats	dunstats
arglistigt	arglistigt
Vaken	Vaken
sexhörningarnas	sexhörningarnas
beställt	beställt
snören	snören
snutits	snutits
radian	radian
snörena	snörena
fyllda	fyllda
centralafrikaners	centralafrikaners
förlät	förlät
upplöst	upplöst
massförstörelsevapens	massförstörelsevapens
tjänade	tjänade
småviltet	småviltet
citronsyran	citronsyran
vattna	vattna
kläde	kläde
upplåta	upplåta
stickmygga	stickmygga
Anak	Anak
svavelvätes	svavelvätes
låge	låge
förkunnar	förkunnar
förvånas	förvånas
massakern	massakern
spårade	spårade
släkten	släkten
mark	mark
resecheckars	resecheckars
möte	möte
bjöden	bjöden
örtagårdars	örtagårdars
fördömda	fördömda
borrats	borrats
besegrades	besegrades
täckte	täckte
funne	funne
förtryckts	förtryckts
arbetssättet	arbetssättet
blödas	blödas
förmörkades	förmörkades
visars	visars
duande	duande
Bröder	Bröder
dödas	dödas
sidensvansar	sidensvansar
upplöser	upplöser
hjälpa	hjälpa
tryckarens	tryckarens
förtäres	förtäres
like	like
fattades	fattades
vaken	vaken
betecknat	betecknat
ryggsimmet	ryggsimmet
fostrade	fostrade
löpare	löpare
fallna	fallna
kyssa	kyssa
somt	somt
konungadömes	konungadömes
redigeringskrig	redigeringskrig
kartografisk	kartografisk
indoktrinera	indoktrinera
förvarade	förvarade
spisoffrets	spisoffrets
altruistisk	altruistisk
lavs	lavs
skänkt	skänkt
droppade	droppade
enda	enda
anklagats	anklagats
domänens	domänens
utför	utför
arbetskamrat	arbetskamrat
självt	självt
året	året
misshandlade	misshandlade
bergfinkars	bergfinkars
skött	skött
påbuden	påbuden
Brödet	Brödet
beaktandeleds	beaktandeleds
tröstare	tröstare
spände	spände
betydande	betydande
antikvarier	antikvarier
förlett	förlett
genomslaget	genomslaget
dödande	dödande
sändes	sändes
stärka	stärka
anklagades	anklagades
styrkt	styrkt
inägorna	inägorna
anklaga	anklaga
valrossars	valrossars
ökade	ökade
omgiva	omgiva
rädd	rädd
droppat	droppat
uppfylle	uppfylle
Hanoks	Hanoks
flyttats	flyttats
preliminärskatt	preliminärskatt
dominerade	dominerade
Nilens	Nilens
sändas	sändas
studiet	studiet
ute	ute
fordran	fordran
anticyklons	anticyklons
läggen	läggen
Betuels	Betuels
agas	agas
gaffeln	gaffeln
råder	råder
bönerna	bönerna
byrådirektör	byrådirektör
Ahabs	Ahabs
höghjulingarna	höghjulingarna
vände	vände
skotsk	skotsk
förstöra	förstöra
åtalar	åtalar
censors	censors
kronologiske	kronologiske
värmen	värmen
sköte	sköte
förledets	förledets
Sara	Sara
fullbordan	fullbordan
stadiers	stadiers
ställd	ställd
förvånade	förvånade
licentiaten	licentiaten
webbplats	webbplats
framsäte	framsäte
uppfyll	uppfyll
tillträde	tillträde
vidhäftande	vidhäftande
bältens	bältens
tystades	tystades
tillkommelsens	tillkommelsens
fästande	fästande
kvaddas	kvaddas
protesterad	protesterad
bordlägga	bordlägga
utplånades	utplånades
oxars	oxars
cykelhandlaren	cykelhandlaren
inramningen	inramningen
beställs	beställs
spisoffret	spisoffret
omsnärjde	omsnärjde
fäste	fäste
kokades	kokades
kvällstidnings	kvällstidnings
andas	andas
förkunnades	förkunnades
uppenbara	uppenbara
syddes	syddes
tågas	tågas
mätta	mätta
använde	använde
rörde	rörde
egyptologis	egyptologis
tålmodigt	tålmodigt
förföljda	förföljda
indoktrineringen	indoktrineringen
Assur	Assur
deltaga	deltaga
Gamaliel	Gamaliel
tågades	tågades
dragen	dragen
förfors	förfors
visade	visade
odjur	odjur
kommunikations	kommunikations
finna	finna
stridsmedlet	stridsmedlet
sådant	sådant
vid	vid
oxarnas	oxarnas
intellektuella	intellektuella
avståndet	avståndet
fjättras	fjättras
Den	Den
sen	sen
dukades	dukades
nejlikan	nejlikan
citrusfrukters	citrusfrukters
utplånande	utplånande
cyklotroners	cyklotroners
örtagård	örtagård
gripna	gripna
Manasses	Manasses
dennes	dennes
delgrupperna	delgrupperna
satt	satt
kände	kände
skriva	skriva
korsordet	korsordet
spotten	spotten
själva	själva
förkunnat	förkunnat
bevis	bevis
rycke	rycke
bruke	bruke
vilket	vilket
borra	borra
Persien	Persien
bombarderades	bombarderades
musikallåtar	musikallåtar
underskriften	underskriften
Hesrons	Hesrons
förfölja	förfölja
stores	stores
jämt	jämt
bestämmer	bestämmer
avmätt	avmätt
förgörs	förgörs
upplys	upplys
ringare	ringare
rappad	rappad
genomsökt	genomsökt
upphävande	upphävande
oskadliggjorde	oskadliggjorde
pack	pack
rädes	rädes
skulptör	skulptör
vädurarna	vädurarna
korsfäst	korsfäst
kolonisters	kolonisters
flyge	flyge
sans	sans
låga	låga
villig	villig
hämta	hämta
tillredda	tillredda
döve	döve
föräldralöst	föräldralöst
vektorfälts	vektorfälts
kuf	kuf
beskärd	beskärd
bortförd	bortförd
departementschefers	departementschefers
förgöres	förgöres
utsträckt	utsträckt
årens	årens
släktes	släktes
nämner	nämner
mög	mög
högskolelags	högskolelags
förenklats	förenklats
beskyddare	beskyddare
företagen	företagen
trugat	trugat
sedeslöshet	sedeslöshet
höljes	höljes
förmörkat	förmörkat
upptänden	upptänden
trumpetare	trumpetare
drage	drage
killingar	killingar
stativ	stativ
omgivna	omgivna
vinylskivornas	vinylskivornas
förödes	förödes
våte	våte
borsten	borsten
stänger	stänger
finskors	finskors
Vilken	Vilken
bedragna	bedragna
musikliv	musikliv
etiketten	etiketten
ponerad	ponerad
utsändas	utsändas
tågats	tågats
inrättat	inrättat
Vilket	Vilket
händelsehorisonter	händelsehorisonter
lyte	lyte
utsträcker	utsträcker
kriget	kriget
samlas	samlas
Dennes	Dennes
svavelväte	svavelväte
nämnes	nämnes
räcken	räcken
blottade	blottade
moppars	moppars
tjugofemöringarna	tjugofemöringarna
antänd	antänd
ponerar	ponerar
kapitalisternas	kapitalisternas
det	det
firad	firad
mös	mös
tänkares	tänkares
studium	studium
amperena	amperena
känden	känden
duetterna	duetterna
bältes	bältes
accent	accent
Ehud	Ehud
gifts	gifts
sina	sina
nästes	nästes
metern	metern
atomfysikens	atomfysikens
socialförsäkringsministrar	socialförsäkringsministrar
såpbubblors	såpbubblors
rört	rört
Tres	Tres
skymd	skymd
minne	minne
ödmjuk	ödmjuk
konsekvente	konsekvente
förstörd	förstörd
fördrivna	fördrivna
isters	isters
föra	föra
spanjorers	spanjorers
läroverk	läroverk
blottades	blottades
ens	ens
finsko	finsko
stötes	stötes
frambären	frambären
falle	falle
vittnesbörden	vittnesbörden
cykelpump	cykelpump
ringe	ringe
Rebeckas	Rebeckas
hindarna	hindarna
underskrifts	underskrifts
kända	kända
Natan	Natan
beaktandeledens	beaktandeledens
klämdag	klämdag
före	före
byrådirektörernas	byrådirektörernas
mäta	mäta
talades	talades
sökte	sökte
halt	halt
fint	fint
krigarna	krigarna
funna	funna
hemsökt	hemsökt
ända	ända
redigeringskrigs	redigeringskrigs
uträckt	uträckt
jodens	jodens
hoppade	hoppade
korsfästs	korsfästs
ungkarlens	ungkarlens
prokrastinera	prokrastinera
källingars	källingars
hurudan	hurudan
höljda	höljda
bryggkaffet	bryggkaffet
sköta	sköta
namne	namne
möts	möts
fördömd	fördömd
upphöjen	upphöjen
anrättningar	anrättningar
vin	vin
driven	driven
lästes	lästes
veten	veten
öst	öst
lodjurens	lodjurens
censor	censor
gäsparna	gäsparna
Iskariot	Iskariot
efterföljd	efterföljd
skilda	skilda
stjäle	stjäle
svänger	svänger
graverades	graverades
täckts	täckts
justitiekanslerer	justitiekanslerer
korn	korn
Goa	Goa
renades	renades
hållna	hållna
slaktas	slaktas
tjäna	tjäna
säkrande	säkrande
tyristorer	tyristorer
brunbjörnarna	brunbjörnarna
kokosnöts	kokosnöts
oxens	oxens
lågt	lågt
åt	åt
vinylskiva	vinylskiva
lära	lära
blottande	blottande
skapade	skapade
klätt	klätt
vittnesbördets	vittnesbördets
egyptologins	egyptologins
Berias	Berias
förfrågans	förfrågans
sjöslag	sjöslag
småvilts	småvilts
ymnighetens	ymnighetens
anticyklonens	anticyklonens
bruse	bruse
de	de
använt	använt
väduren	väduren
allmänspråklige	allmänspråklige
nästa	nästa
blidkad	blidkad
lögnprofeterna	lögnprofeterna
förmörka	förmörka
fegisars	fegisars
lika	lika
formeln	formeln
årsfester	årsfester
interagera	interagera
beröm	beröm
lärt	lärt
utfärdat	utfärdat
tryckte	tryckte
asbest	asbest
benämns	benämns
tog	tog
stöta	stöta
pennalen	pennalen
låta	låta
uppfylles	uppfylles
förkunnas	förkunnas
Baal	Baal
skuldoffersvädur	skuldoffersvädur
skalärprodukter	skalärprodukter
avfallen	avfallen
sänd	sänd
inbärgen	inbärgen
stötande	stötande
minska	minska
accenterna	accenterna
bevaras	bevaras
matchs	matchs
Tabor	Tabor
beskärde	beskärde
torka	torka
skrivare	skrivare
fria	fria
företaga	företaga
brandväggarnas	brandväggarnas
utbytena	utbytena
ringarna	ringarna
narkomanens	narkomanens
Det	Det
ordnings	ordnings
döpt	döpt
kilarna	kilarna
blidkas	blidkas
bevaren	bevaren
rikes	rikes
växe	växe
fakulteternas	fakulteternas
lögnprofeternas	lögnprofeternas
talen	talen
Baals	Baals
Salome	Salome
höj	höj
skyhöge	skyhöge
marks	marks
isotonens	isotonens
snigel	snigel
koncentrerande	koncentrerande
Baraks	Baraks
hugges	hugges
avbärgat	avbärgat
löses	löses
kära	kära
avbildande	avbildande
Sans	Sans
ledarsidor	ledarsidor
Ismaels	Ismaels
gross	gross
Tamar	Tamar
embarkeringskortets	embarkeringskortets
Vars	Vars
förtryck	förtryck
preliminär	preliminär
skapare	skapare
bunde	bunde
fingeravtrycks	fingeravtrycks
lärd	lärd
atomfysik	atomfysik
upphöjd	upphöjd
förlike	förlike
ringaren	ringaren
togs	togs
miste	miste
trätt	trätt
mången	mången
bergfinken	bergfinken
ögonglobers	ögonglobers
Fallen	Fallen
Gud	Gud
ställa	ställa
påbudet	påbudet
åsens	åsens
borgaren	borgaren
falsifierade	falsifierade
skötet	skötet
fungerar	fungerar
förda	förda
högskolelagarna	högskolelagarna
ingen	ingen
fylld	fylld
vedergälle	vedergälle
Datan	Datan
märke	märke
vita	vita
Dianas	Dianas
vis	vis
tjänare	tjänare
Vin	Vin
packets	packets
utvandrade	utvandrade
terapeuts	terapeuts
bakgrundsstrålnings	bakgrundsstrålnings
borgarens	borgarens
finansmarknaderna	finansmarknaderna
handläggas	handläggas
bebott	bebott
svastikans	svastikans
påbuds	påbuds
sandas	sandas
överblickat	överblickat
som	som
undersökande	undersökande
egyptierna	egyptierna
mysande	mysande
predikades	predikades
bildsidor	bildsidor
grymmare	grymmare
argentinskorna	argentinskorna
gastade	gastade
drogens	drogens
åkerstycke	åkerstycke
qvadrater	qvadrater
upplåten	upplåten
hemsöka	hemsöka
ställda	ställda
ripjakts	ripjakts
koncentrationer	koncentrationer
bjödo	bjödo
maakatéernas	maakatéernas
täcken	täcken
kommuterar	kommuterar
ordningens	ordningens
hala	hala
villkoren	villkoren
Dessa	Dessa
bara	bara
filter	filter
bakhåll	bakhåll
tåga	tåga
handläggs	handläggs
cichlids	cichlids
låter	låter
lärare	lärare
Naftali	Naftali
slipat	slipat
fackverket	fackverket
stickmyggor	stickmyggor
förkunnare	förkunnare
förgiftad	förgiftad
sänts	sänts
ungkarl	ungkarl
oxar	oxar
utgjord	utgjord
trycks	trycks
utbyte	utbyte
fiskare	fiskare
stupade	stupade
snödroppe	snödroppe
morfism	morfism
värmebehandlat	värmebehandlat
bombarderats	bombarderats
Jasons	Jasons
lösas	lösas
köksön	köksön
åskväder	åskväder
Ana	Ana
svepande	svepande
kvantifierade	kvantifierade
vilka	vilka
Akas	Akas
bebodde	bebodde
fattar	fattar
bortfört	bortfört
lider	lider
fotgängaren	fotgängaren
fungerade	fungerade
följda	följda
hyresvärd	hyresvärd
bevise	bevise
medfödde	medfödde
diskuteras	diskuteras
stjärntydarna	stjärntydarna
hotfull	hotfull
fegisens	fegisens
Saras	Saras
drogerna	drogerna
ögonglobs	ögonglobs
tålmodiga	tålmodiga
5-öringens	5-öringens
blygas	blygas
fallera	fallera
snöret	snöret
visen	visen
radianer	radianer
höjd	höjd
talande	talande
tjugofemöringens	tjugofemöringens
hämtar	hämtar
Arba	Arba
tyristorerna	tyristorerna
fatta	fatta
julaftonens	julaftonens
fetma	fetma
stridsmedel	stridsmedel
Helt	Helt
Judeens	Judeens
dragna	dragna
klövs	klövs
grossen	grossen
sornas	sornas
antände	antände
mätten	mätten
handlade	handlade
glänsande	glänsande
lösande	lösande
cypriotiskas	cypriotiskas
förtövande	förtövande
bygges	bygges
smältas	smältas
sko	sko
dräps	dräps
gäckade	gäckade
knäveck	knäveck
tänkare	tänkare
limpans	limpans
Man	Man
domän	domän
bridge	bridge
köksöars	köksöars
säkrar	säkrar
vikt	vikt
klövens	klövens
rövande	rövande
västliga	västliga
bränns	bränns
beredda	beredda
händelsehorisonten	händelsehorisonten
blåses	blåses
elverken	elverken
döm	döm
daggkåpan	daggkåpan
oxideras	oxideras
odjuret	odjuret
avhärvlade	avhärvlade
hemsökes	hemsökes
knäveckets	knäveckets
oändligaste	oändligaste
bjudes	bjudes
inbärgade	inbärgade
väckas	väckas
brassat	brassat
retades	retades
åten	åten
vilddjurs	vilddjurs
vann	vann
ledda	ledda
anklagen	anklagen
lönnmördas	lönnmördas
förföljare	förföljare
lönnmördats	lönnmördats
tryckas	tryckas
stängda	stängda
altruisters	altruisters
mitokondries	mitokondries
kolumnbredd	kolumnbredd
rörande	rörande
bakhålls	bakhålls
överstes	överstes
röra	röra
tillreda	tillreda
sådan	sådan
intrången	intrången
vridas	vridas
talats	talats
kor	kor
eskimåer	eskimåer
tala	tala
söks	söks
stärken	stärken
utesluts	utesluts
konsekventa	konsekventa
upplyses	upplyses
läsen	läsen
preliminäre	preliminäre
höre	höre
stärkt	stärkt
roten	roten
kokas	kokas
nejs	nejs
ond	ond
läka	läka
krondiken	krondiken
pärms	pärms
vattnar	vattnar
vinge	vinge
tillgängligheten	tillgängligheten
förras	förras
Davids	Davids
årtusendes	årtusendes
ihågkommen	ihågkommen
holonymens	holonymens
Absaloms	Absaloms
upphöja	upphöja
borgare	borgare
sjungs	sjungs
uddarna	uddarna
undantagen	undantagen
slagverkares	slagverkares
förgöras	förgöras
korsord	korsord
inramningars	inramningars
tryckarna	tryckarna
lamans	lamans
kexets	kexets
domänerna	domänerna
stjäl	stjäl
kirrande	kirrande
delat	delat
säljen	säljen
undantaget	undantaget
fostrare	fostrare
byttan	byttan
pennalens	pennalens
annexet	annexet
allegorin	allegorin
höres	höres
torkare	torkare
försonas	försonas
hjälpt	hjälpt
beställde	beställde
drages	drages
funno	funno
räcka	räcka
använd	använd
minskar	minskar
mustens	mustens
alkoholism	alkoholism
licentiats	licentiats
flygas	flygas
undervattensbåtars	undervattensbåtars
Sikems	Sikems
vises	vises
gallerior	gallerior
anställd	anställd
biträde	biträde
åttondelar	åttondelar
stadgen	stadgen
läkare	läkare
byråassistents	byråassistents
Assyriens	Assyriens
kompilerats	kompilerats
röva	röva
håla	håla
såld	såld
snarast	snarast
lägsta	lägsta
lösa	lösa
vette	vette
sändande	sändande
utroten	utroten
historisk	historisk
yrkesutövningen	yrkesutövningen
halvimperials	halvimperials
bundna	bundna
Edom	Edom
moder	moder
jeeparna	jeeparna
holonym	holonym
intrångs	intrångs
beredde	beredde
mittpunkts	mittpunkts
under	under
anden	anden
versionerna	versionerna
leksak	leksak
kolonistens	kolonistens
tillredes	tillredes
Öga	Öga
muggen	muggen
vädur	vädur
utkommen	utkommen
galleriorna	galleriorna
rycka	rycka
mopps	mopps
utrotades	utrotades
raggmunkarna	raggmunkarna
ondast	ondast
Orions	Orions
retronymens	retronymens
grymme	grymme
barrskogar	barrskogar
diesel	diesel
beställa	beställa
besegra	besegra
torkarnas	torkarnas
rovs	rovs
sedvänjor	sedvänjor
dräpt	dräpt
många	många
skifte	skifte
kors	kors
Husas	Husas
blåhaken	blåhaken
systematiserad	systematiserad
arrendena	arrendena
kvaddar	kvaddar
förfars	förfars
bön	bön
fångenskapens	fångenskapens
förtärda	förtärda
bytt	bytt
Ögat	Ögat
strålen	strålen
färgat	färgat
Amminadabs	Amminadabs
mista	mista
assisterade	assisterade
trädstammen	trädstammen
sökts	sökts
legitimitetens	legitimitetens
rötterna	rötterna
massförstörelsevapen	massförstörelsevapen
ripjaktens	ripjaktens
refererande	refererande
döva	döva
erövrare	erövrare
Josefs	Josefs
piercings	piercings
gäckas	gäckas
katalanske	katalanske
redaktionssekreterarnas	redaktionssekreterarnas
rödhakars	rödhakars
graverar	graverar
böjd	böjd
vilken	vilken
övrigas	övrigas
satsar	satsar
murarens	murarens
anklagar	anklagar
sporde	sporde
arglistig	arglistig
reta	reta
sudda	sudda
förgätas	förgätas
berömts	berömts
ugglors	ugglors
rappande	rappande
skjuls	skjuls
julaftnarnas	julaftnarnas
ha	ha
Högstes	Högstes
snöre	snöre
värdemängds	värdemängds
fyllas	fyllas
säker	säker
årsfest	årsfest
kvantiteter	kvantiteter
Joa	Joa
förlikt	förlikt
utfärdas	utfärdas
Haso	Haso
vit	vit
blottat	blottat
prokrastinerande	prokrastinerande
ymnighets	ymnighets
förmörkade	förmörkade
krockarnas	krockarnas
uppställde	uppställde
upplösas	upplösas
sken	sken
tig	tig
genomslagets	genomslagets
fylla	fylla
utsträcka	utsträcka
kokande	kokande
tranbärs	tranbärs
vidhäftade	vidhäftade
öppnas	öppnas
klappade	klappade
minskade	minskade
sexhörningars	sexhörningars
lösts	lösts
massakerns	massakerns
rättfärdigas	rättfärdigas
utlyst	utlyst
åtalas	åtalas
öppnats	öppnats
spenderande	spenderande
lagstiftningar	lagstiftningar
sedens	sedens
söka	söka
stadier	stadier
hölje	hölje
Anaks	Anaks
lagats	lagats
glåporden	glåporden
gravitation	gravitation
Judeen	Judeen
släkte	släkte
blåst	blåst
Barak	Barak
juicen	juicen
nymånadsdagar	nymånadsdagar
påbudens	påbudens
indoktrineras	indoktrineras
steningar	steningar
värmebehandlar	värmebehandlar
ballonger	ballonger
utgjordes	utgjordes
förgjort	förgjort
din	din
fästena	fästena
silverbägarna	silverbägarna
färgbild	färgbild
udd	udd
avbärgad	avbärgad
Varde	Varde
brukade	brukade
trycka	trycka
San	San
byrådirektören	byrådirektören
stjälen	stjälen
räkor	räkor
fotgängarna	fotgängarna
epistel	epistel
oxiderande	oxiderande
raggmunk	raggmunk
Serubbabel	Serubbabel
gileaditen	gileaditen
korer	korer
undervattensbåts	undervattensbåts
hörda	hörda
berömde	berömde
åtnjutas	åtnjutas
tillfrisknat	tillfrisknat
cabbarna	cabbarna
ovanor	ovanor
värka	värka
överseende	överseende
Aran	Aran
finansmarknadens	finansmarknadens
blotta	blotta
egyptier	egyptier
cypriotiska	cypriotiska
nejlikornas	nejlikornas
agitatorer	agitatorer
stridsmedlen	stridsmedlen
framsäten	framsäten
retsticka	retsticka
docerade	docerade
kinesens	kinesens
förlika	förlika
guldfiskarna	guldfiskarna
långtradares	långtradares
påbud	påbud
givna	givna
ödmjuka	ödmjuka
säkrades	säkrades
källingen	källingen
determinanter	determinanter
offrade	offrade
kvacksalvares	kvacksalvares
suddar	suddar
X-kromosomens	X-kromosomens
bigamis	bigamis
byttor	byttor
spejare	spejare
utsträcks	utsträcks
gånge	gånge
bränna	bränna
snörens	snörens
frisörens	frisörens
fatte	fatte
vittnesbörd	vittnesbörd
uppvärmning	uppvärmning
trakasserat	trakasserat
benämnande	benämnande
öppnades	öppnades
åttiondelars	åttiondelars
sådana	sådana
Manasse	Manasse
stjärtars	stjärtars
relaterar	relaterar
höghjuling	höghjuling
fagott	fagott
förnimmande	förnimmande
restaurerar	restaurerar
höljas	höljas
uppenbaras	uppenbaras
trycker	trycker
fångenskaps	fångenskaps
etiketterna	etiketterna
store	store
dråparna	dråparna
Tagen	Tagen
lagade	lagade
tatuerarnas	tatuerarnas
grumlade	grumlade
fästenas	fästenas
morfismerna	morfismerna
bundne	bundne
misshandlar	misshandlar
rövas	rövas
sanerade	sanerade
hjortar	hjortar
5-öring	5-öring
svängdes	svängdes
vattenkonster	vattenkonster
mala	mala
indiskans	indiskans
fogat	fogat
tigits	tigits
uppenbarande	uppenbarande
killingarnas	killingarnas
upphöjde	upphöjde
nämnda	nämnda
bjudna	bjudna
bit	bit
drängen	drängen
fat	fat
lame	lame
rymdfysiks	rymdfysiks
lösare	lösare
vilddjur	vilddjur
villkor	villkor
rädda	rädda
markerna	markerna
fyllen	fyllen
sädesledarens	sädesledarens
eskimåernas	eskimåernas
byttornas	byttornas
behållare	behållare
hjorts	hjorts
behållna	behållna
terrorists	terrorists
Evad	Evad
modets	modets
högskolestyrelsernas	högskolestyrelsernas
tröstas	tröstas
twittras	twittras
uppfyllda	uppfyllda
ventilers	ventilers
åttondelars	åttondelars
hinder	hinder
trakassera	trakassera
gladd	gladd
dröja	dröja
bältets	bältets
skötte	skötte
pingis	pingis
tågade	tågade
korsfästande	korsfästande
täcke	täcke
använda	använda
kläder	kläder
Abias	Abias
förtryckt	förtryckt
hotfulle	hotfulle
saknade	saknade
beröms	beröms
initiativtagares	initiativtagares
borgen	borgen
utplåna	utplåna
återbesöken	återbesöken
fortfarande	fortfarande
sköts	sköts
domäns	domäns
dröjen	dröjen
bespejade	bespejade
Betuel	Betuel
löst	löst
skånken	skånken
bärande	bärande
gives	gives
firas	firas
talat	talat
klädda	klädda
filtren	filtren
Jason	Jason
upptänd	upptänd
säljs	säljs
omdefinierande	omdefinierande
koka	koka
befordran	befordran
dunstar	dunstar
gravitationens	gravitationens
fagottisterna	fagottisterna
blinda	blinda
rovets	rovets
mat	mat
twittrande	twittrande
läsa	läsa
upphäva	upphäva
släktens	släktens
falls	falls
utpantning	utpantning
Libanons	Libanons
årtusendena	årtusendena
frågade	frågade
klon	klon
masochists	masochists
upptändes	upptändes
signerade	signerade
provisoriers	provisoriers
tänkte	tänkte
käre	käre
föräldralösa	föräldralösa
faste	faste
bronsmedalj	bronsmedalj
hör	hör
våldsverkares	våldsverkares
svindel	svindel
frukte	frukte
