generalisiere	generalisiere
Begrenzung	Begrenzung
Palisade	Palisade
hasse	hasse
kämpfen	kämpfen
Anlässe	Anlässe
Gemüseläden	Gemüseläden
Gleitzeit	Gleitzeit
Sizilianer	Sizilianer
verkleide	verkleide
entschleiert	entschleiert
gequasselt	gequasselt
Sündern	Sündern
Feinde	Feinde
wünschet	wünschet
bleibst	bleibst
inszenierst	inszenierst
Türkis	Türkis
Werken	Werken
lang	lang
willen	willen
betätigest	betätigest
Ankern	Ankern
Hurriter	Hurriter
arrivierst	arrivierst
beteuerest	beteuerest
achte	achte
überliefere	überliefere
entzogen	entzogen
Einer	Einer
raubet	raubet
besitzest	besitzest
piesackest	piesackest
bölkte	bölkte
holte	holte
heiliget	heiliget
krösest	krösest
analysiere	analysiere
beanspruchest	beanspruchest
schmelzt	schmelzt
bekehrst	bekehrst
inhalierest	inhalierest
quietsche	quietsche
kristallisiertest	kristallisiertest
Herkünften	Herkünften
harmoniert	harmoniert
Rotzinkerzen	Rotzinkerzen
Heide	Heide
hupet	hupet
Sünders	Sünders
plumpsten	plumpsten
bescheißt	bescheißt
erzürnet	erzürnet
ersparten	ersparten
zwang	zwang
fritieret	fritieret
parametrisierst	parametrisierst
greinet	greinet
Leiche	Leiche
kürzt	kürzt
verrosteten	verrosteten
Nehmet	Nehmet
Wehklage	Wehklage
Dödel	Dödel
Lunisolarkalender	Lunisolarkalender
durchwacht	durchwacht
verlasset	verlasset
fahrt	fahrt
gewurstelt	gewurstelt
kabelten	kabelten
verflog	verflog
Aromastoffe	Aromastoffe
Brüdern	Brüdern
Gedicht	Gedicht
Briefe	Briefe
Gaunern	Gaunern
kürzten	kürzten
Gnaden	Gnaden
erlöset	erlöset
Hüllenelektronen	Hüllenelektronen
Regieren	Regieren
putzt	putzt
finanzierest	finanzierest
Wasserquelle	Wasserquelle
Schlangen	Schlangen
entdecket	entdecket
springen	springen
Substanz	Substanz
Isolatoren	Isolatoren
Hirt	Hirt
tiefe	tiefe
wichste	wichste
Rehböcken	Rehböcken
Dans	Dans
armen	armen
verdinglichest	verdinglichest
Basilikum	Basilikum
Hobby	Hobby
Langzeichen	Langzeichen
impfst	impfst
Trockendocks	Trockendocks
ringet	ringet
verkündigt	verkündigt
erzürnt	erzürnt
Ärgernisse	Ärgernisse
Kriegsschauplatz	Kriegsschauplatz
Golfplätzen	Golfplätzen
Grönländer	Grönländer
Fellen	Fellen
NAND-Gatter	NAND-Gatter
Körpergeruch	Körpergeruch
verunglimpftet	verunglimpftet
schreckt	schreckt
Reichweite	Reichweite
dürftet	dürftet
stoppte	stoppte
Teppiche	Teppiche
verspielest	verspielest
lügen	lügen
Geschwindigkeitsmessern	Geschwindigkeitsmessern
Pflanzung	Pflanzung
begrubt	begrubt
weist	weist
frottierten	frottierten
Wadenbeines	Wadenbeines
Weinstöcke	Weinstöcke
egalisierten	egalisierten
kräuselten	kräuselten
laufet	laufet
schätzte	schätzte
Testamenten	Testamenten
lavierte	lavierte
speicherten	speicherten
solle	solle
krank	krank
Gangster	Gangster
Aromastoffen	Aromastoffen
weisest	weisest
Ränke	Ränke
Strontiumamalgamen	Strontiumamalgamen
harmonierte	harmonierte
beben	beben
Strahlentierchen	Strahlentierchen
schätzt	schätzt
bummeltet	bummeltet
ausführte	ausführte
bandagiert	bandagiert
Blitze	Blitze
Bundesgebieten	Bundesgebieten
jaget	jaget
Fischotters	Fischotters
entert	entert
tust	tust
beunruhige	beunruhige
wollten	wollten
destabilisierst	destabilisierst
begleicht	begleicht
sollst	sollst
Schlaraffenländern	Schlaraffenländern
springst	springst
Alten	Alten
fabulierte	fabulierte
überreicht	überreicht
gabelt	gabelt
glänzt	glänzt
Jünger	Jünger
lehret	lehret
Tasten	Tasten
Schnallen	Schnallen
pressiert	pressiert
treffen	treffen
vertagest	vertagest
Lotterien	Lotterien
gereichte	gereichte
Freizeitzentrum	Freizeitzentrum
verderbest	verderbest
Ärzte	Ärzte
Unwahrheit	Unwahrheit
Katamaranen	Katamaranen
seines	seines
fetten	fetten
beschlug	beschlug
Erdboden	Erdboden
dunkelt	dunkelt
Aha-Erlebnis	Aha-Erlebnis
legst	legst
fragest	fragest
auszogst	auszogst
gehört	gehört
ermordeten	ermordeten
punktetest	punktetest
Verdacht	Verdacht
zähle	zähle
kaufe	kaufe
regelet	regelet
Kassiteriten	Kassiteriten
Kehret	Kehret
Langschwanzpinguin	Langschwanzpinguin
Märtyrer	Märtyrer
Abschreckung	Abschreckung
Suchanfragen	Suchanfragen
Ding	Ding
Gerücht	Gerücht
Linguisten	Linguisten
lauschte	lauschte
rekonstruieren	rekonstruieren
wollest	wollest
beäugen	beäugen
Beobachtungen	Beobachtungen
aufkämen	aufkämen
Dudelsack	Dudelsack
quantisiere	quantisiere
Argentit	Argentit
Baiser	Baiser
Haue	Haue
Füße	Füße
knufften	knufften
Essen	Essen
glaubte	glaubte
urbanisiert	urbanisiert
Butzemann	Butzemann
Messies	Messies
Gedächtnissen	Gedächtnissen
umhüllst	umhüllst
Basilisk	Basilisk
besprengen	besprengen
diese	diese
heben	heben
Kutter	Kutter
Apfelbäumen	Apfelbäumen
Prostylos	Prostylos
härte	härte
Dreieinigkeit	Dreieinigkeit
urbanisier	urbanisier
strandeten	strandeten
sichere	sichere
beschwören	beschwören
Betten	Betten
Äxte	Äxte
Schaffe	Schaffe
Bilderstürmer	Bilderstürmer
defragmentierten	defragmentierten
Falz	Falz
Omnibusse	Omnibusse
Asylrechte	Asylrechte
forschte	forschte
greifet	greifet
pipettierten	pipettierten
Diebe	Diebe
weise	weise
Reliquiar	Reliquiar
Säcken	Säcken
Trägergasen	Trägergasen
Karer	Karer
verwahrt	verwahrt
Krume	Krume
dürfte	dürfte
Aluminaten	Aluminaten
verbrauchte	verbrauchte
hydrolysierest	hydrolysierest
beichteten	beichteten
Schlagzeuger	Schlagzeuger
setzten	setzten
separieren	separieren
tatteret	tatteret
Binde	Binde
lüftet	lüftet
Tote	Tote
Aacheners	Aacheners
angehöre	angehöre
Rasterkraftmikroskop	Rasterkraftmikroskop
replizierten	replizierten
installierten	installierten
dümpelst	dümpelst
meldet	meldet
schießt	schießt
wisperest	wisperest
Zeithorizonte	Zeithorizonte
glühenden	glühenden
Gespenstern	Gespenstern
gehörten	gehörten
Blitzableiter	Blitzableiter
Dienstgrad	Dienstgrad
gute	gute
regieren	regieren
fastetest	fastetest
gewinnen	gewinnen
Fiasko	Fiasko
Borhydrid	Borhydrid
Ösophagospasmus	Ösophagospasmus
plagen	plagen
scheute	scheute
gedenk	gedenk
Leugnung	Leugnung
Bruchstriches	Bruchstriches
Ranzigkeit	Ranzigkeit
War	War
tage	tage
Ingredienzen	Ingredienzen
separieret	separieret
stolz	stolz
Höhe	Höhe
Wege	Wege
Feierabende	Feierabende
schubset	schubset
eins	eins
Keilen	Keilen
Flenser	Flenser
knüpfte	knüpfte
dritte	dritte
Heuschrecke	Heuschrecke
Flussbett	Flussbett
Carbids	Carbids
kontaktiere	kontaktiere
Klaue	Klaue
rüste	rüste
schwöret	schwöret
Bete	Bete
verzweigst	verzweigst
vertilgte	vertilgte
verbesserten	verbesserten
Sprichwörtern	Sprichwörtern
Selbstsicherheit	Selbstsicherheit
wetzte	wetzte
scheitertet	scheitertet
Filzläusen	Filzläusen
zählend	zählend
erhörst	erhörst
imprägnieret	imprägnieret
Schade	Schade
liebt	liebt
verständig	verständig
Skorpione	Skorpione
glaubt	glaubt
zagt	zagt
Ansichtskarte	Ansichtskarte
bölket	bölket
versuchet	versuchet
Fettsäcken	Fettsäcken
schimmerst	schimmerst
irgendein	irgendein
Fehden	Fehden
wog	wog
Ion	Ion
klickte	klickte
manchen	manchen
amenagier	amenagier
verliere	verliere
Kortholt	Kortholt
verwahrst	verwahrst
producieret	producieret
Pailletten	Pailletten
Eselsohren	Eselsohren
Krieg	Krieg
Aktenkoffer	Aktenkoffer
Kanzleien	Kanzleien
Arsenbergwerk	Arsenbergwerk
Rückumlauten	Rückumlauten
knuffend	knuffend
leistete	leistete
Bausch	Bausch
halle	halle
Licht	Licht
zappen	zappen
Zeugen	Zeugen
Anachronismus	Anachronismus
Nährmedien	Nährmedien
prostituierte	prostituierte
schenke	schenke
Halogenatom	Halogenatom
Höhlen	Höhlen
Sprichwort	Sprichwort
blitzt	blitzt
Komponisten	Komponisten
lachen	lachen
Säcke	Säcke
Optimisten	Optimisten
Nukleinsäuren	Nukleinsäuren
Futtermittel	Futtermittel
suchest	suchest
Freitagnachmittagen	Freitagnachmittagen
eroberte	eroberte
Brieföffner	Brieföffner
Autoklav	Autoklav
Kaufhäuser	Kaufhäuser
Jagdhund	Jagdhund
Reinigungsschrittes	Reinigungsschrittes
Penis	Penis
Lehrbüchern	Lehrbüchern
Zuschauer	Zuschauer
schweigen	schweigen
Fallt	Fallt
wirfst	wirfst
vereinbarten	vereinbarten
ärgertest	ärgertest
pflücktet	pflücktet
benützt	benützt
überweiset	überweiset
Fanmeilen	Fanmeilen
Einstufung	Einstufung
Programmiererinnen	Programmiererinnen
Hahnenkämmen	Hahnenkämmen
machte	machte
gedachtest	gedachtest
Lob	Lob
umgaben	umgaben
verwerten	verwerten
Stärke	Stärke
blondierten	blondierten
wart	wart
Deutungen	Deutungen
liebst	liebst
konsolidierend	konsolidierend
fehlte	fehlte
nähe	nähe
dekompilierten	dekompilierten
erntete	erntete
Hebet	Hebet
hüte	hüte
Homodimeren	Homodimeren
verunreinigt	verunreinigt
fehlen	fehlen
kreieren	kreieren
bitte	bitte
benütztest	benütztest
scheue	scheue
untersagtest	untersagtest
Zapfhähnen	Zapfhähnen
Tukans	Tukans
lösen	lösen
übersiehst	übersiehst
kichern	kichern
Toten	Toten
erhebst	erhebst
Taschendiebe	Taschendiebe
puddelst	puddelst
addieret	addieret
dividiert	dividiert
Massenarbeitslosigkeit	Massenarbeitslosigkeit
mißversteht	mißversteht
Augur	Augur
frappierte	frappierte
Wände	Wände
elfte	elfte
Unglaube	Unglaube
entmineralisierten	entmineralisierten
speiset	speiset
Euren	Euren
vergrubt	vergrubt
streutet	streutet
versüße	versüße
bestand	bestand
Nehmt	Nehmt
Bonzen	Bonzen
beleuchteten	beleuchteten
Charakteristika	Charakteristika
Fäuste	Fäuste
erforschest	erforschest
Thioestere	Thioestere
Panzerschrecke	Panzerschrecke
Überziehen	Überziehen
Remisen	Remisen
Einöde	Einöde
Domäne	Domäne
folgt	folgt
bebet	bebet
billigte	billigte
Aggressoren	Aggressoren
Krusten	Krusten
erkanntet	erkanntet
Lazarett	Lazarett
Mikrometer	Mikrometer
Schauen	Schauen
formirend	formirend
schöben	schöben
Geber	Geber
Kruste	Kruste
verführten	verführten
Carbid	Carbid
Finanzministerium	Finanzministerium
steinigst	steinigst
UND-Gatter	UND-Gatter
fertig	fertig
Schreibern	Schreibern
Welche	Welche
beschotterten	beschotterten
Notizen	Notizen
klicket	klicket
jemand	jemand
lohnten	lohnten
Signalen	Signalen
Halsabschneidern	Halsabschneidern
hingehst	hingehst
Martyrologium	Martyrologium
bringst	bringst
verbündeten	verbündeten
Ehre	Ehre
Wert	Wert
lanciertet	lanciertet
Fettes	Fettes
Fremden	Fremden
oben	oben
verirrt	verirrt
Dewargefäße	Dewargefäße
touchierte	touchierte
Schwirrvögel	Schwirrvögel
Wadenbein	Wadenbein
backen	backen
rechten	rechten
enterten	enterten
gewähr	gewähr
Stimmen	Stimmen
Kassiterits	Kassiterits
Jahre	Jahre
Buchfinken	Buchfinken
verifizierten	verifizierten
Hypochlorit	Hypochlorit
erforschet	erforschet
rebelliere	rebelliere
dümpelest	dümpelest
thematisierten	thematisierten
wirst	wirst
Halleluja	Halleluja
feierst	feierst
Vollkornbrot	Vollkornbrot
folgtet	folgtet
Markise	Markise
Diesen	Diesen
Alkali	Alkali
Reststoff	Reststoff
generiert	generiert
regeln	regeln
rinnt	rinnt
beschottert	beschottert
verringerten	verringerten
Leugnungen	Leugnungen
sedimentierte	sedimentierte
anders	anders
solchen	solchen
spalten	spalten
sagst	sagst
erwachet	erwachet
Noseans	Noseans
Energiespeicher	Energiespeicher
Radsätzen	Radsätzen
seufzest	seufzest
imkernd	imkernd
Gewürze	Gewürze
zittere	zittere
Regenwald	Regenwald
opfern	opfern
beneidest	beneidest
Panamaer	Panamaer
Funkfeuern	Funkfeuern
Mobilfunknetzen	Mobilfunknetzen
Apotheose	Apotheose
Tollkirsche	Tollkirsche
verpufftest	verpufftest
fertige	fertige
formulieren	formulieren
Zeithorizonten	Zeithorizonten
Kochfeldern	Kochfeldern
überwachest	überwachest
räumen	räumen
gönnst	gönnst
Uranerzen	Uranerzen
feiert	feiert
brach	brach
Freeganer	Freeganer
entkörperlichten	entkörperlichten
werft	werft
Heuschrecken	Heuschrecken
Toren	Toren
lodertet	lodertet
Ersten	Ersten
Rotzinkerz	Rotzinkerz
hebräisch	hebräisch
optimierte	optimierte
überstehst	überstehst
einem	einem
reinigst	reinigst
glaubten	glaubten
Würfelspiele	Würfelspiele
Rotgüssen	Rotgüssen
berufe	berufe
verbündete	verbündete
ausrufest	ausrufest
misstrauest	misstrauest
eiterten	eiterten
Zäune	Zäune
sagtet	sagtet
Griechen	Griechen
Leuchtkäfer	Leuchtkäfer
segelte	segelte
Reiseleitern	Reiseleitern
hetzte	hetzte
rauben	rauben
Dithiolane	Dithiolane
Feiertage	Feiertage
essest	essest
lesen	lesen
Galoppen	Galoppen
eggte	eggte
umbrächten	umbrächten
redetet	redetet
zupfte	zupfte
anderen	anderen
Eutern	Eutern
faschieret	faschieret
Auszüge	Auszüge
Zipfelmützen	Zipfelmützen
Darlegung	Darlegung
punkteten	punkteten
entwischtet	entwischtet
Gässchen	Gässchen
zerbrechen	zerbrechen
sorgte	sorgte
betrübtest	betrübtest
Rückwege	Rückwege
dümpelte	dümpelte
wiederkamen	wiederkamen
verstecken	verstecken
Schlöte	Schlöte
desertiertet	desertiertet
hydrogentartrate	hydrogentartrate
Fittichen	Fittichen
Aufprall	Aufprall
Blumensträußen	Blumensträußen
Bienen	Bienen
Mischelement	Mischelement
sedimentieret	sedimentieret
Androiden	Androiden
Erfahrung	Erfahrung
suchet	suchet
Steinen	Steinen
Markisen	Markisen
folgen	folgen
Weihen	Weihen
Schale	Schale
Äste	Äste
deute	deute
Schaffnerinnen	Schaffnerinnen
Schaden	Schaden
Massage	Massage
Elementarzellen	Elementarzellen
Notärztin	Notärztin
schlachtet	schlachtet
veranstaltest	veranstaltest
schleim	schleim
verzehrt	verzehrt
zierte	zierte
Ratsherren	Ratsherren
Kindergeld	Kindergeld
Komponistinnen	Komponistinnen
erbrütet	erbrütet
spezialisierst	spezialisierst
Hände	Hände
Pflaumen	Pflaumen
auflöste	auflöste
verwechselst	verwechselst
Ältesten	Ältesten
Stadtbezirken	Stadtbezirken
heparinisiere	heparinisiere
Meere	Meere
Reliquiare	Reliquiare
observierst	observierst
bekannte	bekannte
Stilllegungen	Stilllegungen
Ränken	Ränken
Prophet	Prophet
leere	leere
höben	höben
Kryostat	Kryostat
Landwirte	Landwirte
spracht	spracht
Spiralen	Spiralen
Freizeitzentren	Freizeitzentren
könnet	könnet
Uterus	Uterus
Laken	Laken
Fallturm	Fallturm
erntet	erntet
Weinberge	Weinberge
teilen	teilen
zerstücken	zerstücken
vollendest	vollendest
Mitwisserschaft	Mitwisserschaft
ermächtigest	ermächtigest
erschüttere	erschüttere
Zähnen	Zähnen
Gasen	Gasen
verprügelte	verprügelte
verfängt	verfängt
Planer	Planer
Schiffen	Schiffen
radiertest	radiertest
Denn	Denn
kämpfet	kämpfet
setze	setze
Städten	Städten
seien	seien
verstecke	verstecke
zertifiziertest	zertifiziertest
Collagen	Collagen
lehrst	lehrst
grabe	grabe
Schätze	Schätze
behütet	behütet
Nussknacker	Nussknacker
dürft	dürft
imkeret	imkeret
überschnitten	überschnitten
Lüste	Lüste
grüntet	grüntet
Astat	Astat
kennest	kennest
Zensus	Zensus
Entsetzet	Entsetzet
Insulaner	Insulaner
weich	weich
krieget	krieget
nütze	nütze
Klüfte	Klüfte
stifte	stifte
trinken	trinken
klonet	klonet
verwaisten	verwaisten
Geringschätzung	Geringschätzung
Dingen	Dingen
hure	hure
erwähnet	erwähnet
Gibst	Gibst
Dochte	Dochte
lancierst	lancierst
Gut	Gut
Zipfelmütze	Zipfelmütze
Ausbeutern	Ausbeutern
spähet	spähet
strafst	strafst
verjährest	verjährest
Chlorat	Chlorat
Gerät	Gerät
sagte	sagte
borgst	borgst
Flamingo	Flamingo
Oxalate	Oxalate
Fußbodens	Fußbodens
Besprechung	Besprechung
Gesetze	Gesetze
bürsten	bürsten
Zwangsarbeiterin	Zwangsarbeiterin
nimmst	nimmst
Kriegsschauplätze	Kriegsschauplätze
Beile	Beile
porträtiere	porträtiere
Armen	Armen
Meines	Meines
Obszönität	Obszönität
Hochhäuser	Hochhäuser
restaurierten	restaurierten
gebäre	gebäre
warntest	warntest
überqueren	überqueren
Berufe	Berufe
evaluierten	evaluierten
Alibis	Alibis
schichtet	schichtet
rauschte	rauschte
dotierst	dotierst
verglichest	verglichest
Schulleiterin	Schulleiterin
Kohlen	Kohlen
wehe	wehe
vertrieb	vertrieb
Sachen	Sachen
Heiratsgütern	Heiratsgütern
verludet	verludet
huren	huren
lügst	lügst
wehret	wehret
falteten	falteten
grüßet	grüßet
drängten	drängten
verwirrt	verwirrt
Durchbruch	Durchbruch
Gehirnwellen	Gehirnwellen
scheinest	scheinest
Geheimdienst	Geheimdienst
konvergiere	konvergiere
konsolidierest	konsolidierest
Flame	Flame
Setzet	Setzet
Klärung	Klärung
schwöre	schwöre
verspätest	verspätest
salzen	salzen
verbasele	verbasele
Zäunen	Zäunen
Mähnenwölfen	Mähnenwölfen
demütigte	demütigte
Kaufleuten	Kaufleuten
nehmt	nehmt
grien	grien
führte	führte
Almanachen	Almanachen
einigte	einigte
wiederholte	wiederholte
finanziert	finanziert
Höschens	Höschens
Kontrollboxen	Kontrollboxen
Räten	Räten
Strafraum	Strafraum
bereitete	bereitete
Nachteile	Nachteile
Stiefmütterchen	Stiefmütterchen
Seines	Seines
Röcken	Röcken
belüftet	belüftet
spanne	spanne
Pentaboraten	Pentaboraten
Schneepflüge	Schneepflüge
verständige	verständige
Dachdecker	Dachdecker
schnorrtet	schnorrtet
neigte	neigte
plumpse	plumpse
wilden	wilden
Reinstoffen	Reinstoffen
Soll	Soll
Sprüchen	Sprüchen
unterstützet	unterstützet
Tiefschutzen	Tiefschutzen
Quellflüssen	Quellflüssen
setzt	setzt
Lehrkörpern	Lehrkörpern
Zehnt	Zehnt
Proton	Proton
gebührt	gebührt
Gründungsprivileg	Gründungsprivileg
maximiere	maximiere
straften	straften
vibrierend	vibrierend
Galeere	Galeere
charakterisierend	charakterisierend
Ochsen	Ochsen
gedacht	gedacht
verfolgst	verfolgst
Backenbärten	Backenbärten
platzt	platzt
verzweifelt	verzweifelt
ausführen	ausführen
kriegen	kriegen
würdet	würdet
pharyngalisierten	pharyngalisierten
Anzeichen	Anzeichen
hinterfragten	hinterfragten
unterwerfe	unterwerfe
vertilgen	vertilgen
Öfchen	Öfchen
Brechnuss	Brechnuss
überführen	überführen
kürze	kürze
dehydrierten	dehydrierten
verbitterte	verbitterte
Sorget	Sorget
Deinen	Deinen
Kopfsalat	Kopfsalat
Schuhen	Schuhen
zentriert	zentriert
Fellhandschuh	Fellhandschuh
widmeten	widmeten
redetest	redetest
Excimerlaser	Excimerlaser
beläufst	beläufst
bauest	bauest
Metapher	Metapher
Perle	Perle
klumpe	klumpe
Automatikgetriebe	Automatikgetriebe
kaufet	kaufet
schmuggelest	schmuggelest
möppertet	möppertet
Tier	Tier
kurze	kurze
Rückumschlägen	Rückumschlägen
Epidemie	Epidemie
Zehen	Zehen
gelangt	gelangt
reim	reim
ermordet	ermordet
verdrehet	verdrehet
Afrikaner	Afrikaner
funktionierte	funktionierte
kennet	kennet
Sportlerinnen	Sportlerinnen
Nachweisreagenzien	Nachweisreagenzien
Fischer	Fischer
ab	ab
sprühend	sprühend
zerstreute	zerstreute
baggerst	baggerst
wilde	wilde
versuchst	versuchst
Anmelder	Anmelder
Flussbetten	Flussbetten
rammte	rammte
verwirren	verwirren
schöpfest	schöpfest
Anhängseln	Anhängseln
Mäppchen	Mäppchen
verarbeite	verarbeite
Isobars	Isobars
Wurzelwachstum	Wurzelwachstum
haschieret	haschieret
Marokkaners	Marokkaners
pendele	pendele
liste	liste
siegte	siegte
Amokläuferinnen	Amokläuferinnen
Am	Am
fabuliert	fabuliert
Zeitschlitze	Zeitschlitze
entsetzte	entsetzte
brause	brause
Alle	Alle
Heben	Heben
klumpt	klumpt
pulsiere	pulsiere
Eiland	Eiland
Heteroatome	Heteroatome
Trübsalen	Trübsalen
Asthenosphäre	Asthenosphäre
Kleinod	Kleinod
Zirkelschluss	Zirkelschluss
keulst	keulst
Panzerschreck	Panzerschreck
ersparte	ersparte
gestatteten	gestatteten
schleimte	schleimte
schreien	schreien
Fußboden	Fußboden
hüpfen	hüpfen
hydrogentartrat	hydrogentartrat
blondieret	blondieret
Stilllegung	Stilllegung
Regierung	Regierung
Pflichten	Pflichten
teilet	teilet
kehre	kehre
abweichet	abweichet
beschotteret	beschotteret
Asteroide	Asteroide
Kräfte	Kräfte
verberge	verberge
jede	jede
pfänden	pfänden
Kornnattern	Kornnattern
Arme	Arme
bewerbet	bewerbet
zuppe	zuppe
Quellen	Quellen
attackieret	attackieret
reizest	reizest
kickend	kickend
grüßte	grüßte
kämpfte	kämpfte
spannte	spannte
aufrichten	aufrichten
begliche	begliche
aller	aller
Zirkelbeweis	Zirkelbeweis
blitztet	blitztet
Zeitungsenten	Zeitungsenten
Herbstwinden	Herbstwinden
eingehet	eingehet
Braunrallen	Braunrallen
schlabberten	schlabberten
legest	legest
fragmentierst	fragmentierst
hintertriebe	hintertriebe
Aufsätze	Aufsätze
Bote	Bote
enge	enge
stimme	stimme
erzürnst	erzürnst
Fettsack	Fettsack
transportierten	transportierten
Bettlers	Bettlers
More	More
Lopariten	Lopariten
schenkest	schenkest
bromiertet	bromiertet
entrümpelest	entrümpelest
spiele	spiele
Quelle	Quelle
berührt	berührt
Krokus	Krokus
Wogen	Wogen
auflegte	auflegte
beides	beides
Scherzes	Scherzes
Schneider	Schneider
Hertz	Hertz
mußt	mußt
Untiefe	Untiefe
Atemluft	Atemluft
verlaß	verlaß
Rutheniumkomplexen	Rutheniumkomplexen
exmatrikulierte	exmatrikulierte
Preisanstiegen	Preisanstiegen
Ausländern	Ausländern
Klappertopf	Klappertopf
Argentits	Argentits
Geflecktheiten	Geflecktheiten
sinkest	sinkest
Pflanzenstoff	Pflanzenstoff
deine	deine
Schwirrvogel	Schwirrvogel
lange	lange
bediene	bediene
antworte	antworte
funzen	funzen
sticke	sticke
Möbelstoffen	Möbelstoffen
transportierst	transportierst
glaubet	glaubet
Jahren	Jahren
Alkin	Alkin
vertilgest	vertilgest
Gasgemisch	Gasgemisch
Konfitüren	Konfitüren
Fusseln	Fusseln
motivierte	motivierte
geschlummert	geschlummert
schlag	schlag
murmelst	murmelst
faltest	faltest
Blattgeweben	Blattgeweben
Korrosionsschutz	Korrosionsschutz
dechiffriere	dechiffriere
Freibergit	Freibergit
maßen	maßen
Handbüchern	Handbüchern
erkundigte	erkundigte
applizirst	applizirst
stigmatisierest	stigmatisierest
Küstenwache	Küstenwache
Fittiche	Fittiche
Bilderstürmers	Bilderstürmers
eggt	eggt
einführt	einführt
fluppe	fluppe
legte	legte
Bär	Bär
bückest	bückest
tun	tun
bescheiße	bescheiße
Königreichen	Königreichen
wispern	wispern
Letzten	Letzten
Überfamilie	Überfamilie
geloben	geloben
Leuchtstoff	Leuchtstoff
Naturen	Naturen
begehrt	begehrt
zürnten	zürnten
halltet	halltet
Version	Version
Welchen	Welchen
verteidigt	verteidigt
Theologie	Theologie
finanziere	finanziere
dressieret	dressieret
verklärt	verklärt
weinet	weinet
fließt	fließt
einigst	einigst
Sprödmetall	Sprödmetall
Atemgas	Atemgas
Landesverräterinnen	Landesverräterinnen
Berufen	Berufen
zerfetzte	zerfetzte
Eingeweiden	Eingeweiden
Schwänzen	Schwänzen
knüpfen	knüpfen
ander	ander
Bevölkerungsdichten	Bevölkerungsdichten
hoben	hoben
Wachen	Wachen
schälte	schälte
solch	solch
verdammtet	verdammtet
assimilierten	assimilierten
jauchzte	jauchzte
besänne	besänne
Malaysierin	Malaysierin
danket	danket
Lasten	Lasten
aufrichtest	aufrichtest
schnappet	schnappet
zürnst	zürnst
Empörung	Empörung
aufstanden	aufstanden
benachrichtige	benachrichtige
trotzest	trotzest
erratet	erratet
Edelsteinen	Edelsteinen
vertreiben	vertreiben
erbrüte	erbrüte
Sucht	Sucht
Physikerin	Physikerin
feierten	feierten
offenbarten	offenbarten
gebäret	gebäret
Oberbegriff	Oberbegriff
Kautschuken	Kautschuken
Wolle	Wolle
grau	grau
zeugest	zeugest
sinterte	sinterte
tendierst	tendierst
verkaufte	verkaufte
Rechenbrett	Rechenbrett
haschiert	haschiert
Safran	Safran
bestraft	bestraft
Besprechungen	Besprechungen
stürzte	stürzte
verstrahlet	verstrahlet
foppten	foppten
erstaunte	erstaunte
ahnten	ahnten
Volltreffer	Volltreffer
führest	führest
Neuigkeiten	Neuigkeiten
abalieniertest	abalieniertest
spukte	spukte
greinen	greinen
häufe	häufe
erzwangt	erzwangt
verbaselt	verbaselt
jammern	jammern
zähltet	zähltet
lohnt	lohnt
Buchstaben	Buchstaben
Tretlager	Tretlager
Lazarette	Lazarette
Münzsammlungen	Münzsammlungen
designierst	designierst
Renegaten	Renegaten
Atomphysiker	Atomphysiker
Päderast	Päderast
keiner	keiner
gewinnet	gewinnet
Fluoratom	Fluoratom
inhalier	inhalier
sterbet	sterbet
hinterlege	hinterlege
fladerst	fladerst
Händedruck	Händedruck
Briefen	Briefen
zählet	zählet
Früchtchen	Früchtchen
ehrte	ehrte
begehr	begehr
versuchen	versuchen
Großfürst	Großfürst
verdeckten	verdeckten
bekehrten	bekehrten
Beiblättern	Beiblättern
Färsen	Färsen
Plumpse	Plumpse
glänzen	glänzen
Radsatzes	Radsatzes
Auszügen	Auszügen
Alibi	Alibi
Schlössern	Schlössern
unterforderten	unterforderten
Affenbrotbäumen	Affenbrotbäumen
Kraftfahrzeugen	Kraftfahrzeugen
Tollkirschen	Tollkirschen
verselbständigst	verselbständigst
Stätte	Stätte
entwaffneten	entwaffneten
initiierten	initiierten
verschlimmere	verschlimmere
verfanget	verfanget
ersparet	ersparet
Dieben	Dieben
Einbrecher	Einbrecher
produziert	produziert
Gesetzen	Gesetzen
klöne	klöne
mästet	mästet
bombardiertet	bombardiertet
stickten	stickten
Äxten	Äxten
rebelliertet	rebelliertet
versklavte	versklavte
geleiteten	geleiteten
schäumt	schäumt
Rutheniumisotop	Rutheniumisotop
anrichte	anrichte
lehnen	lehnen
schauten	schauten
fastete	fastete
initiieret	initiieret
Sanatoriums	Sanatoriums
lobe	lobe
unterschiede	unterschiede
Laib	Laib
Dochten	Dochten
reife	reife
erlassen	erlassen
ertraget	ertraget
Rückumschlages	Rückumschlages
Weste	Weste
laut	laut
Werke	Werke
Mischung	Mischung
spielet	spielet
freuet	freuet
Polierstahl	Polierstahl
kreierten	kreierten
Otavit	Otavit
entheiligten	entheiligten
ratschlagen	ratschlagen
Konfitüre	Konfitüre
Prozedur	Prozedur
Wolfesgrube	Wolfesgrube
elften	elften
regen	regen
infiziertet	infiziertet
Magier	Magier
mopst	mopst
sündigst	sündigst
Ausbeuterei	Ausbeuterei
Ludwigsburger	Ludwigsburger
linke	linke
Kirgisinnen	Kirgisinnen
Prostyloi	Prostyloi
Tintenklecksen	Tintenklecksen
Bajonetten	Bajonetten
Treibhausgasen	Treibhausgasen
konnte	konnte
krähte	krähte
beliefen	beliefen
plärrt	plärrt
zentrifugierst	zentrifugierst
Tausch	Tausch
Malaysiers	Malaysiers
verpuffe	verpuffe
Kürass	Kürass
Hornunges	Hornunges
werten	werten
Rechnung	Rechnung
erkälteten	erkälteten
föhnest	föhnest
erfreute	erfreute
Grüßet	Grüßet
Affenbrotbaum	Affenbrotbaum
vermischen	vermischen
erkalten	erkalten
Pfandgeld	Pfandgeld
predigte	predigte
reichte	reichte
Zeitplan	Zeitplan
reimte	reimte
Laubbaum	Laubbaum
vermöge	vermöge
Füllen	Füllen
ladest	ladest
Vergrößerungen	Vergrößerungen
Kohlenstoffgehalten	Kohlenstoffgehalten
reizt	reizt
Märkten	Märkten
Abtrünnigen	Abtrünnigen
labe	labe
nagelest	nagelest
Festen	Festen
frohlockte	frohlockte
lehrest	lehrest
Gegenleistungen	Gegenleistungen
Rotscheitelreiher	Rotscheitelreiher
Schwestern	Schwestern
stäupen	stäupen
Kontraindikation	Kontraindikation
Warte	Warte
schleiß	schleiß
Molybdite	Molybdite
seinen	seinen
privatisiert	privatisiert
Apportierhund	Apportierhund
diskutierst	diskutierst
bewiese	bewiese
Raucherin	Raucherin
Betainen	Betainen
gönnest	gönnest
Rauten	Rauten
deren	deren
heile	heile
ritzten	ritzten
sündigte	sündigte
prangte	prangte
oxidierst	oxidierst
Schwänze	Schwänze
Regenten	Regenten
Satzung	Satzung
Sinnen	Sinnen
schäumtest	schäumtest
kosten	kosten
vertrauten	vertrauten
Meinen	Meinen
bestimmst	bestimmst
Drohkulissen	Drohkulissen
Leuchtstoffen	Leuchtstoffen
Konzentrat	Konzentrat
gestalten	gestalten
Omnibus	Omnibus
Anzeichens	Anzeichens
schabst	schabst
Schanktischen	Schanktischen
zerrisset	zerrisset
steigerten	steigerten
bewähret	bewähret
lebet	lebet
jappte	jappte
Politologen	Politologen
Sagte	Sagte
hurst	hurst
wachte	wachte
zeugte	zeugte
kichert	kichert
flambierest	flambierest
Weichlote	Weichlote
übrigbleibet	übrigbleibet
Pumpellyiten	Pumpellyiten
Zahnfleischentzündungen	Zahnfleischentzündungen
kautest	kautest
Nährmediums	Nährmediums
Schwester	Schwester
ungehorsame	ungehorsame
Führet	Führet
Unserer	Unserer
Gehörst	Gehörst
webte	webte
Sonderbericht	Sonderbericht
warne	warne
Provinzen	Provinzen
könnte	könnte
Gegebenheiten	Gegebenheiten
Gewürzen	Gewürzen
besorgest	besorgest
Hornung	Hornung
Elastomer	Elastomer
Ausgangssperren	Ausgangssperren
spezialisiere	spezialisiere
Zinkionen	Zinkionen
teilte	teilte
unsere	unsere
begehret	begehret
Linie	Linie
verbraucht	verbraucht
lehnte	lehnte
Dominicanerin	Dominicanerin
plissiere	plissiere
Feldzug	Feldzug
wegführe	wegführe
Hobbys	Hobbys
Polizeisprechern	Polizeisprechern
rächte	rächte
speisend	speisend
nötigte	nötigte
kupieren	kupieren
deckte	deckte
außer	außer
dingten	dingten
instrumentalisierest	instrumentalisierest
überlieferten	überlieferten
verbrauchten	verbrauchten
schnitten	schnitten
bestellt	bestellt
Herabsetzungen	Herabsetzungen
verbündet	verbündet
wechseln	wechseln
idealisierten	idealisierten
murmelten	murmelten
Woge	Woge
Sippe	Sippe
Fiebermittel	Fiebermittel
Dorsche	Dorsche
Notstand	Notstand
schaust	schaust
koordinieret	koordinieret
Zeugnissen	Zeugnissen
einführen	einführen
Frommen	Frommen
Anfechtungen	Anfechtungen
Reiterschwertern	Reiterschwertern
entkäme	entkäme
leiste	leiste
Ihre	Ihre
schauen	schauen
Schwan	Schwan
Nanosatelliten	Nanosatelliten
zirpe	zirpe
Adventskalender	Adventskalender
frevle	frevle
Weichseln	Weichseln
langweilst	langweilst
rühmte	rühmte
segmentierten	segmentierten
beziehen	beziehen
lösten	lösten
mehr	mehr
Gefilden	Gefilden
Ausstiegstüren	Ausstiegstüren
duzet	duzet
kaufte	kaufte
grünen	grünen
Brite	Brite
genieret	genieret
weinte	weinte
zentrifugieren	zentrifugieren
kitzeln	kitzeln
Vanadaten	Vanadaten
Baisers	Baisers
defragmentierest	defragmentierest
Recitativen	Recitativen
verwahret	verwahret
Linien	Linien
träge	träge
Lammfellhandschuhen	Lammfellhandschuhen
Frösche	Frösche
ausgereckter	ausgereckter
Playlist	Playlist
betrübst	betrübst
liehe	liehe
Kerzenlichtern	Kerzenlichtern
gehorchest	gehorchest
Trinkgefäße	Trinkgefäße
eurem	eurem
unterwerfest	unterwerfest
fabuliere	fabuliere
Prozeduren	Prozeduren
Gepäckträgern	Gepäckträgern
Verwundeten	Verwundeten
Domänen	Domänen
klagen	klagen
Zeitschlitzen	Zeitschlitzen
wärmet	wärmet
Erste	Erste
Schamentzündung	Schamentzündung
amputiere	amputiere
bestellten	bestellten
fern	fern
Uranerz	Uranerz
Halter	Halter
machest	machest
annektierten	annektierten
heilige	heilige
Rücktrittes	Rücktrittes
konstatiere	konstatiere
Hirnstämmen	Hirnstämmen
plagest	plagest
Apportierhunde	Apportierhunde
neige	neige
Theistin	Theistin
Kernladungszahl	Kernladungszahl
werdet	werdet
Wirtschaftswissenschaft	Wirtschaftswissenschaft
Halbzeiten	Halbzeiten
gelangen	gelangen
konsumieren	konsumieren
Sekte	Sekte
Abfertigungsschalters	Abfertigungsschalters
Leiden	Leiden
feiertest	feiertest
wallfahrteten	wallfahrteten
salz	salz
Gymnasien	Gymnasien
führst	führst
unterschieden	unterschieden
vorn	vorn
Augenglases	Augenglases
Teufeln	Teufeln
abziehen	abziehen
versuche	versuche
lehrte	lehrte
Buchhalterin	Buchhalterin
Animation	Animation
erniedrigst	erniedrigst
Wahnen	Wahnen
hilfst	hilfst
aufkommt	aufkommt
widmend	widmend
steig	steig
Sabotagen	Sabotagen
ramme	ramme
scheltet	scheltet
kapiert	kapiert
Rhabarbern	Rhabarbern
Fetten	Fetten
Wissen	Wissen
Plüschtiere	Plüschtiere
Gasflasche	Gasflasche
partitionierten	partitionierten
rebellieret	rebellieret
bereiten	bereiten
vermahnet	vermahnet
Schwächungen	Schwächungen
instanziier	instanziier
Tiefschutz	Tiefschutz
tobend	tobend
deckst	deckst
begnügt	begnügt
Dorngesträuchen	Dorngesträuchen
ehrest	ehrest
esset	esset
fallest	fallest
bemächtigest	bemächtigest
Epidemien	Epidemien
vertonet	vertonet
hinterfragst	hinterfragst
Weh	Weh
Brettspielen	Brettspielen
auflöst	auflöst
malt	malt
wollt	wollt
attestierten	attestierten
dringt	dringt
Mein	Mein
beansprucht	beansprucht
merke	merke
erschütterte	erschütterte
Anschläge	Anschläge
knutschest	knutschest
gedenkest	gedenkest
rühmst	rühmst
blende	blende
verführe	verführe
Impedanz	Impedanz
schläft	schläft
versagt	versagt
Staatsanleihe	Staatsanleihe
gelobst	gelobst
bedürft	bedürft
blondiert	blondiert
vernickelte	vernickelte
Primärenergien	Primärenergien
Eistaucher	Eistaucher
Trickbetrüger	Trickbetrüger
offenbart	offenbart
Füllfederhalter	Füllfederhalter
Laufringe	Laufringe
narren	narren
Erstarren	Erstarren
Ebene	Ebene
Tetraiodiden	Tetraiodiden
nähte	nähte
flupptest	flupptest
bringet	bringet
durften	durften
verzeichnete	verzeichnete
Pentaborat	Pentaborat
Hirte	Hirte
strecken	strecken
Schafen	Schafen
rühmet	rühmet
nötige	nötige
Einzelgänger	Einzelgänger
dunkelten	dunkelten
heiße	heiße
schwebe	schwebe
Tannen	Tannen
werden	werden
heiligem	heiligem
beißet	beißet
verkriechet	verkriechet
wechselwirkte	wechselwirkte
schenken	schenken
Akkadierinnen	Akkadierinnen
Zeitbomben	Zeitbomben
Heiden	Heiden
strafte	strafte
Zwergschwan	Zwergschwan
verzehre	verzehre
ermordetet	ermordetet
Peptids	Peptids
knackt	knackt
rangieret	rangieret
Ochs	Ochs
Briefwechsel	Briefwechsel
emailliert	emailliert
schau	schau
stimmen	stimmen
griff	griff
rekrutierest	rekrutierest
dringst	dringst
Kadavergehorsam	Kadavergehorsam
vergiften	vergiften
zürnest	zürnest
verunglimpfen	verunglimpfen
inszeniere	inszeniere
schreist	schreist
suchte	suchte
dramatisieren	dramatisieren
eskalieret	eskalieret
befehlen	befehlen
wir	wir
driftete	driftete
erlabe	erlabe
fälle	fälle
bewahret	bewahret
kommest	kommest
gehetzt	gehetzt
umkämen	umkämen
Sichelzellenanämien	Sichelzellenanämien
Nadel	Nadel
erpress	erpress
erwärmst	erwärmst
eigenen	eigenen
ungeistlichen	ungeistlichen
Cholesterin	Cholesterin
Begrenzungen	Begrenzungen
verspielte	verspielte
Maß	Maß
Blattgewebe	Blattgewebe
Fiesling	Fiesling
Stechpalmen	Stechpalmen
besetzen	besetzen
Arbeitsleistung	Arbeitsleistung
Einfältigkeiten	Einfältigkeiten
Dezernaten	Dezernaten
Weinet	Weinet
betrübest	betrübest
Bienenstock	Bienenstock
desertierst	desertierst
austilge	austilge
Verwaltungsakte	Verwaltungsakte
Abartigkeit	Abartigkeit
Werkzeugen	Werkzeugen
Überschüsse	Überschüsse
bollerte	bollerte
Laie	Laie
Traubenlesen	Traubenlesen
baue	baue
orgelt	orgelt
spukest	spukest
duzen	duzen
Weile	Weile
sedimentiere	sedimentiere
weinst	weinst
Hörst	Hörst
Kirchhof	Kirchhof
Abbild	Abbild
vermutest	vermutest
Bächen	Bächen
überweis	überweis
bewiest	bewiest
kritzele	kritzele
referenzierst	referenzierst
Reisebüros	Reisebüros
fritierten	fritierten
verrostet	verrostet
andere	andere
verdeckst	verdeckst
Fortsetzungen	Fortsetzungen
füllte	füllte
assimilierte	assimilierte
arbeit	arbeit
bekotete	bekotete
Temperaturanstieg	Temperaturanstieg
Kirgisin	Kirgisin
bewässern	bewässern
Kurkuma	Kurkuma
Feuerteufel	Feuerteufel
verknüpfet	verknüpfet
eiterte	eiterte
Sigle	Sigle
laden	laden
Bande	Bande
schließen	schließen
erweckst	erweckst
überweist	überweist
Auge	Auge
Ente	Ente
schmusen	schmusen
verachtend	verachtend
mästest	mästest
Reißnagel	Reißnagel
Büstenhaltern	Büstenhaltern
Katz-und-Maus-Spiele	Katz-und-Maus-Spiele
geherrscht	geherrscht
Fokus	Fokus
leerst	leerst
ausgerecktem	ausgerecktem
Tübingern	Tübingern
glühende	glühende
Gehilfen	Gehilfen
Kannst	Kannst
Uteri	Uteri
meißelt	meißelt
Taufen	Taufen
Fahrt	Fahrt
Metallothioneinen	Metallothioneinen
Bildschirmfotos	Bildschirmfotos
fällen	fällen
Fluorkohlenwasserstoff	Fluorkohlenwasserstoff
mobilisierten	mobilisierten
verwiesen	verwiesen
verbitterest	verbitterest
bröckeln	bröckeln
brandeten	brandeten
Wachet	Wachet
eingehst	eingehst
Gründungsprivilegien	Gründungsprivilegien
zeltest	zeltest
Aderhäuten	Aderhäuten
Leset	Leset
umarbeitest	umarbeitest
emendierte	emendierte
frappiere	frappiere
quatschen	quatschen
macht	macht
stammelest	stammelest
befehlt	befehlt
Kissenschlacht	Kissenschlacht
Dudelsäcken	Dudelsäcken
Exilanten	Exilanten
gewinne	gewinne
Rehe	Rehe
fällt	fällt
träumte	träumte
sich	sich
bedurftest	bedurftest
pflücke	pflücke
Konifere	Konifere
Steuerwagen	Steuerwagen
rufst	rufst
Einöden	Einöden
Dank	Dank
reagierte	reagierte
schwenkt	schwenkt
unterscheide	unterscheide
dichten	dichten
Autoklaven	Autoklaven
Geldautomaten	Geldautomaten
nähre	nähre
Fragen	Fragen
zeuge	zeuge
endlagern	endlagern
kehrst	kehrst
Same	Same
gehorchte	gehorchte
lärmte	lärmte
enträtselten	enträtselten
löste	löste
Meinem	Meinem
zerfielen	zerfielen
wachset	wachset
predigtest	predigtest
knutschst	knutschst
illustriere	illustriere
idealisieret	idealisieret
Vordenkern	Vordenkern
Decken	Decken
Maultier	Maultier
entschädiget	entschädiget
rufe	rufe
Äquatoren	Äquatoren
Dewargefäß	Dewargefäß
mobilisieret	mobilisieret
Kronsbeere	Kronsbeere
Galeeren	Galeeren
Adelungen	Adelungen
griechisch	griechisch
Essigsäurechlorid	Essigsäurechlorid
deklarierte	deklarierte
Gram	Gram
lausche	lausche
zwölfte	zwölfte
Ichs	Ichs
Händedrücken	Händedrücken
geboten	geboten
Entsetzen	Entsetzen
unterbrächen	unterbrächen
Denen	Denen
stolze	stolze
sagtest	sagtest
Marjellchens	Marjellchens
wache	wache
Schnipseln	Schnipseln
Grab	Grab
beweist	beweist
welchen	welchen
Wer	Wer
Stiefvätern	Stiefvätern
inspirierten	inspirierten
Gehirnwelle	Gehirnwelle
Schnittlauch	Schnittlauch
verblute	verblute
auszieht	auszieht
Märchenbüchern	Märchenbüchern
Mop	Mop
Efeu	Efeu
Portale	Portale
Gästen	Gästen
bräunen	bräunen
beide	beide
hegt	hegt
harmonierest	harmonierest
verschont	verschont
benähmen	benähmen
Trinkgefäßen	Trinkgefäßen
Leiste	Leiste
blast	blast
folgend	folgend
Zirkelschlüssen	Zirkelschlüssen
instanziiere	instanziiere
decke	decke
lüftetet	lüftetet
Aufträgen	Aufträgen
Buche	Buche
Sorgen	Sorgen
Alterität	Alterität
Halbzeit	Halbzeit
behauptest	behauptest
Kandidaturen	Kandidaturen
bewahrheitete	bewahrheitete
stiftest	stiftest
beißt	beißt
trägt	trägt
gedurft	gedurft
füsilierte	füsilierte
herrschen	herrschen
Abfertigungsgebäude	Abfertigungsgebäude
Linguist	Linguist
gründe	gründe
Quellfluss	Quellfluss
Trübsale	Trübsale
widerrufe	widerrufe
gehörte	gehörte
verfliegest	verfliegest
Pfründe	Pfründe
rufen	rufen
grüble	grüble
streite	streite
generiertet	generiertet
fotzte	fotzte
überdenkend	überdenkend
erkaltest	erkaltest
Höret	Höret
zürn	zürn
Kopfverletzungen	Kopfverletzungen
Zwingburg	Zwingburg
Spitzen	Spitzen
verkapselten	verkapselten
Druckfehler	Druckfehler
stigmatisierst	stigmatisierst
funktionalisierte	funktionalisierte
dringen	dringen
Gebäck	Gebäck
ringst	ringst
Antimustern	Antimustern
besinnen	besinnen
Ambiguitäten	Ambiguitäten
zuppen	zuppen
Grenze	Grenze
Alles	Alles
hantiert	hantiert
Referenz	Referenz
messen	messen
verstecktet	verstecktet
vertilgten	vertilgten
reifen	reifen
Astats	Astats
liebe	liebe
Kaktusfeige	Kaktusfeige
flitzte	flitzte
Held	Held
räumet	räumet
bekriegt	bekriegt
Milzen	Milzen
evakuierte	evakuierte
deponierte	deponierte
schämte	schämte
segeln	segeln
sponseret	sponseret
vermutet	vermutet
grabbelten	grabbelten
gewärtigten	gewärtigten
Antitranspirante	Antitranspirante
Mäusespeck	Mäusespeck
wünschst	wünschst
rännen	rännen
verurteile	verurteile
Zankapfels	Zankapfels
Schätzen	Schätzen
zerrüttet	zerrüttet
Gläubiger	Gläubiger
Fellachin	Fellachin
drescht	drescht
teile	teile
Däumlingen	Däumlingen
Werkzeuge	Werkzeuge
schreie	schreie
Aktienkurs	Aktienkurs
plazierest	plazierest
wegen	wegen
grüßest	grüßest
vergast	vergast
leid	leid
Leid	Leid
Zähne	Zähne
Ruß	Ruß
Recht	Recht
anhanget	anhanget
schaffet	schaffet
linsten	linsten
beleuchte	beleuchte
sterilisierten	sterilisierten
Grießen	Grießen
verfügten	verfügten
Drachenblut	Drachenblut
Katz-und-Maus-Spielen	Katz-und-Maus-Spielen
betrübtet	betrübtet
Büschen	Büschen
karikieret	karikieret
Dattel	Dattel
meuternd	meuternd
betrübt	betrübt
Putschisten	Putschisten
späht	späht
Seetauchers	Seetauchers
Palästen	Palästen
verzieh	verzieh
tut	tut
folge	folge
loben	loben
Kernspaltungen	Kernspaltungen
erweckest	erweckest
mangeln	mangeln
Beinen	Beinen
Philerast	Philerast
Landwirt	Landwirt
stärke	stärke
Knüppels	Knüppels
unehret	unehret
gratuliere	gratuliere
Pardelkatze	Pardelkatze
Schuldner	Schuldner
charakterisiert	charakterisiert
anzögen	anzögen
Drillingen	Drillingen
reizet	reizet
Ionenaustauscher	Ionenaustauscher
Sportlerin	Sportlerin
reif	reif
hängte	hängte
lachte	lachte
Malaysierinnen	Malaysierinnen
Atommodellen	Atommodellen
streckst	streckst
Molybdit	Molybdit
fließen	fließen
ermordetest	ermordetest
Wirte	Wirte
versteckten	versteckten
ernteten	ernteten
flambierten	flambierten
drückte	drückte
bewürben	bewürben
Kupferkiese	Kupferkiese
Arbeitsbereich	Arbeitsbereich
Küsserei	Küsserei
Wiederauferstehungen	Wiederauferstehungen
Trinker	Trinker
Grieche	Grieche
frevles	frevles
behaltest	behaltest
unterbewertete	unterbewertete
verringert	verringert
anfinge	anfinge
sortierest	sortierest
alles	alles
Tische	Tische
eigene	eigene
Silbersulfidbelag	Silbersulfidbelag
erhebet	erhebet
Aggressor	Aggressor
jenen	jenen
lostet	lostet
Ängsten	Ängsten
Innenschau	Innenschau
Freitagnachmittage	Freitagnachmittage
sponsert	sponsert
Kuckucken	Kuckucken
Buben	Buben
fromme	fromme
Wasserquellen	Wasserquellen
Epiker	Epiker
Stempeluhren	Stempeluhren
stiege	stiege
Kommoden	Kommoden
begründest	begründest
versklavt	versklavt
erkannten	erkannten
Zeitüberschreitung	Zeitüberschreitung
Generation	Generation
motivieren	motivieren
ungehorsam	ungehorsam
tyrannisierte	tyrannisierte
beherrscht	beherrscht
bereuest	bereuest
gewitterest	gewitterest
Isobar	Isobar
Eingaben	Eingaben
bücktest	bücktest
umarmen	umarmen
Azubi	Azubi
Lümmeltüten	Lümmeltüten
Trichter	Trichter
vermöget	vermöget
verfehlten	verfehlten
auszöge	auszöge
schützt	schützt
prosteten	prosteten
pflegte	pflegte
backt	backt
sollte	sollte
schenket	schenket
gehet	gehet
hobt	hobt
Reisebüro	Reisebüro
Gespenst	Gespenst
entgegenkamen	entgegenkamen
massierend	massierend
protokollierst	protokollierst
Bertrandit	Bertrandit
Dienstgrade	Dienstgrade
bekennet	bekennet
Wegen	Wegen
verdrängt	verdrängt
wünschtest	wünschtest
velarisiert	velarisiert
trompetete	trompetete
Mopps	Mopps
Erzeugung	Erzeugung
versuchest	versuchest
Mageninhalten	Mageninhalten
Nukleinsäure	Nukleinsäure
Adeliepinguins	Adeliepinguins
Nanosatellit	Nanosatellit
Geschichtsbüchern	Geschichtsbüchern
stoße	stoße
Nahrungsbestandteil	Nahrungsbestandteil
bewahrst	bewahrst
Erfahrungen	Erfahrungen
Brüder	Brüder
verachte	verachte
Flaschenhälsen	Flaschenhälsen
Tatsachenbeschönigern	Tatsachenbeschönigern
Schläge	Schläge
dissentierte	dissentierte
Tetraiodide	Tetraiodide
liebten	liebten
ritze	ritze
Milchflasche	Milchflasche
strullerte	strullerte
zuhört	zuhört
fehlet	fehlet
Leichname	Leichname
schichteten	schichteten
bemühten	bemühten
nachwandelst	nachwandelst
essen	essen
Bleiglanz	Bleiglanz
Pausbacke	Pausbacke
keine	keine
mühe	mühe
verkaufst	verkaufst
Übertretung	Übertretung
Sexten	Sexten
leide	leide
trinkst	trinkst
Elf	Elf
manövrieret	manövrieret
Willst	Willst
Fische	Fische
naschten	naschten
kollidierte	kollidierte
Hehlern	Hehlern
sahet	sahet
regiert	regiert
Friede	Friede
Trockendock	Trockendock
Technikerinnen	Technikerinnen
härtet	härtet
verkauft	verkauft
verkleinerest	verkleinerest
Karikaturistinnen	Karikaturistinnen
Fellachinnen	Fellachinnen
Gasgemischen	Gasgemischen
Reinstoff	Reinstoff
Küchenmaschine	Küchenmaschine
Zur-Schau-Stellen	Zur-Schau-Stellen
surrst	surrst
beichten	beichten
denaturieret	denaturieret
flense	flense
trauerten	trauerten
haust	haust
Kürasse	Kürasse
Halbmond	Halbmond
erwürgtest	erwürgtest
Adenosin	Adenosin
Spektroskopie	Spektroskopie
Otaviten	Otaviten
wogen	wogen
Kerls	Kerls
Gehorchet	Gehorchet
Bären	Bären
babbeltet	babbeltet
Hallelujas	Hallelujas
Harpunen	Harpunen
malträtiert	malträtiert
Schafe	Schafe
halbe	halbe
predigend	predigend
Beten	Beten
enttäusche	enttäusche
reichet	reichet
Schatten	Schatten
Angabe	Angabe
Krankenschein	Krankenschein
Klotzes	Klotzes
Notärztinnen	Notärztinnen
streiften	streiften
härten	härten
Stätten	Stätten
Heere	Heere
überschattet	überschattet
Wehklagen	Wehklagen
Wehret	Wehret
schmeicheln	schmeicheln
Kairiner	Kairiner
heißet	heißet
nähret	nähret
wende	wende
Kaffeelöffel	Kaffeelöffel
keulte	keulte
leider	leider
erlöse	erlöse
blitzte	blitzte
bedrücktest	bedrücktest
er	er
gleich	gleich
eurer	eurer
endlagerten	endlagerten
Steine	Steine
Gibt	Gibt
dingt	dingt
föhnten	föhnten
Mähnenwolfes	Mähnenwolfes
Literaturen	Literaturen
Zöpfe	Zöpfe
fahret	fahret
Carbiden	Carbiden
Lümmeltüte	Lümmeltüte
Dolde	Dolde
Gebote	Gebote
Steuerberatern	Steuerberatern
zeuget	zeuget
unterdrücke	unterdrücke
Schenken	Schenken
Metallothionein	Metallothionein
scheuchen	scheuchen
sehet	sehet
betreibet	betreibet
wild	wild
Schnitzeljagd	Schnitzeljagd
holet	holet
Märkte	Märkte
Negermusik	Negermusik
Blässe	Blässe
Taschendieb	Taschendieb
vertilge	vertilge
halbierest	halbierest
Unternehmung	Unternehmung
berühret	berühret
nagelte	nagelte
räucheret	räucheret
Düfte	Düfte
Bademäntel	Bademäntel
weine	weine
konvertiere	konvertiere
Höschen	Höschen
Kristallen	Kristallen
diente	diente
fehle	fehle
Polyphosphat	Polyphosphat
Wäre	Wäre
Ende	Ende
gewährtest	gewährtest
gehorchet	gehorchet
bitten	bitten
Ich	Ich
werde	werde
bemühet	bemühet
putzte	putzte
sedimentiertet	sedimentiertet
führen	führen
säet	säet
negierest	negierest
Dürren	Dürren
grause	grause
eskaliert	eskaliert
Tischen	Tischen
emaillieret	emaillieret
recycelten	recycelten
preise	preise
Wüste	Wüste
klappen	klappen
reichtest	reichtest
Schönredner	Schönredner
Aerosolen	Aerosolen
gebündelt	gebündelt
weichest	weichest
Dödeln	Dödeln
harren	harren
zirpen	zirpen
alarmieren	alarmieren
strafen	strafen
Wunde	Wunde
hüpfest	hüpfest
tobte	tobte
verschickte	verschickte
Zeilen	Zeilen
lochtest	lochtest
hievten	hievten
verdammte	verdammte
Plüschtier	Plüschtier
Geliebten	Geliebten
Bleiglanzes	Bleiglanzes
egalisiertet	egalisiertet
Knöllchens	Knöllchens
referenzierte	referenzierte
substituierten	substituierten
anzeigte	anzeigte
hauen	hauen
wechselwirkt	wechselwirkt
Kriegsenden	Kriegsenden
Sterne	Sterne
Forschungen	Forschungen
bummelet	bummelet
Rooibos	Rooibos
Zapfhahn	Zapfhahn
überweise	überweise
tobet	tobet
Abartigkeiten	Abartigkeiten
Klotz	Klotz
hydrolysierend	hydrolysierend
verletzt	verletzt
beschwöre	beschwöre
verhören	verhören
Schreiben	Schreiben
Abhängen	Abhängen
knurrtet	knurrtet
liebtest	liebtest
Zeile	Zeile
beschuldiget	beschuldiget
stürzest	stürzest
hell	hell
Chelatkomplex	Chelatkomplex
Kernspaltung	Kernspaltung
Tukanen	Tukanen
beseht	beseht
Vorstädten	Vorstädten
Gehorsams	Gehorsams
wurdet	wurdet
Welteninseln	Welteninseln
Aase	Aase
Totenglocke	Totenglocke
amenagiere	amenagiere
Signal	Signal
hieltest	hieltest
Sprachräumen	Sprachräumen
Wehe	Wehe
interpretierten	interpretierten
jauchzt	jauchzt
Tyrann	Tyrann
Puffersystem	Puffersystem
Großstädter	Großstädter
Meinst	Meinst
gewähret	gewähret
Händen	Händen
sorge	sorge
schiesst	schiesst
jemanden	jemanden
Wühltischen	Wühltischen
Füllet	Füllet
schreiet	schreiet
reifst	reifst
hebet	hebet
schlaft	schlaft
verklärest	verklärest
Talisman	Talisman
verleumdete	verleumdete
Tritt	Tritt
arme	arme
Tut	Tut
vierten	vierten
fotzt	fotzt
Gichten	Gichten
aufheben	aufheben
ziehet	ziehet
ihren	ihren
verzieht	verzieht
Homodimere	Homodimere
suchten	suchten
werfet	werfet
Bärenfellen	Bärenfellen
Seile	Seile
sedimentiert	sedimentiert
traueret	traueret
deines	deines
ein	ein
Teppichen	Teppichen
kooperierte	kooperierte
Diagnostik	Diagnostik
befestigt	befestigt
duckmäuseret	duckmäuseret
auflegst	auflegst
belauere	belauere
aufwachte	aufwachte
Managementsystemen	Managementsystemen
Gleitzeiten	Gleitzeiten
Laien	Laien
emendieret	emendieret
Arbeitsbereichen	Arbeitsbereichen
brauchte	brauchte
lostest	lostest
überfischt	überfischt
Tun	Tun
Gitarrenspieler	Gitarrenspieler
grabble	grabble
jaulst	jaulst
Bleche	Bleche
fegte	fegte
Essigsäurechloriden	Essigsäurechloriden
Gehilfe	Gehilfe
einen	einen
Bund	Bund
babbelten	babbelten
wehrten	wehrten
hintertreiben	hintertreiben
Einrad	Einrad
Selbstversuch	Selbstversuch
Achatschnecken	Achatschnecken
Großstädtern	Großstädtern
wichsten	wichsten
wärt	wärt
zerbrechest	zerbrechest
zuteilte	zuteilte
zeugst	zeugst
mopsend	mopsend
zerstreuest	zerstreuest
Farbstoffe	Farbstoffe
Almanache	Almanache
untertretet	untertretet
aufstehet	aufstehet
Schickse	Schickse
zuppst	zuppst
Weinbergen	Weinbergen
Theologien	Theologien
Platte	Platte
fluppten	fluppten
entkörperlichte	entkörperlichte
umarbeiten	umarbeiten
Graphem	Graphem
erdacht	erdacht
Technetaten	Technetaten
Halte	Halte
Basiliken	Basiliken
verschränken	verschränken
bereits	bereits
ruhest	ruhest
grünet	grünet
Primatologen	Primatologen
ansehet	ansehet
Blaumeise	Blaumeise
behauptete	behauptete
Biene	Biene
erkennet	erkennet
Puffersystemen	Puffersystemen
privilegierst	privilegierst
Beziehung	Beziehung
bequemte	bequemte
ihr	ihr
Schreibtischtäter	Schreibtischtäter
Gebäcken	Gebäcken
vereinbaren	vereinbaren
Einen	Einen
Wiedergutmachungen	Wiedergutmachungen
hegten	hegten
eingeht	eingeht
ausgeht	ausgeht
Hehler	Hehler
reich	reich
verführtest	verführtest
hämmerte	hämmerte
zürntet	zürntet
Imperialismen	Imperialismen
zanket	zanket
Feste	Feste
genehmigt	genehmigt
Wembley-Toren	Wembley-Toren
Leichen	Leichen
wärst	wärst
entdeckst	entdeckst
Rosinenkuchenmodell	Rosinenkuchenmodell
unschuldigen	unschuldigen
Neuigkeit	Neuigkeit
wurde	wurde
heischten	heischten
Ektoplasmen	Ektoplasmen
Sauberfrauen	Sauberfrauen
verleumdetest	verleumdetest
käbbelnd	käbbelnd
Würfelspiel	Würfelspiel
hupen	hupen
WebHooks	WebHooks
Bushaltestellen	Bushaltestellen
Stierkämpfen	Stierkämpfen
überfallen	überfallen
bricht	bricht
Unterseite	Unterseite
klingest	klingest
begeben	begeben
vertreibe	vertreibe
blockiert	blockiert
dringest	dringest
habet	habet
Loparite	Loparite
verglühte	verglühte
gefügt	gefügt
lavierend	lavierend
beten	beten
regieret	regieret
schenkst	schenkst
unterbewerte	unterbewerte
Lebenskraft	Lebenskraft
heiligt	heiligt
drücke	drücke
Ahnen	Ahnen
weinest	weinest
narret	narret
fingieret	fingieret
Aspartamen	Aspartamen
ruckeln	ruckeln
Adamsapfel	Adamsapfel
analysiert	analysiert
zerreißt	zerreißt
Arsenolithen	Arsenolithen
besprachen	besprachen
werte	werte
aufhebt	aufhebt
Ställe	Ställe
heulte	heulte
raffiniere	raffiniere
erstehen	erstehen
Sexte	Sexte
pulsiert	pulsiert
posiertet	posiertet
Den	Den
fremde	fremde
mischst	mischst
bildest	bildest
verkriechst	verkriechst
Deinem	Deinem
flirtete	flirtete
gehören	gehören
falle	falle
Kanzlerinnen	Kanzlerinnen
Kriegsknechten	Kriegsknechten
boykottierst	boykottierst
impfte	impfte
Edelsteine	Edelsteine
schwängen	schwängen
besucht	besucht
verstehet	verstehet
frohlockest	frohlockest
Altbau	Altbau
widerstanden	widerstanden
verzweifelten	verzweifelten
Überschüssen	Überschüssen
Bettler	Bettler
niemand	niemand
Samarskit	Samarskit
wünschte	wünschte
abtrünnige	abtrünnige
erlasset	erlasset
kauern	kauern
lösest	lösest
knüpfet	knüpfet
schnitt	schnitt
moppet	moppet
Zain	Zain
helfet	helfet
Jungfernflug	Jungfernflug
schlachten	schlachten
Taube	Taube
Botokuden	Botokuden
Prüfberichten	Prüfberichten
liegst	liegst
Einheimischen	Einheimischen
beklagte	beklagte
Sabbatjahre	Sabbatjahre
kugelten	kugelten
Leuchtkäfern	Leuchtkäfern
verringertet	verringertet
Wärt	Wärt
verstörte	verstörte
Blaumeisen	Blaumeisen
fluche	fluche
frohlockten	frohlockten
glawbten	glawbten
Wehre	Wehre
Pudern	Pudern
sprüht	sprüht
fraget	fraget
Kardinal	Kardinal
bauten	bauten
Huren	Huren
Senkung	Senkung
Mittelaltermarkt	Mittelaltermarkt
schreiben	schreiben
Remis	Remis
Stall	Stall
Seehechte	Seehechte
ringelten	ringelten
Verwaltungsakten	Verwaltungsakten
Drohkulisse	Drohkulisse
Gegebenheit	Gegebenheit
verwirrte	verwirrte
Teekessel	Teekessel
erbringst	erbringst
erklingt	erklingt
Flöten	Flöten
durchzuckest	durchzuckest
Bedeutung	Bedeutung
Streiten	Streiten
Tausche	Tausche
Gemütes	Gemütes
Orgel	Orgel
zankte	zankte
Kontaktierungen	Kontaktierungen
Beschuldigung	Beschuldigung
Brote	Brote
offenbartest	offenbartest
Kerl	Kerl
begebet	begebet
rechte	rechte
surre	surre
hinterzögen	hinterzögen
trüb	trüb
Ochse	Ochse
Atombomben	Atombomben
substituierend	substituierend
behalte	behalte
Zwetschgen	Zwetschgen
innere	innere
Vogelscheuche	Vogelscheuche
nützt	nützt
Aufpralle	Aufpralle
wähnt	wähnt
eingehest	eingehest
zerbräche	zerbräche
Spurensicherung	Spurensicherung
Meter	Meter
grünt	grünt
verschränkest	verschränkest
gelost	gelost
Temperaturanstiege	Temperaturanstiege
aufnahmt	aufnahmt
urteilte	urteilte
teil	teil
pilgert	pilgert
flitzen	flitzen
aufkäme	aufkäme
ungeistlich	ungeistlich
kämmt	kämmt
Arbeitskreis	Arbeitskreis
regierest	regierest
kabelte	kabelte
Atemlüfte	Atemlüfte
schweiget	schweiget
Schnute	Schnute
begrabet	begrabet
dressierten	dressierten
entständen	entständen
kramen	kramen
spritzt	spritzt
allen	allen
hadertet	hadertet
Euphemismus	Euphemismus
sagen	sagen
standet	standet
aufkommen	aufkommen
rufet	rufet
liebte	liebte
Cyanat	Cyanat
begräbt	begräbt
Gemurmel	Gemurmel
Sabbatjahr	Sabbatjahr
Höhen	Höhen
Suffixen	Suffixen
Berge	Berge
Rinde	Rinde
Martyrologien	Martyrologien
Bilderstürmereien	Bilderstürmereien
Weinen	Weinen
ritt	ritt
Fischotter	Fischotter
Wunden	Wunden
konnotierst	konnotierst
hastete	hastete
Indianern	Indianern
strafet	strafet
Moren	Moren
Fäusten	Fäusten
Dessous	Dessous
Chronisten	Chronisten
ob	ob
Volkslehren	Volkslehren
vierte	vierte
bezahlt	bezahlt
folgst	folgst
Älteste	Älteste
Garben	Garben
Arbeitsgruppen	Arbeitsgruppen
Tintenfisch	Tintenfisch
griffe	griffe
regte	regte
feierte	feierte
dekoriere	dekoriere
drücken	drücken
klemmen	klemmen
reagiert	reagiert
entsündigen	entsündigen
ertragen	ertragen
beweiset	beweiset
braust	braust
panaschieren	panaschieren
brechet	brechet
Fahrzeugkatalysatoren	Fahrzeugkatalysatoren
bewahrt	bewahrt
stiften	stiften
steige	steige
hüten	hüten
mangelte	mangelte
brillieren	brillieren
Nadelbäumen	Nadelbäumen
Mutagen	Mutagen
Korrosionsschutzen	Korrosionsschutzen
Gebirgen	Gebirgen
Raben	Raben
Ach	Ach
trinkest	trinkest
Landstreichereien	Landstreichereien
wollte	wollte
Gemüt	Gemüt
scheucht	scheucht
keinem	keinem
solches	solches
verbärgen	verbärgen
schlage	schlage
Möbiusbändern	Möbiusbändern
ihnen	ihnen
Irrtumes	Irrtumes
anzöge	anzöge
inspirierest	inspirierest
Nadelbäume	Nadelbäume
Türklingel	Türklingel
respektiert	respektiert
streckte	streckte
ackerst	ackerst
Citrat	Citrat
quatschest	quatschest
gedächtet	gedächtet
Schalen	Schalen
Hadithe	Hadithe
parametrisierte	parametrisierte
parfümierst	parfümierst
Geschrei	Geschrei
verführte	verführte
schnürest	schnürest
Teekesseln	Teekesseln
schweigst	schweigst
strömt	strömt
malet	malet
Schlagern	Schlagern
Klassenzimmer	Klassenzimmer
Gefängnisse	Gefängnisse
interagiert	interagiert
Pis	Pis
erbaust	erbaust
absagen	absagen
Fingerspitze	Fingerspitze
Würzen	Würzen
zersetzet	zersetzet
Eisenkräutern	Eisenkräutern
ruckelst	ruckelst
Äther	Äther
imitiert	imitiert
unschuldige	unschuldige
Zapfen	Zapfen
lest	lest
Amnestie	Amnestie
Aerosole	Aerosole
desensibilisierten	desensibilisierten
Dilettanten	Dilettanten
baten	baten
überdächte	überdächte
verselbständigt	verselbständigt
könnt	könnt
reiftet	reiftet
rundest	rundest
Aprikose	Aprikose
tabuisiert	tabuisiert
Schote	Schote
Samstagnachmittagen	Samstagnachmittagen
Flossen	Flossen
besäet	besäet
Mageninhalt	Mageninhalt
Roben	Roben
Begünstigungen	Begünstigungen
aufrichtet	aufrichtet
Rehbock	Rehbock
gähnten	gähnten
versteckte	versteckte
musizierte	musizierte
verglühest	verglühest
Kleptokratien	Kleptokratien
replizieret	replizieret
Kraftfahrzeuges	Kraftfahrzeuges
Crescendos	Crescendos
erinnre	erinnre
Lehnen	Lehnen
Kapitalverkehr	Kapitalverkehr
aufhobt	aufhobt
rittest	rittest
verziehst	verziehst
Unsere	Unsere
Lenkstange	Lenkstange
Germanist	Germanist
Nachteilen	Nachteilen
wachse	wachse
anrichten	anrichten
Aktienkursen	Aktienkursen
ärgernd	ärgernd
Android	Android
entsetzten	entsetzten
Leichtmetalle	Leichtmetalle
anzeige	anzeige
revoltierte	revoltierte
läutetet	läutetet
fladerten	fladerten
Falltürme	Falltürme
Kassettenrekorder	Kassettenrekorder
gare	gare
hintertrieben	hintertrieben
koexistierten	koexistierten
begründetest	begründetest
Schreien	Schreien
Alkalien	Alkalien
produzierest	produzierest
fülle	fülle
Alltag	Alltag
Wahn	Wahn
verbündend	verbündend
flucht	flucht
Gefilde	Gefilde
fritiert	fritiert
gebietet	gebietet
Aha-Erlebnisse	Aha-Erlebnisse
speiste	speiste
foppst	foppst
losten	losten
Arsenite	Arsenite
Stadtbezirke	Stadtbezirke
extemporiere	extemporiere
Feiertagen	Feiertagen
Skorpionen	Skorpionen
Gesamtmenge	Gesamtmenge
steckst	steckst
faule	faule
ernten	ernten
gebet	gebet
Taschenwörterbuch	Taschenwörterbuch
brichst	brichst
Drang	Drang
kehrte	kehrte
Klassenzimmern	Klassenzimmern
Maße	Maße
Anspielungen	Anspielungen
porträtiert	porträtiert
fluppen	fluppen
Organistin	Organistin
bereitend	bereitend
ungefälschtem	ungefälschtem
erlösen	erlösen
höret	höret
Fadenlauf	Fadenlauf
betätigtet	betätigtet
Urbaren	Urbaren
Merkel-Rauten	Merkel-Rauten
bedrückest	bedrückest
begehrtest	begehrtest
klaget	klaget
zerstreuten	zerstreuten
Monarchien	Monarchien
Gefängnissen	Gefängnissen
überdenkst	überdenkst
Fiebermitteln	Fiebermitteln
Lehne	Lehne
Zitronensäften	Zitronensäften
raubte	raubte
rodete	rodete
Pedanten	Pedanten
eine	eine
verfange	verfange
besetzest	besetzest
Rechenbrettern	Rechenbrettern
Rundbriefen	Rundbriefen
deinem	deinem
Pfunden	Pfunden
Wille	Wille
Seil	Seil
hicksest	hicksest
vertilgst	vertilgst
globalisier	globalisier
Noseanen	Noseanen
untertreten	untertreten
Bittersüß	Bittersüß
mineralisierten	mineralisierten
Rumänin	Rumänin
verkündet	verkündet
Hochsommer	Hochsommer
trage	trage
Arbeitsunfähigkeit	Arbeitsunfähigkeit
Anfechtung	Anfechtung
googelest	googelest
Tatsachenbeschöniger	Tatsachenbeschöniger
Assistentinnen	Assistentinnen
glaubend	glaubend
formirte	formirte
Schnarchralle	Schnarchralle
Firnisse	Firnisse
bescherten	bescherten
Arsenbergwerken	Arsenbergwerken
fluchet	fluchet
injizierest	injizierest
bejubelte	bejubelte
Raten	Raten
blättertet	blättertet
verdränget	verdränget
Chasaren	Chasaren
Wänden	Wänden
fügt	fügt
demütig	demütig
Heringe	Heringe
Hektare	Hektare
reden	reden
Kühen	Kühen
Gedränge	Gedränge
Ausbeuter	Ausbeuter
Hubschraubern	Hubschraubern
Stämmen	Stämmen
gebt	gebt
fluppt	fluppt
Orten	Orten
Finanzministerien	Finanzministerien
Strafräume	Strafräume
Füllfederhalters	Füllfederhalters
Bluff	Bluff
Inder	Inder
Bürzel	Bürzel
obfuskieren	obfuskieren
Teile	Teile
grübelte	grübelte
trinket	trinket
evakuieret	evakuieret
löstet	löstet
Mobilfunknetze	Mobilfunknetze
Cola	Cola
Abkürzungsverzeichnisse	Abkürzungsverzeichnisse
Subspezies	Subspezies
Beziehungen	Beziehungen
kurz	kurz
zweite	zweite
setzen	setzen
leset	leset
strafest	strafest
ansehen	ansehen
besitzet	besitzet
platz	platz
erst	erst
Hardwareentwicklerin	Hardwareentwicklerin
dienest	dienest
Seinen	Seinen
beeindrucket	beeindrucket
Höfen	Höfen
lautete	lautete
überführt	überführt
exmatrikuliertet	exmatrikuliertet
stärket	stärket
Deuterium	Deuterium
gesellt	gesellt
Fett	Fett
verfinstere	verfinstere
diversifiziert	diversifiziert
Rubinen	Rubinen
Aprikosen	Aprikosen
Radfahrer	Radfahrer
verkehrte	verkehrte
begrub	begrub
buddeln	buddeln
Rheumatismus	Rheumatismus
Gruftis	Gruftis
verzögerte	verzögerte
schneidet	schneidet
Durchbruches	Durchbruches
Reflexionen	Reflexionen
grünst	grünst
bollerest	bollerest
aase	aase
Pfleglingen	Pfleglingen
Herkunft	Herkunft
ausgereckten	ausgereckten
Fotosynthese	Fotosynthese
blamierest	blamierest
stand	stand
Ein	Ein
heiß	heiß
Abnahmen	Abnahmen
bündelten	bündelten
Schober	Schober
Kristalle	Kristalle
Gallanen	Gallanen
erbest	erbest
kauten	kauten
lockerst	lockerst
Busen	Busen
Spektralbereich	Spektralbereich
geratest	geratest
Maßen	Maßen
betrügen	betrügen
Möbelstoff	Möbelstoff
Abfahrtsliste	Abfahrtsliste
verzieret	verzieret
auszogen	auszogen
säst	säst
Würze	Würze
webet	webet
greife	greife
gelobt	gelobt
Numerus	Numerus
Hirnstämme	Hirnstämme
billigen	billigen
prophezeiet	prophezeiet
vermögen	vermögen
bezichtigt	bezichtigt
gedenke	gedenke
verantwortet	verantwortet
möge	möge
kurbelte	kurbelte
Spannt	Spannt
verfinstert	verfinstert
kritzelet	kritzelet
Ha	Ha
decken	decken
erscheinest	erscheinest
nippst	nippst
betrieben	betrieben
läutet	läutet
manche	manche
Gewichten	Gewichten
Höhle	Höhle
Gehör	Gehör
ummantelten	ummantelten
diversifiziere	diversifiziere
verbluten	verbluten
raffinier	raffinier
gaffest	gaffest
unsres	unsres
dekorieren	dekorieren
tastet	tastet
missverstände	missverstände
tragt	tragt
pressierten	pressierten
bewährt	bewährt
schnell	schnell
Haltepunkten	Haltepunkten
polymerisier	polymerisier
wechselte	wechselte
Wachtel	Wachtel
Gurten	Gurten
bespracht	bespracht
nachwandelt	nachwandelt
erzeigest	erzeigest
Jochen	Jochen
folterte	folterte
Großfürsten	Großfürsten
Rücktrittbremse	Rücktrittbremse
verzehrst	verzehrst
überwiese	überwiese
Habe	Habe
Sanatorien	Sanatorien
entsündigten	entsündigten
Bestecken	Bestecken
Streich	Streich
Wechselstuben	Wechselstuben
hättet	hättet
schenkte	schenkte
Steigen	Steigen
Rhodochrositen	Rhodochrositen
handhabest	handhabest
verspätete	verspätete
bündelet	bündelet
Adelung	Adelung
Dunkelkammern	Dunkelkammern
Hüfte	Hüfte
Speeren	Speeren
verkündigst	verkündigst
Rhodochrosite	Rhodochrosite
Knabe	Knabe
Halt	Halt
Heptamolybdat	Heptamolybdat
wähnet	wähnet
Streife	Streife
Montagmittagen	Montagmittagen
Ausländer	Ausländer
Rubine	Rubine
verweise	verweise
Jagdbomber	Jagdbomber
Lammfellhandschuhs	Lammfellhandschuhs
Emmer	Emmer
Trümmersprache	Trümmersprache
Scheißkerlen	Scheißkerlen
Schlägst	Schlägst
taufe	taufe
Unglauben	Unglauben
liebest	liebest
idealisierest	idealisierest
deaktiviere	deaktiviere
Pfeilen	Pfeilen
lieb	lieb
simulierst	simulierst
hineinbrächte	hineinbrächte
erinnerest	erinnerest
vermeßest	vermeßest
Sagen	Sagen
Berylle	Berylle
Marjellchen	Marjellchen
Erzherzogshüte	Erzherzogshüte
ausführe	ausführe
Sitzfleisch	Sitzfleisch
Jude	Jude
beäugst	beäugst
föchte	föchte
Wandergewerbe	Wandergewerbe
bewahrheitetet	bewahrheitetet
Setzt	Setzt
gehorchten	gehorchten
Anrufbeantworter	Anrufbeantworter
Telefonnummern	Telefonnummern
eggten	eggten
pustet	pustet
duschten	duschten
Stufen	Stufen
ehren	ehren
welche	welche
lockerte	lockerte
Brieftaubenzüchter	Brieftaubenzüchter
extemporieret	extemporieret
widerlegte	widerlegte
Schrei	Schrei
Fällen	Fällen
kochte	kochte
vergaste	vergaste
Rutheniumisotopen	Rutheniumisotopen
Heteroatom	Heteroatom
skypst	skypst
Abgaskatalysatoren	Abgaskatalysatoren
nahte	nahte
Ei	Ei
rufest	rufest
Würfen	Würfen
Seelöwe	Seelöwe
Abschiedsbrief	Abschiedsbrief
einerntest	einerntest
drangen	drangen
Steuerwagens	Steuerwagens
Gewinnungen	Gewinnungen
Sinne	Sinne
waren	waren
erziehst	erziehst
Wespen	Wespen
überprüfte	überprüfte
Schreiber	Schreiber
implodiere	implodiere
reinstitutionalisierten	reinstitutionalisierten
Bedenken	Bedenken
Retter	Retter
mißverstehet	mißverstehet
motivierten	motivierten
gelang	gelang
Pläsier	Pläsier
mehret	mehret
Strontiumamalgams	Strontiumamalgams
Patres	Patres
Melanteriten	Melanteriten
Gewicht	Gewicht
warte	warte
Dünungen	Dünungen
Langschwanzpinguinen	Langschwanzpinguinen
griffen	griffen
Geschichtsbücher	Geschichtsbücher
Hast	Hast
kugele	kugele
tragest	tragest
erfüllst	erfüllst
Blechen	Blechen
Kannen	Kannen
alle	alle
überstehend	überstehend
stärkte	stärkte
bracht	bracht
streute	streute
Lebenskräften	Lebenskräften
meinst	meinst
Ellen	Ellen
ärgerte	ärgerte
schlabberte	schlabberte
brechen	brechen
nachwandeln	nachwandeln
erlaube	erlaube
Füllfeder	Füllfeder
Gefangenen	Gefangenen
erwachend	erwachend
Funktionalität	Funktionalität
Toypudeln	Toypudeln
Abschirmungen	Abschirmungen
hasset	hasset
Donnerstagabenden	Donnerstagabenden
Shortcut	Shortcut
Introjektion	Introjektion
Ypecaharalle	Ypecaharalle
vermahnt	vermahnt
Verwundete	Verwundete
Juden	Juden
steckte	steckte
analysierest	analysierest
Dichten	Dichten
Minimierung	Minimierung
verschafft	verschafft
Bezeugungen	Bezeugungen
wehrend	wehrend
reinige	reinige
verdammten	verdammten
hegst	hegst
verhalte	verhalte
reichst	reichst
Muhme	Muhme
berücksichtiget	berücksichtiget
flirre	flirre
watet	watet
jeden	jeden
Linken	Linken
gedächten	gedächten
schwadronierten	schwadronierten
begebe	begebe
notlandet	notlandet
labert	labert
unterwirft	unterwirft
leuchtete	leuchtete
batest	batest
koordinierte	koordinierte
Anfängern	Anfängern
zersetzte	zersetzte
hatte	hatte
Abbindebeschleuniger	Abbindebeschleuniger
schmelzen	schmelzen
aufrichte	aufrichte
Erbse	Erbse
Wache	Wache
Welpen	Welpen
kategorisierst	kategorisierst
schnatternd	schnatternd
streiten	streiten
Hochhäusern	Hochhäusern
Jüngern	Jüngern
spannt	spannt
reichtet	reichtet
demoralisiere	demoralisiere
Beteiligte	Beteiligte
Stearat	Stearat
beauftragt	beauftragt
Boten	Boten
Male	Male
dirigiert	dirigiert
sollten	sollten
amenagierst	amenagierst
fluchte	fluchte
überreichen	überreichen
täuschte	täuschte
Rücktrittbremsen	Rücktrittbremsen
pflanzen	pflanzen
pressiere	pressiere
wehrtest	wehrtest
am	am
assimilieret	assimilieret
Effekt	Effekt
lochten	lochten
seit	seit
Rufen	Rufen
häuftet	häuftet
kramten	kramten
begehrst	begehrst
Aller	Aller
vandaliere	vandaliere
Messiassen	Messiassen
Samen	Samen
verführen	verführen
Anker	Anker
Wühltische	Wühltische
wären	wären
argumentierten	argumentierten
Somiten	Somiten
verdamm	verdamm
achten	achten
Ringe	Ringe
notlande	notlande
Erbsen	Erbsen
foppte	foppte
entsetzen	entsetzen
sitzt	sitzt
Brandbeschleuniger	Brandbeschleuniger
Zainen	Zainen
schöpfe	schöpfe
Nanotesla	Nanotesla
fragst	fragst
Bazziten	Bazziten
kauerten	kauerten
bleiben	bleiben
Wirst	Wirst
schnappt	schnappt
Fremdwörter	Fremdwörter
Hallen	Hallen
Taschenwörterbuches	Taschenwörterbuches
Orte	Orte
verzeichne	verzeichne
flöteten	flöteten
Maut	Maut
posierten	posierten
verdammend	verdammend
schaut	schaut
planschtest	planschtest
Cyclodextrinen	Cyclodextrinen
heftete	heftete
beteuerten	beteuerten
Sonnenfinsternissen	Sonnenfinsternissen
prediget	prediget
klappst	klappst
Spielen	Spielen
kappet	kappet
entwaffnest	entwaffnest
widmest	widmest
Hahnenkämme	Hahnenkämme
zeigst	zeigst
Nahrungsbestandteilen	Nahrungsbestandteilen
verwirrest	verwirrest
erwärmte	erwärmte
verdammen	verdammen
Anwendungsgebiete	Anwendungsgebiete
raubest	raubest
zappten	zappten
Brotkästen	Brotkästen
Andrologie	Andrologie
verschmelzen	verschmelzen
reformieren	reformieren
schwellen	schwellen
Thioacetalen	Thioacetalen
verlassen	verlassen
flieh	flieh
Störe	Störe
Reiterschwert	Reiterschwert
plaziert	plaziert
Radfahrern	Radfahrern
bilden	bilden
Blitzen	Blitzen
Für	Für
jappten	jappten
entgegenkamst	entgegenkamst
fette	fette
Arresten	Arresten
Rechte	Rechte
leben	leben
Einfältigkeit	Einfältigkeit
Gaschromatographie	Gaschromatographie
Satzungen	Satzungen
drillest	drillest
Charakteristikan	Charakteristikan
decket	decket
Robe	Robe
abweichest	abweichest
tagen	tagen
jedem	jedem
Knöllchen	Knöllchen
Kalifeldspate	Kalifeldspate
meldeten	meldeten
älteste	älteste
herrschet	herrschet
desensibilisierte	desensibilisierte
analysieret	analysieret
Fetzens	Fetzens
filzen	filzen
erstürmet	erstürmet
Thioester	Thioester
begnadigst	begnadigst
träumen	träumen
erfahret	erfahret
erkältete	erkältete
erpresst	erpresst
gräbst	gräbst
Tanne	Tanne
zupftet	zupftet
dirigieren	dirigieren
frohlocke	frohlocke
Aussätzige	Aussätzige
Nanoteslan	Nanoteslan
Spanne	Spanne
mogelest	mogelest
denaturierte	denaturierte
demütige	demütige
Serverzugriffe	Serverzugriffe
Saiblingen	Saiblingen
diesen	diesen
Seine	Seine
besänftigtest	besänftigtest
erhörest	erhörest
Elektrophil	Elektrophil
kommst	kommst
Gänge	Gänge
liege	liege
verunglimpfest	verunglimpfest
attestiertet	attestiertet
Fanatiker	Fanatiker
Geschäften	Geschäften
Minischwein	Minischwein
Schneepflug	Schneepflug
Sekten	Sekten
verstrahlten	verstrahlten
schonte	schonte
Saiblinge	Saiblinge
grienest	grienest
Räte	Räte
Holzquirl	Holzquirl
pflügen	pflügen
Halbgott	Halbgott
Ihr	Ihr
schwirret	schwirret
Riegel	Riegel
heißt	heißt
erhöhet	erhöhet
stützet	stützet
Gedächtnisse	Gedächtnisse
Herabsetzung	Herabsetzung
dienet	dienet
Maultiere	Maultiere
Prügelstrafen	Prügelstrafen
prangest	prangest
beneidete	beneidete
übte	übte
reichen	reichen
verzierten	verzierten
Schaffet	Schaffet
Städte	Städte
Pferden	Pferden
Mittelaltermarktes	Mittelaltermarktes
Schild	Schild
Adlerbussard	Adlerbussard
gelobten	gelobten
eher	eher
verantwortetest	verantwortetest
Schwänzchen	Schwänzchen
Buchstabe	Buchstabe
Galopps	Galopps
Eissteinen	Eissteinen
Haarverlusten	Haarverlusten
umarmet	umarmet
Ölspuren	Ölspuren
Diäresen	Diäresen
Kleinoden	Kleinoden
scheiterest	scheiterest
Glauben	Glauben
Dominicanerinnen	Dominicanerinnen
ausfuhren	ausfuhren
parliere	parliere
Reizen	Reizen
Gehorsam	Gehorsam
warntet	warntet
gedächte	gedächte
Totgeburten	Totgeburten
markiere	markiere
touchiere	touchiere
verklagst	verklagst
urteilen	urteilen
Mönche	Mönche
chloroformiere	chloroformiere
Linke	Linke
Lautschrift	Lautschrift
Deutung	Deutung
Tieren	Tieren
gebühren	gebühren
schaffest	schaffest
Königreiche	Königreiche
ertönst	ertönst
fassest	fassest
säusele	säusele
Germanisten	Germanisten
jagst	jagst
googelten	googelten
köderet	köderet
Adhäsionen	Adhäsionen
pflügest	pflügest
Vorhäute	Vorhäute
Flensern	Flensern
fragte	fragte
vermag	vermag
Metallspiegel	Metallspiegel
Tiere	Tiere
häufte	häufte
begrabt	begrabt
entmineralisierst	entmineralisierst
klönen	klönen
zerstreuet	zerstreuet
Beteiligten	Beteiligten
Fallet	Fallet
sehnte	sehnte
Nullpunkt	Nullpunkt
steiget	steiget
Zinkat	Zinkat
Haarverlust	Haarverlust
strafe	strafe
wehren	wehren
ringe	ringe
Suffix	Suffix
redete	redete
höbest	höbest
fasset	fasset
massakrierte	massakrierte
Säue	Säue
befehle	befehle
ungefälschter	ungefälschter
Werden	Werden
verstehst	verstehst
Katalanen	Katalanen
vertraget	vertraget
Lobe	Lobe
Kleinode	Kleinode
gedenket	gedenket
arrivieren	arrivieren
rächest	rächest
Strahlentierchens	Strahlentierchens
losen	losen
solcher	solcher
Psi	Psi
tanzen	tanzen
Fußmatte	Fußmatte
Druckfehlern	Druckfehlern
zerbricht	zerbricht
harrten	harrten
Bevölkerungsdichte	Bevölkerungsdichte
grüßend	grüßend
kein	kein
Abarten	Abarten
grünend	grünend
Verbindungsdrähten	Verbindungsdrähten
dramatisiert	dramatisiert
Trotzkist	Trotzkist
letzte	letzte
Deine	Deine
Blumenstrauß	Blumenstrauß
warnt	warnt
Erzeugungen	Erzeugungen
Äthern	Äthern
überlebest	überlebest
Sollst	Sollst
mikrominiaturisiere	mikrominiaturisiere
Rutheniumkomplex	Rutheniumkomplex
Ypecaharallen	Ypecaharallen
Schwermetallionen	Schwermetallionen
Lichte	Lichte
filteret	filteret
listeten	listeten
einführte	einführte
Neumonden	Neumonden
reanimierten	reanimierten
steigen	steigen
Lusitaners	Lusitaners
Flamme	Flamme
bräunst	bräunst
stoppten	stoppten
spaltete	spaltete
wischt	wischt
Tintenfische	Tintenfische
schwelle	schwelle
kappten	kappten
möget	möget
anfingst	anfingst
panaschieret	panaschieret
kranken	kranken
sagten	sagten
strullerst	strullerst
ausgereckt	ausgereckt
umbrächte	umbrächte
sprachen	sprachen
Drehtüren	Drehtüren
Möbiusbänder	Möbiusbänder
Löwe	Löwe
Steige	Steige
unserem	unserem
filzten	filzten
überweisend	überweisend
puste	puste
könnest	könnest
argumentierest	argumentierest
Silberdrähten	Silberdrähten
versuchten	versuchten
schubse	schubse
heiligten	heiligten
kehret	kehret
batet	batet
Anmeldern	Anmeldern
revoltiert	revoltiert
konsumiere	konsumiere
erfahrt	erfahrt
Zehnten	Zehnten
betrüge	betrüge
Reichweiten	Reichweiten
Kerfe	Kerfe
hintertreibt	hintertreibt
besuchen	besuchen
stationierten	stationierten
Propheten	Propheten
erlabet	erlabet
gehorcht	gehorcht
Buntspechten	Buntspechten
balkanisierte	balkanisierte
heißest	heißest
Trichtern	Trichtern
torpediert	torpediert
Telefonnummer	Telefonnummer
nimmt	nimmt
Beilen	Beilen
freiwillige	freiwillige
verkaufe	verkaufe
begehrtet	begehrtet
besorgend	besorgend
Recitativ	Recitativ
verkröchet	verkröchet
spurtest	spurtest
Eilande	Eilande
Genie	Genie
funktioniertest	funktioniertest
föchten	föchten
Finanzminister	Finanzminister
Schlager	Schlager
Strohhälmchen	Strohhälmchen
laben	laben
erniedrigt	erniedrigt
bestellte	bestellte
zeugt	zeugt
verklagt	verklagt
brandet	brandet
Pfarrerinnen	Pfarrerinnen
ausführt	ausführt
meinem	meinem
Kehre	Kehre
Untern	Untern
säte	säte
verwirkliche	verwirkliche
reglementiert	reglementiert
anzeigen	anzeigen
alarmiere	alarmiere
gleiche	gleiche
reicht	reicht
Normdatum	Normdatum
Bertrandite	Bertrandite
Trotzkisten	Trotzkisten
Spieße	Spieße
gezügelt	gezügelt
Gebern	Gebern
Fluoratomen	Fluoratomen
Scheck	Scheck
Märtyrern	Märtyrern
Premieren	Premieren
Organisation	Organisation
bestrafe	bestrafe
Gummibaumes	Gummibaumes
bequemest	bequemest
moppte	moppte
verbluteten	verbluteten
emigriert	emigriert
schlaf	schlaf
Pest	Pest
Fußmatten	Fußmatten
sehest	sehest
strömte	strömte
Diese	Diese
skypet	skypet
Pflicht	Pflicht
entsündigte	entsündigte
kaserniert	kaserniert
langte	langte
absagt	absagt
ummantle	ummantle
ach	ach
Assistentin	Assistentin
ratschlagt	ratschlagt
helle	helle
Macht	Macht
Gauner	Gauner
Trioxid	Trioxid
sterilisiert	sterilisiert
Einem	Einem
Bushaltestelle	Bushaltestelle
möchtest	möchtest
gespeist	gespeist
babbelt	babbelt
warnet	warnet
bedingten	bedingten
schätze	schätze
tatet	tatet
Gebeine	Gebeine
lackieren	lackieren
plärrtest	plärrtest
Buntwaschmittel	Buntwaschmittel
Ansteckers	Ansteckers
erhört	erhört
punktest	punktest
fistet	fistet
Taufe	Taufe
offenbar	offenbar
beschlügen	beschlügen
Eisstein	Eisstein
wallfahrten	wallfahrten
hebräische	hebräische
ärgere	ärgere
stehet	stehet
Anhang	Anhang
Sonnenfinsternis	Sonnenfinsternis
Untier	Untier
Schau	Schau
Metonymie	Metonymie
Klüften	Klüften
Wasserbades	Wasserbades
beförderet	beförderet
Öfchens	Öfchens
gehörst	gehörst
wehrte	wehrte
wirft	wirft
Abkömmlingen	Abkömmlingen
knitterte	knitterte
trieben	trieben
Ambiguität	Ambiguität
begrabest	begrabest
Ruße	Ruße
Kohlrübe	Kohlrübe
Übelkeit	Übelkeit
grübelten	grübelten
pflanze	pflanze
graben	graben
weisen	weisen
betonierte	betonierte
Muster	Muster
wiederholten	wiederholten
Malaysier	Malaysier
Abnahme	Abnahme
jungen	jungen
ernte	ernte
wässerten	wässerten
Lautschriften	Lautschriften
Haben	Haben
Ackerschachtelhalm	Ackerschachtelhalm
Wollt	Wollt
glaubst	glaubst
kremieren	kremieren
enttäuschet	enttäuschet
Dich	Dich
blase	blase
Ängste	Ängste
Atemgasen	Atemgasen
belohnte	belohnte
lehre	lehre
verderbet	verderbet
pensionierest	pensionierest
kühl	kühl
Hin	Hin
anzeigest	anzeigest
könnten	könnten
Traubenlese	Traubenlese
Premierministerinnen	Premierministerinnen
Membranen	Membranen
Fledermaus	Fledermaus
schneidend	schneidend
lispelten	lispelten
tappst	tappst
Gehorcht	Gehorcht
Vesper	Vesper
schaffen	schaffen
Radiergummis	Radiergummis
Flammen	Flammen
Zeitplanes	Zeitplanes
Sollte	Sollte
kram	kram
hassest	hassest
verselbstständigest	verselbstständigest
dingte	dingte
erkennest	erkennest
legend	legend
erwürgten	erwürgten
suchen	suchen
losest	losest
Brieföffners	Brieföffners
offenbare	offenbare
lebst	lebst
Renegat	Renegat
winkt	winkt
ärger	ärger
jaule	jaule
verblutete	verblutete
leertet	leertet
Fahret	Fahret
erstehst	erstehst
Altären	Altären
löse	löse
hänget	hänget
tanze	tanze
dotiere	dotiere
rüstete	rüstete
Gase	Gase
besitze	besitze
beider	beider
hängen	hängen
verkündigest	verkündigest
Trinket	Trinket
initiierst	initiierst
Lötzinn	Lötzinn
Keiner	Keiner
Nagellackentferner	Nagellackentferner
leite	leite
Schwärmereien	Schwärmereien
Stör	Stör
Selbstversuche	Selbstversuche
schiebest	schiebest
bröckelten	bröckelten
Zeitbombe	Zeitbombe
begnügte	begnügte
haderte	haderte
Röcke	Röcke
schaffe	schaffe
Aphasien	Aphasien
stillte	stillte
Silberdrahts	Silberdrahts
ringen	ringen
kollidierten	kollidierten
pflüget	pflüget
Rundbriefe	Rundbriefe
kräusle	kräusle
Füllfedern	Füllfedern
Herden	Herden
konstatiertest	konstatiertest
Ratet	Ratet
ahne	ahne
explodierst	explodierst
Grizzlybären	Grizzlybären
Referenzen	Referenzen
Banknoten	Banknoten
Meldezettel	Meldezettel
schmierte	schmierte
Acetat	Acetat
Vordenker	Vordenker
seht	seht
radierte	radierte
fingiere	fingiere
Schobern	Schobern
Schwebfliegen	Schwebfliegen
überquerst	überquerst
weichen	weichen
Halbmonden	Halbmonden
winke	winke
Adamsäpfeln	Adamsäpfeln
führe	führe
Keine	Keine
Worte	Worte
Adler	Adler
rauschen	rauschen
zentrierest	zentrierest
führet	führet
schwadroniert	schwadroniert
rede	rede
machst	machst
moppen	moppen
Palme	Palme
anrufen	anrufen
schwimmen	schwimmen
parkierst	parkierst
Somite	Somite
unterrichtet	unterrichtet
Pforten	Pforten
glänzten	glänzten
halben	halben
Grufti	Grufti
ölt	ölt
anrührt	anrührt
flötete	flötete
prophezeie	prophezeie
Stücken	Stücken
gehöre	gehöre
reifte	reifte
bündelest	bündelest
halte	halte
Monden	Monden
begehren	begehren
Fluorgehalt	Fluorgehalt
christianisiere	christianisiere
Kakaos	Kakaos
Schläfchen	Schläfchen
Chasar	Chasar
Elfen	Elfen
vereinigt	vereinigt
stoßet	stoßet
schäme	schäme
aufhoben	aufhoben
Ösophagospasmen	Ösophagospasmen
blamierte	blamierte
Katamaran	Katamaran
Halsabschneider	Halsabschneider
Kriege	Kriege
dampfst	dampfst
Kurkumen	Kurkumen
Sabbaten	Sabbaten
entrümpelst	entrümpelst
henken	henken
befestigten	befestigten
Dorsch	Dorsch
Raucherinnen	Raucherinnen
denn	denn
gewarnt	gewarnt
erbringen	erbringen
Barbareien	Barbareien
glaube	glaube
verseift	verseift
gelobte	gelobte
Kuckucke	Kuckucke
stellet	stellet
Kupferkiesen	Kupferkiesen
Enden	Enden
nahest	nahest
speisen	speisen
unterdrückte	unterdrückte
Anführern	Anführern
reizen	reizen
besprächen	besprächen
hinterlegt	hinterlegt
Gute	Gute
sitzen	sitzen
fertigte	fertigte
Selbstversuchen	Selbstversuchen
Pfeile	Pfeile
sezierst	sezierst
bemüht	bemüht
kommet	kommet
geschämt	geschämt
erfahrest	erfahrest
erben	erben
spekulieren	spekulieren
Atommassen	Atommassen
Rekursionen	Rekursionen
Haarshampoos	Haarshampoos
Krustentier	Krustentier
kramst	kramst
prostete	prostete
wurstelten	wurstelten
verlobt	verlobt
Monaten	Monaten
schmettern	schmettern
dankte	dankte
Braunralle	Braunralle
bedeckst	bedeckst
Wembley-Tore	Wembley-Tore
gründen	gründen
Solchen	Solchen
Tintenklecks	Tintenklecks
Verehrer	Verehrer
Wasserbädern	Wasserbädern
dürfest	dürfest
entwischten	entwischten
Kindergeldern	Kindergeldern
Bombardierung	Bombardierung
Generatoren	Generatoren
Schicksen	Schicksen
erdachten	erdachten
vernichtest	vernichtest
schautet	schautet
ehrst	ehrst
Basilisken	Basilisken
Eine	Eine
wegführen	wegführen
sabbere	sabbere
flehst	flehst
hingeht	hingeht
erhöhest	erhöhest
verunzierte	verunzierte
Jünglingen	Jünglingen
Bürzeln	Bürzeln
drängest	drängest
regiere	regiere
Sorge	Sorge
schmeichelest	schmeichelest
Zwetschge	Zwetschge
betrübet	betrübet
Unter	Unter
anhangen	anhangen
Kühe	Kühe
keinen	keinen
Herrn	Herrn
erhebest	erhebest
verzeigt	verzeigt
sehnet	sehnet
rekrutiere	rekrutiere
stoßt	stoßt
gezählt	gezählt
heiligest	heiligest
Mönchen	Mönchen
Agoraphobie	Agoraphobie
Pedant	Pedant
begäben	begäben
Sauberfrau	Sauberfrau
stirbst	stirbst
dehydrierte	dehydrierte
gibst	gibst
lachet	lachet
Automatikgetrieben	Automatikgetrieben
verbot	verbot
Enthärtungen	Enthärtungen
Ionen	Ionen
Anlass	Anlass
eines	eines
forschet	forschet
werdest	werdest
Asylrechten	Asylrechten
konntet	konntet
kooperierst	kooperierst
Fetzen	Fetzen
bebten	bebten
Sage	Sage
Falle	Falle
Suchet	Suchet
ferne	ferne
gestattest	gestattest
bemerket	bemerket
Butzemänner	Butzemänner
Fanmeile	Fanmeile
sagest	sagest
bedeckt	bedeckt
Welteninsel	Welteninsel
Jungen	Jungen
schwächst	schwächst
müsse	müsse
Regent	Regent
bezichtigten	bezichtigten
Drache	Drache
Anwendungsgebiet	Anwendungsgebiet
Argyrodite	Argyrodite
aasend	aasend
verhungert	verhungert
vergrabest	vergrabest
angehören	angehören
gestikuliere	gestikuliere
Fluorgehalte	Fluorgehalte
quasselten	quasselten
wach	wach
mußten	mußten
Kohlenstoffgehalt	Kohlenstoffgehalt
Chlorwasserstoffmoleküls	Chlorwasserstoffmoleküls
seine	seine
dürfen	dürfen
Gewalttätern	Gewalttätern
drifte	drifte
Türkenbund	Türkenbund
Teufel	Teufel
Feind	Feind
bekriegtet	bekriegtet
verkündigte	verkündigte
verbüßest	verbüßest
veranstalten	veranstalten
gestikulierst	gestikulierst
kürzest	kürzest
erstürmt	erstürmt
taten	taten
Schlüchte	Schlüchte
Lüsten	Lüsten
merken	merken
unsre	unsre
sterbt	sterbt
klappten	klappten
besuche	besuche
colorierend	colorierend
Oheim	Oheim
Stimme	Stimme
appellierst	appellierst
beeindruckt	beeindruckt
Pinguinen	Pinguinen
Spende	Spende
Urheimaten	Urheimaten
Böreks	Böreks
heulet	heulet
Name	Name
Schaffnerin	Schaffnerin
weh	weh
habe	habe
verwechseltet	verwechseltet
Banden	Banden
sieht	sieht
Ratsherr	Ratsherr
Ärschen	Ärschen
interagierte	interagierte
faschieren	faschieren
erfüllt	erfüllt
verkürze	verkürze
duckt	duckt
Euter	Euter
Honigbären	Honigbären
vermeße	vermeße
Bauwerken	Bauwerken
Füßen	Füßen
verteidigte	verteidigte
Physikerinnen	Physikerinnen
bezieht	bezieht
Kettenraucher	Kettenraucher
Gebot	Gebot
kristallisierest	kristallisierest
schauspieleren	schauspieleren
verkürztest	verkürztest
Bademantel	Bademantel
Locken	Locken
Kardinäle	Kardinäle
Aktivisten	Aktivisten
Floß	Floß
installiert	installiert
Geschwindigkeitsmesser	Geschwindigkeitsmesser
Regiert	Regiert
Chlorats	Chlorats
Vaginen	Vaginen
Bebauungsplänen	Bebauungsplänen
bemerken	bemerken
Massenanteilen	Massenanteilen
besorgten	besorgten
verlötest	verlötest
loste	loste
tränkten	tränkten
Abfertigungsschalter	Abfertigungsschalter
Perlen	Perlen
Weihe	Weihe
Peptid	Peptid
gesagt	gesagt
Autonomie	Autonomie
durchwachen	durchwachen
verfolgt	verfolgt
Fusselbart	Fusselbart
rundet	rundet
bekannten	bekannten
Blockflöten	Blockflöten
Testamente	Testamente
schämst	schämst
Sphären	Sphären
erkannte	erkannte
schlängelest	schlängelest
respektiere	respektiere
greifen	greifen
Extremen	Extremen
Badezimmers	Badezimmers
bebte	bebte
Schnipsel	Schnipsel
Trägerwellen	Trägerwellen
überfischte	überfischte
sündiget	sündiget
übrigbleibt	übrigbleibt
grauten	grauten
besäen	besäen
meinet	meinet
Briketten	Briketten
Wimpertierchen	Wimpertierchen
drillte	drillte
erweckt	erweckt
Epoxide	Epoxide
borgte	borgte
Barschaften	Barschaften
schlafest	schlafest
Donor	Donor
wallte	wallte
schummelst	schummelst
Erlösungen	Erlösungen
Bestechungsgelder	Bestechungsgelder
unserer	unserer
pendelt	pendelt
amputierten	amputierten
Unterwerfungen	Unterwerfungen
Pforte	Pforte
trotzt	trotzt
Einsatz	Einsatz
schaffte	schaffte
pflanzt	pflanzt
Spießen	Spießen
Piratensender	Piratensender
Stäbe	Stäbe
schließt	schließt
tabuisierten	tabuisierten
rodet	rodet
denen	denen
Schauet	Schauet
Denkmünzen	Denkmünzen
gafften	gafften
Paradiesäpfeln	Paradiesäpfeln
Hektaren	Hektaren
wehre	wehre
Kommst	Kommst
parlieren	parlieren
bequemtet	bequemtet
hämmerst	hämmerst
entmineralisieret	entmineralisieret
gravierst	gravierst
verwertete	verwertete
Sollten	Sollten
frevler	frevler
zerbrichst	zerbrichst
setzest	setzest
besorgt	besorgt
Tiegel	Tiegel
Kopfsalaten	Kopfsalaten
versucht	versucht
möchten	möchten
erliegen	erliegen
verkleidete	verkleidete
Kleinodien	Kleinodien
gedenkt	gedenkt
Safrane	Safrane
Silbererze	Silbererze
unsrer	unsrer
Leichnamen	Leichnamen
schmuggele	schmuggele
unterrichten	unterrichten
dechiffrierend	dechiffrierend
Arreste	Arreste
Riesen	Riesen
Geschreis	Geschreis
trübe	trübe
murmelte	murmelte
verstörten	verstörten
Ställen	Ställen
stiegen	stiegen
Nigger	Nigger
säuselest	säuselest
viele	viele
wässerst	wässerst
Primärenergie	Primärenergie
Döner	Döner
grün	grün
aufnahmen	aufnahmen
baggerte	baggerte
maß	maß
sündigten	sündigten
Bist	Bist
verließen	verließen
widerstand	widerstand
Dorngesträuch	Dorngesträuch
bleibest	bleibest
Hode	Hode
Handbuch	Handbuch
Hunden	Hunden
traget	traget
Hirsche	Hirsche
empört	empört
lodert	lodert
besäest	besäest
Frettchen	Frettchen
reglementierte	reglementierte
eng	eng
Altäre	Altäre
Festons	Festons
Gar	Gar
verschaffte	verschaffte
Falzen	Falzen
entfolgst	entfolgst
Hälsen	Hälsen
offenbarest	offenbarest
Rehen	Rehen
klettert	klettert
Schwermetallion	Schwermetallion
Geldautomat	Geldautomat
erschrickst	erschrickst
treibest	treibest
ihn	ihn
glaubest	glaubest
bereitet	bereitet
zählte	zählte
läuten	läuten
zweifelte	zweifelte
verscheißerte	verscheißerte
Beschleuniger	Beschleuniger
kühlen	kühlen
filtern	filtern
Lusitaner	Lusitaner
ärgerst	ärgerst
Streite	Streite
schlummerte	schlummerte
Unterseiten	Unterseiten
Knechte	Knechte
ratschlagte	ratschlagte
Scherzen	Scherzen
hinterzöge	hinterzöge
müssest	müssest
geniertest	geniertest
Schläfchens	Schläfchens
Hummer	Hummer
zügelten	zügelten
Sehnen	Sehnen
schlabbere	schlabbere
leistest	leistest
Mikrometern	Mikrometern
Bromidquellen	Bromidquellen
implodier	implodier
vertreibt	vertreibt
Klappertöpfen	Klappertöpfen
bang	bang
stützen	stützen
Californium	Californium
planschest	planschest
irren	irren
gehorchst	gehorchst
bestimmten	bestimmten
Menschenhandel	Menschenhandel
zeichnest	zeichnest
Dann	Dann
Fischzucht	Fischzucht
verunreinigst	verunreinigst
hörest	hörest
malten	malten
demütiget	demütiget
verschmelze	verschmelze
begrabe	begrabe
Senkungen	Senkungen
letzten	letzten
Kreise	Kreise
säumen	säumen
segmentiere	segmentiere
meinen	meinen
Waren	Waren
verbitterten	verbitterten
Iberers	Iberers
privilegiere	privilegiere
kritzelst	kritzelst
Götze	Götze
beeinflusst	beeinflusst
meines	meines
wehr	wehr
vergaset	vergaset
Säuen	Säuen
Beryll	Beryll
Leitkegeln	Leitkegeln
drängte	drängte
schluchze	schluchze
protestierest	protestierest
Chlorwasserstoffmolekül	Chlorwasserstoffmolekül
eures	eures
Fröschen	Fröschen
besänftiget	besänftiget
Leitungsweg	Leitungsweg
solchem	solchem
zeichnet	zeichnet
füllst	füllst
kämmtet	kämmtet
vandalieren	vandalieren
protokollieren	protokollieren
Elle	Elle
triebe	triebe
türmen	türmen
parkierten	parkierten
Drachen	Drachen
verschärfst	verschärfst
protestiere	protestiere
Götzen	Götzen
Backpflaumen	Backpflaumen
konjugiere	konjugiere
Entree	Entree
Kerzenlichter	Kerzenlichter
Sprechers	Sprechers
Dinge	Dinge
Anhänge	Anhänge
ehre	ehre
Türme	Türme
Begünstigung	Begünstigung
Petersfisch	Petersfisch
Auguren	Auguren
Mensch	Mensch
Anfänger	Anfänger
liehen	liehen
Nachruf	Nachruf
lieben	lieben
Graben	Graben
rollten	rollten
gut	gut
bürsteten	bürsteten
Kalifeldspat	Kalifeldspat
ritten	ritten
vernehmen	vernehmen
Gummibäumen	Gummibäumen
Heringen	Heringen
repräsentieret	repräsentieret
erstarre	erstarre
wallfahrest	wallfahrest
Pläsieren	Pläsieren
steigeret	steigeret
Stoffwechselwegen	Stoffwechselwegen
bekannt	bekannt
Helme	Helme
verlasse	verlasse
Herd	Herd
erlösest	erlösest
ermutigt	ermutigt
Brieftaubenzüchters	Brieftaubenzüchters
kaufest	kaufest
fresse	fresse
äusserst	äusserst
grünte	grünte
Randbemerkung	Randbemerkung
Pfunde	Pfunde
widmet	widmet
blitzet	blitzet
Gelobt	Gelobt
empörte	empörte
Stärkungsmittel	Stärkungsmittel
verziehe	verziehe
kehren	kehren
Reiseleiter	Reiseleiter
Milz	Milz
massierst	massierst
Coventrisierungen	Coventrisierungen
konvergierest	konvergierest
Drillinge	Drillinge
vermahnte	vermahnte
Töpfe	Töpfe
Gedanken	Gedanken
bekehret	bekehret
klage	klage
kostet	kostet
Hubschrauber	Hubschrauber
herrschst	herrschst
Montagmittag	Montagmittag
gebieten	gebieten
Campingplätzen	Campingplätzen
besehet	besehet
Ringeltaube	Ringeltaube
meinte	meinte
Ölfasses	Ölfasses
Kriegen	Kriegen
betrübten	betrübten
karikierten	karikierten
siehst	siehst
Sitzfleisches	Sitzfleisches
Bildpunkt	Bildpunkt
Beiblätter	Beiblätter
ackerest	ackerest
Rast	Rast
neiden	neiden
mogelten	mogelten
Verbrechen	Verbrechen
boykottierten	boykottierten
lispelt	lispelt
Leichenschauhäusern	Leichenschauhäusern
präsentiere	präsentiere
verdrängen	verdrängen
Rufet	Rufet
überdenkest	überdenkest
langweiltest	langweiltest
Acetaten	Acetaten
tätowierest	tätowierest
speichertest	speichertest
bandagierte	bandagierte
Bienenstöcke	Bienenstöcke
Stierkämpfe	Stierkämpfe
Maultieren	Maultieren
Abschußringe	Abschußringe
Bette	Bette
tattert	tattert
seufzt	seufzt
überbewerte	überbewerte
Wachteln	Wachteln
hebräischen	hebräischen
Pater	Pater
Schotten	Schotten
Stämme	Stämme
Verdachtes	Verdachtes
Deckenzapfen	Deckenzapfen
weiche	weiche
heilet	heilet
Exzentriker	Exzentriker
Füchsen	Füchsen
Unterschlagung	Unterschlagung
Politologe	Politologe
Verkehrsflugzeug	Verkehrsflugzeug
schauspielert	schauspielert
erstehet	erstehet
Abfertigungsgebäuden	Abfertigungsgebäuden
Schlepper	Schlepper
all	all
Felsboden	Felsboden
addierte	addierte
herrschte	herrschte
Päckchen	Päckchen
Attentäter	Attentäter
stammeln	stammeln
Erdbirnen	Erdbirnen
explodierten	explodierten
krähen	krähen
Bildschirmfoto	Bildschirmfoto
wachet	wachet
Wucher	Wucher
nähet	nähet
verdränge	verdränge
tasteten	tasteten
Mitschuld	Mitschuld
vertilgt	vertilgt
zeugten	zeugten
Gefangene	Gefangene
dritten	dritten
zwängtet	zwängtet
schließe	schließe
scherzt	scherzt
Märchenbuches	Märchenbuches
Schlüchten	Schlüchten
beiden	beiden
fallet	fallet
Donoren	Donoren
trödele	trödele
umhüll	umhüll
Adeliepinguin	Adeliepinguin
verdammt	verdammt
Kerf	Kerf
Elementarzelle	Elementarzelle
baute	baute
prahlet	prahlet
sonderte	sonderte
unterstützten	unterstützten
Paragraphenreitern	Paragraphenreitern
Fehlen	Fehlen
Ärzteblättern	Ärzteblättern
beeinflusste	beeinflusste
opferte	opferte
zuhörte	zuhörte
lege	lege
bezahlest	bezahlest
blitze	blitze
taufen	taufen
Kaufleute	Kaufleute
saget	saget
scheiterst	scheiterst
Europameistern	Europameistern
imprägniere	imprägniere
Wiederauferstehung	Wiederauferstehung
Flöße	Flöße
einst	einst
verspäte	verspäte
kategorisierte	kategorisierte
entschädigte	entschädigte
interpretiert	interpretiert
Brötchen	Brötchen
Hochzeitstorten	Hochzeitstorten
hadere	hadere
Gammastrahlen	Gammastrahlen
haltest	haltest
Spektralbereichen	Spektralbereichen
hebe	hebe
Jagdhunden	Jagdhunden
Polizeisprecher	Polizeisprecher
illustriertet	illustriertet
Kanzlei	Kanzlei
plissieren	plissieren
respektieren	respektieren
erzeigen	erzeigen
Augen	Augen
tagten	tagten
Bruchstrich	Bruchstrich
Friedensforscherinnen	Friedensforscherinnen
Dezernat	Dezernat
schmetterst	schmetterst
entheilige	entheilige
spaltest	spaltest
sinke	sinke
stäupte	stäupte
Aufsätzen	Aufsätzen
gelobtet	gelobtet
brillierest	brillierest
Solches	Solches
kasernierte	kasernierte
ihres	ihres
Abtrünnige	Abtrünnige
Kavalier	Kavalier
streue	streue
pflanzet	pflanzet
zieren	zieren
fahrest	fahrest
füllen	füllen
erziehen	erziehen
stellst	stellst
aktualisiere	aktualisiere
Gepäckträger	Gepäckträger
ballaste	ballaste
watete	watete
Brettspiele	Brettspiele
verladet	verladet
Einsätzen	Einsätzen
übersehest	übersehest
Datentypen	Datentypen
pflügten	pflügten
Kaufhäusern	Kaufhäusern
hingehet	hingehet
verselbstständige	verselbstständige
versteigerest	versteigerest
gewöhnte	gewöhnte
ziert	ziert
Überweisung	Überweisung
Harpune	Harpune
aber	aber
Prüfbericht	Prüfbericht
abalienierest	abalienierest
ziehst	ziehst
junge	junge
grüße	grüße
Pflanzungen	Pflanzungen
downloadet	downloadet
Bundesgebiet	Bundesgebiet
Monarchie	Monarchie
verschlimmerte	verschlimmerte
Notständen	Notständen
Oberlippe	Oberlippe
Grenzen	Grenzen
versteckst	versteckst
ausgehst	ausgehst
nächsten	nächsten
repräsentierten	repräsentierten
vergiftet	vergiftet
bejubelst	bejubelst
Stoffwechselweg	Stoffwechselweg
dampfte	dampfte
fokussierten	fokussierten
Metallquirlen	Metallquirlen
hänge	hänge
Iberer	Iberer
emigrieret	emigrieret
Erdkruste	Erdkruste
Assimilationen	Assimilationen
gleite	gleite
angehört	angehört
Zunge	Zunge
entsetzet	entsetzet
Löwen	Löwen
Mischelementen	Mischelementen
fünfte	fünfte
vergliche	vergliche
Steiget	Steiget
Blättchen	Blättchen
Futur	Futur
bimmelte	bimmelte
leiden	leiden
Erzherzogshüten	Erzherzogshüten
soll	soll
Garten	Garten
Genetikerin	Genetikerin
Chlorid	Chlorid
außen	außen
Linguistinnen	Linguistinnen
Beschuldigungen	Beschuldigungen
umhüllend	umhüllend
zürntest	zürntest
Gemeinde	Gemeinde
verewigt	verewigt
wer	wer
Firnis	Firnis
sagt	sagt
Heeren	Heeren
Ärgernissen	Ärgernissen
Abkömmling	Abkömmling
erlauben	erlauben
Träumers	Träumers
suche	suche
haste	haste
Speere	Speere
Tumulten	Tumulten
Seetaucher	Seetaucher
verboten	verboten
bedingst	bedingst
verkürzest	verkürzest
jammerte	jammerte
Vergeltungen	Vergeltungen
Bunde	Bunde
Hainbuche	Hainbuche
Lehrkörpers	Lehrkörpers
Empörungen	Empörungen
austilgen	austilgen
schrecken	schrecken
fladerest	fladerest
Meerschweinchen	Meerschweinchen
verdunstet	verdunstet
beschrifte	beschrifte
liebet	liebet
Achseln	Achseln
Kerzenfischen	Kerzenfischen
Hinterwäldlern	Hinterwäldlern
binden	binden
brauchst	brauchst
Atmosphäre	Atmosphäre
Sekretärinnen	Sekretärinnen
entwendete	entwendete
mögest	mögest
Früchten	Früchten
höbe	höbe
Anachronismen	Anachronismen
dresche	dresche
tat	tat
Anführer	Anführer
tattre	tattre
spielen	spielen
Wanderfalken	Wanderfalken
Gallan	Gallan
tragen	tragen
folg	folg
Schlagzeugern	Schlagzeugern
Paralipse	Paralipse
Kuttern	Kuttern
Eins	Eins
Buchfink	Buchfink
Abbindebeschleunigern	Abbindebeschleunigern
Heuhaufen	Heuhaufen
Keile	Keile
schämest	schämest
Organisationen	Organisationen
beantragt	beantragt
Hüftgelenken	Hüftgelenken
ältesten	ältesten
erstände	erstände
Shortcuts	Shortcuts
grüßen	grüßen
wahr	wahr
verknüpft	verknüpft
Idolatrien	Idolatrien
tränke	tränke
dirigieret	dirigieret
Europium	Europium
forschen	forschen
weichet	weichet
aßest	aßest
vertiefe	vertiefe
knurrt	knurrt
zweifel	zweifel
austilgest	austilgest
gedachte	gedachte
rangierst	rangierst
Hummern	Hummern
verlieren	verlieren
kupiert	kupiert
Desserts	Desserts
grabest	grabest
gleitest	gleitest
verstört	verstört
kennst	kennst
lüge	lüge
Bergsteiger	Bergsteiger
steuerst	steuerst
mühte	mühte
Ästen	Ästen
Indern	Indern
versuchte	versuchte
Alte	Alte
sabbelten	sabbelten
Dein	Dein
Gewinnung	Gewinnung
Genkinits	Genkinits
überbewertet	überbewertet
aufwacht	aufwacht
Massagen	Massagen
enträtselst	enträtselst
ersten	ersten
Katamarane	Katamarane
schautest	schautest
vergleichet	vergleichet
Außenministerien	Außenministerien
Privatsachen	Privatsachen
zwölften	zwölften
kontaktieret	kontaktieret
begruben	begruben
sucht	sucht
taufet	taufet
regierte	regierte
brauche	brauche
knusperten	knusperten
bedient	bedient
Binden	Binden
Lobet	Lobet
könne	könne
gelegt	gelegt
höbet	höbet
blasen	blasen
manövrierte	manövrierte
Gammastrahl	Gammastrahl
Quatsch	Quatsch
eure	eure
ermahnet	ermahnet
Vorstoß	Vorstoß
Knüppeln	Knüppeln
geahnt	geahnt
Herr	Herr
Blutgefäß	Blutgefäß
misstrauet	misstrauet
stillest	stillest
Kakao	Kakao
sezierte	sezierte
hättest	hättest
annektierst	annektierst
privatisierest	privatisierest
Bienenzüchter	Bienenzüchter
Waldbränden	Waldbränden
Jungfernflüge	Jungfernflüge
Smaragdkehlkolibris	Smaragdkehlkolibris
Preisen	Preisen
protestieret	protestieret
Abschiedsbriefe	Abschiedsbriefe
wachsen	wachsen
frikassierend	frikassierend
verlautet	verlautet
schwirrt	schwirrt
wachen	wachen
Träumer	Träumer
verjährte	verjährte
Freibrief	Freibrief
missversteht	missversteht
stelle	stelle
kühle	kühle
berücksichtigt	berücksichtigt
scheuchtest	scheuchtest
Reinigungsschritten	Reinigungsschritten
Spirale	Spirale
sabbelt	sabbelt
arbeiten	arbeiten
finanzieret	finanzieret
Abkürzungsverzeichnis	Abkürzungsverzeichnis
blamierten	blamierten
stärken	stärken
Kautschuke	Kautschuke
regiertest	regiertest
boßte	boßte
UND-Gattern	UND-Gattern
Gebeinen	Gebeinen
mikrominiaturisierten	mikrominiaturisierten
tunet	tunet
Schilden	Schilden
predige	predige
punkten	punkten
Schönrednern	Schönrednern
piesacken	piesacken
Wären	Wären
erbte	erbte
möchtet	möchtet
Gemeinden	Gemeinden
gestatte	gestatte
Meinet	Meinet
linken	linken
Kompassen	Kompassen
Machet	Machet
Aas	Aas
flehte	flehte
beweisest	beweisest
malochet	malochet
absolviertet	absolviertet
lebest	lebest
Streichen	Streichen
Fermium	Fermium
addieren	addieren
restaurieret	restaurieret
Ebenen	Ebenen
Zahnfleischentzündung	Zahnfleischentzündung
wünscht	wünscht
belüftete	belüftete
Ausnahmen	Ausnahmen
verforme	verforme
Grenzwert	Grenzwert
sicherst	sicherst
Kerzenfische	Kerzenfische
übrigbleiben	übrigbleiben
bekehrt	bekehrt
verspäteten	verspäteten
Besteck	Besteck
Türmen	Türmen
Playlists	Playlists
köderte	köderte
Gelobet	Gelobet
bauet	bauet
erliegst	erliegst
neigest	neigest
treibst	treibst
reparieret	reparieret
Bis	Bis
nähert	nähert
bombardiert	bombardiert
querest	querest
besprenget	besprenget
malochte	malochte
trieb	trieb
rebellieren	rebellieren
Mikrowellenfilter	Mikrowellenfilter
Pinguin	Pinguin
gelobet	gelobet
fressen	fressen
stürzt	stürzt
spricht	spricht
Provinz	Provinz
glühten	glühten
taufte	taufte
Operationssaal	Operationssaal
erforscht	erforscht
baust	baust
fokussieret	fokussieret
Marokkanern	Marokkanern
Sabbate	Sabbate
lögest	lögest
gewünscht	gewünscht
gehst	gehst
verkündigten	verkündigten
Gicht	Gicht
nötig	nötig
obfuskierten	obfuskierten
buddelten	buddelten
Schreibtischtätern	Schreibtischtätern
torpedieret	torpedieret
vielen	vielen
speisest	speisest
Schlägen	Schlägen
umhüllt	umhüllt
konnotieret	konnotieret
gestaltest	gestaltest
stimmet	stimmet
Freibergits	Freibergits
Hälse	Hälse
folgte	folgte
scherze	scherze
Menschen	Menschen
Darlehen	Darlehen
attackieren	attackieren
habt	habt
Jahr	Jahr
Maxima	Maxima
umgäben	umgäben
nächste	nächste
Myriade	Myriade
wurden	wurden
Bleigehalten	Bleigehalten
frisch	frisch
ziere	ziere
spekuliere	spekuliere
Erstlinge	Erstlinge
Effekten	Effekten
sintertest	sintertest
versteigernd	versteigernd
stäupt	stäupt
verseuchen	verseuchen
täuschet	täuschet
Abhänge	Abhänge
setztet	setztet
Pfleglinge	Pfleglinge
Dampfschiffen	Dampfschiffen
erzwinget	erzwinget
deklarierten	deklarierten
fastetet	fastetet
Polarisation	Polarisation
bromiert	bromiert
wahre	wahre
Trickbetrügern	Trickbetrügern
faul	faul
Trinken	Trinken
auszögen	auszögen
verallgemeinerest	verallgemeinerest
Sprachraum	Sprachraum
Brechnüssen	Brechnüssen
Kunstgeschichte	Kunstgeschichte
frische	frische
verblieben	verblieben
Hansen	Hansen
Halogenatomen	Halogenatomen
klingt	klingt
Zementen	Zementen
deutete	deutete
versteckt	versteckt
übersteht	übersteht
Leide	Leide
Laubbläser	Laubbläser
Lautwandeln	Lautwandeln
legt	legt
Geigerzähler	Geigerzähler
seist	seist
Glatteis	Glatteis
weissagst	weissagst
aufstand	aufstand
amenagieren	amenagieren
balkanisierten	balkanisierten
löset	löset
unterfordern	unterfordern
Biokraftstoff	Biokraftstoff
verschonet	verschonet
schummelten	schummelten
schimmerest	schimmerest
Angaben	Angaben
freute	freute
bedenket	bedenket
Greyerzern	Greyerzern
Arsenit	Arsenit
Rechten	Rechten
drosselt	drosselt
warten	warten
Rabe	Rabe
absolviere	absolviere
beanspruchte	beanspruchte
helfest	helfest
funktionalisiertest	funktionalisiertest
bereue	bereue
Europameisters	Europameisters
glaubtet	glaubtet
Danket	Danket
Eisenkraut	Eisenkraut
Freunde	Freunde
spritzet	spritzet
Videoaufzeichnung	Videoaufzeichnung
verstanden	verstanden
Weiß	Weiß
hätte	hätte
Ångström	Ångström
Banketten	Banketten
wiederkamt	wiederkamt
vertiefet	vertiefet
funkelet	funkelet
Glaubet	Glaubet
immunisiere	immunisiere
Zeug	Zeug
frottier	frottier
Abschreckungen	Abschreckungen
Hure	Hure
Gläubigern	Gläubigern
vertonten	vertonten
bequemen	bequemen
dümpelt	dümpelt
schlängelt	schlängelt
benehme	benehme
blockierten	blockierten
fresset	fresset
Ringeltauben	Ringeltauben
Außenministerium	Außenministerium
gebot	gebot
sehn	sehn
Beine	Beine
revoltieren	revoltieren
Fokusse	Fokusse
Kronsbeeren	Kronsbeeren
reinstitutionalisiert	reinstitutionalisiert
begraben	begraben
sitzet	sitzet
arm	arm
preist	preist
Vipernatter	Vipernatter
ortete	ortete
referenziere	referenziere
ihre	ihre
Fischen	Fischen
gewitterte	gewitterte
anzeigt	anzeigt
bereite	bereite
pflegst	pflegst
Knaben	Knaben
Lobgesängen	Lobgesängen
Loben	Loben
gekröst	gekröst
inneren	inneren
Als	Als
erwache	erwache
näht	näht
verschlingt	verschlingt
Libellen	Libellen
vertraute	vertraute
schleißt	schleißt
trompete	trompete
wurdest	wurdest
Feuerteufels	Feuerteufels
ratschlagten	ratschlagten
sprecht	sprecht
Golfplatz	Golfplatz
egge	egge
produzierten	produzierten
rolltet	rolltet
Ölspur	Ölspur
besichtiget	besichtiget
Abszisse	Abszisse
wallet	wallet
brecht	brecht
schöpfte	schöpfte
gelangte	gelangte
anruft	anruft
simuliertet	simuliertet
Sphäre	Sphäre
Wollte	Wollte
Reizt	Reizt
Meine	Meine
duschte	duschte
Metallquirle	Metallquirle
Portal	Portal
bestanden	bestanden
Komplexionen	Komplexionen
erste	erste
unterbrächest	unterbrächest
brillieret	brillieret
predig	predig
spielte	spielte
danke	danke
begehrend	begehrend
liebend	liebend
erwischten	erwischten
geräuchert	geräuchert
Fingerhüte	Fingerhüte
zerstückt	zerstückt
Teilnehmerin	Teilnehmerin
löstest	löstest
Innenministerien	Innenministerien
Preisanstieg	Preisanstieg
konvertieren	konvertieren
Technetiumatom	Technetiumatom
Pausbacken	Pausbacken
vor	vor
produzierte	produzierte
Rußen	Rußen
denaturierten	denaturierten
hievst	hievst
verschärftet	verschärftet
beantrage	beantrage
entschleieret	entschleieret
vertrage	vertrage
substituierest	substituierest
Pflanzenwachstum	Pflanzenwachstum
applizirte	applizirte
reparierten	reparierten
Besuch	Besuch
Kleptokratie	Kleptokratie
filzst	filzst
Gigapascal	Gigapascal
Nullpunktes	Nullpunktes
Stiefvater	Stiefvater
verdunsten	verdunsten
Excimerlasern	Excimerlasern
feire	feire
vier	vier
schnelle	schnelle
schläfst	schläfst
Zäume	Zäume
Lautwandel	Lautwandel
jeder	jeder
Ablösung	Ablösung
Normdaten	Normdaten
schämet	schämet
habest	habest
Schal	Schal
Vogelscheuchen	Vogelscheuchen
verzweigt	verzweigt
wälzet	wälzet
Aussätzigen	Aussätzigen
Silbererzen	Silbererzen
irrte	irrte
weg	weg
Entmachtung	Entmachtung
still	still
Adlerbussarden	Adlerbussarden
wolle	wolle
verwirfst	verwirfst
klagte	klagte
spaltetest	spaltetest
Kost	Kost
wälzt	wälzt
Judenrat	Judenrat
Tauben	Tauben
abtrünnigen	abtrünnigen
Warten	Warten
Unrecht	Unrecht
Kontrollkästchen	Kontrollkästchen
Königen	Königen
grübelt	grübelt
geleite	geleite
harmoniere	harmoniere
Wiedergutmachung	Wiedergutmachung
Schleppern	Schleppern
bessere	bessere
sinnst	sinnst
verewiget	verewiget
Lehrbücher	Lehrbücher
überschattete	überschattete
Kakadu	Kakadu
Oxalaten	Oxalaten
wärme	wärme
Letzte	Letzte
Last	Last
sannen	sannen
trägst	trägst
verseucht	verseucht
Deckenfarbe	Deckenfarbe
Lobgesänge	Lobgesänge
bewässertet	bewässertet
Joche	Joche
WebHook	WebHook
heparinisierten	heparinisierten
Solcher	Solcher
präsentier	präsentier
weichst	weichst
Ecke	Ecke
Forschung	Forschung
speiest	speiest
Schiffe	Schiffe
Liebchen	Liebchen
Berber	Berber
Seilen	Seilen
verführest	verführest
ankerst	ankerst
Seit	Seit
Neumonde	Neumonde
oxidierte	oxidierte
Solche	Solche
Helmen	Helmen
schmuggle	schmuggle
ratet	ratet
verlöteten	verlöteten
besät	besät
ermutigte	ermutigte
besichtigt	besichtigt
Coventrisierung	Coventrisierung
Gebirge	Gebirge
bleibet	bleibet
erzeigte	erzeigte
Gläubigen	Gläubigen
malen	malen
schaben	schaben
Fussel	Fussel
besprichst	besprichst
Oberlandesgericht	Oberlandesgericht
heil	heil
betrüben	betrüben
Huflattich	Huflattich
klappest	klappest
Epoxiden	Epoxiden
funkeln	funkeln
Funkfeuer	Funkfeuer
verkündige	verkündige
wacht	wacht
legen	legen
Gäste	Gäste
Schneepflügen	Schneepflügen
Monate	Monate
Geflecktheit	Geflecktheit
Sprecher	Sprecher
haarten	haarten
Pfahl	Pfahl
setzte	setzte
vernichtete	vernichtete
bombardiere	bombardiere
Geliebte	Geliebte
Füchsinnen	Füchsinnen
Empfängnisverhütungen	Empfängnisverhütungen
Pfählen	Pfählen
Eure	Eure
brauste	brauste
emittiert	emittiert
kabbelet	kabbelet
amen	amen
bewieset	bewieset
glawbte	glawbte
blaset	blaset
Schuhe	Schuhe
Schanktisch	Schanktisch
nähernd	nähernd
handhaben	handhaben
Hacker	Hacker
erbauet	erbauet
sprechet	sprechet
entflieht	entflieht
entzögen	entzögen
Krankenscheinen	Krankenscheinen
schütze	schütze
entzweiest	entzweiest
gelobend	gelobend
gewärtigt	gewärtigt
wäre	wäre
wehrt	wehrt
Sei	Sei
Butike	Butike
Reinelementen	Reinelementen
füsilierten	füsilierten
geselle	geselle
babbelst	babbelst
plissierten	plissierten
haarte	haarte
weinen	weinen
abzieht	abzieht
dich	dich
Gaschromatographien	Gaschromatographien
laute	laute
Bildpunkten	Bildpunkten
heftetest	heftetest
Deuteriums	Deuteriums
süsse	süsse
Schenke	Schenke
Schreiet	Schreiet
fladern	fladern
Schlange	Schlange
Tyrannen	Tyrannen
Aderhaut	Aderhaut
verderben	verderben
Stellen	Stellen
blitz	blitz
Unternehmensanwendungsintegrationen	Unternehmensanwendungsintegrationen
Gerichten	Gerichten
zuppt	zuppt
Atommodelle	Atommodelle
Dachdeckerinnen	Dachdeckerinnen
leer	leer
Amtsträger	Amtsträger
verhalten	verhalten
Antimusters	Antimusters
wohnte	wohnte
strandend	strandend
Republikflucht	Republikflucht
trüge	trüge
geleitet	geleitet
ratschlaget	ratschlaget
Agoraphobien	Agoraphobien
Transportweg	Transportweg
verschreibt	verschreibt
flambiert	flambiert
Campingplatzes	Campingplatzes
folterst	folterst
Vorstädte	Vorstädte
Augengläsern	Augengläsern
Atommasse	Atommasse
verführt	verführt
Hadith	Hadith
substituieren	substituieren
Maximierung	Maximierung
Ölfässern	Ölfässern
globalisieret	globalisieret
handhabt	handhabt
Seiten	Seiten
Radiergummi	Radiergummi
Metaphern	Metaphern
Münzsammlung	Münzsammlung
gabelst	gabelst
negierte	negierte
Acht	Acht
Rückumlaute	Rückumlaute
Kreisen	Kreisen
Bergen	Bergen
vernickele	vernickele
gelobest	gelobest
nahe	nahe
bewies	bewies
meißeltest	meißeltest
Reinelemente	Reinelemente
bat	bat
mein	mein
zeug	zeug
folget	folget
Küstenwachen	Küstenwachen
Geräte	Geräte
Präservativs	Präservativs
verkleinern	verkleinern
möpperst	möpperst
Gängen	Gängen
gereicht	gereicht
Unterschlagungen	Unterschlagungen
beschuldigt	beschuldigt
bewässerst	bewässerst
war	war
fabulierest	fabulierest
halten	halten
entkämen	entkämen
Mopp	Mopp
süsst	süsst
zerrütteten	zerrütteten
Amt	Amt
chloroformieret	chloroformieret
gähne	gähne
funzt	funzt
predigen	predigen
Ihren	Ihren
niemanden	niemanden
hätten	hätten
billige	billige
säume	säume
Zehe	Zehe
Sogen	Sogen
Sonderberichte	Sonderberichte
demütigst	demütigst
tote	tote
links	links
besichert	besichert
Fingerhüten	Fingerhüten
Türkise	Türkise
erfreu	erfreu
Orgeln	Orgeln
Honigbär	Honigbär
sondern	sondern
kletteret	kletteret
zensiere	zensiere
Ringen	Ringen
diskutiere	diskutiere
Ächselchen	Ächselchen
begehrest	begehrest
sterilisierte	sterilisierte
gedenken	gedenken
Gefäßen	Gefäßen
Broten	Broten
möchte	möchte
errötest	errötest
durchläutert	durchläutert
Könige	Könige
angehöret	angehöret
lögen	lögen
pensionierten	pensionierten
haben	haben
gedachten	gedachten
Alteritäten	Alteritäten
Kompromiss	Kompromiss
Chinakohl	Chinakohl
Hanse	Hanse
wünschen	wünschen
schnattert	schnattert
befürchtet	befürchtet
Abschußring	Abschußring
Kosten	Kosten
überreichst	überreichst
zürnte	zürnte
Kontraindikationen	Kontraindikationen
stutzt	stutzt
grüßt	grüßt
Einwirkungen	Einwirkungen
Hälmchen	Hälmchen
anhangt	anhangt
Geckos	Geckos
beherrschest	beherrschest
Briefköpfen	Briefköpfen
steuerte	steuerte
maximierten	maximierten
lose	lose
zwingst	zwingst
erlöst	erlöst
infizieret	infizieret
jappen	jappen
stapfst	stapfst
schlagest	schlagest
zerstreust	zerstreust
Bazzit	Bazzit
wünschest	wünschest
observiertest	observiertest
lös	lös
fluktuiert	fluktuiert
Bauwerke	Bauwerke
bimmelten	bimmelten
befestigte	befestigte
fluchten	fluchten
mehrte	mehrte
würde	würde
erwärmten	erwärmten
velarisierend	velarisierend
glauben	glauben
erntest	erntest
vibriere	vibriere
Hunde	Hunde
prostet	prostet
verlautete	verlautete
Minischweine	Minischweine
Indianer	Indianer
Aachener	Aachener
Puder	Puder
Hypochlorite	Hypochlorite
verprügelet	verprügelet
Serverzugriffen	Serverzugriffen
Unrechten	Unrechten
murmeln	murmeln
verringeret	verringeret
begnadigte	begnadigte
Trübsal	Trübsal
grünest	grünest
brenne	brenne
entfachet	entfachet
geknautscht	geknautscht
mischt	mischt
hattest	hattest
scheitern	scheitern
merkte	merkte
ausziehst	ausziehst
scheinen	scheinen
zerfetzt	zerfetzt
dividiere	dividiere
grüne	grüne
durchläuterte	durchläuterte
vermischten	vermischten
schätzen	schätzen
belauerten	belauerten
Fluoratome	Fluoratome
zuppte	zuppte
Verselbstständigung	Verselbstständigung
laufe	laufe
blondieren	blondieren
Badezimmer	Badezimmer
vermahne	vermahne
halbierte	halbierte
übet	übet
Präservativen	Präservativen
Fremde	Fremde
entwickele	entwickele
Erstlingen	Erstlingen
Achsel	Achsel
Sprödmetallen	Sprödmetallen
erbet	erbet
Bäche	Bäche
knistert	knistert
knusperst	knusperst
lackiere	lackiere
Genies	Genies
heilte	heilte
gelobtest	gelobtest
wenden	wenden
Videoaufzeichnungen	Videoaufzeichnungen
Pferde	Pferde
rüstetest	rüstetest
besorg	besorg
Langeweile	Langeweile
verbleibet	verbleibet
Ehren	Ehren
ehe	ehe
meine	meine
Preis	Preis
fegst	fegst
tendiertet	tendiertet
Breiten	Breiten
irre	irre
gratuliert	gratuliert
Friesen	Friesen
ringele	ringele
begehrten	begehrten
kabelst	kabelst
entfolgte	entfolgte
Fahlflanken-Ameisenwürger	Fahlflanken-Ameisenwürger
zerschlaget	zerschlaget
beklage	beklage
gefällst	gefällst
zürne	zürne
verbaseln	verbaseln
Eingeweide	Eingeweide
Girls	Girls
Pflaume	Pflaume
drosselten	drosselten
Früchte	Früchte
Paradiesapfel	Paradiesapfel
breche	breche
schreibst	schreibst
Metallspiegeln	Metallspiegeln
parametrisierten	parametrisierten
durfte	durfte
verließet	verließet
Ring	Ring
Haltepunkt	Haltepunkt
Borkenkäfer	Borkenkäfer
protestierst	protestierst
widerlegest	widerlegest
Paläste	Paläste
Bäusche	Bäusche
Zeugnisse	Zeugnisse
harrest	harrest
begehrte	begehrte
Fällt	Fällt
fistete	fistete
gewährte	gewährte
Kräften	Kräften
Rücktritt	Rücktritt
lauten	lauten
bewahrest	bewahrest
Apfelbäume	Apfelbäume
befördert	befördert
entflöhen	entflöhen
Volkslehre	Volkslehre
entzweit	entzweit
Diethylether	Diethylether
Anarchisten	Anarchisten
leiten	leiten
peiltest	peiltest
Briten	Briten
Leichenschauhäuser	Leichenschauhäuser
Chemikerinnen	Chemikerinnen
grüßten	grüßten
Planern	Planern
kabeln	kabeln
flirtest	flirtest
Sprüche	Sprüche
Weißt	Weißt
wohnet	wohnet
deponiere	deponiere
Amen	Amen
moppst	moppst
vergibst	vergibst
Fallen	Fallen
lüg	lüg
schlagt	schlagt
Milchflaschen	Milchflaschen
liebtet	liebtet
weissagten	weissagten
schneide	schneide
erschrickt	erschrickt
stickt	stickt
koste	koste
Laubbläsern	Laubbläsern
belohnten	belohnten
verkehrten	verkehrten
der	der
entsündigt	entsündigt
Schwächung	Schwächung
posierst	posierst
Leitungswegs	Leitungswegs
streuen	streuen
ausrufen	ausrufen
leihe	leihe
querte	querte
Knechten	Knechten
Paillette	Paillette
Blütenachse	Blütenachse
Bagger	Bagger
höhnest	höhnest
zerrissen	zerrissen
Anschlägen	Anschlägen
Brikette	Brikette
Leitkegel	Leitkegel
respektierten	respektierten
Willen	Willen
Band	Band
vermahnten	vermahnten
euren	euren
ruhe	ruhe
messet	messet
beleidigst	beleidigst
Fürst	Fürst
trödeltest	trödeltest
frikassiert	frikassiert
bange	bange
Verkehrsflugzeuge	Verkehrsflugzeuge
Amputierten	Amputierten
Staatsführungen	Staatsführungen
musizieret	musizieret
Werk	Werk
aufhebest	aufhebest
Tust	Tust
vollendete	vollendete
regierst	regierst
boß	boß
Hummel	Hummel
verachtet	verachtet
Gebete	Gebete
gewöhnt	gewöhnt
Grizzlybär	Grizzlybär
Hie	Hie
trotze	trotze
würden	würden
stirbt	stirbt
Wiederbelebung	Wiederbelebung
Suche	Suche
Stufe	Stufe
Bluffs	Bluffs
Zankapfel	Zankapfel
Gewalttäter	Gewalttäter
suchst	suchst
Asteroid	Asteroid
verbündest	verbündest
Euphemismen	Euphemismen
Büstenhalters	Büstenhalters
Feldbett	Feldbett
erliegest	erliegest
fallen	fallen
fluktuierte	fluktuierte
schauet	schauet
Eines	Eines
changiere	changiere
schwimmst	schwimmst
Autokraten	Autokraten
gefällt	gefällt
verziehen	verziehen
transportiere	transportiere
pfände	pfände
willst	willst
gelobe	gelobe
Glaubst	Glaubst
Mops	Mops
wehen	wehen
verreisest	verreisest
schnorrest	schnorrest
Männlein	Männlein
zeugen	zeugen
zweiten	zweiten
verdammst	verdammst
wert	wert
freiwilligen	freiwilligen
Diamantringen	Diamantringen
Grabbeltischen	Grabbeltischen
Buch	Buch
auflegt	auflegt
Führe	Führe
Buntspechte	Buntspechte
hieltet	hieltet
Einheimische	Einheimische
Gurt	Gurt
merket	merket
harrtest	harrtest
Bifurkationen	Bifurkationen
zweifeln	zweifeln
erwähnten	erwähnten
beunruhigte	beunruhigte
Feierabend	Feierabend
hattet	hattet
Suchanfrage	Suchanfrage
schämten	schämten
Inkarnationen	Inkarnationen
Decket	Decket
zeiget	zeiget
Treibhausgase	Treibhausgase
Meeren	Meeren
dolmetschst	dolmetschst
Sehne	Sehne
durchzuck	durchzuck
predigt	predigt
erfüllet	erfüllet
Teilen	Teilen
Lärche	Lärche
hilft	hilft
Werte	Werte
Kälber	Kälber
Tumult	Tumult
gebären	gebären
verformen	verformen
sabbre	sabbre
aßet	aßet
Ackerschachtelhalme	Ackerschachtelhalme
verlaßt	verlaßt
anrührte	anrührte
Arm	Arm
sei	sei
prahlte	prahlte
Wir	Wir
Vorhäuten	Vorhäuten
Qualifikationen	Qualifikationen
Polierstählen	Polierstählen
denaturiert	denaturiert
bedürftet	bedürftet
Lärchen	Lärchen
Habt	Habt
würdest	würdest
Denkmünze	Denkmünze
Schamentzündungen	Schamentzündungen
Schilde	Schilde
pilgerte	pilgerte
Samstagnachmittag	Samstagnachmittag
Amputierte	Amputierte
Eingabe	Eingabe
betreten	betreten
säumet	säumet
Laubholz	Laubholz
nehmet	nehmet
Fußballweltmeisterschaftsqualifikationsspielen	Fußballweltmeisterschaftsqualifikationsspielen
Gläubige	Gläubige
Malen	Malen
Berichterstattungen	Berichterstattungen
verdreht	verdreht
schmuste	schmuste
Weiblein	Weiblein
Kriegsknechte	Kriegsknechte
enttäuschtest	enttäuschtest
beweise	beweise
lobet	lobet
fällst	fällst
Herde	Herde
gibt	gibt
umkäme	umkäme
bis	bis
schwangt	schwangt
erstarrten	erstarrten
begrübest	begrübest
Zubrötchen	Zubrötchen
Versorgungen	Versorgungen
Fette	Fette
downloadete	downloadete
haare	haare
einer	einer
Kohle	Kohle
schießen	schießen
Grüße	Grüße
Weinstöcken	Weinstöcken
stapele	stapele
Bube	Bube
filzte	filzte
bekehrte	bekehrte
verabschiedeten	verabschiedeten
addierest	addierest
Mähnenwolf	Mähnenwolf
Hackern	Hackern
zuteil	zuteil
Weißflügelpinguin	Weißflügelpinguin
schlafet	schlafet
Fahlflanken-Ameisenwürgern	Fahlflanken-Ameisenwürgern
Tiefen	Tiefen
verbarg	verbarg
Päckchens	Päckchens
hebst	hebst
Argyroditen	Argyroditen
versüßtet	versüßtet
Deck	Deck
Toypudel	Toypudel
transportierte	transportierte
löge	löge
Autonomien	Autonomien
wohnst	wohnst
Ärztin	Ärztin
Tübinger	Tübinger
schwebte	schwebte
Hochsommern	Hochsommern
Töpfen	Töpfen
zerstreut	zerstreut
Aspartame	Aspartame
Steuerbord	Steuerbord
Wehr	Wehr
verbirgst	verbirgst
entgehst	entgehst
Oxonium	Oxonium
Kernladungszahlen	Kernladungszahlen
Hörspiel	Hörspiel
Hat	Hat
Narkotikum	Narkotikum
begehre	begehre
verkürzten	verkürzten
verdeckte	verdeckte
siegen	siegen
allem	allem
entwickelten	entwickelten
formiret	formiret
Laufringen	Laufringen
Finanzministern	Finanzministern
Aphasie	Aphasie
streifte	streifte
bereiteten	bereiteten
Rechnungen	Rechnungen
verurteilen	verurteilen
Mache	Mache
Schlaraffenlandes	Schlaraffenlandes
Stolz	Stolz
vermagst	vermagst
Crescendo	Crescendo
Aktivist	Aktivist
verseifet	verseifet
Solch	Solch
reformierten	reformierten
bezahlst	bezahlst
Höfe	Höfe
Herbstwinde	Herbstwinde
erklinge	erklinge
sortiert	sortiert
bemühst	bemühst
bedenken	bedenken
Wüsten	Wüsten
Anhängsel	Anhängsel
Gefügen	Gefügen
sage	sage
zerrüttete	zerrüttete
brachen	brachen
Klärungen	Klärungen
Weichloten	Weichloten
Rhabarber	Rhabarber
generalisiert	generalisiert
prostituieret	prostituieret
ehret	ehret
Kaufkraft	Kaufkraft
stoßest	stoßest
begrübe	begrübe
Trioxiden	Trioxiden
machet	machet
Ecken	Ecken
verstehest	verstehest
Biokraftstoffes	Biokraftstoffes
Zerfall	Zerfall
Wechselstube	Wechselstube
Futtermitteln	Futtermitteln
Bällchen	Bällchen
Urologe	Urologe
Elementen	Elementen
posiert	posiert
sitzest	sitzest
bete	bete
knistern	knistern
Gigapascaln	Gigapascaln
strafend	strafend
helft	helft
ziehest	ziehest
Zöpfen	Zöpfen
bekennst	bekennst
Gefäße	Gefäße
klone	klone
leuchten	leuchten
blätteret	blätteret
beschlaget	beschlaget
log	log
erzeigten	erzeigten
schlaget	schlaget
legten	legten
Laiben	Laiben
Kaliumdichromat	Kaliumdichromat
verallgemeinerst	verallgemeinerst
bedeckest	bedeckest
pflügte	pflügte
Fahrzeugkatalysator	Fahrzeugkatalysator
wisperten	wisperten
entgehe	entgehe
Beobachtung	Beobachtung
formulierst	formulierst
stäupten	stäupten
kremierten	kremierten
lauf	lauf
pflanzte	pflanzte
Überziehens	Überziehens
vergibt	vergibt
Stücke	Stücke
deaktivierst	deaktivierst
äussern	äussern
untersagest	untersagest
schaute	schaute
stürzen	stürzen
frommen	frommen
Flöte	Flöte
verwirklicht	verwirklicht
zittertest	zittertest
Bärenfelle	Bärenfelle
Asiatin	Asiatin
schauest	schauest
Kacke	Kacke
Laufring	Laufring
Rechtsruck	Rechtsruck
entstände	entstände
Zwergschwanes	Zwergschwanes
Leichtmetallen	Leichtmetallen
Türklingeln	Türklingeln
Ansteckern	Ansteckern
spannen	spannen
darfst	darfst
Samarskite	Samarskite
Kompass	Kompass
unseres	unseres
vernehmest	vernehmest
Bärte	Bärte
beschottre	beschottre
Luftschiff	Luftschiff
zwänget	zwänget
Fusselbärten	Fusselbärten
Zement	Zement
mögt	mögt
Grabe	Grabe
erwürgest	erwürgest
nehmest	nehmest
Sitz	Sitz
colorierten	colorierten
verdamme	verdamme
misstrauen	misstrauen
Zeitungsente	Zeitungsente
übrigbleibe	übrigbleibe
Artischocken	Artischocken
Zerfällen	Zerfällen
ausfuhr	ausfuhr
ermahnt	ermahnt
fremden	fremden
konnten	konnten
Urbare	Urbare
strecke	strecke
malträtiere	malträtiere
Stolze	Stolze
Apostel	Apostel
Generationen	Generationen
Blockflöte	Blockflöte
Glühwürmchen	Glühwürmchen
Stühlen	Stühlen
Küchenmaschinen	Küchenmaschinen
steinigte	steinigte
vermahnen	vermahnen
gepuddelt	gepuddelt
herrschten	herrschten
schlafe	schlafe
holst	holst
bemächtigte	bemächtigte
optimiert	optimiert
keines	keines
erhöht	erhöht
Gasflaschen	Gasflaschen
höhnte	höhnte
Gegenleistung	Gegenleistung
entfachten	entfachten
verwirft	verwirft
deinen	deinen
trügen	trügen
lebte	lebte
Bombardierungen	Bombardierungen
Plumpsen	Plumpsen
lügt	lügt
verabschiedetet	verabschiedetet
Elstern	Elstern
unseren	unseren
hantierte	hantierte
quantisierte	quantisierte
beanspruchet	beanspruchet
Fellhandschuhen	Fellhandschuhen
Ärztinnen	Ärztinnen
konntest	konntest
henket	henket
kaufst	kaufst
Laufen	Laufen
Weil	Weil
speist	speist
Freunden	Freunden
Mammut	Mammut
Halle	Halle
Verbindungsdraht	Verbindungsdraht
verhörest	verhörest
verlähmt	verlähmt
Stäben	Stäben
polymerisierte	polymerisierte
speise	speise
Fußballweltmeisterschaftsqualifikationsspiel	Fußballweltmeisterschaftsqualifikationsspiel
Unwahrheiten	Unwahrheiten
verfehle	verfehle
Krumen	Krumen
leget	leget
Benzol	Benzol
Lesen	Lesen
erlaubest	erlaubest
versagen	versagen
mampfte	mampfte
Elektronenschale	Elektronenschale
kriegte	kriegte
dein	dein
lieget	lieget
lauft	lauft
Fieberanfall	Fieberanfall
Abbildern	Abbildern
schöpfen	schöpfen
Pianos	Pianos
Spitze	Spitze
Bromidquelle	Bromidquelle
Gipfeltreffen	Gipfeltreffen
Worten	Worten
aufsteht	aufsteht
bewässerest	bewässerest
beschwindele	beschwindele
Füchsin	Füchsin
Werde	Werde
Operationssälen	Operationssälen
Geschäfte	Geschäfte
geraten	geraten
sorgen	sorgen
kabbelnd	kabbelnd
reiche	reiche
Ärzten	Ärzten
Hirten	Hirten
verlobte	verlobte
Apostels	Apostels
beleidige	beleidige
Decks	Decks
feiern	feiern
scheinet	scheinet
Laufet	Laufet
scheu	scheu
Jünglinge	Jünglinge
Atombombe	Atombombe
designiertet	designiertet
geleitest	geleitest
Treppen	Treppen
Koniferen	Koniferen
Werdet	Werdet
Zwingburgen	Zwingburgen
verzögerten	verzögerten
Namen	Namen
widerriefe	widerriefe
sündigt	sündigt
zertifizierst	zertifizierst
Antitranspiranten	Antitranspiranten
jene	jene
regierten	regierten
Farbstoffen	Farbstoffen
Böse	Böse
Pimmel	Pimmel
erwachte	erwachte
Helden	Helden
Gebeten	Gebeten
geliebt	geliebt
trefft	trefft
wünsche	wünsche
benachrichtiget	benachrichtiget
lobte	lobte
verliert	verliert
verifizieret	verifizieret
Herzchen	Herzchen
Däumlings	Däumlings
schicke	schicke
Frage	Frage
massakrierten	massakrierten
tätowiertet	tätowiertet
schauend	schauend
Füchse	Füchse
Kassettenrekordern	Kassettenrekordern
Industrienation	Industrienation
Fülle	Fülle
überfällst	überfällst
berufen	berufen
sprichst	sprichst
destabilisierte	destabilisierte
Leisten	Leisten
Abschirmung	Abschirmung
concessioniert	concessioniert
Besuchen	Besuchen
sterbest	sterbest
verdeckt	verdeckt
Managementsystem	Managementsystem
scheuchten	scheuchten
Körpergeruches	Körpergeruches
verkauften	verkauften
Hinterwäldler	Hinterwäldler
Dithiolan	Dithiolan
Ass	Ass
erriet	erriet
assimiliertest	assimiliertest
Libelle	Libelle
versuchtet	versuchtet
zerfielest	zerfielest
malträtierte	malträtierte
öle	öle
Wisset	Wisset
klemmt	klemmt
schmuggelte	schmuggelte
schaffst	schaffst
unterwerft	unterwerft
Esset	Esset
Bajonette	Bajonette
fragmentiert	fragmentiert
Düften	Düften
preiset	preiset
Scheißkerl	Scheißkerl
changieren	changieren
vereinigte	vereinigte
Stärket	Stärket
verunziere	verunziere
halt	halt
nachwandelte	nachwandelte
Tritte	Tritte
stürze	stürze
beschert	beschert
Technetate	Technetate
zelte	zelte
stiftete	stiftete
meuterest	meuterest
stapften	stapften
nippend	nippend
erfreuen	erfreuen
Weg	Weg
Denunziationen	Denunziationen
irgendeine	irgendeine
Frieden	Frieden
ausgereckte	ausgereckte
Schneidern	Schneidern
neidest	neidest
Paragraphenreiter	Paragraphenreiter
anrichtet	anrichtet
griechischen	griechischen
lade	lade
erwärmet	erwärmet
schickte	schickte
betrete	betrete
häufen	häufen
brennen	brennen
überwachten	überwachten
Alkine	Alkine
verdammet	verdammet
gedenkst	gedenkst
tagest	tagest
gedolmetscht	gedolmetscht
Mäuse	Mäuse
Türkin	Türkin
Mauten	Mauten
besser	besser
emittierte	emittierte
Dobermännern	Dobermännern
quietschest	quietschest
Irrtümern	Irrtümern
Zebrahaies	Zebrahaies
versteckend	versteckend
faschierst	faschierst
toten	toten
tief	tief
Rückweg	Rückweg
verkapselt	verkapselt
fritierst	fritierst
pharyngalisierst	pharyngalisierst
Siglen	Siglen
seinem	seinem
Hirschen	Hirschen
betrübte	betrübte
Fremdwort	Fremdwort
schon	schon
Brauhaus	Brauhaus
zählten	zählten
Reststoffen	Reststoffen
stellen	stellen
Komponistin	Komponistin
Büchereien	Büchereien
Trümmersprachen	Trümmersprachen
Ärzteblatt	Ärzteblatt
Theistinnen	Theistinnen
appellierte	appellierte
Geburtsnamen	Geburtsnamen
verkürzte	verkürzte
fliehe	fliehe
Käsereiben	Käsereiben
mußte	mußte
unser	unser
mampfen	mampfen
Tiefe	Tiefe
Kompromissen	Kompromissen
predigten	predigten
Landstreicher	Landstreicher
bestimmt	bestimmt
Anliegen	Anliegen
Abflug	Abflug
Saget	Saget
Armband	Armband
stille	stille
Silbergeschirr	Silbergeschirr
läute	läute
zensierten	zensierten
bekennt	bekennt
Nussknackern	Nussknackern
grünten	grünten
glänzte	glänzte
überschneidet	überschneidet
Mäusen	Mäusen
Steuerborden	Steuerborden
peilst	peilst
Soge	Soge
überschatteten	überschatteten
kritzeln	kritzeln
zerstückte	zerstückte
Bleigehalt	Bleigehalt
Schlot	Schlot
Flamen	Flamen
ersparen	ersparen
Gedanke	Gedanke
Konzentrate	Konzentrate
injiziert	injiziert
Schwarzseherin	Schwarzseherin
Treppe	Treppe
betrübend	betrübend
Fluorkohlenwasserstoffe	Fluorkohlenwasserstoffe
verbaselte	verbaselte
haltet	haltet
Blicksilber	Blicksilber
recycele	recycele
solche	solche
beschrifteten	beschrifteten
Musters	Musters
kickst	kickst
Flitzer	Flitzer
rotten	rotten
kitzele	kitzele
sehnst	sehnst
entsetzt	entsetzt
Vetter	Vetter
Einrädern	Einrädern
wohnest	wohnest
hauest	hauest
liegen	liegen
duckmäusere	duckmäusere
stimmte	stimmte
Pi	Pi
tappten	tappten
knacktest	knacktest
dürfe	dürfe
ankern	ankern
Türkenbünden	Türkenbünden
Zäumen	Zäumen
Genkinit	Genkinit
Hinkelstein	Hinkelstein
Eiszapfen	Eiszapfen
türmt	türmt
regelten	regelten
Eutektikum	Eutektikum
Protonen	Protonen
sortierte	sortierte
Hinkelsteine	Hinkelsteine
verstand	verstand
Mutagenen	Mutagenen
stapelten	stapelten
Heiratsgut	Heiratsgut
dissentierten	dissentierten
bist	bist
Substanzen	Substanzen
rote	rote
drängst	drängst
Atomphysikern	Atomphysikern
käbbelte	käbbelte
Kalb	Kalb
thematisierte	thematisierte
fluppst	fluppst
Grieße	Grieße
betrübe	betrübe
ihrem	ihrem
lehren	lehren
Extrems	Extrems
Darlegungen	Darlegungen
bewiesen	bewiesen
Felle	Felle
verschicket	verschicket
Kein	Kein
Gesamtmengen	Gesamtmengen
fasse	fasse
hineinbrächten	hineinbrächten
fallt	fallt
preisen	preisen
Dachdeckerin	Dachdeckerin
taufst	taufst
Eiszapfens	Eiszapfens
wehte	wehte
parfümierte	parfümierte
Fromme	Fromme
verunglimpfte	verunglimpfte
blenden	blenden
sollt	sollt
Türkinnen	Türkinnen
Telefonverkäufer	Telefonverkäufer
schmiert	schmiert
Borhydride	Borhydride
kapiertet	kapiertet
Gedrängen	Gedrängen
feiere	feiere
verkürztet	verkürztet
verwechsele	verwechsele
den	den
entwendet	entwendet
erzeige	erzeige
Sternen	Sternen
pflanzest	pflanzest
zagest	zagest
Petersfischen	Petersfischen
steigest	steigest
jedes	jedes
vertrieben	vertrieben
reanimiere	reanimiere
Klauen	Klauen
setztest	setztest
Büsche	Büsche
erzeigt	erzeigt
rüstetet	rüstetet
Riese	Riese
setzet	setzet
Dürre	Dürre
erobern	erobern
saht	saht
All	All
Greyerzer	Greyerzer
Flosse	Flosse
gravierten	gravierten
verwechselet	verwechselet
ruhte	ruhte
Seehechten	Seehechten
besicheret	besicheret
überreichend	überreichend
Piratensendern	Piratensendern
Entsetzt	Entsetzt
überprüftest	überprüftest
concessionieren	concessionieren
erscheine	erscheine
Kommet	Kommet
koche	koche
unehrt	unehrt
vertuest	vertuest
Karern	Karern
herrschest	herrschest
schaue	schaue
Steuerberater	Steuerberater
zürnet	zürnet
fällte	fällte
Abfahrtslisten	Abfahrtslisten
Buchhalterinnen	Buchhalterinnen
Entrées	Entrées
Membran	Membran
Ausnahme	Ausnahme
Trägergas	Trägergas
Käsereibe	Käsereibe
verkürzt	verkürzt
raten	raten
Raute	Raute
mache	mache
Seelöwen	Seelöwen
koexistierte	koexistierte
behütetest	behütetest
Inauguration	Inauguration
Schnittlauche	Schnittlauche
Talismanen	Talismanen
Thioacetal	Thioacetal
Rotgusses	Rotgusses
Stühle	Stühle
Massenanteil	Massenanteil
Geboten	Geboten
Monde	Monde
Rekursion	Rekursion
grausten	grausten
verschlungen	verschlungen
schwöllen	schwöllen
stehest	stehest
dekompiliertest	dekompiliertest
verlähmte	verlähmte
vertäte	vertäte
schnüren	schnüren
Nervenzellen	Nervenzellen
beweisen	beweisen
erstaunst	erstaunst
verkündiget	verkündiget
Bankettes	Bankettes
verhungerte	verhungerte
hatten	hatten
flenstet	flenstet
ermächtige	ermächtige
Magiern	Magiern
löst	löst
Traggasen	Traggasen
plagte	plagte
Junge	Junge
erlagst	erlagst
Westen	Westen
Arsch	Arsch
knautsche	knautsche
naschst	naschst
sponsertest	sponsertest
hickste	hickste
verwaiset	verwaiset
fünften	fünften
einernten	einernten
warst	warst
schwächend	schwächend
zeugtest	zeugtest
Zebrahai	Zebrahai
linstest	linstest
verbrauchet	verbrauchet
vertagt	vertagt
blitzen	blitzen
lösend	lösend
reizte	reizte
imitiertet	imitiertet
entmineralisieren	entmineralisieren
heiligte	heiligte
Nanokondensatoren	Nanokondensatoren
stellte	stellte
rekonstruieret	rekonstruieret
fragen	fragen
verbirgt	verbirgt
verdinglichtest	verdinglichtest
Wandergesellen	Wandergesellen
Tore	Tore
sichten	sichten
Transportwegen	Transportwegen
Judenräte	Judenräte
Gerichte	Gerichte
ducktest	ducktest
tyrannisiertest	tyrannisiertest
dürften	dürften
brausen	brausen
verscheißert	verscheißert
Entmachtungen	Entmachtungen
evaluiert	evaluiert
Zitronensaft	Zitronensaft
Grabbeltisch	Grabbeltisch
binde	binde
schluchzte	schluchzte
straftet	straftet
zerschlagt	zerschlagt
sorget	sorget
Minimierungen	Minimierungen
verletzte	verletzte
