ослабели	ослабели
посрами	посрами
прислуги	прислуги
посвятить	посвятить
добром	добром
поникла	поникла
Божию	Божию
потаенные	потаенные
искусить	искусить
камню	камню
исходила	исходила
спали	спали
небе	небе
любимы	любимы
саранче	саранче
левши	левши
выходят	выходят
смешанная	смешанная
выдайте	выдайте
спаси	спаси
любите	любите
вечера	вечера
обирай	обирай
убили	убили
сказывай	сказывай
отменить	отменить
потаенного	потаенного
тьмы	тьмы
подвигли	подвигли
сделайте	сделайте
внимайте	внимайте
постановить	постановить
заколи	заколи
заходи	заходи
точила	точила
которых	которых
всякою	всякою
собирать	собирать
меха	меха
наушника	наушника
согрешить	согрешить
преуспевать	преуспевать
сварите	сварите
вина	вина
накормить	накормить
крестит	крестит
Кому	Кому
фараоне	фараоне
посохом	посохом
образ	образ
богатых	богатых
наш	наш
Приветствуют	Приветствуют
опустили	опустили
изнеженных	изнеженных
благо	благо
крылом	крылом
сынов	сынов
избило	избило
почиет	почиет
прямою	прямою
жертвами	жертвами
начать	начать
Дух	Дух
поддерживали	поддерживали
возьмем	возьмем
пророчеством	пророчеством
голодных	голодных
всходите	всходите
посадите	посадите
поддерживать	поддерживать
протоках	протоках
Слове	Слове
сказали	сказали
поднятых	поднятых
уха	уха
родит	родит
новых	новых
разбирать	разбирать
слепых	слепых
удерживайте	удерживайте
гумне	гумне
захватила	захватила
возьмете	возьмете
наполнить	наполнить
худо	худо
раздирать	раздирать
прокаженных	прокаженных
переходит	переходит
красоты	красоты
отступить	отступить
проходят	проходят
порази	порази
замечать	замечать
имевшая	имевшая
избавить	избавить
воспоминайте	воспоминайте
мечом	мечом
имело	имело
подкрепили	подкрепили
води	води
узнаешь	узнаешь
набрать	набрать
отходить	отходить
напоены	напоены
вытру	вытру
блаженным	блаженным
Царю	Царю
всякое	всякое
левый	левый
главным	главным
самого	самого
слушай	слушай
вороной	вороной
посетили	посетили
сохранили	сохранили
сосчитать	сосчитать
веса	веса
Тем	Тем
Свою	Свою
пожалело	пожалело
положили	положили
получить	получить
смело	смело
умирающий	умирающий
пророчествуйте	пророчествуйте
чужого	чужого
медлили	медлили
родившая	родившая
жертвах	жертвах
засохло	засохло
траву	траву
шестой	шестой
Жертвы	Жертвы
покрывала	покрывала
пострадали	пострадали
дома	дома
потекли	потекли
сокрытый	сокрытый
низложи	низложи
заключили	заключили
варить	варить
отвратили	отвратили
прислугу	прислугу
спросить	спросить
нагою	нагою
опустошен	опустошен
сложи	сложи
отдали	отдали
протоки	протоки
било	било
этого	этого
царски	царски
кругу	кругу
красный	красный
свободных	свободных
Велики	Велики
немало	немало
превозносить	превозносить
Был	Был
варили	варили
скалах	скалах
превозмогло	превозмогло
соверши	соверши
устройстве	устройстве
Свой	Свой
пропасть	пропасть
болоте	болоте
поручите	поручите
содержали	содержали
войске	войске
пожалеть	пожалеть
Сам	Сам
поднял	поднял
благовестить	благовестить
Галилейской	Галилейской
кропить	кропить
гвозди	гвозди
возросли	возросли
пойте	пойте
приносить	приносить
Словом	Словом
возбудите	возбудите
целых	целых
смущали	смущали
толкали	толкали
медлить	медлить
вмещать	вмещать
открывать	открывать
раздели	раздели
звездах	звездах
сделай	сделай
переносить	переносить
темным	темным
запрети	запрети
сделало	сделало
признали	признали
языков	языков
протяни	протяни
крыло	крыло
страшное	страшное
жемчугом	жемчугом
прославили	прославили
кадите	кадите
жребием	жребием
доходила	доходила
спешила	спешила
подходите	подходите
рассеките	рассеките
носильщиков	носильщиков
осадить	осадить
управляющий	управляющий
лишить	лишить
надел	надел
снисходить	снисходить
разделить	разделить
утру	утру
поручили	поручили
страсти	страсти
белы	белы
обнажен	обнажен
приняло	приняло
черный	черный
переменили	переменили
возьму	возьму
построила	построила
письме	письме
покрывал	покрывал
грабить	грабить
построить	построить
свитке	свитке
оробел	оробел
потерянной	потерянной
сладкое	сладкое
переходили	переходили
неправ	неправ
стояла	стояла
входили	входили
добра	добра
страже	страже
испытанных	испытанных
освободи	освободи
утихло	утихло
мог	мог
буду	буду
отнята	отнята
прекрати	прекрати
красных	красных
спешить	спешить
выговорить	выговорить
известили	известили
смотрите	смотрите
дорогою	дорогою
затрубите	затрубите
открыт	открыт
свободный	свободный
ехидны	ехидны
умирать	умирать
поразили	поразили
затворит	затворит
укрепить	укрепить
поправить	поправить
возгласи	возгласи
лицах	лицах
велят	велят
челах	челах
заколал	заколал
умертвила	умертвила
бесславить	бесславить
богатые	богатые
исполняйте	исполняйте
прокаженные	прокаженные
владеть	владеть
приносила	приносила
лев	лев
вылитая	вылитая
оценили	оценили
пьяного	пьяного
святою	святою
отмени	отмени
принято	принято
благословляй	благословляй
обгорело	обгорело
согласные	согласные
жары	жары
покрой	покрой
вскорми	вскорми
творите	творите
утомленного	утомленного
выступите	выступите
богам	богам
саранча	саранча
отходили	отходили
выбросить	выбросить
уговаривать	уговаривать
рубили	рубили
выполним	выполним
лице	лице
пощади	пощади
умерщвляйте	умерщвляйте
облаке	облаке
братьям	братьям
ослабеть	ослабеть
порядке	порядке
верить	верить
твердым	твердым
брак	брак
тверд	тверд
рули	рули
привалили	привалили
избивать	избивать
звала	звала
проклятого	проклятого
вложили	вложили
красные	красные
внуки	внуки
призрак	призрак
подложи	подложи
своем	своем
начинали	начинали
нашем	нашем
малы	малы
доставляло	доставляло
строила	строила
прямые	прямые
половина	половина
покой	покой
дрогнули	дрогнули
соединился	соединился
слепые	слепые
колене	колене
взять	взять
страхе	страхе
глаза	глаза
выкупите	выкупите
раскрыли	раскрыли
пой	пой
умножили	умножили
повисла	повисла
желающий	желающий
принимайте	принимайте
возносите	возносите
отошли	отошли
вырос	вырос
чужой	чужой
имущество	имущество
утомленный	утомленный
велико	велико
беременные	беременные
исходили	исходили
огорчили	огорчили
исправили	исправили
возьмет	возьмет
немой	немой
отнятого	отнятого
уповали	уповали
приучила	приучила
весом	весом
откажет	откажет
смертные	смертные
победили	победили
молчали	молчали
посылала	посылала
соляною	соляною
внимать	внимать
голодный	голодный
умоляли	умоляли
устроила	устроила
стану	стану
сторожа	сторожа
укрепите	укрепите
поводом	поводом
нечистоту	нечистоту
рабу	рабу
онемеешь	онемеешь
девяноста	девяноста
любимая	любимая
целые	целые
владычествовать	владычествовать
служи	служи
убила	убила
свекровь	свекровь
садился	садился
разных	разных
святом	святом
четвертою	четвертою
доводите	доводите
осквернила	осквернила
скорым	скорым
послужить	послужить
простирай	простирай
страшных	страшных
унизили	унизили
Которого	Которого
опусти	опусти
сокруши	сокруши
потекло	потекло
кругом	кругом
намерен	намерен
жертвам	жертвам
отличить	отличить
обладайте	обладайте
Приветствуй	Приветствуй
дорогой	дорогой
берете	берете
каждое	каждое
родят	родят
молоке	молоке
чудовища	чудовища
золоте	золоте
сберегите	сберегите
твердою	твердою
заключите	заключите
возвестим	возвестим
отвозили	отвозили
совершали	совершали
изливай	изливай
умножали	умножали
огорчали	огорчали
которою	которою
поднимали	поднимали
Даном	Даном
язык	язык
рассудить	рассудить
мала	мала
приносили	приносили
разводите	разводите
четвертой	четвертой
истукану	истукану
духа	духа
заговоришь	заговоришь
строим	строим
услышали	услышали
носила	носила
какой	какой
славословить	славословить
искать	искать
кормить	кормить
уговорить	уговорить
выпал	выпал
последуй	последуй
снохи	снохи
устройством	устройством
реке	реке
красив	красив
воспой	воспой
правых	правых
языком	языком
вытащи	вытащи
нового	нового
известить	известить
святые	святые
сказала	сказала
голубой	голубой
оставится	оставится
обитая	обитая
растили	растили
чтите	чтите
сразила	сразила
отринь	отринь
Рев	Рев
распознаем	распознаем
второй	второй
рассеянным	рассеянным
скованный	скованный
замечайте	замечайте
убийца	убийца
убийцы	убийцы
привалив	привалив
нечист	нечист
почтили	почтили
хотим	хотим
нему	нему
простите	простите
посвяти	посвяти
Благослови	Благослови
ставили	ставили
спрашивать	спрашивать
раздирайте	раздирайте
спрашивай	спрашивай
вытащили	вытащили
минует	минует
горды	горды
оставили	оставили
явить	явить
случай	случай
давили	давили
тысяча	тысяча
жилищам	жилищам
видим	видим
осенила	осенила
знакомых	знакомых
понесло	понесло
благовестием	благовестием
умножить	умножить
схватила	схватила
набрала	набрала
мытаря	мытаря
дерзновением	дерзновением
отдать	отдать
иной	иной
пожирала	пожирала
Бела	Бела
чужою	чужою
срубить	срубить
виден	виден
прилагай	прилагай
молодой	молодой
искусили	искусили
беременную	беременную
можете	можете
мой	мой
приклони	приклони
одру	одру
затрепетали	затрепетали
принять	принять
померкли	померкли
продолжало	продолжало
отцах	отцах
Царя	Царя
сходить	сходить
значить	значить
рыдайте	рыдайте
живою	живою
сохранить	сохранить
отлучить	отлучить
сопровождать	сопровождать
искупить	искупить
устроили	устроили
кормили	кормили
принудить	принудить
раздавали	раздавали
твою	твою
местом	местом
белым	белым
юноше	юноше
хвалите	хвалите
боком	боком
обгорели	обгорели
вороные	вороные
наклонили	наклонили
удерживать	удерживать
возливала	возливала
открой	открой
носильщиками	носильщиками
роста	роста
твердом	твердом
сердечной	сердечной
положила	положила
преследовала	преследовала
каждою	каждою
делить	делить
любимое	любимое
узнай	узнай
берем	берем
убегу	убегу
торгу	торгу
поцелуй	поцелуй
ведите	ведите
Ком	Ком
строили	строили
нехороша	нехороша
предавайте	предавайте
разложите	разложите
отворить	отворить
схоронили	схоронили
предложила	предложила
вымойте	вымойте
возлюбила	возлюбила
перейди	перейди
призванным	призванным
каждым	каждым
безумным	безумным
держали	держали
пейте	пейте
выстрелили	выстрелили
заговорит	заговорит
воссиял	воссиял
истукан	истукан
животным	животным
доставляй	доставляй
Возьмет	Возьмет
напоен	напоен
внукам	внукам
принесло	принесло
живым	живым
обществе	обществе
преступили	преступили
малые	малые
преследуй	преследуй
возлагать	возлагать
повторите	повторите
провозгласить	провозгласить
отстать	отстать
пою	пою
лукавым	лукавым
скованного	скованного
сам	сам
половине	половине
направить	направить
хромые	хромые
заразы	заразы
сокрытой	сокрытой
Велик	Велик
заплатили	заплатили
черным	черным
одолела	одолела
медлите	медлите
беременная	беременная
труби	труби
воссиять	воссиять
приучили	приучили
приветствуй	приветствуй
возвеличился	возвеличился
отправляйте	отправляйте
платили	платили
воронам	воронам
поручали	поручали
потускло	потускло
убитого	убитого
имуществом	имуществом
желало	желало
твердых	твердых
собирали	собирали
изменить	изменить
пролить	пролить
разорите	разорите
скал	скал
Приветствует	Приветствует
может	может
помните	помните
наследуйте	наследуйте
черви	черви
Иудину	Иудину
преданным	преданным
дозволяйте	дозволяйте
Тире	Тире
возлагали	возлагали
изменишь	изменишь
отходите	отходите
чудовище	чудовище
принадлежащие	принадлежащие
смотри	смотри
кому	кому
взывайте	взывайте
пророчествуй	пророчествуй
возьмут	возьмут
помет	помет
намерены	намерены
божество	божество
своротить	своротить
половинах	половинах
посетить	посетить
искушали	искушали
избранное	избранное
благе	благе
попроси	попроси
соблазнили	соблазнили
искало	искало
потом	потом
налагать	налагать
пар	пар
есть	есть
меньше	меньше
одержимых	одержимых
подложили	подложили
сотворили	сотворили
серебре	серебре
кормите	кормите
благослови	благослови
мертвый	мертвый
предавай	предавай
находим	находим
посылать	посылать
начинай	начинай
выливайте	выливайте
родным	родным
облегчи	облегчи
язвами	язвами
обитаем	обитаем
уцелело	уцелело
мечу	мечу
пролили	пролили
мирен	мирен
купили	купили
бабкам	бабкам
изнеженную	изнеженную
покрова	покрова
простертою	простертою
носить	носить
пьяною	пьяною
доходили	доходили
служили	служили
обратила	обратила
литые	литые
освободить	освободить
сирот	сирот
выть	выть
называть	называть
цвет	цвет
посылали	посылали
твердую	твердую
камня	камня
отринут	отринут
засевайте	засевайте
верующий	верующий
купите	купите
станом	станом
рассекали	рассекали
чужое	чужое
преступить	преступить
открывайте	открывайте
открытом	открытом
призывали	призывали
прогоните	прогоните
постигли	постигли
опьянел	опьянел
пленила	пленила
бросила	бросила
выбрасывайте	выбрасывайте
противоречить	противоречить
духом	духом
утвердить	утвердить
умерло	умерло
снимите	снимите
поднята	поднята
ним	ним
можем	можем
открыто	открыто
унывайте	унывайте
выносите	выносите
Тиром	Тиром
творили	творили
безумные	безумные
старых	старых
хромого	хромого
жилами	жилами
благотворите	благотворите
оскудела	оскудела
братьями	братьями
отврати	отврати
животные	животные
половины	половины
отводили	отводили
литого	литого
поставить	поставить
небольшой	небольшой
украсить	украсить
доводить	доводить
ждите	ждите
выдавали	выдавали
вводите	вводите
месте	месте
исполнился	исполнился
отходят	отходят
животного	животного
убитые	убитые
каплет	каплет
худом	худом
поступи	поступи
трубить	трубить
малый	малый
рождайте	рождайте
блаженного	блаженного
очистите	очистите
порти	порти
служанкою	служанкою
расслабленный	расслабленный
твердой	твердой
отдайте	отдайте
раздражали	раздражали
одержимого	одержимого
победить	победить
убедили	убедили
расположи	расположи
согрешив	согрешив
любимых	любимых
осудить	осудить
увеличился	увеличился
выходить	выходить
располагал	располагал
узнают	узнают
оставлять	оставлять
могло	могло
разорить	разорить
сторожам	сторожам
снегом	снегом
жернова	жернова
имеем	имеем
первым	первым
мучили	мучили
язве	язве
языку	языку
овладеть	овладеть
пребывать	пребывать
любимым	любимым
родился	родился
людях	людях
страдающий	страдающий
фараонов	фараонов
соедини	соедини
зимой	зимой
ворон	ворон
заставить	заставить
Жертва	Жертва
мухе	мухе
возливайте	возливайте
учился	учился
служанке	служанке
палить	палить
светили	светили
причинили	причинили
успокоить	успокоить
сел	сел
осмолила	осмолила
могли	могли
последуйте	последуйте
желала	желала
Как	Как
ночного	ночного
тысяче	тысяче
осадили	осадили
иссох	иссох
отвалит	отвалит
язвах	язвах
выслушать	выслушать
голою	голою
лукавый	лукавый
тьма	тьма
было	было
подходили	подходили
пиши	пиши
прикрепи	прикрепи
кадила	кадила
временное	временное
щади	щади
рулем	рулем
ступите	ступите
устав	устав
Мало	Мало
расположите	расположите
управляли	управляли
иные	иные
снабди	снабди
плачу	плачу
выходила	выходила
оно	оно
отпустим	отпустим
проходите	проходите
раздражили	раздражили
произносила	произносила
возбудили	возбудили
весах	весах
возрос	возрос
овладейте	овладейте
Израилеву	Израилеву
мешка	мешка
судив	судив
человеческую	человеческую
исчислить	исчислить
воздухе	воздухе
служить	служить
приготовили	приготовили
новой	новой
отдала	отдала
слепым	слепым
считать	считать
неверные	неверные
запретили	запретили
носите	носите
онемеют	онемеют
считайте	считайте
наложите	наложите
мертвых	мертвых
козлом	козлом
разорили	разорили
восходить	восходить
сделанным	сделанным
голове	голове
поношении	поношении
нехорош	нехорош
смешанные	смешанные
сказывайте	сказывайте
Хвали	Хвали
жди	жди
венцом	венцом
искушай	искушай
лицом	лицом
накормили	накормили
разрушили	разрушили
золотою	золотою
сложить	сложить
произноси	произноси
сирота	сирота
доставили	доставили
старейшины	старейшины
переходите	переходите
бывшая	бывшая
укреплять	укреплять
протоками	протоками
умертви	умертви
одетым	одетым
вспомнила	вспомнила
травы	травы
птенцов	птенцов
напоминайте	напоминайте
Святых	Святых
переходи	переходи
Христом	Христом
купить	купить
вступили	вступили
горькую	горькую
признаешь	признаешь
совершила	совершила
помышлять	помышлять
мыслите	мыслите
суди	суди
тверда	тверда
вывело	вывело
явился	явился
уступи	уступи
пьяный	пьяный
рассеянного	рассеянного
постигла	постигла
пожирать	пожирать
строят	строят
оба	оба
внушить	внушить
прямых	прямых
омывать	омывать
почитает	почитает
Велика	Велика
обнажи	обнажи
придворных	придворных
мухи	мухи
страшился	страшился
празднуй	празднуй
чину	чину
манною	манною
умирали	умирали
другой	другой
последовала	последовала
приветствуют	приветствуют
дайте	дайте
сознает	сознает
молока	молока
наполни	наполни
устрашили	устрашили
подними	подними
успокоили	успокоили
повис	повис
козлов	козлов
страхом	страхом
известите	известите
послужив	послужив
даруй	даруй
проклятых	проклятых
это	это
отведите	отведите
лиц	лиц
чтить	чтить
выкупить	выкупить
соделай	соделай
владычествовали	владычествовали
верха	верха
сокрыт	сокрыт
Мой	Мой
посвятили	посвятили
жила	жила
унизить	унизить
пронзили	пронзили
коленом	коленом
матери	матери
значила	значила
страха	страха
оказывали	оказывали
нечисты	нечисты
пронзила	пронзила
укрепляли	укрепляли
наливала	наливала
истуканом	истуканом
подкрепи	подкрепи
прибыл	прибыл
сварили	сварили
благодарив	благодарив
одинокою	одинокою
располагает	располагает
Возьму	Возьму
истребить	истребить
отсекли	отсекли
обгорела	обгорела
самых	самых
кадить	кадить
отошлите	отошлите
помышляли	помышляли
доказали	доказали
всходили	всходили
покоился	покоился
просили	просили
заколения	заколения
сестры	сестры
благословляйте	благословляйте
срубите	срубите
страшить	страшить
бросали	бросали
град	град
удалился	удалился
Святым	Святым
сосчитали	сосчитали
выходит	выходит
страх	страх
посвятила	посвятила
заходят	заходят
бока	бока
Сию	Сию
приклонили	приклонили
бедный	бедный
весе	весе
скверны	скверны
превозмогла	превозмогла
стражам	стражам
великою	великою
открытого	открытого
содержите	содержите
вела	вела
теснился	теснился
люди	люди
Божием	Божием
родившие	родившие
замер	замер
поразите	поразите
познает	познает
находила	находила
произвела	произвела
превратить	превратить
пленных	пленных
славословили	славословили
возлюбленным	возлюбленным
тысячами	тысячами
впала	впала
Свои	Свои
возлюбленный	возлюбленный
взывать	взывать
одетого	одетого
силе	силе
молодая	молодая
рубить	рубить
немым	немым
голубого	голубого
пощадили	пощадили
страсть	страсть
попускаете	попускаете
проклинать	проклинать
моя	моя
счет	счет
ввело	ввело
находили	находили
воздайте	воздайте
томился	томился
вари	вари
царя	царя
отыщи	отыщи
мертвою	мертвою
познаете	познаете
Хочешь	Хочешь
злодействе	злодействе
тленного	тленного
напоить	напоить
мои	мои
открытую	открытую
зло	зло
узнаем	узнаем
сопровождали	сопровождали
признайте	признайте
жабами	жабами
сказывала	сказывала
построили	построили
погрешите	погрешите
принесем	принесем
блудила	блудила
молился	молился
жабам	жабам
варите	варите
покройте	покройте
Самом	Самом
считает	считает
стражами	стражами
слез	слез
звезду	звезду
умерли	умерли
грабили	грабили
живая	живая
наклони	наклони
Духом	Духом
умертвить	умертвить
Апостол	Апостол
будь	будь
внушили	внушили
изливайте	изливайте
входите	входите
вызывающий	вызывающий
соблюди	соблюди
выдавай	выдавай
червю	червю
наполните	наполните
возносить	возносить
украсила	украсила
низком	низком
извести	извести
сладкие	сладкие
сокрой	сокрой
очистим	очистим
пали	пали
произнеси	произнеси
первою	первою
жил	жил
вступился	вступился
возвестили	возвестили
окружите	окружите
расслабленным	расслабленным
славить	славить
тленным	тленным
фараон	фараон
обманывай	обманывай
вымой	вымой
Твоем	Твоем
разделили	разделили
втором	втором
заключила	заключила
духовные	духовные
отстали	отстали
саранчу	саранчу
выдавать	выдавать
разит	разит
пухла	пухла
лукавые	лукавые
жернов	жернов
передвигает	передвигает
молите	молите
похороните	похороните
исходят	исходят
иная	иная
устрашить	устрашить
ином	ином
услышите	услышите
твердо	твердо
весами	весами
глухого	глухого
считал	считал
вторых	вторых
кадили	кадили
согрешили	согрешили
оставить	оставить
разбросали	разбросали
Силом	Силом
да	да
сделанный	сделанный
Аду	Аду
язву	язву
находят	находят
расти	расти
познаешь	познаешь
лесом	лесом
люби	люби
полы	полы
укрепился	укрепился
наполняло	наполняло
пару	пару
главу	главу
окончила	окончила
берегу	берегу
душа	душа
пожалели	пожалели
повод	повод
глазом	глазом
велите	велите
левою	левою
мозгом	мозгом
подбирать	подбирать
вороны	вороны
рассказывай	рассказывай
богу	богу
попросите	попросите
восхвалили	восхвалили
управляй	управляй
твердые	твердые
положи	положи
крестился	крестился
желчи	желчи
фараоном	фараоном
сердечные	сердечные
нечиста	нечиста
Дине	Дине
госпожи	госпожи
губили	губили
производите	производите
жертве	жертве
камнем	камнем
никакая	никакая
развалиною	развалиною
очисти	очисти
ревнуйте	ревнуйте
обгорел	обгорел
духами	духами
гордо	гордо
козлами	козлами
постигло	постигло
пожалел	пожалел
воротился	воротился
зарыдал	зарыдал
укрепили	укрепили
покрыло	покрыло
взяли	взяли
имеет	имеет
даруешь	даруешь
мертвым	мертвым
рабе	рабе
Самой	Самой
захватили	захватили
какие	какие
нага	нага
ворона	ворона
потаенном	потаенном
беременной	беременной
чудное	чудное
жала	жала
называй	называй
расположили	расположили
наскучил	наскучил
отделите	отделите
Своем	Своем
проклинай	проклинай
спешит	спешит
лукавых	лукавых
возносили	возносили
благословила	благословила
Нового	Нового
входить	входить
какою	какою
отпускать	отпускать
открыть	открыть
заплатить	заплатить
начале	начале
спросите	спросите
возвысили	возвысили
неверующие	неверующие
учите	учите
пола	пола
возноси	возноси
избили	избили
кричали	кричали
превозносился	превозносился
вопрошали	вопрошали
родных	родных
одолело	одолело
воплем	воплем
беременною	беременною
счету	счету
убийством	убийством
добычу	добычу
первое	первое
прекратился	прекратился
минуло	минуло
вопрошать	вопрошать
слеп	слеп
цари	цари
заняты	заняты
онемел	онемел
силу	силу
подтвердить	подтвердить
твои	твои
благовествуй	благовествуй
смертным	смертным
исполнила	исполнила
наставили	наставили
сухой	сухой
жилищ	жилищ
взяла	взяла
реки	реки
крыле	крыле
моря	моря
поднято	поднято
богатым	богатым
откройте	откройте
отдели	отдели
сторожу	сторожу
предложить	предложить
уходили	уходили
убить	убить
имели	имели
спите	спите
переменить	переменить
пригласите	пригласите
Святого	Святого
убегали	убегали
выполняйте	выполняйте
любила	любила
Соляную	Соляную
сделанной	сделанной
распознает	распознает
бери	бери
воплю	воплю
посвятите	посвятите
исследуй	исследуй
утвердился	утвердился
покров	покров
начинайте	начинайте
столах	столах
владейте	владейте
столпе	столпе
поспешили	поспешили
померк	померк
нанять	нанять
Души	Души
малых	малых
бесчестите	бесчестите
лгите	лгите
обирал	обирал
числом	числом
наполнился	наполнился
бедные	бедные
налагайте	налагайте
цвете	цвете
обновить	обновить
вспомните	вспомните
жемчуга	жемчуга
имеют	имеют
перебило	перебило
хулили	хулили
опустошить	опустошить
набрали	набрали
приложить	приложить
раздавить	раздавить
образу	образу
влекло	влекло
царях	царях
зле	зле
спустила	спустила
почитаю	почитаю
рассмотри	рассмотри
скот	скот
осмоли	осмоли
снохе	снохе
осени	осени
избранным	избранным
рак	рак
оказывай	оказывай
челе	челе
никакою	никакою
каждых	каждых
получила	получила
спросила	спросила
который	который
отважился	отважился
воспитывала	воспитывала
ком	ком
Богу	Богу
променять	променять
уцелел	уцелел
храни	храни
просите	просите
одинокую	одинокую
горькая	горькая
волах	волах
объясни	объясни
прочитайте	прочитайте
завещал	завещал
выслушайте	выслушайте
раскрыла	раскрыла
добре	добре
соблазнить	соблазнить
ударить	ударить
находился	находился
померкло	померкло
мозгов	мозгов
отсчитайте	отсчитайте
одинокая	одинокая
старою	старою
носился	носился
начала	начала
возлюбленного	возлюбленного
заразою	заразою
возложили	возложили
простирать	простирать
пило	пило
прибыла	прибыла
пернатых	пернатых
устраните	устраните
доходит	доходит
одушевленных	одушевленных
допустили	допустили
малого	малого
Твой	Твой
исследуйте	исследуйте
вывезли	вывезли
сокрушили	сокрушили
отличен	отличен
подкрепить	подкрепить
утре	утре
богатого	богатого
ослабевайте	ослабевайте
привезла	привезла
заклятого	заклятого
нечистоте	нечистоте
посылайте	посылайте
налагали	налагали
говорила	говорила
подумайте	подумайте
рождала	рождала
наг	наг
подумали	подумали
наступив	наступив
ходи	ходи
честные	честные
ослепили	ослепили
была	была
рождали	рождали
Моя	Моя
жили	жили
среду	среду
избавляйте	избавляйте
пригласи	пригласи
венца	венца
самом	самом
прикрепила	прикрепила
посвящали	посвящали
спустили	спустили
старые	старые
научили	научили
вкусили	вкусили
спешите	спешите
предавать	предавать
образуем	образуем
умертвите	умертвите
восклицать	восклицать
поглотили	поглотили
лукавого	лукавого
святая	святая
выходим	выходим
перемените	перемените
восстановите	восстановите
почиешь	почиешь
соблюдите	соблюдите
возьми	возьми
наложили	наложили
родишь	родишь
поступали	поступали
смешанною	смешанною
приобрела	приобрела
преданный	преданный
обманывайте	обманывайте
напоминать	напоминать
молодую	молодую
искушать	искушать
предали	предали
подпал	подпал
смешанное	смешанное
камни	камни
блудить	блудить
тьмою	тьмою
правый	правый
подтвердили	подтвердили
переспит	переспит
временные	временные
посмотри	посмотри
уведомить	уведомить
выкупи	выкупи
злодейством	злодейством
зеленого	зеленого
домом	домом
стоят	стоят
пролился	пролился
громов	громов
сладкого	сладкого
терпи	терпи
соединить	соединить
молили	молили
соорудили	соорудили
обходите	обходите
бить	бить
половину	половину
головах	головах
которая	которая
головы	головы
поту	поту
живом	живом
узнайте	узнайте
устроить	устроить
слезу	слезу
кропили	кропили
вы	вы
просить	просить
пели	пели
молодого	молодого
согласился	согласился
небом	небом
принимали	принимали
поешь	поешь
городом	городом
слушать	слушать
откормленные	откормленные
принеси	принеси
обольстила	обольстила
сходим	сходим
иным	иным
рои	рои
бесславием	бесславием
мутить	мутить
объявила	объявила
наставить	наставить
думайте	думайте
слышим	слышим
почитал	почитал
провозгласите	провозгласите
вопросили	вопросили
брака	брака
предложили	предложили
наклонился	наклонился
срамили	срамили
спрятала	спрятала
другого	другого
проповедуйте	проповедуйте
первые	первые
подкрепите	подкрепите
похвалился	похвалился
находить	находить
грешили	грешили
право	право
разить	разить
благодарить	благодарить
иссохло	иссохло
Белы	Белы
прославляй	прославляй
имея	имея
приложили	приложили
первого	первого
изгоняйте	изгоняйте
плечом	плечом
рассудили	рассудили
осквернить	осквернить
отяготили	отяготили
нечистою	нечистою
проводили	проводили
охраняющий	охраняющий
овладел	овладел
если	если
затрубили	затрубили
пишем	пишем
благотворить	благотворить
рубите	рубите
возлюбите	возлюбите
пленный	пленный
подражали	подражали
сохраните	сохраните
мечи	мечи
слушали	слушали
вноси	вноси
никакой	никакой
превратили	превратили
явили	явили
избранная	избранная
путем	путем
перехватили	перехватили
почетных	почетных
изгнали	изгнали
рассмотрите	рассмотрите
восхвалите	восхвалите
скалами	скалами
познаем	познаем
Марка	Марка
узнать	узнать
лишен	лишен
образа	образа
красоте	красоте
выводить	выводить
имеющий	имеющий
тысячам	тысячам
миру	миру
старое	старое
внука	внука
призраку	призраку
громом	громом
стеснили	стеснили
мужчинах	мужчинах
положите	положите
простираешь	простираешь
яви	яви
получали	получали
овнов	овнов
серебром	серебром
сделали	сделали
мучить	мучить
умножила	умножила
простертая	простертая
каждую	каждую
скрывать	скрывать
точиле	точиле
навык	навык
кончен	кончен
хочешь	хочешь
поехали	поехали
щадите	щадите
побили	побили
страж	страж
истребила	истребила
встали	встали
жабы	жабы
прости	прости
козлу	козлу
нарушили	нарушили
быть	быть
терпите	терпите
узнали	узнали
освятите	освятите
хранить	хранить
толки	толки
скрытая	скрытая
восстановим	восстановим
торжествуйте	торжествуйте
изнеженный	изнеженный
еси	еси
пример	пример
уповайте	уповайте
выводит	выводит
теснить	теснить
золотом	золотом
выросли	выросли
хромых	хромых
подняли	подняли
голодного	голодного
вступите	вступите
пухли	пухли
белых	белых
двором	двором
Хочет	Хочет
пронзить	пронзить
языческой	языческой
запрудили	запрудили
противоречили	противоречили
Буду	Буду
уходить	уходить
доставляла	доставляла
Самая	Самая
признаю	признаю
посвящай	посвящай
отходила	отходила
землетрясении	землетрясении
язычески	язычески
отвратите	отвратите
рабах	рабах
голодные	голодные
тверди	тверди
одолели	одолели
прогони	прогони
смешанных	смешанных
похитили	похитили
почитайте	почитайте
возвратить	возвратить
половиною	половиною
пили	пили
болотом	болотом
святого	святого
испортите	испортите
исполняй	исполняй
желали	желали
помета	помета
цветами	цветами
Дан	Дан
избивали	избивали
вопрошающий	вопрошающий
окропили	окропили
морю	морю
свитком	свитком
оценить	оценить
доносят	доносят
желай	желай
предавали	предавали
погасили	погасили
изменился	изменился
испытывайте	испытывайте
забытых	забытых
совершили	совершили
называли	называли
предупредили	предупредили
большом	большом
рад	рад
бесноватый	бесноватый
отнесла	отнесла
оставляйте	оставляйте
неверен	неверен
гусеницы	гусеницы
заключи	заключи
спроси	спроси
тельцу	тельцу
счетом	счетом
убитый	убитый
сердечным	сердечным
восстал	восстал
как	как
поступили	поступили
Оно	Оно
чужую	чужую
больного	больного
проходить	проходить
жертв	жертв
нечистой	нечистой
осади	осади
побить	побить
сатану	сатану
обольстили	обольстили
покрою	покрою
отсчитать	отсчитать
разговаривают	разговаривают
рассказывали	рассказывали
молодые	молодые
язвам	язвам
разори	разори
девяносто	девяносто
мало	мало
управлять	управлять
проезжал	проезжал
пил	пил
убийц	убийц
душе	душе
почти	почти
иное	иное
тварь	тварь
дало	дало
дополните	дополните
продолжала	продолжала
которого	которого
знакомые	знакомые
граде	граде
горькой	горькой
снисходите	снисходите
избранные	избранные
связанные	связанные
ослабела	ослабела
Твоя	Твоя
человеческою	человеческою
роду	роду
видите	видите
чудные	чудные
затворив	затворив
самою	самою
небольшую	небольшую
снабдили	снабдили
души	души
Будь	Будь
отягощать	отягощать
искушайте	искушайте
управляем	управляем
вине	вине
перехватите	перехватите
поспешив	поспешив
продолжай	продолжай
помнила	помнила
омыть	омыть
сходишь	сходишь
плече	плече
выходите	выходите
заходить	заходить
убитою	убитою
паре	паре
кончили	кончили
Начало	Начало
Мои	Мои
томить	томить
окружили	окружили
располагая	располагая
Самый	Самый
Приветствуйте	Приветствуйте
взял	взял
помышляйте	помышляйте
духов	духов
выводи	выводи
вечером	вечером
сладкою	сладкою
поразить	поразить
вопросите	вопросите
Моем	Моем
обветшало	обветшало
устроен	устроен
судить	судить
выведите	выведите
каждая	каждая
ожесточите	ожесточите
божеству	божеству
уразумел	уразумел
охраняй	охраняй
гусенице	гусенице
выстрели	выстрели
разбили	разбили
воздай	воздай
хотят	хотят
обличи	обличи
жертва	жертва
влекла	влекла
возлагай	возлагай
лица	лица
простирал	простирал
века	века
Бог	Бог
рассудите	рассудите
счете	счете
останови	останови
хвалился	хвалился
огорчен	огорчен
ищи	ищи
отними	отними
письмом	письмом
каков	каков
искала	искала
выполнить	выполнить
гвоздем	гвоздем
выбросите	выбросите
блуди	блуди
Душа	Душа
удалить	удалить
узнала	узнала
наполняйте	наполняйте
срамить	срамить
похулили	похулили
тайною	тайною
принят	принят
смертного	смертного
второю	второю
вложить	вложить
растила	растила
аспид	аспид
дрогнуло	дрогнуло
возливать	возливать
считаешь	считаешь
голосом	голосом
отняты	отняты
отцов	отцов
приступили	приступили
свободным	свободным
озере	озере
которой	которой
морскою	морскою
хулить	хулить
вдовы	вдовы
усилить	усилить
занятые	занятые
животных	животных
пожалуйте	пожалуйте
могут	могут
новые	новые
хромым	хромым
целую	целую
возвращен	возвращен
прям	прям
одет	одет
засохла	засохла
хранили	хранили
уговори	уговори
столпом	столпом
Галилейскую	Галилейскую
переходят	переходят
устранить	устранить
избранной	избранной
легкое	легкое
составить	составить
трава	трава
округ	округ
утаить	утаить
засохли	засохли
извратить	извратить
отсеки	отсеки
гумном	гумном
познай	познай
побила	побила
отвозят	отвозят
порядку	порядку
скрывай	скрывай
населенные	населенные
уходят	уходят
откормленный	откормленный
уходит	уходит
запретить	запретить
голоса	голоса
верх	верх
признать	признать
Воздай	Воздай
выбрасывать	выбрасывать
зеленых	зеленых
лицу	лицу
заключить	заключить
ревнуй	ревнуй
укрепи	укрепи
избранных	избранных
Благ	Благ
пред	пред
пригласили	пригласили
тысяч	тысяч
совершить	совершить
мытарь	мытарь
пища	пища
скрытые	скрытые
чужом	чужом
отложи	отложи
отходит	отходит
аспидов	аспидов
немого	немого
целовала	целовала
принятые	принятые
рогом	рогом
восстановили	восстановили
голодным	голодным
остановили	остановили
бесноватого	бесноватого
почитаете	почитаете
пребывали	пребывали
хотите	хотите
сироту	сироту
просты	просты
вступить	вступить
смутить	смутить
поехал	поехал
открытое	открытое
соделаю	соделаю
рада	рада
теста	теста
бесчестить	бесчестить
завещаю	завещаю
держите	держите
молотить	молотить
выполняла	выполняла
левша	левша
приводить	приводить
главные	главные
почитали	почитали
дворах	дворах
приложите	приложите
сходила	сходила
Иудин	Иудин
поднят	поднят
удержали	удержали
разбросайте	разбросайте
замеси	замеси
избранного	избранного
попросили	попросили
проповедуй	проповедуй
хвалить	хвалить
лишили	лишили
ехидна	ехидна
собирала	собирала
вносите	вносите
обратить	обратить
разрушить	разрушить
призывайте	призывайте
второе	второе
подтверди	подтверди
венце	венце
похвалить	похвалить
узнаю	узнаю
смирить	смирить
почетном	почетном
отправили	отправили
Возлюбленный	Возлюбленный
умер	умер
овцою	овцою
саранчою	саранчою
гордою	гордою
нарушить	нарушить
какого	какого
пройду	пройду
дороге	дороге
постыдить	постыдить
одолеть	одолеть
новым	новым
раздирающий	раздирающий
приветствующий	приветствующий
отдало	отдало
отправился	отправился
пас	пас
остановить	остановить
попускаешь	попускаешь
расположен	расположен
поселить	поселить
очистили	очистили
любимой	любимой
положить	положить
сосчитай	сосчитай
погасить	погасить
рассказывайте	рассказывайте
шипов	шипов
предсказывайте	предсказывайте
сравнить	сравнить
родить	родить
обветшала	обветшала
делили	делили
приветствовал	приветствовал
нашла	нашла
нехороши	нехороши
крестишь	крестишь
твори	твори
вынеси	вынеси
торжествуй	торжествуй
целое	целое
тельцами	тельцами
вышло	вышло
повороти	повороти
немых	немых
направился	направился
знакомого	знакомого
трубите	трубите
ходу	ходу
главного	главного
подумал	подумал
удерживали	удерживали
сходят	сходят
реши	реши
молоти	молоти
звезда	звезда
открытой	открытой
больных	больных
напоили	напоили
звезде	звезде
любили	любили
Христа	Христа
одни	одни
тысячах	тысячах
поправили	поправили
исчислите	исчислите
пустою	пустою
свои	свои
надевай	надевай
помни	помни
ждали	ждали
большую	большую
разбудила	разбудила
поступить	поступить
Знаем	Знаем
сделала	сделала
сходите	сходите
Соляной	Соляной
подпали	подпали
сатане	сатане
отлучите	отлучите
легкие	легкие
множеством	множеством
морскую	морскую
рыдали	рыдали
невежды	невежды
Матерь	Матерь
окончить	окончить
стоим	стоим
выкопай	выкопай
благословить	благословить
Адам	Адам
растить	растить
сотворите	сотворите
подражать	подражать
юношах	юношах
требуйте	требуйте
Он	Он
воздать	воздать
уменьши	уменьши
пить	пить
принята	принята
сказывали	сказывали
избить	избить
всем	всем
пересчитайте	пересчитайте
заплати	заплати
исполним	исполним
льстили	льстили
исполнили	исполнили
поместить	поместить
Какая	Какая
окропи	окропи
Благословите	Благословите
странствующий	странствующий
благом	благом
научен	научен
произносите	произносите
имейте	имейте
хотела	хотела
Возлюбленном	Возлюбленном
доказать	доказать
числе	числе
принимала	принимала
свободные	свободные
простертым	простертым
пленным	пленным
убийце	убийце
приносите	приносите
возбудить	возбудить
занято	занято
написанное	написанное
мстили	мстили
бабке	бабке
ела	ела
налетели	налетели
ваш	ваш
рта	рта
Богов	Богов
проводит	проводит
спросили	спросили
наступите	наступите
расслабленных	расслабленных
можешь	можешь
посмотрите	посмотрите
написал	написал
приклоните	приклоните
живой	живой
пророчестве	пророчестве
голов	голов
выстроить	выстроить
благословлять	благословлять
мешке	мешке
ужина	ужина
воскури	воскури
окружила	окружила
облаком	облаком
молила	молила
мстите	мстите
новом	новом
Твою	Твою
изливали	изливали
Реву	Реву
жилищу	жилищу
отпустите	отпустите
бросили	бросили
созрели	созрели
навести	навести
оставляй	оставляй
глухою	глухою
стражи	стражи
сокрушите	сокрушите
поверить	поверить
покрывали	покрывали
хромой	хромой
возвести	возвести
повредили	повредили
умоляй	умоляй
посрамить	посрамить
опустошили	опустошили
духе	духе
правым	правым
принимать	принимать
Сия	Сия
слушала	слушала
окружали	окружали
возлюбленных	возлюбленных
поглотить	поглотить
открывай	открывай
сохраняла	сохраняла
проводить	проводить
обходить	обходить
приходили	приходили
вином	вином
узнаете	узнаете
бичом	бичом
пояса	пояса
цвета	цвета
ставить	ставить
озером	озером
белый	белый
смешанный	смешанный
затыкает	затыкает
желчь	желчь
отложили	отложили
черные	черные
Израилевой	Израилевой
приноси	приноси
доброю	доброю
подарила	подарила
решите	решите
покровом	покровом
сотворила	сотворила
схватить	схватить
семейством	семейством
благи	благи
запрудите	запрудите
последовало	последовало
омывали	омывали
веди	веди
убогого	убогого
само	само
отличился	отличился
утомленных	утомленных
поем	поем
вину	вину
сейте	сейте
золота	золота
разделила	разделила
началом	началом
путевые	путевые
открыли	открыли
Начала	Начала
чада	чада
разным	разным
сухою	сухою
судите	судите
посадить	посадить
выводили	выводили
обрезывали	обрезывали
чинили	чинили
жали	жали
отыщите	отыщите
сбереги	сбереги
возлюбленной	возлюбленной
прочитать	прочитать
чад	чад
осквернили	осквернили
протянут	протянут
имевшие	имевшие
похули	похули
взяло	взяло
бедного	бедного
выносили	выносили
птичкою	птичкою
пьяные	пьяные
срубили	срубили
держи	держи
возвысить	возвысить
выдай	выдай
Иудиной	Иудиной
Благо	Благо
избавлять	избавлять
зарыдали	зарыдали
последовали	последовали
изменит	изменит
чужие	чужие
целовать	целовать
Дина	Дина
почитают	почитают
согрешите	согрешите
мертво	мертво
обольстить	обольстить
возлюбленною	возлюбленною
выносит	выносит
служите	служите
сатана	сатана
пути	пути
выстроили	выстроили
тени	тени
празднуйте	празднуйте
приобрели	приобрели
сходит	сходит
сравните	сравните
вспомнили	вспомнили
Силе	Силе
приготовить	приготовить
сверкающий	сверкающий
произвело	произвело
вывели	вывели
большая	большая
положен	положен
скотом	скотом
подражайте	подражайте
святую	святую
проклятую	проклятую
узнает	узнает
смешанного	смешанного
покрывать	покрывать
страшного	страшного
другая	другая
пожалуй	пожалуй
отягощай	отягощай
богами	богами
Духе	Духе
доставить	доставить
впал	впал
оставила	оставила
бесовскую	бесовскую
вес	вес
научился	научился
открытым	открытым
по	по
поносить	поносить
споры	споры
поноси	поноси
покрыли	покрыли
разгласили	разгласили
поразила	поразила
велик	велик
вкусите	вкусите
заколают	заколают
Знайте	Знайте
Сеном	Сеном
взывали	взывали
сами	сами
дозволяй	дозволяй
превозмогли	превозмогли
проси	проси
обратился	обратился
сатаною	сатаною
тайна	тайна
теле	теле
надевать	надевать
таланту	таланту
добыча	добыча
сохрани	сохрани
спрятали	спрятали
лишился	лишился
великую	великую
принесли	принесли
прославить	прославить
прямой	прямой
самым	самым
Святом	Святом
превозносите	превозносите
молчите	молчите
затворила	затворила
полированной	полированной
Хвалите	Хвалите
спасу	спасу
самый	самый
прибыли	прибыли
глазу	глазу
мысли	мысли
добро	добро
возложить	возложить
мучила	мучила
Будет	Будет
потерянною	потерянною
молодых	молодых
погубить	погубить
Христе	Христе
огорчился	огорчился
человеческой	человеческой
воспитанные	воспитанные
восходите	восходите
погубите	погубите
любим	любим
нечистым	нечистым
сей	сей
рабы	рабы
посети	посети
обществом	обществом
вызывали	вызывали
поясом	поясом
блаженных	блаженных
тысяченачальникам	тысяченачальникам
белого	белого
познала	познала
меньшая	меньшая
собирайте	собирайте
образом	образом
отправляли	отправляли
ничтожества	ничтожества
доносили	доносили
отсчитай	отсчитай
удалите	удалите
принудили	принудили
губи	губи
правого	правого
котлов	котлов
самая	самая
скверною	скверною
морем	морем
исцелить	исцелить
принадлежащую	принадлежащую
бела	бела
семействе	семействе
сокрушен	сокрушен
проклятою	проклятою
пасли	пасли
имеешь	имеешь
наги	наги
водить	водить
родословные	родословные
Боге	Боге
благ	благ
поднять	поднять
обитали	обитали
язв	язв
производить	производить
Ханаанскою	Ханаанскою
первых	первых
заключен	заключен
плену	плену
лежите	лежите
простертого	простертого
низринут	низринут
вопроси	вопроси
Слушайте	Слушайте
направили	направили
уразумели	уразумели
выступили	выступили
уповать	уповать
мужчины	мужчины
считают	считают
поспешите	поспешите
молоком	молоком
сокрытую	сокрытую
расспроси	расспроси
палит	палит
сухая	сухая
всю	всю
изгоняли	изгоняли
навыком	навыком
обгорелою	обгорелою
ходить	ходить
путевой	путевой
встал	встал
оных	оных
подносят	подносят
проток	проток
освятили	освятили
сестре	сестре
признают	признают
Богом	Богом
дереве	дереве
золото	золото
полу	полу
мертвые	мертвые
вывез	вывез
большою	большою
царю	царю
возлюбили	возлюбили
исцели	исцели
познайте	познайте
сироты	сироты
пчелы	пчелы
сынах	сынах
завладеть	завладеть
червь	червь
дворами	дворами
простирает	простирает
возлюбленную	возлюбленную
аспиды	аспиды
думали	думали
защищать	защищать
раздражить	раздражить
будешь	будешь
разгласите	разгласите
будете	будете
звали	звали
прославлять	прославлять
завладейте	завладейте
слепого	слепого
отяжелело	отяжелело
презирать	презирать
поручен	поручен
надеть	надеть
бывшую	бывшую
языческую	языческую
разбить	разбить
бесовской	бесовской
мертвого	мертвого
воспитывали	воспитывали
уразуметь	уразуметь
век	век
проклят	проклят
смел	смел
черта	черта
множестве	множестве
Можешь	Можешь
подходить	подходить
прокаженным	прокаженным
спорить	спорить
объяви	объяви
проводят	проводят
граду	граду
написать	написать
красоту	красоту
грешить	грешить
скоте	скоте
повторили	повторили
возлюби	возлюби
отложите	отложите
малым	малым
иссохли	иссохли
малом	малом
разрушен	разрушен
обложили	обложили
пчеле	пчеле
принимай	принимай
Духу	Духу
насади	насади
злословили	злословили
злом	злом
ворону	ворону
разбила	разбила
глухие	глухие
нечистота	нечистота
повредить	повредить
похитила	похитила
телом	телом
составили	составили
веке	веке
богом	богом
погубили	погубили
правые	правые
отправлять	отправлять
молодом	молодом
слушало	слушало
выливай	выливай
тестом	тестом
пройди	пройди
чью	чью
обложи	обложи
отвалят	отвалят
кричите	кричите
бросить	бросить
смешанной	смешанной
хочет	хочет
заклятым	заклятым
Бога	Бога
проклинали	проклинали
блудили	блудили
ввели	ввели
рождать	рождать
выслушали	выслушали
целом	целом
сухие	сухие
распознать	распознать
превозносили	превозносили
которую	которую
полюби	полюби
понесли	понесли
верху	верху
славили	славили
извратила	извратила
прямым	прямым
пары	пары
повторился	повторился
ухом	ухом
изменили	изменили
скрепите	скрепите
посох	посох
затрепетал	затрепетал
берет	берет
говори	говори
возврати	возврати
владели	владели
перебить	перебить
схватили	схватили
оном	оном
вводили	вводили
подарили	подарили
тельцов	тельцов
вредить	вредить
счета	счета
переносим	переносим
уразумейте	уразумейте
возлег	возлег
овнами	овнами
воспоминать	воспоминать
неверующая	неверующая
села	села
допустила	допустила
права	права
низложить	низложить
пленные	пленные
ртом	ртом
любимый	любимый
желать	желать
похвалили	похвалили
льстить	льстить
живые	живые
ослабевать	ослабевать
объяснить	объяснить
раскрытая	раскрытая
вторым	вторым
беременных	беременных
поносили	поносили
округа	округа
вопросить	вопросить
собранные	собранные
доводит	доводит
отделили	отделили
дворе	дворе
дщери	дщери
схоронить	схоронить
раскрытую	раскрытую
проходит	проходит
освятить	освятить
начало	начало
одержимая	одержимая
горькою	горькою
обличить	обличить
губить	губить
гусеница	гусеница
налетело	налетело
истребите	истребите
привалите	привалите
родили	родили
засевай	засевай
убийстве	убийстве
пьяных	пьяных
выслушай	выслушай
пропасти	пропасти
утвердили	утвердили
твари	твари
вышли	вышли
козлах	козлах
унывали	унывали
соделается	соделается
мал	мал
белые	белые
возмутили	возмутили
предложи	предложи
налагала	налагала
хром	хром
мучился	мучился
похоронен	похоронен
неверных	неверных
сходили	сходили
воспойте	воспойте
манны	манны
рассеянный	рассеянный
смели	смели
приступить	приступить
преследовали	преследовали
исходит	исходит
стоишь	стоишь
Рабы	Рабы
бросился	бросился
ваше	ваше
темных	темных
вспомни	вспомни
омыли	омыли
отнесли	отнесли
возложи	возложи
зелени	зелени
войска	войска
самое	самое
примером	примером
оскудели	оскудели
слепой	слепой
утих	утих
скрепить	скрепить
ночное	ночное
приложился	приложился
были	были
столе	столе
полюбила	полюбила
пока	пока
созывать	созывать
сокройте	сокройте
заставили	заставили
правою	правою
обратите	обратите
открывали	открывали
поручился	поручился
строишь	строишь
своротила	своротила
одною	одною
учили	учили
шестом	шестом
черту	черту
рой	рой
стояли	стояли
животное	животное
наскучили	наскучили
образует	образует
поглотила	поглотила
одетые	одетые
благословите	благословите
попускал	попускал
отправить	отправить
поднимите	поднимите
освети	освети
заколали	заколали
стеснен	стеснен
платить	платить
населенный	населенный
подняло	подняло
жило	жило
купила	купила
проклинайте	проклинайте
уходите	уходите
преуспевали	преуспевали
будем	будем
говорили	говорили
произнесли	произнесли
оскверните	оскверните
птенцах	птенцах
Христу	Христу
умертвили	умертвили
воспитанный	воспитанный
пила	пила
давить	давить
убит	убит
малое	малое
встретили	встретили
страдали	страдали
яме	яме
возьмешь	возьмешь
сосчитайте	сосчитайте
Силу	Силу
начерпала	начерпала
приветствуете	приветствуете
страшным	страшным
приняла	приняла
расслабленные	расслабленные
торжествующий	торжествующий
полированную	полированную
тесните	тесните
богатый	богатый
отнятых	отнятых
научите	научите
долги	долги
поставила	поставила
затворите	затворите
творить	творить
расспросите	расспросите
велишь	велишь
благовествуйте	благовествуйте
расположился	расположился
сажали	сажали
соляным	соляным
откажу	откажу
осудили	осудили
променяли	променяли
исцеляйте	исцеляйте
приводили	приводили
твоя	твоя
судили	судили
долга	долга
обвинить	обвинить
наполнила	наполнила
последовать	последовать
избавился	избавился
бич	бич
чудным	чудным
вытрут	вытрут
огорчить	огорчить
бабки	бабки
дай	дай
согласного	согласного
придворным	придворным
аспидом	аспидом
города	города
которые	которые
ступили	ступили
помнили	помнили
воздала	воздала
сруби	сруби
искали	искали
призывать	призывать
берега	берега
хулите	хулите
отяжелели	отяжелели
жив	жив
строить	строить
головами	головами
объявить	объявить
говорите	говорите
рыдать	рыдать
окончи	окончи
низринь	низринь
иного	иного
влекли	влекли
старого	старого
берег	берег
изливать	изливать
смущен	смущен
язвы	язвы
козлам	козлам
одре	одре
накорми	накорми
моем	моем
платите	платите
утаили	утаили
дщерь	дщерь
возливай	возливай
хотели	хотели
пара	пара
трубили	трубили
невеждам	невеждам
злак	злак
Воздайте	Воздайте
проходишь	проходишь
созывайте	созывайте
невежд	невежд
ними	ними
просила	просила
исполнить	исполнить
звезд	звезд
возложите	возложите
блага	блага
определить	определить
словом	словом
утвердите	утвердите
сразился	сразился
аспида	аспида
безумных	безумных
поддерживайте	поддерживайте
воронов	воронов
удерживай	удерживай
наши	наши
выходишь	выходишь
возложила	возложила
воскурить	воскурить
богах	богах
связанного	связанного
помнить	помнить
разговаривал	разговаривал
растворила	растворила
воссияло	воссияло
поникли	поникли
отпустить	отпустить
проходи	проходи
произносили	произносили
духовным	духовным
охраняйте	охраняйте
возросло	возросло
ужин	ужин
вороти	вороти
восклицали	восклицали
расслабленного	расслабленного
пух	пух
возвестите	возвестите
точило	точило
перебили	перебили
делали	делали
простирала	простирала
благодарите	благодарите
разводить	разводить
живых	живых
отвратить	отвратить
подносить	подносить
возлюбленные	возлюбленные
почтить	почтить
любимую	любимую
приклонить	приклонить
внимали	внимали
говорить	говорить
прилагать	прилагать
пьем	пьем
заколите	заколите
петля	петля
домой	домой
сказать	сказать
сходи	сходи
исполни	исполни
учить	учить
леса	леса
растворить	растворить
разграбили	разграбили
отпускайте	отпускайте
хочу	хочу
презирали	презирали
сели	сели
Можете	Можете
объявите	объявите
отпусти	отпусти
вели	вели
второго	второго
Какое	Какое
испытанного	испытанного
могу	могу
затворили	затворили
рака	рака
рассеянных	рассеянных
наследуешь	наследуешь
тельцам	тельцам
выходи	выходи
познать	познать
отделен	отделен
бесноватые	бесноватые
бесчести	бесчести
спорите	спорите
похоронить	похоронить
больные	больные
верили	верили
бесноватых	бесноватых
жертвы	жертвы
призванные	призванные
выходили	выходили
гола	гола
никакое	никакое
признает	признает
заклятое	заклятое
добыч	добыч
замолчали	замолчали
познают	познают
молодым	молодым
окружить	окружить
отнято	отнято
вкусить	вкусить
мутите	мутите
скрытых	скрытых
поворотить	поворотить
одетый	одетый
светить	светить
жилой	жилой
творила	творила
совершите	совершите
торга	торга
пьющий	пьющий
честным	честным
переноси	переноси
Духа	Духа
наняли	наняли
захватить	захватить
избавили	избавили
замесила	замесила
созрела	созрела
допускала	допускала
погряз	погряз
ели	ели
прославляли	прославляли
связанных	связанных
утром	утром
большого	большого
родила	родила
войском	войском
деревом	деревом
благую	благую
напоминай	напоминай
открытою	открытою
уверен	уверен
отнимите	отнимите
петь	петь
дополнить	дополнить
фараону	фараону
простирали	простирали
приветствовала	приветствовала
преданного	преданного
выкупали	выкупали
били	били
обходили	обходили
упоминайте	упоминайте
литых	литых
поцелую	поцелую
замерло	замерло
имеете	имеете
белою	белою
закрою	закрою
будет	будет
наполнили	наполнили
отступив	отступив
разрешить	разрешить
сестрою	сестрою
утверди	утверди
мыслить	мыслить
грешите	грешите
пребывайте	пребывайте
назидая	назидая
затыкали	затыкали
Теми	Теми
случая	случая
убогие	убогие
опьянейте	опьянейте
черных	черных
божества	божества
уходи	уходи
поя	поя
убитой	убитой
духам	духам
поговорив	поговорив
получите	получите
привезли	привезли
защитить	защитить
каждой	каждой
худ	худ
дерзновении	дерзновении
вин	вин
бога	бога
большой	большой
жару	жару
обложила	обложила
сказало	сказало
преследуйте	преследуйте
садите	садите
храните	храните
ходили	ходили
уступили	уступили
провозгласи	провозгласи
напоила	напоила
поставили	поставили
наполняй	наполняй
бедных	бедных
преступите	преступите
строите	строите
самой	самой
жабах	жабах
принесла	принесла
старейшинах	старейшинах
смирен	смирен
Апостолом	Апостолом
уверить	уверить
произносить	произносить
восклицайте	восклицайте
убитых	убитых
золотого	золотого
уговаривали	уговаривали
он	он
изгонять	изгонять
проходила	проходила
поддерживала	поддерживала
начерпали	начерпали
низкою	низкою
сатаны	сатаны
выбросили	выбросили
смутили	смутили
мою	мою
встретила	встретила
погрязли	погрязли
славила	славила
скалу	скалу
приготовила	приготовила
странствуйте	странствуйте
наполняла	наполняла
выговори	выговори
проводите	проводите
исполните	исполните
новорожденные	новорожденные
отсек	отсек
проходили	проходили
вступали	вступали
рассуди	рассуди
отступили	отступили
возвестила	возвестила
новое	новое
оказывать	оказывать
предупреди	предупреди
отнят	отнят
каждого	каждого
поношением	поношением
Будут	Будут
овну	овну
уведомили	уведомили
отворила	отворила
другие	другие
раздражите	раздражите
объявили	объявили
навестить	навестить
ослепить	ослепить
предавала	предавала
закрой	закрой
яму	яму
Может	Может
преуспевайте	преуспевайте
обе	обе
неправы	неправы
приходите	приходите
столом	столом
ищем	ищем
бесчестили	бесчестили
главных	главных
покрывало	покрывало
сироте	сироте
Матери	Матери
возлюбленном	возлюбленном
ходите	ходите
насадила	насадила
одушевленное	одушевленное
восполнить	восполнить
наложить	наложить
землетрясением	землетрясением
брани	брани
новорожденного	новорожденного
скрывайте	скрывайте
иных	иных
умерщвляй	умерщвляй
передвигай	передвигай
богов	богов
дать	дать
истребили	истребили
поместила	поместила
разрешите	разрешите
возвращали	возвращали
немалую	немалую
возгласите	возгласите
затворить	затворить
переходить	переходить
научить	научить
зла	зла
могла	могла
испортили	испортили
святой	святой
определили	определили
вечере	вечере
потаенных	потаенных
хвали	хвали
портить	портить
судился	судился
заменим	заменим
вложи	вложи
невежда	невежда
лицами	лицами
посадили	посадили
пересчитай	пересчитай
воспитывайте	воспитывайте
беременным	беременным
сторож	сторож
возлегло	возлегло
каком	каком
Было	Было
сухую	сухую
терпим	терпим
чужая	чужая
слушайте	слушайте
оставляли	оставляли
разложили	разложили
сади	сади
переспим	переспим
страху	страху
сделать	сделать
злаков	злаков
отпустила	отпустила
столп	столп
жилищах	жилищах
усилили	усилили
сокрытые	сокрытые
сотвори	сотвори
схватите	схватите
бог	бог
смирите	смирите
победит	победит
живого	живого
поселили	поселили
ослепила	ослепила
жаб	жаб
знаком	знаком
страдать	страдать
пострадать	пострадать
считай	считай
самую	самую
восполнили	восполнили
Израильскою	Израильскою
похорони	похорони
замолчу	замолчу
скакали	скакали
душу	душу
помилуйте	помилуйте
выступив	выступив
печи	печи
очистить	очистить
Мою	Мою
прочитай	прочитай
утопает	утопает
твой	твой
постанови	постанови
вылитых	вылитых
изгнать	изгнать
другую	другую
сознаю	сознаю
подносили	подносили
передвигают	передвигают
оказывайте	оказывайте
приходить	приходить
будут	будут
удалили	удалили
траве	траве
отводит	отводит
жилищами	жилищами
стояло	стояло
заменили	заменили
котором	котором
Слушай	Слушай
светила	светила
объясним	объясним
стражу	стражу
чадо	чадо
жало	жало
наступить	наступить
обветшали	обветшали
лежали	лежали
благословили	благословили
собранным	собранным
духу	духу
слове	слове
бел	бел
приняли	приняли
отвори	отвори
нечистых	нечистых
больным	больным
простираете	простираете
тень	тень
подбирала	подбирала
заходит	заходит
восстать	восстать
лесах	лесах
почитать	почитать
снега	снега
родословных	родословных
чья	чья
приветствуйте	приветствуйте
тысячи	тысячи
увеличили	увеличили
восходили	восходили
завладели	завладели
поступите	поступите
матерь	матерь
спит	спит
какую	какую
изменила	изменила
оробели	оробели
восстановить	восстановить
обнови	обнови
котлом	котлом
веруйте	веруйте
всходить	всходить
населенного	населенного
похитить	похитить
возлегли	возлегли
твердое	твердое
спорили	спорили
овце	овце
выдавайте	выдавайте
приняты	приняты
устранили	устранили
призванный	призванный
зиму	зиму
проезжая	проезжая
подвиг	подвиг
святым	святым
тайны	тайны
Сене	Сене
дух	дух
прилагайте	прилагайте
называйте	называйте
сказывать	сказывать
искупи	искупи
строился	строился
испытывали	испытывали
отвела	отвела
отступите	отступите
плачем	плачем
уставом	уставом
сокрушить	сокрушить
язва	язва
талант	талант
забытая	забытая
нехорошо	нехорошо
скакать	скакать
блаженный	блаженный
Дину	Дину
меньшие	меньшие
поверили	поверили
садить	садить
красота	красота
мех	мех
выи	выи
поникло	поникло
соделались	соделались
собирай	собирай
языке	языке
тысяченачальнику	тысяченачальнику
замедлить	замедлить
бесноватым	бесноватым
постиг	постиг
божествах	божествах
поступив	поступив
думать	думать
худа	худа
простить	простить
написала	написала
теснили	теснили
смири	смири
простертой	простертой
птичку	птичку
пленили	пленили
сверкали	сверкали
снегу	снегу
тельца	тельца
ставила	ставила
почитай	почитай
заплатите	заплатите
восстали	восстали
воле	воле
козлы	козлы
дал	дал
добыче	добыче
почетного	почетного
чтили	чтили
отворили	отворили
скрывала	скрывала
тьме	тьме
лгали	лгали
перейдем	перейдем
вызывать	вызывать
порядка	порядка
отвели	отвели
которым	которым
Раба	Раба
ничтожество	ничтожество
больше	больше
убедила	убедила
настаивали	настаивали
наследует	наследует
красного	красного
возмутить	возмутить
каждый	каждый
неверным	неверным
они	они
уменьшить	уменьшить
браните	браните
Ханаанскую	Ханаанскую
вскормила	вскормила
наступили	наступили
меча	меча
весу	весу
звезды	звезды
остановила	остановила
никакого	никакого
наушник	наушник
учи	учи
ожесточи	ожесточи
предсказывали	предсказывали
осветила	осветила
сама	сама
призванных	призванных
пернатые	пернатые
откормленных	откормленных
вносить	вносить
собранный	собранный
поворотили	поворотили
она	она
вмещала	вмещала
познали	познали
жребии	жребии
настаивал	настаивал
царскою	царскою
встретить	встретить
испытанный	испытанный
выдать	выдать
страшные	страшные
среды	среды
обладать	обладать
поручи	поручи
соорудить	соорудить
убитым	убитым
скале	скале
вредили	вредили
отважен	отважен
восстанови	восстанови
обрати	обрати
разграбить	разграбить
бедным	бедным
великой	великой
обвини	обвини
молотили	молотили
точил	точил
постыди	постыди
допускали	допускали
возвратите	возвратите
отделить	отделить
написали	написали
замедли	замедли
проклятые	проклятые
Новы	Новы
наливай	наливай
пол	пол
откормленного	откормленного
изнеженная	изнеженная
соделала	соделала
ослабело	ослабело
завладел	завладел
манна	манна
золотой	золотой
отвален	отвален
приступив	приступив
нашли	нашли
каждом	каждом
свободного	свободного
скрытое	скрытое
возвратился	возвратился
замолчи	замолчи
тьму	тьму
разбирайте	разбирайте
истреби	истреби
возбуди	возбуди
купи	купи
ударила	ударила
петли	петли
Возлюбленного	Возлюбленного
ростом	ростом
возвестится	возвестится
целого	целого
ожесточили	ожесточили
мстить	мстить
известила	известила
облегчить	облегчить
нечистые	нечистые
находит	находит
член	член
стоите	стоите
отпустили	отпустили
одержимый	одержимый
повреди	повреди
Христов	Христов
горькие	горькие
овладели	овладели
вытащить	вытащить
развалинами	развалинами
чести	чести
града	града
какая	какая
ночные	ночные
развалинах	развалинах
тверды	тверды
разбит	разбит
открытых	открытых
погуби	погуби
унывать	унывать
был	был
продолжали	продолжали
образе	образе
отяготить	отяготить
разбудили	разбудили
пьяным	пьяным
лицо	лицо
матерях	матерях
Которой	Которой
скорую	скорую
освяти	освяти
разные	разные
злословить	злословить
покоить	покоить
госпоже	госпоже
обитать	обитать
смертный	смертный
исцеляла	исцеляла
развалинам	развалинам
выкопали	выкопали
умножился	умножился
строит	строит
выпали	выпали
потускли	потускли
возвестить	возвестить
требуй	требуй
выросло	выросло
переходишь	переходишь
саранчи	саранчи
увеличить	увеличить
проводив	проводив
мешки	мешки
подняла	подняла
свекрови	свекрови
Марком	Марком
река	река
восстало	восстало
благословляли	благословляли
помилуй	помилуй
утихли	утихли
раздражен	раздражен
злою	злою
отведи	отведи
избранный	избранный
верхом	верхом
черного	черного
слышали	слышали
вводить	вводить
Самого	Самого
переносит	переносит
скала	скала
убеди	убеди
жилы	жилы
кормила	кормила
первом	первом
горд	горд
погребен	погребен
рога	рога
открытый	открытый
лесу	лесу
благодарили	благодарили
скоту	скоту
отдай	отдай
погрешили	погрешили
разреши	разреши
Богами	Богами
глухой	глухой
стража	стража
поговорить	поговорить
рабою	рабою
язвою	язвою
вынесли	вынесли
самые	самые
головою	головою
исправить	исправить
напасти	напасти
жертву	жертву
свари	свари
слушающий	слушающий
чудных	чудных
исчислили	исчислили
сложили	сложили
провозгласили	провозгласили
крестить	крестить
печь	печь
возливали	возливали
Который	Который
онемело	онемело
вело	вело
внуши	внуши
тысячу	тысячу
приводите	приводите
назидается	назидается
исчисли	исчисли
нем	нем
прославился	прославился
немые	немые
каждые	каждые
причинить	причинить
ночных	ночных
сними	сними
Будете	Будете
выпало	выпало
дала	дала
Израильской	Израильской
написанные	написанные
удержи	удержи
любить	любить
садили	садили
сажен	сажен
держу	держу
градом	градом
служила	служила
жертвою	жертвою
нашу	нашу
долгом	долгом
вдовою	вдовою
убийцу	убийцу
разделите	разделите
производили	производили
бил	бил
сохраняйте	сохраняйте
камнях	камнях
шипа	шипа
другом	другом
обратили	обратили
фараона	фараона
членом	членом
выведи	выведи
возвратили	возвратили
святых	святых
носили	носили
пищи	пищи
послужили	послужили
погреби	погреби
презирайте	презирайте
белом	белом
каплют	каплют
налагай	налагай
выступить	выступить
раба	раба
переносят	переносят
мехе	мехе
объяснили	объяснили
литое	литое
сердечною	сердечною
упоминать	упоминать
воздух	воздух
имущества	имущества
дали	дали
получили	получили
защищайте	защищайте
воздали	воздали
духи	духи
жилища	жилища
своя	своя
защити	защити
твердая	твердая
нагой	нагой
считаете	считаете
прикрепили	прикрепили
научи	научи
обрезывай	обрезывай
Мал	Мал
звездам	звездам
Цари	Цари
духовных	духовных
утопать	утопать
пустую	пустую
напасть	напасть
познаю	познаю
похоронили	похоронили
стоит	стоит
окончили	окончили
возвеличить	возвеличить
