mampfen	mampfen
Pfahl	Pfahl
hinterfragten	hinterfragten
treffen	treffen
Sachen	Sachen
kabelst	kabelst
schäme	schäme
blitz	blitz
heiße	heiße
Arsenit	Arsenit
bedeckt	bedeckt
liebte	liebte
Atomphysiker	Atomphysiker
Borhydride	Borhydride
implodiere	implodiere
filzst	filzst
Inkarnationen	Inkarnationen
Adelungen	Adelungen
verbarg	verbarg
Paillette	Paillette
kapiert	kapiert
Technetiumatom	Technetiumatom
Rückweg	Rückweg
Eiszapfens	Eiszapfens
könnt	könnt
Adamsäpfeln	Adamsäpfeln
Gesetze	Gesetze
verprügelet	verprügelet
Mopp	Mopp
Füllfederhalter	Füllfederhalter
Abkömmling	Abkömmling
erstehen	erstehen
stoßet	stoßet
Rechenbrett	Rechenbrett
Kaffeelöffel	Kaffeelöffel
Fadenlauf	Fadenlauf
Teufel	Teufel
destabilisierte	destabilisierte
neiden	neiden
Fahlflanken-Ameisenwürgern	Fahlflanken-Ameisenwürgern
Erfahrungen	Erfahrungen
unterbrächest	unterbrächest
Märtyrer	Märtyrer
stimme	stimme
Trotzkisten	Trotzkisten
ummantle	ummantle
Korrosionsschutz	Korrosionsschutz
Dorsch	Dorsch
Händedrücken	Händedrücken
Finanzminister	Finanzminister
Hirnstämme	Hirnstämme
Kost	Kost
kühle	kühle
privatisierest	privatisierest
Händedruck	Händedruck
schenket	schenket
könne	könne
verletzte	verletzte
beschlügen	beschlügen
versagen	versagen
Nadel	Nadel
mobilisieret	mobilisieret
zerfielen	zerfielen
entwaffnest	entwaffnest
bringst	bringst
Luftschiff	Luftschiff
segmentierten	segmentierten
strafst	strafst
Besuchen	Besuchen
Tiere	Tiere
Wanderfalken	Wanderfalken
lehrte	lehrte
kontaktiere	kontaktiere
bezahlst	bezahlst
kaufest	kaufest
Affenbrotbäumen	Affenbrotbäumen
Schneidern	Schneidern
weinst	weinst
Aktienkurs	Aktienkurs
speist	speist
lostest	lostest
Bromidquelle	Bromidquelle
Seilen	Seilen
bemächtigte	bemächtigte
Schreibtischtäter	Schreibtischtäter
deckst	deckst
bandagiert	bandagiert
Raucherinnen	Raucherinnen
bemächtigest	bemächtigest
ankern	ankern
Erbse	Erbse
laute	laute
regierst	regierst
Rheumatismus	Rheumatismus
Rücktritt	Rücktritt
speiste	speiste
blende	blende
Braunralle	Braunralle
meinen	meinen
unterbewerte	unterbewerte
Füllfederhalters	Füllfederhalters
ziehest	ziehest
nahest	nahest
grünst	grünst
amputiere	amputiere
Toren	Toren
holst	holst
Kohlenstoffgehalt	Kohlenstoffgehalt
generalisiere	generalisiere
Raucherin	Raucherin
Eistaucher	Eistaucher
nehmet	nehmet
ernte	ernte
reizte	reizte
haarte	haarte
gezählt	gezählt
Stadtbezirken	Stadtbezirken
Garben	Garben
Koniferen	Koniferen
Anlässe	Anlässe
Zeitplanes	Zeitplanes
steuerte	steuerte
fraget	fraget
Reisebüros	Reisebüros
spritzt	spritzt
Wasserquellen	Wasserquellen
äussern	äussern
Arbeitsbereich	Arbeitsbereich
Arresten	Arresten
drängte	drängte
Minischweine	Minischweine
Mache	Mache
finanziert	finanziert
rebellieren	rebellieren
Asteroide	Asteroide
sagte	sagte
links	links
Massagen	Massagen
Gallanen	Gallanen
verdeckst	verdeckst
strullerst	strullerst
Dochte	Dochte
gewärtigten	gewärtigten
substituierten	substituierten
Bezeugungen	Bezeugungen
hantierte	hantierte
verleumdetest	verleumdetest
spaltest	spaltest
fritierst	fritierst
Linguist	Linguist
regierest	regierest
Fluoratome	Fluoratome
Radsätzen	Radsätzen
Rußen	Rußen
zuhört	zuhört
genehmigt	genehmigt
Alkali	Alkali
protokollierst	protokollierst
besser	besser
referenziere	referenziere
scheitern	scheitern
Arsenbergwerk	Arsenbergwerk
jappen	jappen
duschte	duschte
Isobars	Isobars
Gehorchet	Gehorchet
Linien	Linien
Sinne	Sinne
Beilen	Beilen
Geschäften	Geschäften
streutet	streutet
beanspruchte	beanspruchte
Kronsbeeren	Kronsbeeren
verzeichne	verzeichne
Asylrechte	Asylrechte
Zeugen	Zeugen
Handbuch	Handbuch
reichst	reichst
segmentiere	segmentiere
Steuerborden	Steuerborden
Falle	Falle
erstehet	erstehet
glänzte	glänzte
unterdrückte	unterdrückte
Paläste	Paläste
rännen	rännen
steig	steig
Diagnostik	Diagnostik
Gewalttäter	Gewalttäter
schwangt	schwangt
bezieht	bezieht
labe	labe
Schreien	Schreien
Halogenatom	Halogenatom
Eisstein	Eisstein
Langschwanzpinguin	Langschwanzpinguin
Höret	Höret
Halleluja	Halleluja
begehrest	begehrest
pulsiert	pulsiert
Grönländer	Grönländer
Trinkgefäße	Trinkgefäße
nagelte	nagelte
versüßtet	versüßtet
kabeln	kabeln
veranstaltest	veranstaltest
Atmosphäre	Atmosphäre
dringst	dringst
Kraftfahrzeuges	Kraftfahrzeuges
Rekursion	Rekursion
bürsteten	bürsteten
Fischzucht	Fischzucht
Prügelstrafen	Prügelstrafen
haltet	haltet
zürn	zürn
scheitertet	scheitertet
rekonstruieren	rekonstruieren
Sünders	Sünders
machest	machest
Färsen	Färsen
Apportierhunde	Apportierhunde
Binde	Binde
scheuchten	scheuchten
Aacheners	Aacheners
Telefonnummer	Telefonnummer
übersteht	übersteht
sagtest	sagtest
billigte	billigte
liebt	liebt
verschlingt	verschlingt
Machet	Machet
log	log
erratet	erratet
überweist	überweist
Verkehrsflugzeuge	Verkehrsflugzeuge
könnest	könnest
höbest	höbest
begrübe	begrübe
dringest	dringest
gereicht	gereicht
Oheim	Oheim
negierte	negierte
lauf	lauf
tattre	tattre
skypet	skypet
drillest	drillest
Pflanzenwachstum	Pflanzenwachstum
separieret	separieret
filteret	filteret
gabelt	gabelt
Bushaltestellen	Bushaltestellen
Weinbergen	Weinbergen
lackieren	lackieren
begebe	begebe
Wespen	Wespen
erliegen	erliegen
steinigst	steinigst
erstaunst	erstaunst
Theistin	Theistin
Trinket	Trinket
Lammfellhandschuhen	Lammfellhandschuhen
vertraget	vertraget
Kuttern	Kuttern
kitzeln	kitzeln
geliebt	geliebt
anzeigt	anzeigt
entwickele	entwickele
Ass	Ass
Entrées	Entrées
entzogen	entzogen
Deckenzapfen	Deckenzapfen
Verkehrsflugzeug	Verkehrsflugzeug
weichest	weichest
rammte	rammte
bräunst	bräunst
erinnre	erinnre
zuppen	zuppen
täuschet	täuschet
Argentits	Argentits
Recitativ	Recitativ
observiertest	observiertest
Nadelbäume	Nadelbäume
vertiefe	vertiefe
Ausländern	Ausländern
erfreu	erfreu
formulieren	formulieren
Gegebenheit	Gegebenheit
produzierest	produzierest
schütze	schütze
reimte	reimte
fresset	fresset
harmonierest	harmonierest
Telefonnummern	Telefonnummern
Linie	Linie
kürzest	kürzest
haderte	haderte
lobet	lobet
beleuchte	beleuchte
Flöße	Flöße
referenzierst	referenzierst
ärgertest	ärgertest
Suchet	Suchet
Optimisten	Optimisten
liebet	liebet
Küsserei	Küsserei
erstehst	erstehst
versteckend	versteckend
verwerten	verwerten
kabelte	kabelte
Ächselchen	Ächselchen
Halbzeiten	Halbzeiten
funzen	funzen
hantiert	hantiert
drangen	drangen
Stärke	Stärke
arrivieren	arrivieren
überlebest	überlebest
Entsetzet	Entsetzet
verletzt	verletzt
kämpfte	kämpfte
Satzungen	Satzungen
lüftet	lüftet
duzet	duzet
gestikuliere	gestikuliere
neigte	neigte
zankte	zankte
maximiere	maximiere
wallet	wallet
gebären	gebären
kühl	kühl
taufen	taufen
bauten	bauten
polymerisierte	polymerisierte
Leichtmetallen	Leichtmetallen
Büchereien	Büchereien
Fahrzeugkatalysator	Fahrzeugkatalysator
Basilikum	Basilikum
Suche	Suche
globalisieret	globalisieret
Tasten	Tasten
spritzet	spritzet
Banketten	Banketten
Metallquirle	Metallquirle
Brikette	Brikette
Eingaben	Eingaben
begehrte	begehrte
Einöden	Einöden
Gewürzen	Gewürzen
begrabet	begrabet
erbte	erbte
verseifet	verseifet
demütige	demütige
prangte	prangte
kürzten	kürzten
Anzeichens	Anzeichens
Metapher	Metapher
Büstenhalters	Büstenhalters
übet	übet
Chronisten	Chronisten
ruckeln	ruckeln
vermischten	vermischten
Gässchen	Gässchen
Galeeren	Galeeren
Spurensicherung	Spurensicherung
assimilierte	assimilierte
verlasset	verlasset
Zebrahaies	Zebrahaies
konvertiere	konvertiere
Spiralen	Spiralen
separieren	separieren
ruckelst	ruckelst
Unrechten	Unrechten
Höschens	Höschens
Muhme	Muhme
boßte	boßte
Gesamtmenge	Gesamtmenge
erfahrest	erfahrest
Omnibusse	Omnibusse
Küchenmaschinen	Küchenmaschinen
schleimte	schleimte
Zahnfleischentzündungen	Zahnfleischentzündungen
Wollt	Wollt
gehorchest	gehorchest
trödeltest	trödeltest
schlafet	schlafet
Schnarchralle	Schnarchralle
zweifel	zweifel
werft	werft
Rückumschlägen	Rückumschlägen
Farbstoffe	Farbstoffe
Hallen	Hallen
Lötzinn	Lötzinn
Abschreckungen	Abschreckungen
verstrahlten	verstrahlten
gönnst	gönnst
Aufpralle	Aufpralle
Flossen	Flossen
Seetaucher	Seetaucher
Ösophagospasmen	Ösophagospasmen
verschärftet	verschärftet
Aphasien	Aphasien
feierst	feierst
dividiere	dividiere
Arsenolithen	Arsenolithen
beklage	beklage
zelte	zelte
imprägnieret	imprägnieret
Schwirrvogel	Schwirrvogel
prophezeiet	prophezeiet
Erdbirnen	Erdbirnen
berührt	berührt
hobt	hobt
besorgend	besorgend
nähert	nähert
Gasgemisch	Gasgemisch
Gefilde	Gefilde
Gnaden	Gnaden
zerstreute	zerstreute
Kriegsschauplätze	Kriegsschauplätze
motivierte	motivierte
Gespenstern	Gespenstern
Abarten	Abarten
lancierst	lancierst
punktest	punktest
Aggressor	Aggressor
nähet	nähet
wehrend	wehrend
replizieret	replizieret
untersagtest	untersagtest
Dödel	Dödel
querest	querest
Wiedergutmachung	Wiedergutmachung
formiret	formiret
schaffte	schaffte
gereichte	gereichte
recycelten	recycelten
bemüht	bemüht
verspätest	verspätest
schwirrt	schwirrt
bereue	bereue
Milzen	Milzen
sinnst	sinnst
Wehret	Wehret
fluktuierte	fluktuierte
verdeckt	verdeckt
teilen	teilen
straftet	straftet
Kreise	Kreise
versteigerest	versteigerest
Gefügen	Gefügen
führst	führst
dehydrierte	dehydrierte
beförderet	beförderet
lüftetet	lüftetet
Huflattich	Huflattich
erinnerest	erinnerest
wünschte	wünschte
interpretiert	interpretiert
Adeliepinguins	Adeliepinguins
Bauwerke	Bauwerke
demütigst	demütigst
Minischwein	Minischwein
kremieren	kremieren
quantisiere	quantisiere
Zementen	Zementen
Unter	Unter
emittierte	emittierte
Kryostat	Kryostat
süsst	süsst
privilegiere	privilegiere
benähmen	benähmen
gefügt	gefügt
Trübsal	Trübsal
exmatrikuliertet	exmatrikuliertet
markiere	markiere
Kanzleien	Kanzleien
Strafräume	Strafräume
gelost	gelost
Judenrat	Judenrat
pensionierten	pensionierten
Milz	Milz
reagierte	reagierte
Ausnahmen	Ausnahmen
verkehrte	verkehrte
Energiespeicher	Energiespeicher
Programmiererinnen	Programmiererinnen
Rückumlauten	Rückumlauten
kennest	kennest
scheucht	scheucht
zentriert	zentriert
Fromme	Fromme
hintertrieben	hintertrieben
ausziehst	ausziehst
Extrems	Extrems
Azubi	Azubi
höhnest	höhnest
lösen	lösen
Tiefschutzen	Tiefschutzen
reformierten	reformierten
Werke	Werke
Gespenst	Gespenst
imkernd	imkernd
Mikrometern	Mikrometern
Zerfall	Zerfall
ausführe	ausführe
liebst	liebst
fluppten	fluppten
mineralisierten	mineralisierten
Palästen	Palästen
wünschtest	wünschtest
verallgemeinerst	verallgemeinerst
reinstitutionalisierten	reinstitutionalisierten
eroberte	eroberte
beneidete	beneidete
Dödeln	Dödeln
charakterisierend	charakterisierend
Argyroditen	Argyroditen
braust	braust
funktionalisierte	funktionalisierte
neigest	neigest
Kirchhof	Kirchhof
verliere	verliere
schlabberte	schlabberte
diversifiziert	diversifiziert
vergrubt	vergrubt
sichere	sichere
Abfertigungsgebäuden	Abfertigungsgebäuden
lackiere	lackiere
erkalten	erkalten
mobilisierten	mobilisierten
versklavt	versklavt
Golfplatz	Golfplatz
strömt	strömt
verkaufst	verkaufst
Treppen	Treppen
Kürasse	Kürasse
Andrologie	Andrologie
Geber	Geber
Amputierten	Amputierten
Arbeitsbereichen	Arbeitsbereichen
gehetzt	gehetzt
käbbelte	käbbelte
vibrierend	vibrierend
notlandet	notlandet
predigte	predigte
Hälmchen	Hälmchen
Gehorsams	Gehorsams
Ansichtskarte	Ansichtskarte
verkaufe	verkaufe
Marjellchens	Marjellchens
baggerte	baggerte
Malaysier	Malaysier
strecken	strecken
regiertest	regiertest
gewährte	gewährte
enträtselten	enträtselten
Rutheniumisotop	Rutheniumisotop
Stufen	Stufen
Augenglases	Augenglases
Bleiglanz	Bleiglanz
kollidierten	kollidierten
beschotterten	beschotterten
Agoraphobien	Agoraphobien
Freitagnachmittagen	Freitagnachmittagen
Coventrisierungen	Coventrisierungen
Blässe	Blässe
verwahrt	verwahrt
Altbau	Altbau
hetzte	hetzte
schnatternd	schnatternd
Nervenzellen	Nervenzellen
gratuliert	gratuliert
Psi	Psi
Malen	Malen
flambiert	flambiert
schubse	schubse
besichtiget	besichtiget
dürfte	dürfte
trefft	trefft
applizirte	applizirte
denaturierte	denaturierte
stehet	stehet
vernichtest	vernichtest
Abschreckung	Abschreckung
Mäppchen	Mäppchen
concessionieren	concessionieren
entsetzt	entsetzt
grün	grün
drosselten	drosselten
auflegte	auflegte
Backenbärten	Backenbärten
schöben	schöben
entfachet	entfachet
Blättchen	Blättchen
Alltag	Alltag
begehrtest	begehrtest
Händen	Händen
faul	faul
tanzen	tanzen
Schau	Schau
Betainen	Betainen
erstaunte	erstaunte
Gewicht	Gewicht
kichern	kichern
Fiebermittel	Fiebermittel
verantwortetest	verantwortetest
Kutter	Kutter
entert	entert
aufsteht	aufsteht
Nanotesla	Nanotesla
könnte	könnte
Fellhandschuh	Fellhandschuh
Nachteile	Nachteile
Kontraindikation	Kontraindikation
eiterten	eiterten
beanspruchest	beanspruchest
Sizilianer	Sizilianer
Kontrollkästchen	Kontrollkästchen
sponseret	sponseret
verkriechst	verkriechst
Würfelspiel	Würfelspiel
plagest	plagest
dringt	dringt
Sonderbericht	Sonderbericht
zuppt	zuppt
Homodimeren	Homodimeren
erniedrigt	erniedrigt
Monde	Monde
leite	leite
Kautschuke	Kautschuke
begnadigte	begnadigte
dankte	dankte
produzierte	produzierte
Früchtchen	Früchtchen
Panzerschrecke	Panzerschrecke
wohnst	wohnst
Wasserbades	Wasserbades
sehnet	sehnet
Wachtel	Wachtel
Tintenfische	Tintenfische
Monden	Monden
WebHooks	WebHooks
Anlass	Anlass
Herbstwinden	Herbstwinden
grabble	grabble
löset	löset
Dudelsäcken	Dudelsäcken
Zwingburg	Zwingburg
Klassenzimmer	Klassenzimmer
brause	brause
Füllet	Füllet
Sollst	Sollst
Pailletten	Pailletten
wirft	wirft
Dienstgrad	Dienstgrad
Elektronenschale	Elektronenschale
Schreiber	Schreiber
Geringschätzung	Geringschätzung
linstest	linstest
besuche	besuche
verglichest	verglichest
stoßest	stoßest
durchzuckest	durchzuckest
überwachten	überwachten
Membran	Membran
Mutagen	Mutagen
Alibis	Alibis
verpuffe	verpuffe
dekoriere	dekoriere
Primärenergien	Primärenergien
versuchen	versuchen
Planer	Planer
Sportlerinnen	Sportlerinnen
fügt	fügt
hegst	hegst
Geschrei	Geschrei
macht	macht
lös	lös
Westen	Westen
Leuchtstoff	Leuchtstoff
gravierten	gravierten
verstört	verstört
Zehnt	Zehnt
Geflecktheit	Geflecktheit
Schenken	Schenken
Maut	Maut
fragst	fragst
Akkadierinnen	Akkadierinnen
planschest	planschest
heile	heile
Türkin	Türkin
schleißt	schleißt
kabbelet	kabbelet
Käsereibe	Käsereibe
Radfahrer	Radfahrer
geleite	geleite
Kopfsalat	Kopfsalat
sage	sage
Bagger	Bagger
kupieren	kupieren
fluppt	fluppt
Schilde	Schilde
werden	werden
unterschiede	unterschiede
befördert	befördert
konsumieren	konsumieren
schlage	schlage
Zeitbombe	Zeitbombe
posiert	posiert
filzte	filzte
geloben	geloben
besicheret	besicheret
Brechnüssen	Brechnüssen
vertagest	vertagest
überquerst	überquerst
Halbmonden	Halbmonden
meldet	meldet
jaulst	jaulst
Mobilfunknetze	Mobilfunknetze
Hirschen	Hirschen
Ha	Ha
traget	traget
reanimiere	reanimiere
Shortcut	Shortcut
geleitet	geleitet
betrübend	betrübend
spiele	spiele
Treppe	Treppe
Minimierungen	Minimierungen
Stiefvätern	Stiefvätern
grüßen	grüßen
blondieret	blondieret
Beteiligte	Beteiligte
bekehrt	bekehrt
Schnitzeljagd	Schnitzeljagd
knistert	knistert
Hainbuche	Hainbuche
plagte	plagte
speise	speise
Kleinod	Kleinod
gebäret	gebäret
ehre	ehre
Linguisten	Linguisten
kreierten	kreierten
predige	predige
mehret	mehret
blitzte	blitzte
wiederholte	wiederholte
Blumensträußen	Blumensträußen
torpedieret	torpedieret
Auszüge	Auszüge
Kalifeldspate	Kalifeldspate
wischt	wischt
dekorieren	dekorieren
idealisierest	idealisierest
verteidigte	verteidigte
befehlt	befehlt
Zapfen	Zapfen
nütze	nütze
stationierten	stationierten
Empörung	Empörung
verkürzt	verkürzt
unterstützten	unterstützten
maß	maß
Bruchstrich	Bruchstrich
mischt	mischt
Ente	Ente
vierte	vierte
scherzt	scherzt
Beteiligten	Beteiligten
überweis	überweis
reif	reif
Unwahrheit	Unwahrheit
begrübest	begrübest
emaillieret	emaillieret
Drehtüren	Drehtüren
Lazarette	Lazarette
beantrage	beantrage
Serverzugriffe	Serverzugriffe
Antitranspirante	Antitranspirante
saget	saget
attestiertet	attestiertet
Erdboden	Erdboden
Abartigkeit	Abartigkeit
besitzet	besitzet
bilden	bilden
zersetzet	zersetzet
winke	winke
punkten	punkten
käbbelnd	käbbelnd
Pentaborat	Pentaborat
blitztet	blitztet
vollendest	vollendest
Paragraphenreiter	Paragraphenreiter
Empfängnisverhütungen	Empfängnisverhütungen
Scheck	Scheck
quietschest	quietschest
wispern	wispern
kitzele	kitzele
Kerls	Kerls
sedimentiert	sedimentiert
Mittelaltermarktes	Mittelaltermarktes
Krankenschein	Krankenschein
instanziiere	instanziiere
Bote	Bote
verringerten	verringerten
Halbzeit	Halbzeit
höbe	höbe
gewährtest	gewährtest
knacktest	knacktest
Mähnenwolf	Mähnenwolf
Teekesseln	Teekesseln
Nussknacker	Nussknacker
erscheine	erscheine
Unterschlagung	Unterschlagung
Übertretung	Übertretung
setzte	setzte
Dominicanerinnen	Dominicanerinnen
Linke	Linke
huren	huren
beherrscht	beherrscht
verwechseltet	verwechseltet
Bauwerken	Bauwerken
Weg	Weg
klingest	klingest
fehle	fehle
vibriere	vibriere
säume	säume
ortete	ortete
Knöllchens	Knöllchens
vermischen	vermischen
bequemen	bequemen
fehlen	fehlen
respektiert	respektiert
Ausnahme	Ausnahme
gedächten	gedächten
meißeltest	meißeltest
massierst	massierst
Mähnenwölfen	Mähnenwölfen
prostituierte	prostituierte
erfüllet	erfüllet
gelobend	gelobend
bezahlt	bezahlt
plumpse	plumpse
steiget	steiget
Crescendo	Crescendo
dolmetschst	dolmetschst
Laubbläser	Laubbläser
Perle	Perle
schwenkt	schwenkt
Remis	Remis
Patres	Patres
entwendet	entwendet
begnügt	begnügt
beweise	beweise
Zeitungsente	Zeitungsente
entheilige	entheilige
Totenglocke	Totenglocke
verschärfst	verschärfst
Habt	Habt
verkürztest	verkürztest
harrten	harrten
verschmelzen	verschmelzen
Langeweile	Langeweile
Anhänge	Anhänge
Bademäntel	Bademäntel
erntet	erntet
Briketten	Briketten
Schuhe	Schuhe
langweiltest	langweiltest
Bildpunkten	Bildpunkten
Ansteckers	Ansteckers
setzet	setzet
addieren	addieren
Montagmittag	Montagmittag
bandagierte	bandagierte
süsse	süsse
Schaffnerin	Schaffnerin
liege	liege
Affenbrotbaum	Affenbrotbaum
Schauen	Schauen
Nagellackentferner	Nagellackentferner
Innenschau	Innenschau
hadere	hadere
gestaltest	gestaltest
überlieferten	überlieferten
verhungerte	verhungerte
Ion	Ion
wechselwirkt	wechselwirkt
schwelle	schwelle
glänzt	glänzt
Benzol	Benzol
touchierte	touchierte
verbitterest	verbitterest
vereinbarten	vereinbarten
diente	diente
Petersfischen	Petersfischen
Ichs	Ichs
immunisiere	immunisiere
boykottierst	boykottierst
Uterus	Uterus
Desserts	Desserts
Kopfverletzungen	Kopfverletzungen
impfst	impfst
hänge	hänge
verberge	verberge
Rutheniumisotopen	Rutheniumisotopen
betreten	betreten
posierst	posierst
koste	koste
bleibet	bleibet
erlabe	erlabe
Primatologen	Primatologen
wollest	wollest
reizet	reizet
Kettenraucher	Kettenraucher
Wandergewerbe	Wandergewerbe
wünschst	wünschst
aufkommen	aufkommen
tyrannisierte	tyrannisierte
zentrifugieren	zentrifugieren
Penis	Penis
Massenanteil	Massenanteil
raubte	raubte
bewiesen	bewiesen
Nanosatelliten	Nanosatelliten
Agoraphobie	Agoraphobie
gewünscht	gewünscht
bestimmt	bestimmt
Gicht	Gicht
radiertest	radiertest
Unwahrheiten	Unwahrheiten
Äthern	Äthern
bölkte	bölkte
Stufe	Stufe
offenbarten	offenbarten
hasse	hasse
bauet	bauet
begnadigst	begnadigst
Rücktrittbremsen	Rücktrittbremsen
gähne	gähne
UND-Gatter	UND-Gatter
bedient	bedient
Nehmt	Nehmt
Hie	Hie
reformieren	reformieren
analysiert	analysiert
Fusseln	Fusseln
wähnt	wähnt
trotze	trotze
Ställe	Ställe
klingt	klingt
benehme	benehme
schnüren	schnüren
Kraftfahrzeugen	Kraftfahrzeugen
Urbaren	Urbaren
Kristallen	Kristallen
Leuchtstoffen	Leuchtstoffen
feiertest	feiertest
Garten	Garten
liebten	liebten
malträtierte	malträtierte
Blicksilber	Blicksilber
bröckelten	bröckelten
Pi	Pi
Wahnen	Wahnen
buddeln	buddeln
Kacke	Kacke
sorgen	sorgen
Rechenbrettern	Rechenbrettern
verliert	verliert
heparinisierten	heparinisierten
Last	Last
bekennst	bekennst
Amnestie	Amnestie
schöpfen	schöpfen
offenbarest	offenbarest
Insulaner	Insulaner
Amokläuferinnen	Amokläuferinnen
mogelest	mogelest
Hochzeitstorten	Hochzeitstorten
Hörspiel	Hörspiel
Leiste	Leiste
Abschiedsbriefe	Abschiedsbriefe
Träumer	Träumer
Bestecken	Bestecken
Jagdhund	Jagdhund
schimmerst	schimmerst
eiterte	eiterte
Vipernatter	Vipernatter
gedenkst	gedenkst
Untier	Untier
Höhle	Höhle
lebte	lebte
besehet	besehet
erlabet	erlabet
knistern	knistern
Essigsäurechlorid	Essigsäurechlorid
Organisationen	Organisationen
häufen	häufen
bewiest	bewiest
Bankettes	Bankettes
bollerte	bollerte
Schnittlauche	Schnittlauche
blitzt	blitzt
Oberlandesgericht	Oberlandesgericht
tat	tat
verselbstständige	verselbstständige
erzürnet	erzürnet
rächte	rächte
tanze	tanze
falteten	falteten
Prophet	Prophet
Fussel	Fussel
übte	übte
inspirierest	inspirierest
flirre	flirre
Streiten	Streiten
verzeichnete	verzeichnete
Flussbett	Flussbett
Kleinodien	Kleinodien
leiten	leiten
gebot	gebot
Omnibus	Omnibus
murmelst	murmelst
parfümierst	parfümierst
Saiblinge	Saiblinge
liste	liste
soll	soll
Untern	Untern
zerreißt	zerreißt
Plüschtiere	Plüschtiere
Iberer	Iberer
fabulierte	fabulierte
hinterzögen	hinterzögen
Schilden	Schilden
Komponistin	Komponistin
verdrängt	verdrängt
Einzelgänger	Einzelgänger
Bausch	Bausch
hängte	hängte
griffen	griffen
besichtigt	besichtigt
Herkünften	Herkünften
verbasele	verbasele
ehret	ehret
Erstarren	Erstarren
fabuliert	fabuliert
eingeht	eingeht
schneidend	schneidend
Temperaturanstiege	Temperaturanstiege
attackieren	attackieren
verselbständigst	verselbständigst
wachset	wachset
Operationssaal	Operationssaal
ärgerst	ärgerst
verstörte	verstörte
begebet	begebet
driftete	driftete
Angabe	Angabe
klemmen	klemmen
ersparen	ersparen
offenbartest	offenbartest
Kakao	Kakao
füsilierte	füsilierte
observierst	observierst
Vordenker	Vordenker
Briten	Briten
Wirtschaftswissenschaft	Wirtschaftswissenschaft
Dürre	Dürre
Berichterstattungen	Berichterstattungen
begrabest	begrabest
löst	löst
Forschung	Forschung
Falz	Falz
Grieße	Grieße
möge	möge
Tier	Tier
Anachronismen	Anachronismen
mißversteht	mißversteht
Suffixen	Suffixen
verzweigt	verzweigt
losest	losest
anrichte	anrichte
schiebest	schiebest
Düfte	Düfte
Konzentrat	Konzentrat
Entmachtungen	Entmachtungen
versuchtet	versuchtet
posierten	posierten
halbierte	halbierte
folterst	folterst
Brotkästen	Brotkästen
Kommst	Kommst
Excimerlaser	Excimerlaser
Dorsche	Dorsche
Bienenzüchter	Bienenzüchter
colorierend	colorierend
Berber	Berber
ärger	ärger
appellierst	appellierst
decke	decke
blondieren	blondieren
betätigtet	betätigtet
zersetzte	zersetzte
ehrte	ehrte
wollten	wollten
zählet	zählet
Verdachtes	Verdachtes
concessioniert	concessioniert
überschneidet	überschneidet
implodier	implodier
überstehst	überstehst
kritzelst	kritzelst
endlagern	endlagern
Malaysierinnen	Malaysierinnen
Drillinge	Drillinge
Talisman	Talisman
Holzquirl	Holzquirl
flirtete	flirtete
Entree	Entree
Gegenleistung	Gegenleistung
annektierst	annektierst
pressiert	pressiert
Habe	Habe
harrtest	harrtest
predigt	predigt
Barbareien	Barbareien
pfände	pfände
Kompass	Kompass
Notizen	Notizen
henket	henket
verurteile	verurteile
fette	fette
freuet	freuet
Hackern	Hackern
Hertz	Hertz
ersparet	ersparet
verkehrten	verkehrten
raubet	raubet
Fallet	Fallet
erlösen	erlösen
dümpelest	dümpelest
Zipfelmützen	Zipfelmützen
Mischelement	Mischelement
präsentiere	präsentiere
meißelt	meißelt
mehrte	mehrte
leerst	leerst
Harpune	Harpune
torpediert	torpediert
ärgere	ärgere
Abkömmlingen	Abkömmlingen
hinterfragst	hinterfragst
Prozeduren	Prozeduren
Feuerteufels	Feuerteufels
Assimilationen	Assimilationen
Schwänzchen	Schwänzchen
irrte	irrte
bewahrst	bewahrst
Neuigkeit	Neuigkeit
blättertet	blättertet
grüßten	grüßten
geboten	geboten
lögest	lögest
Fallturm	Fallturm
Leichname	Leichname
ärgerte	ärgerte
Gebäck	Gebäck
babbelten	babbelten
Elfen	Elfen
Grab	Grab
Hanse	Hanse
Epidemien	Epidemien
erbet	erbet
Nadelbäumen	Nadelbäumen
reanimierten	reanimierten
Landwirte	Landwirte
Stearat	Stearat
plissieren	plissieren
dunkelt	dunkelt
beherrschest	beherrschest
Türkenbund	Türkenbund
Blockflöten	Blockflöten
solle	solle
verfängt	verfängt
bewässertet	bewässertet
rüste	rüste
Anzeichen	Anzeichen
Skorpione	Skorpione
Banknoten	Banknoten
gepuddelt	gepuddelt
Perlen	Perlen
berücksichtigt	berücksichtigt
Homodimere	Homodimere
laufet	laufet
lösest	lösest
Herabsetzung	Herabsetzung
Präservativen	Präservativen
unterwirft	unterwirft
entkörperlichten	entkörperlichten
sehet	sehet
verrosteten	verrosteten
Chlorwasserstoffmolekül	Chlorwasserstoffmolekül
Lautschriften	Lautschriften
räumet	räumet
besänftigtest	besänftigtest
glaubet	glaubet
pharyngalisierten	pharyngalisierten
verstecken	verstecken
bedürftet	bedürftet
Sonnenfinsternis	Sonnenfinsternis
Willen	Willen
kramen	kramen
heißet	heißet
Geschwindigkeitsmessern	Geschwindigkeitsmessern
Wege	Wege
Introjektion	Introjektion
versuche	versuche
befestigte	befestigte
Erlösungen	Erlösungen
kommet	kommet
filzten	filzten
Effekten	Effekten
Autonomien	Autonomien
Deuteriums	Deuteriums
entrümpelst	entrümpelst
motivieren	motivieren
tage	tage
moppet	moppet
Mäusespeck	Mäusespeck
berücksichtiget	berücksichtiget
Dingen	Dingen
flambierten	flambierten
glaubst	glaubst
halle	halle
Zirkelschluss	Zirkelschluss
Bürzel	Bürzel
Bildpunkt	Bildpunkt
Deckenfarbe	Deckenfarbe
Marjellchen	Marjellchen
verblutete	verblutete
anzeigest	anzeigest
sollte	sollte
Böreks	Böreks
Maßen	Maßen
knusperst	knusperst
behalte	behalte
Basiliken	Basiliken
versucht	versucht
Kommet	Kommet
dampfte	dampfte
lohnten	lohnten
betrübtest	betrübtest
malträtiere	malträtiere
zerfetzte	zerfetzte
verstehet	verstehet
Freibergit	Freibergit
Heteroatome	Heteroatome
Teufeln	Teufeln
Pfründe	Pfründe
Pfarrerinnen	Pfarrerinnen
Weiblein	Weiblein
rühmet	rühmet
Biokraftstoffes	Biokraftstoffes
ducktest	ducktest
Gauner	Gauner
Mauten	Mauten
Schicksen	Schicksen
Tintenfisch	Tintenfisch
Lammfellhandschuhs	Lammfellhandschuhs
schließe	schließe
optimierte	optimierte
Atemgasen	Atemgasen
Präservativs	Präservativs
erniedrigst	erniedrigst
fetten	fetten
entzweiest	entzweiest
Arsenite	Arsenite
Zwergschwanes	Zwergschwanes
bezahlest	bezahlest
pharyngalisierst	pharyngalisierst
Fieberanfall	Fieberanfall
Sehne	Sehne
schmuggelest	schmuggelest
quatschen	quatschen
erkennet	erkennet
Exilanten	Exilanten
kauern	kauern
aasend	aasend
Libellen	Libellen
reinigst	reinigst
Genie	Genie
bauest	bauest
Arbeitskreis	Arbeitskreis
stickt	stickt
tabuisiert	tabuisiert
Leichenschauhäuser	Leichenschauhäuser
zerschlaget	zerschlaget
Rast	Rast
fladern	fladern
Zirkelbeweis	Zirkelbeweis
verhungert	verhungert
Jungen	Jungen
dümpelst	dümpelst
betrübe	betrübe
Geckos	Geckos
Karern	Karern
flehst	flehst
Herabsetzungen	Herabsetzungen
idealisieret	idealisieret
Taufe	Taufe
predigten	predigten
taufet	taufet
Amputierte	Amputierte
Donor	Donor
geknautscht	geknautscht
bekriegt	bekriegt
Kaliumdichromat	Kaliumdichromat
Uranerz	Uranerz
schleim	schleim
Apostel	Apostel
strullerte	strullerte
Geheimdienst	Geheimdienst
fällte	fällte
Achsel	Achsel
Jüngern	Jüngern
Wachteln	Wachteln
Grabbeltischen	Grabbeltischen
stammeln	stammeln
Hochsommern	Hochsommern
Seelöwen	Seelöwen
erkältete	erkältete
grünest	grünest
Busen	Busen
erfüllt	erfüllt
Erzherzogshüte	Erzherzogshüte
schlängelest	schlängelest
respektiere	respektiere
Päckchens	Päckchens
umhüllt	umhüllt
Theologien	Theologien
Fallt	Fallt
Grüßet	Grüßet
verknüpft	verknüpft
Fluorkohlenwasserstoff	Fluorkohlenwasserstoff
bewiese	bewiese
Pedant	Pedant
föhnest	föhnest
fingieret	fingieret
Quatsch	Quatsch
verführen	verführen
begrabe	begrabe
Gaschromatographien	Gaschromatographien
denaturierten	denaturierten
Buchhalterinnen	Buchhalterinnen
Paragraphenreitern	Paragraphenreitern
emendieret	emendieret
fragte	fragte
durchwacht	durchwacht
regieret	regieret
Jagdhunden	Jagdhunden
Ablösung	Ablösung
Leuchtkäfer	Leuchtkäfer
substituierest	substituierest
hörest	hörest
Begünstigung	Begünstigung
besitze	besitze
sprecht	sprecht
reichtet	reichtet
rundet	rundet
Pläsier	Pläsier
gedenken	gedenken
Gichten	Gichten
beschwindele	beschwindele
beleuchteten	beleuchteten
Oxalate	Oxalate
zertifizierst	zertifizierst
Grenze	Grenze
Seil	Seil
strandeten	strandeten
Tausche	Tausche
parametrisierten	parametrisierten
Dienstgrade	Dienstgrade
Kerf	Kerf
formulierst	formulierst
Myriade	Myriade
Halogenatomen	Halogenatomen
wegen	wegen
Rücktrittes	Rücktrittes
illustriere	illustriere
Transportweg	Transportweg
Stall	Stall
predigend	predigend
ermächtigest	ermächtigest
kabbelnd	kabbelnd
verkürzest	verkürzest
liehen	liehen
Blaumeise	Blaumeise
flitzen	flitzen
fertigte	fertigte
schälte	schälte
verbesserten	verbesserten
Gewürze	Gewürze
Verbindungsdrähten	Verbindungsdrähten
zürne	zürne
Ausländer	Ausländer
verbündete	verbündete
frohlockte	frohlockte
Schwermetallionen	Schwermetallionen
Eingabe	Eingabe
Schlagern	Schlagern
kapiertet	kapiertet
säumet	säumet
Automatikgetriebe	Automatikgetriebe
Vollkornbrot	Vollkornbrot
widmend	widmend
bereite	bereite
Aluminaten	Aluminaten
zweifeln	zweifeln
suchen	suchen
glaubte	glaubte
erforschest	erforschest
Einöde	Einöde
Quellen	Quellen
Fetzen	Fetzen
entwischten	entwischten
auflegt	auflegt
säumen	säumen
bemerken	bemerken
legte	legte
Kupferkiese	Kupferkiese
konjugiere	konjugiere
Falltürme	Falltürme
Signalen	Signalen
schleiß	schleiß
lüg	lüg
pendele	pendele
Verehrer	Verehrer
entwaffneten	entwaffneten
schaute	schaute
polymerisier	polymerisier
erforscht	erforscht
Milchflasche	Milchflasche
wehen	wehen
Krumen	Krumen
lang	lang
verschlimmerte	verschlimmerte
strafend	strafend
Tumulten	Tumulten
Hinkelsteine	Hinkelsteine
zagest	zagest
lauft	lauft
betrübten	betrübten
Hirnstämmen	Hirnstämmen
Tust	Tust
hydrogentartrate	hydrogentartrate
Bifurkationen	Bifurkationen
Schwestern	Schwestern
egalisiertet	egalisiertet
scheinet	scheinet
Bazzit	Bazzit
Freibrief	Freibrief
Frommen	Frommen
Liebchen	Liebchen
Gedicht	Gedicht
ertönst	ertönst
Gemeinden	Gemeinden
sehnte	sehnte
fallest	fallest
wart	wart
Skorpionen	Skorpionen
destabilisierst	destabilisierst
zerfielest	zerfielest
Baisers	Baisers
tränkten	tränkten
Ansteckern	Ansteckern
Schuldner	Schuldner
Zankapfel	Zankapfel
benützt	benützt
Hypochlorit	Hypochlorit
trauerten	trauerten
Epoxiden	Epoxiden
Atemluft	Atemluft
pilgert	pilgert
lavierte	lavierte
meinet	meinet
lodertet	lodertet
Fülle	Fülle
Propheten	Propheten
überreichen	überreichen
Cola	Cola
Meine	Meine
Sonnenfinsternissen	Sonnenfinsternissen
bombardiere	bombardiere
protokollieren	protokollieren
Rinde	Rinde
verabschiedeten	verabschiedeten
Schreiben	Schreiben
Böse	Böse
Kirgisinnen	Kirgisinnen
erhörest	erhörest
reiftet	reiftet
endlagerten	endlagerten
Planern	Planern
Bäusche	Bäusche
Leset	Leset
trüb	trüb
Playlists	Playlists
kehrte	kehrte
folgst	folgst
revoltierte	revoltierte
schwadroniert	schwadroniert
frohlockten	frohlockten
kritzele	kritzele
bekehrst	bekehrst
klappten	klappten
müssest	müssest
Panzerschreck	Panzerschreck
Adlerbussarden	Adlerbussarden
Mikrowellenfilter	Mikrowellenfilter
weisest	weisest
ziehst	ziehst
Bürzeln	Bürzeln
ackerest	ackerest
Pflanzung	Pflanzung
konsumiere	konsumiere
erbrüte	erbrüte
Blattgeweben	Blattgeweben
lieb	lieb
reim	reim
strecke	strecke
Fremdwort	Fremdwort
Kindergeldern	Kindergeldern
Notstand	Notstand
erweckest	erweckest
Nanosatellit	Nanosatellit
beliefen	beliefen
Fischotters	Fischotters
Hadith	Hadith
schießt	schießt
Campingplätzen	Campingplätzen
Wänden	Wänden
überfallen	überfallen
schmuggle	schmuggle
entschleieret	entschleieret
Neuigkeiten	Neuigkeiten
Schnipseln	Schnipseln
Selbstversuchen	Selbstversuchen
Rückumschlages	Rückumschlages
Lautschrift	Lautschrift
nähe	nähe
Schönrednern	Schönrednern
harrest	harrest
Girls	Girls
schaffet	schaffet
Nahrungsbestandteilen	Nahrungsbestandteilen
Türkinnen	Türkinnen
Fahlflanken-Ameisenwürger	Fahlflanken-Ameisenwürger
inszeniere	inszeniere
Darlehen	Darlehen
überweiset	überweiset
fassest	fassest
Reiseleitern	Reiseleitern
Traggasen	Traggasen
sortiert	sortiert
taufe	taufe
tut	tut
Grizzlybären	Grizzlybären
Safran	Safran
weinen	weinen
verstecktet	verstecktet
befestigten	befestigten
Meinet	Meinet
spekulieren	spekulieren
Fetzens	Fetzens
verließet	verließet
schluchzte	schluchzte
entschädigte	entschädigte
läutet	läutet
beseht	beseht
Anrufbeantworter	Anrufbeantworter
verhören	verhören
hintertreibt	hintertreibt
benachrichtige	benachrichtige
respektierten	respektierten
kriegte	kriegte
jaget	jaget
verewigt	verewigt
handhaben	handhaben
Außenministerium	Außenministerium
unschuldige	unschuldige
Gewinnungen	Gewinnungen
zerbrechest	zerbrechest
Abschirmung	Abschirmung
verdammtet	verdammtet
Otaviten	Otaviten
erliegst	erliegst
duckt	duckt
Trinker	Trinker
traueret	traueret
werdest	werdest
beschrifte	beschrifte
Trockendocks	Trockendocks
Basilisk	Basilisk
borgte	borgte
ramme	ramme
stapelten	stapelten
babbelst	babbelst
Uranerzen	Uranerzen
Smaragdkehlkolibris	Smaragdkehlkolibris
erfüllst	erfüllst
merket	merket
Lopariten	Lopariten
umgaben	umgaben
warnet	warnet
stürzest	stürzest
verselbständigt	verselbständigt
Adlerbussard	Adlerbussard
Tumult	Tumult
Abkürzungsverzeichnis	Abkürzungsverzeichnis
nahe	nahe
Bedeutung	Bedeutung
Briefköpfen	Briefköpfen
übersiehst	übersiehst
besprengen	besprengen
Klappertöpfen	Klappertöpfen
Held	Held
Achatschnecken	Achatschnecken
Brieftaubenzüchters	Brieftaubenzüchters
Lebenskräften	Lebenskräften
Unternehmensanwendungsintegrationen	Unternehmensanwendungsintegrationen
Sphären	Sphären
verbündeten	verbündeten
bewahrheitete	bewahrheitete
Reinstoff	Reinstoff
knurrtet	knurrtet
interagiert	interagiert
Bruchstriches	Bruchstriches
verbitterten	verbitterten
privatisiert	privatisiert
Schlagzeuger	Schlagzeuger
Membranen	Membranen
koordinieret	koordinieret
jappte	jappte
fragest	fragest
eingehest	eingehest
schreiet	schreiet
Kriegsschauplatz	Kriegsschauplatz
verdammend	verdammend
Fahrzeugkatalysatoren	Fahrzeugkatalysatoren
denaturiert	denaturiert
betrübest	betrübest
trödele	trödele
beschuldiget	beschuldiget
regelet	regelet
wässerten	wässerten
Hüllenelektronen	Hüllenelektronen
vertreiben	vertreiben
Bademantel	Bademantel
Nachweisreagenzien	Nachweisreagenzien
Felsboden	Felsboden
Schönredner	Schönredner
Reststoff	Reststoff
Geschwindigkeitsmesser	Geschwindigkeitsmesser
verlobt	verlobt
schießen	schießen
Gummibaumes	Gummibaumes
piesackest	piesackest
Radsatzes	Radsatzes
Bromidquellen	Bromidquellen
harmoniert	harmoniert
Spirale	Spirale
zerrissen	zerrissen
evaluierten	evaluierten
analysierest	analysierest
schmuste	schmuste
Aderhaut	Aderhaut
vergiften	vergiften
fabuliere	fabuliere
Sprichwörtern	Sprichwörtern
erwürgten	erwürgten
Bleche	Bleche
Bajonette	Bajonette
vertrauten	vertrauten
Normdatum	Normdatum
verblute	verblute
Lebenskraft	Lebenskraft
behütet	behütet
erlaube	erlaube
Auszügen	Auszügen
zuteilte	zuteilte
Selbstversuch	Selbstversuch
streue	streue
Öfchens	Öfchens
bedingst	bedingst
beschert	beschert
unterwerfe	unterwerfe
gewinnet	gewinnet
Almanachen	Almanachen
faschieren	faschieren
Begünstigungen	Begünstigungen
Pianos	Pianos
Maße	Maße
gewärtigt	gewärtigt
Einstufung	Einstufung
grübelten	grübelten
zähltet	zähltet
fotzte	fotzte
malt	malt
tappten	tappten
bitte	bitte
Lärche	Lärche
speichertest	speichertest
kommest	kommest
schenkest	schenkest
verbaselte	verbaselte
strafest	strafest
fluchten	fluchten
Konfitüren	Konfitüren
verstehst	verstehst
Piratensender	Piratensender
Galeere	Galeere
repräsentieret	repräsentieret
zürntest	zürntest
Welteninseln	Welteninseln
schautet	schautet
Tischen	Tischen
Toypudel	Toypudel
Fiesling	Fiesling
mühe	mühe
erbauet	erbauet
säet	säet
Treibhausgase	Treibhausgase
Geburtsnamen	Geburtsnamen
zeichnest	zeichnest
stärke	stärke
versüße	versüße
Silbersulfidbelag	Silbersulfidbelag
harren	harren
schickte	schickte
missversteht	missversteht
dürftet	dürftet
kupiert	kupiert
sorge	sorge
Dewargefäße	Dewargefäße
protestieret	protestieret
Panamaer	Panamaer
versteckten	versteckten
Katamarane	Katamarane
schlaf	schlaf
besetzen	besetzen
Krokus	Krokus
gehorchet	gehorchet
höbet	höbet
liebe	liebe
Überfamilie	Überfamilie
Quellflüssen	Quellflüssen
Glatteis	Glatteis
imitiertet	imitiertet
Sage	Sage
Nahrungsbestandteil	Nahrungsbestandteil
Leugnung	Leugnung
errötest	errötest
widmeten	widmeten
Träumers	Träumers
Wiederbelebung	Wiederbelebung
Überschüsse	Überschüsse
drängten	drängten
Knöllchen	Knöllchen
stützen	stützen
beleidigst	beleidigst
entgehst	entgehst
Berylle	Berylle
Kompassen	Kompassen
lispelt	lispelt
Hinterwäldler	Hinterwäldler
Druckfehler	Druckfehler
bemühten	bemühten
gewurstelt	gewurstelt
suchst	suchst
Mammut	Mammut
auflöste	auflöste
wohnte	wohnte
umgäben	umgäben
Flenser	Flenser
Oberlippe	Oberlippe
überbewertet	überbewertet
sicherst	sicherst
versuchten	versuchten
Schlepper	Schlepper
suche	suche
funkelet	funkelet
Zeitungsenten	Zeitungsenten
replizierten	replizierten
steuerst	steuerst
fluktuiert	fluktuiert
pulsiere	pulsiere
Halbmond	Halbmond
Freitagnachmittage	Freitagnachmittage
lösend	lösend
Kassettenrekorder	Kassettenrekorder
Schlöte	Schlöte
tobend	tobend
Aerosole	Aerosole
Reichweite	Reichweite
Substanzen	Substanzen
Gangster	Gangster
malen	malen
spukest	spukest
aktualisiere	aktualisiere
dividiert	dividiert
Kassiterits	Kassiterits
mästet	mästet
Fokusse	Fokusse
vandaliere	vandaliere
Fehlen	Fehlen
helfest	helfest
Schlössern	Schlössern
zerbräche	zerbräche
hinterlegt	hinterlegt
vergast	vergast
Silbererze	Silbererze
Melanteriten	Melanteriten
belauerten	belauerten
Stätte	Stätte
interpretierten	interpretierten
Kriegen	Kriegen
heilet	heilet
hure	hure
gewähret	gewähret
injizierest	injizierest
erpresst	erpresst
Anarchisten	Anarchisten
verfange	verfange
besänne	besänne
Gram	Gram
Gasflasche	Gasflasche
Lenkstange	Lenkstange
ältesten	ältesten
geselle	geselle
Abhängen	Abhängen
Buchfink	Buchfink
haschieret	haschieret
Flosse	Flosse
Spektralbereichen	Spektralbereichen
überwiese	überwiese
Teile	Teile
Remisen	Remisen
verklagst	verklagst
beichteten	beichteten
Notärztin	Notärztin
narret	narret
ausführt	ausführt
Hadithe	Hadithe
Premierministerinnen	Premierministerinnen
Gleitzeiten	Gleitzeiten
Donnerstagabenden	Donnerstagabenden
harmoniere	harmoniere
konvergierest	konvergierest
denaturieret	denaturieret
gewitterest	gewitterest
türmt	türmt
pflanzen	pflanzen
umhüllend	umhüllend
fülle	fülle
lieget	lieget
herrschest	herrschest
koexistierte	koexistierte
Pausbacken	Pausbacken
Schickse	Schickse
beweisen	beweisen
Puder	Puder
blitze	blitze
verdeckten	verdeckten
fingiere	fingiere
erstarre	erstarre
regeln	regeln
Heringen	Heringen
Hektaren	Hektaren
privilegierst	privilegierst
wache	wache
zirpen	zirpen
habet	habet
Knüppels	Knüppels
schauten	schauten
gestikulierst	gestikulierst
Taschenwörterbuches	Taschenwörterbuches
beschottert	beschottert
Zeilen	Zeilen
Krieg	Krieg
Sprichwort	Sprichwort
Würze	Würze
Samstagnachmittag	Samstagnachmittag
Friedensforscherinnen	Friedensforscherinnen
zuhörte	zuhörte
Charakteristika	Charakteristika
darfst	darfst
fluchet	fluchet
eskaliert	eskaliert
Ingredienzen	Ingredienzen
Stellen	Stellen
hydrolysierend	hydrolysierend
verlassen	verlassen
Abgaskatalysatoren	Abgaskatalysatoren
Thioestere	Thioestere
Sprödmetallen	Sprödmetallen
Arme	Arme
Verbrechen	Verbrechen
protestierest	protestierest
Kautschuken	Kautschuken
Anführer	Anführer
läute	läute
vergaste	vergaste
verdinglichest	verdinglichest
habest	habest
binden	binden
pflanzt	pflanzt
Bilderstürmer	Bilderstürmer
begrub	begrub
klumpt	klumpt
Hobbys	Hobbys
Bienen	Bienen
weinet	weinet
regierten	regierten
sterilisierten	sterilisierten
Besprechung	Besprechung
spracht	spracht
panaschieret	panaschieret
Schulleiterin	Schulleiterin
verifizieret	verifizieret
schaffest	schaffest
rächest	rächest
heil	heil
ritzten	ritzten
begräbt	begräbt
verbitterte	verbitterte
Rosinenkuchenmodell	Rosinenkuchenmodell
Germanist	Germanist
Borhydrid	Borhydrid
foppte	foppte
beeinflusst	beeinflusst
Anfechtungen	Anfechtungen
lieben	lieben
konvergiere	konvergiere
neige	neige
bewerbet	bewerbet
meinst	meinst
verbluten	verbluten
Körpergeruches	Körpergeruches
Reliquiare	Reliquiare
Totgeburten	Totgeburten
Fanatiker	Fanatiker
überschattet	überschattet
zeuge	zeuge
schwöllen	schwöllen
Pedanten	Pedanten
Dilettanten	Dilettanten
porträtiert	porträtiert
Ruß	Ruß
bleibst	bleibst
Trübsale	Trübsale
Kardinäle	Kardinäle
trotzest	trotzest
zweifelte	zweifelte
überreicht	überreicht
verweise	verweise
More	More
grübelte	grübelte
Maximierung	Maximierung
Asiatin	Asiatin
reizen	reizen
warnt	warnt
bummeltet	bummeltet
Schlaraffenländern	Schlaraffenländern
Ende	Ende
bestraft	bestraft
vermeßest	vermeßest
buddelten	buddelten
Krankenscheinen	Krankenscheinen
entfolgte	entfolgte
Provinz	Provinz
Steuerberater	Steuerberater
wehren	wehren
infiziertet	infiziertet
Donoren	Donoren
halte	halte
Sabotagen	Sabotagen
Schaffe	Schaffe
Wahn	Wahn
Gammastrahl	Gammastrahl
Tyrann	Tyrann
Kadavergehorsam	Kadavergehorsam
Hehlern	Hehlern
verzehrt	verzehrt
irre	irre
wacht	wacht
deckte	deckte
lärmte	lärmte
vergiftet	vergiftet
reiche	reiche
bequemte	bequemte
Herkunft	Herkunft
Büstenhaltern	Büstenhaltern
Finanzministerium	Finanzministerium
zeuget	zeuget
Krustentier	Krustentier
bewürben	bewürben
Gepäckträgern	Gepäckträgern
Galopps	Galopps
sehn	sehn
streckte	streckte
blätteret	blätteret
salz	salz
zürnten	zürnten
Fußballweltmeisterschaftsqualifikationsspielen	Fußballweltmeisterschaftsqualifikationsspielen
verscheißerte	verscheißerte
vertuest	vertuest
punkteten	punkteten
zeugt	zeugt
Scherzen	Scherzen
haare	haare
Schuhen	Schuhen
Vorstädte	Vorstädte
pressierten	pressierten
Mischung	Mischung
bejubelst	bejubelst
grüßte	grüßte
fritieret	fritieret
Gehilfen	Gehilfen
malet	malet
fragmentierst	fragmentierst
Ringen	Ringen
Transportwegen	Transportwegen
Trinkgefäßen	Trinkgefäßen
Rhabarber	Rhabarber
changiere	changiere
Abfertigungsgebäude	Abfertigungsgebäude
Kehre	Kehre
pflücke	pflücke
Darlegungen	Darlegungen
repräsentierten	repräsentierten
kaufst	kaufst
aufkommt	aufkommt
Großfürsten	Großfürsten
Ausgangssperren	Ausgangssperren
suchest	suchest
Wimpertierchen	Wimpertierchen
Proton	Proton
suchet	suchet
Lehrbücher	Lehrbücher
besuchen	besuchen
appellierte	appellierte
haarten	haarten
generalisiert	generalisiert
nähernd	nähernd
untersagest	untersagest
Abnahme	Abnahme
plumpsten	plumpsten
freute	freute
predigtest	predigtest
verfinstere	verfinstere
grüßest	grüßest
rekrutiere	rekrutiere
Gründungsprivilegien	Gründungsprivilegien
besucht	besucht
fegte	fegte
fluche	fluche
Bleigehalt	Bleigehalt
flitzte	flitzte
Gasgemischen	Gasgemischen
scheuchen	scheuchen
dekompiliertest	dekompiliertest
schwängen	schwängen
Hurriter	Hurriter
verbündet	verbündet
schätze	schätze
Rückwege	Rückwege
Gasen	Gasen
Mutagenen	Mutagenen
Polierstahl	Polierstahl
verknüpfet	verknüpfet
ernteten	ernteten
Samstagnachmittagen	Samstagnachmittagen
reglementiert	reglementiert
Falzen	Falzen
Anker	Anker
Sprachräumen	Sprachräumen
Gibt	Gibt
Leichtmetalle	Leichtmetalle
gequasselt	gequasselt
unterscheide	unterscheide
Vergeltungen	Vergeltungen
Weißflügelpinguin	Weißflügelpinguin
Portale	Portale
machst	machst
bezichtigten	bezichtigten
Adeliepinguin	Adeliepinguin
Ösophagospasmus	Ösophagospasmus
möget	möget
thematisierten	thematisierten
greife	greife
zeugen	zeugen
stutzt	stutzt
applizirst	applizirst
erwähnten	erwähnten
verfehlten	verfehlten
gewähr	gewähr
Bombardierung	Bombardierung
Alkalien	Alkalien
verdunstet	verdunstet
speisend	speisend
Pflicht	Pflicht
Flammen	Flammen
Elstern	Elstern
Hüfte	Hüfte
erkundigte	erkundigte
desensibilisierten	desensibilisierten
Dudelsack	Dudelsack
bemühst	bemühst
Gläubigen	Gläubigen
stellen	stellen
verzeigt	verzeigt
begehr	begehr
verseucht	verseucht
überweisend	überweisend
Arm	Arm
Dobermännern	Dobermännern
jagst	jagst
Aha-Erlebnis	Aha-Erlebnis
dirigieren	dirigieren
Euphemismen	Euphemismen
duschten	duschten
wälzt	wälzt
erlagst	erlagst
Begrenzung	Begrenzung
Drillingen	Drillingen
Massenanteilen	Massenanteilen
Erzeugung	Erzeugung
umarmen	umarmen
blitzen	blitzen
versuchte	versuchte
verludet	verludet
emendierte	emendierte
Mageninhalt	Mageninhalt
späht	späht
Stätten	Stätten
Begrenzungen	Begrenzungen
gehörten	gehörten
Stimme	Stimme
legt	legt
weichst	weichst
Erzherzogshüten	Erzherzogshüten
blitzet	blitzet
moppte	moppte
sitzt	sitzt
speiest	speiest
misstrauet	misstrauet
besorgten	besorgten
Leichenschauhäusern	Leichenschauhäusern
näht	näht
Senkung	Senkung
ersparte	ersparte
Bertrandite	Bertrandite
verbluteten	verbluteten
Höschen	Höschen
Stechpalmen	Stechpalmen
chloroformiere	chloroformiere
restaurieret	restaurieret
zwänget	zwänget
Darlegung	Darlegung
geschämt	geschämt
Epiker	Epiker
ehrst	ehrst
knufften	knufften
Leuchtkäfern	Leuchtkäfern
grünet	grünet
bewahrt	bewahrt
sterbt	sterbt
analysieret	analysieret
Empörungen	Empörungen
schaffen	schaffen
langte	langte
Zitronensaft	Zitronensaft
Acetaten	Acetaten
bemühet	bemühet
vertonten	vertonten
schaue	schaue
entrümpelest	entrümpelest
Höhlen	Höhlen
verwertete	verwertete
beißet	beißet
raffiniere	raffiniere
verwirrte	verwirrte
zürnst	zürnst
oxidierst	oxidierst
gafften	gafften
zupftet	zupftet
deponiere	deponiere
Geschichtsbüchern	Geschichtsbüchern
Entmachtung	Entmachtung
Kochfeldern	Kochfeldern
feierte	feierte
versuchet	versuchet
ausgeht	ausgeht
Retter	Retter
begehret	begehret
verforme	verforme
dienest	dienest
kauerten	kauerten
schauet	schauet
liegen	liegen
begäben	begäben
erlaubest	erlaubest
zappen	zappen
verdeckte	verdeckte
Fehden	Fehden
grauten	grauten
Polizeisprecher	Polizeisprecher
entflöhen	entflöhen
Schwebfliegen	Schwebfliegen
notlande	notlande
Genkinits	Genkinits
folge	folge
Substanz	Substanz
massakrierten	massakrierten
schließt	schließt
Abartigkeiten	Abartigkeiten
verspäte	verspäte
greinen	greinen
vertagt	vertagt
entmineralisierten	entmineralisierten
Traubenlese	Traubenlese
Greyerzer	Greyerzer
dissentierte	dissentierte
ritze	ritze
Prostylos	Prostylos
Blütenachse	Blütenachse
begehrt	begehrt
bescherten	bescherten
entschleiert	entschleiert
Grießen	Grießen
bespracht	bespracht
Eutern	Eutern
Strontiumamalgamen	Strontiumamalgamen
Konfitüre	Konfitüre
bestellt	bestellt
Automatikgetrieben	Automatikgetrieben
Theologie	Theologie
gravierst	gravierst
betrübtet	betrübtet
pilgerte	pilgerte
Wehre	Wehre
Klappertopf	Klappertopf
Politologen	Politologen
Fetten	Fetten
Landstreicher	Landstreicher
Technikerinnen	Technikerinnen
Sanatoriums	Sanatoriums
Bebauungsplänen	Bebauungsplänen
Qualifikationen	Qualifikationen
Maultieren	Maultieren
Drang	Drang
Indern	Indern
Beschuldigung	Beschuldigung
Hin	Hin
gewöhnte	gewöhnte
verzieht	verzieht
Kandidaturen	Kandidaturen
Kreisen	Kreisen
Gigapascaln	Gigapascaln
erfreuen	erfreuen
addieret	addieret
Charakteristikan	Charakteristikan
optimiert	optimiert
Wühltischen	Wühltischen
eingehst	eingehst
Elf	Elf
Extremen	Extremen
tragt	tragt
defragmentierest	defragmentierest
Weihe	Weihe
entschädiget	entschädiget
Blitze	Blitze
tobte	tobte
erschütterte	erschütterte
Zain	Zain
verhalte	verhalte
löse	löse
sezierte	sezierte
hebe	hebe
heulte	heulte
straften	straften
steckst	steckst
schabst	schabst
breche	breche
Bundesgebiet	Bundesgebiet
fluchte	fluchte
Wechselstube	Wechselstube
hinterzöge	hinterzöge
nehmt	nehmt
zeugst	zeugst
Indianer	Indianer
Päckchen	Päckchen
umarbeiten	umarbeiten
Gigapascal	Gigapascal
Monarchien	Monarchien
verbrauchten	verbrauchten
Palisade	Palisade
schmetterst	schmetterst
Fellhandschuhen	Fellhandschuhen
befestigt	befestigt
bereitend	bereitend
Kohlrübe	Kohlrübe
erstarrten	erstarrten
Überziehen	Überziehen
strandend	strandend
Backpflaumen	Backpflaumen
bebten	bebten
Beschuldigungen	Beschuldigungen
Funkfeuer	Funkfeuer
Fiasko	Fiasko
verbleibet	verbleibet
Leisten	Leisten
Schote	Schote
Strahlentierchen	Strahlentierchen
begründetest	begründetest
Kriegsenden	Kriegsenden
glawbte	glawbte
träumte	träumte
ermutigt	ermutigt
Gaschromatographie	Gaschromatographie
Freeganer	Freeganer
Raute	Raute
keulte	keulte
Teekessel	Teekessel
Adler	Adler
grünt	grünt
Pimmel	Pimmel
Heteroatom	Heteroatom
verschreibt	verschreibt
bückest	bückest
Wände	Wände
Anführern	Anführern
Festons	Festons
Sitzfleisch	Sitzfleisch
kritzelet	kritzelet
plissierten	plissierten
Impedanz	Impedanz
Abszisse	Abszisse
besorg	besorg
zürnte	zürnte
Erstlingen	Erstlingen
knüpfet	knüpfet
putzt	putzt
ärgernd	ärgernd
Schlüchte	Schlüchte
widmet	widmet
schluchze	schluchze
Acetat	Acetat
Seile	Seile
Männlein	Männlein
Silberdrähten	Silberdrähten
liehe	liehe
Alibi	Alibi
misstrauest	misstrauest
Würfelspiele	Würfelspiele
Massage	Massage
Dinge	Dinge
Isolatoren	Isolatoren
Lautwandel	Lautwandel
Werk	Werk
Steige	Steige
Gefängnisse	Gefängnisse
sagtet	sagtet
sticke	sticke
geherrscht	geherrscht
Märchenbuches	Märchenbuches
überdächte	überdächte
Ausbeuterei	Ausbeuterei
Zerfällen	Zerfällen
schaffst	schaffst
Trockendock	Trockendock
Sucht	Sucht
schichtet	schichtet
erzwinget	erzwinget
Schanktischen	Schanktischen
Schaffet	Schaffet
Sitzfleisches	Sitzfleisches
Anachronismus	Anachronismus
Antimusters	Antimusters
platzt	platzt
rüstetest	rüstetest
antworte	antworte
Zur-Schau-Stellen	Zur-Schau-Stellen
verunreinigst	verunreinigst
Laufringen	Laufringen
hievst	hievst
verführe	verführe
Lunisolarkalender	Lunisolarkalender
Noseans	Noseans
fritiert	fritiert
lispelten	lispelten
verdunsten	verdunsten
Butzemänner	Butzemänner
Tukanen	Tukanen
Gemüseläden	Gemüseläden
touchiere	touchiere
tätowierest	tätowierest
Zankapfels	Zankapfels
verzögerte	verzögerte
eggten	eggten
zeug	zeug
kickst	kickst
Wühltische	Wühltische
stoßt	stoßt
schrecken	schrecken
stützet	stützet
gehört	gehört
koordinierte	koordinierte
Außenministerien	Außenministerien
sterbest	sterbest
wehrten	wehrten
verbrauchet	verbrauchet
wirfst	wirfst
verziehe	verziehe
Schnute	Schnute
recycele	recycele
scheiterest	scheiterest
frohlockest	frohlockest
kabelten	kabelten
Crescendos	Crescendos
inhalier	inhalier
mehr	mehr
träumen	träumen
Abfertigungsschalters	Abfertigungsschalters
versuchest	versuchest
Kernspaltung	Kernspaltung
Deck	Deck
Trichtern	Trichtern
karikierten	karikierten
Einwirkungen	Einwirkungen
kurbelte	kurbelte
verbraucht	verbraucht
säuselest	säuselest
behaltest	behaltest
Bienenstöcke	Bienenstöcke
tyrannisiertest	tyrannisiertest
Magier	Magier
Coventrisierung	Coventrisierung
quatschest	quatschest
Blaumeisen	Blaumeisen
extemporiere	extemporiere
beteuerten	beteuerten
reifst	reifst
Rechnungen	Rechnungen
legen	legen
vertreibt	vertreibt
Teilen	Teilen
Streite	Streite
Temperaturanstieg	Temperaturanstieg
Sollte	Sollte
gelegt	gelegt
Ringeltauben	Ringeltauben
zeltest	zeltest
Beziehung	Beziehung
Füllfeder	Füllfeder
Rhodochrositen	Rhodochrositen
Bundesgebieten	Bundesgebieten
prostituieret	prostituieret
sitzest	sitzest
plagen	plagen
verkleidete	verkleidete
räucheret	räucheret
Katz-und-Maus-Spiele	Katz-und-Maus-Spiele
erobern	erobern
Wasserbädern	Wasserbädern
Tintenklecks	Tintenklecks
thematisierte	thematisierte
Lüsten	Lüsten
schlafest	schlafest
schau	schau
warntet	warntet
Gallan	Gallan
kaserniert	kaserniert
graben	graben
beunruhige	beunruhige
Blitzableiter	Blitzableiter
Lehne	Lehne
Hummer	Hummer
Ebenen	Ebenen
Waldbränden	Waldbränden
transportierte	transportierte
Geldautomaten	Geldautomaten
Wucher	Wucher
beeinflusste	beeinflusste
erhebet	erhebet
Gymnasien	Gymnasien
folgt	folgt
leistest	leistest
weinest	weinest
hicksest	hicksest
streiften	streiften
verformen	verformen
brillieret	brillieret
Galoppen	Galoppen
Küstenwache	Küstenwache
Firnis	Firnis
Massenarbeitslosigkeit	Massenarbeitslosigkeit
Kronsbeere	Kronsbeere
Gewinnung	Gewinnung
Münzsammlungen	Münzsammlungen
verlasse	verlasse
Grenzwert	Grenzwert
Fallen	Fallen
Martyrologien	Martyrologien
behauptete	behauptete
Diäresen	Diäresen
Lusitaners	Lusitaners
pflüget	pflüget
Scherzes	Scherzes
substituierend	substituierend
Unrecht	Unrecht
gesagt	gesagt
Buchfinken	Buchfinken
regiert	regiert
Silberdrahts	Silberdrahts
velarisierend	velarisierend
verdrängen	verdrängen
Welpen	Welpen
flenstet	flenstet
schnappt	schnappt
meinte	meinte
Gebete	Gebete
Heptamolybdat	Heptamolybdat
zerbrechen	zerbrechen
verkleinerest	verkleinerest
Obszönität	Obszönität
Carbid	Carbid
Scheißkerlen	Scheißkerlen
Indianern	Indianern
entkämen	entkämen
Tretlager	Tretlager
grüßend	grüßend
Plumpsen	Plumpsen
Polizeisprechern	Polizeisprechern
hupen	hupen
meldeten	meldeten
googelest	googelest
Zeug	Zeug
moppen	moppen
Verdacht	Verdacht
verkürzten	verkürzten
Ausstiegstüren	Ausstiegstüren
schreie	schreie
Handbüchern	Handbüchern
Abkürzungsverzeichnisse	Abkürzungsverzeichnisse
wünschest	wünschest
erlöst	erlöst
billigen	billigen
Bluff	Bluff
predigen	predigen
Schade	Schade
schäumtest	schäumtest
Blechen	Blechen
stirbt	stirbt
Strontiumamalgams	Strontiumamalgams
Pfandgeld	Pfandgeld
Lasten	Lasten
Atommodellen	Atommodellen
Trioxid	Trioxid
betrete	betrete
Komponisten	Komponisten
Stoffwechselwegen	Stoffwechselwegen
Steuerberatern	Steuerberatern
hüpfen	hüpfen
Ärzteblättern	Ärzteblättern
beläufst	beläufst
handhabest	handhabest
Wehklage	Wehklage
verleumdete	verleumdete
Brite	Brite
lochten	lochten
mikrominiaturisierten	mikrominiaturisierten
Spannt	Spannt
Unterschlagungen	Unterschlagungen
verkauften	verkauften
drosselt	drosselt
Ölspuren	Ölspuren
Erbsen	Erbsen
Argentit	Argentit
begrabt	begrabt
nahte	nahte
verfügten	verfügten
Metallspiegeln	Metallspiegeln
steigerten	steigerten
Junge	Junge
Fortsetzungen	Fortsetzungen
Katamaranen	Katamaranen
Wille	Wille
Flamen	Flamen
brandet	brandet
bequemest	bequemest
Schnittlauch	Schnittlauch
Sekretärinnen	Sekretärinnen
emailliert	emailliert
regelten	regelten
leertet	leertet
Überschüssen	Überschüssen
Haue	Haue
bedeckst	bedeckst
kritzeln	kritzeln
Subspezies	Subspezies
säusele	säusele
Dolde	Dolde
falle	falle
besprenget	besprenget
Rutheniumkomplex	Rutheniumkomplex
duzen	duzen
ziert	ziert
Gemurmel	Gemurmel
Rotzinkerzen	Rotzinkerzen
vernehmen	vernehmen
referenzierte	referenzierte
erbrütet	erbrütet
Anfängern	Anfängern
zieren	zieren
demoralisiere	demoralisiere
gelobet	gelobet
kehret	kehret
wisperten	wisperten
Speeren	Speeren
Fluoratom	Fluoratom
deutete	deutete
verreisest	verreisest
Spieße	Spieße
verpufftest	verpufftest
Mensch	Mensch
beantragt	beantragt
Werkzeuge	Werkzeuge
Hode	Hode
Technetate	Technetate
stillest	stillest
musizieret	musizieret
schämst	schämst
Füllfedern	Füllfedern
verseuchen	verseuchen
Zehnten	Zehnten
Rubinen	Rubinen
betrübte	betrübte
plaziert	plaziert
zeugte	zeugte
Bergsteiger	Bergsteiger
sponsertest	sponsertest
produzierten	produzierten
anzeigte	anzeigte
klappest	klappest
Klotz	Klotz
Wolle	Wolle
grünend	grünend
Ratsherr	Ratsherr
betreibet	betreibet
Zinkat	Zinkat
warst	warst
Eselsohren	Eselsohren
bequemtet	bequemtet
Halsabschneider	Halsabschneider
wälzet	wälzet
prediget	prediget
kappten	kappten
höben	höben
setzen	setzen
verführest	verführest
holet	holet
Kehret	Kehret
malochet	malochet
Brötchen	Brötchen
parkierst	parkierst
wehrtest	wehrtest
Frettchen	Frettchen
Tetraiodiden	Tetraiodiden
Dessous	Dessous
Kürass	Kürass
Hochhäuser	Hochhäuser
parliere	parliere
Fußmatten	Fußmatten
Gelobt	Gelobt
brauchst	brauchst
Excimerlasern	Excimerlasern
rebelliere	rebelliere
überfischt	überfischt
deponierte	deponierte
Bete	Bete
Abhänge	Abhänge
Reisebüro	Reisebüro
Sitz	Sitz
Heringe	Heringe
Inauguration	Inauguration
kennst	kennst
Aas	Aas
Graben	Graben
verführt	verführt
ermordetest	ermordetest
müsse	müsse
sterbet	sterbet
blase	blase
foppst	foppst
Fußballweltmeisterschaftsqualifikationsspiel	Fußballweltmeisterschaftsqualifikationsspiel
überwachest	überwachest
verantwortet	verantwortet
brandeten	brandeten
blamierte	blamierte
grüble	grüble
vernickele	vernickele
sehest	sehest
koche	koche
zerschlagt	zerschlagt
Bunde	Bunde
Spanne	Spanne
transportierten	transportierten
Großstädter	Großstädter
verzweigst	verzweigst
rufe	rufe
Cholesterin	Cholesterin
merke	merke
Schneepflügen	Schneepflügen
begehren	begehren
zerstreuten	zerstreuten
beeindrucket	beeindrucket
Türklingel	Türklingel
Feldbett	Feldbett
glänzten	glänzten
Dominicanerin	Dominicanerin
unschuldigen	unschuldigen
verjährte	verjährte
mein	mein
Stärkungsmittel	Stärkungsmittel
Alteritäten	Alteritäten
erstände	erstände
Preisanstieg	Preisanstieg
grüne	grüne
Kavalier	Kavalier
Lusitaner	Lusitaner
Kardinal	Kardinal
verkürze	verkürze
Schwächungen	Schwächungen
speisen	speisen
Ecken	Ecken
Schwärmereien	Schwärmereien
verringertet	verringertet
punktetest	punktetest
Decks	Decks
erwürgtest	erwürgtest
billige	billige
Funktionalität	Funktionalität
Montagmittagen	Montagmittagen
schlafe	schlafe
Spende	Spende
Fettes	Fettes
Apfelbäume	Apfelbäume
Angaben	Angaben
kristallisierest	kristallisierest
Ruße	Ruße
Rooibos	Rooibos
Stierkämpfen	Stierkämpfen
ahnten	ahnten
Bedenken	Bedenken
gedolmetscht	gedolmetscht
Asteroid	Asteroid
folgen	folgen
erkaltest	erkaltest
Brettspielen	Brettspielen
loste	loste
Gewalttätern	Gewalttätern
rundest	rundest
verwechselst	verwechselst
Adhäsionen	Adhäsionen
grien	grien
Druckfehlern	Druckfehlern
Pis	Pis
erlöset	erlöset
gelobten	gelobten
Nachteilen	Nachteilen
prahlte	prahlte
wünschen	wünschen
Dachdeckerinnen	Dachdeckerinnen
schwöret	schwöret
Geschichtsbücher	Geschichtsbücher
wechselwirkte	wechselwirkte
Stiefmütterchen	Stiefmütterchen
reichtest	reichtest
stimmen	stimmen
erwärmet	erwärmet
filzen	filzen
produziert	produziert
setztest	setztest
globalisier	globalisier
Fußmatte	Fußmatte
ringelten	ringelten
besinnen	besinnen
Tatsachenbeschöniger	Tatsachenbeschöniger
Besteck	Besteck
Streich	Streich
Sehnen	Sehnen
Laufring	Laufring
löge	löge
tatteret	tatteret
bereiteten	bereiteten
Schläfchen	Schläfchen
Kaufhäusern	Kaufhäusern
finanziere	finanziere
reinstitutionalisiert	reinstitutionalisiert
Schlager	Schlager
Zeithorizonte	Zeithorizonte
amenagiere	amenagiere
machet	machet
meine	meine
gehst	gehst
bereitet	bereitet
entsetzte	entsetzte
Amtsträger	Amtsträger
grüßet	grüßet
reich	reich
funktioniertest	funktioniertest
Farbstoffen	Farbstoffen
verachtend	verachtend
drängest	drängest
Prozedur	Prozedur
gehorcht	gehorcht
Hörst	Hörst
Physikerin	Physikerin
Male	Male
gehorchst	gehorchst
glaubt	glaubt
Hobby	Hobby
Gehirnwellen	Gehirnwellen
klöne	klöne
erweckt	erweckt
initiierten	initiierten
Mönchen	Mönchen
schmettern	schmettern
entfachten	entfachten
demütig	demütig
Kakaos	Kakaos
Döner	Döner
gare	gare
Eiszapfen	Eiszapfen
porträtiere	porträtiere
Fremdwörter	Fremdwörter
gehörst	gehörst
Gemüt	Gemüt
flötete	flötete
härten	härten
reparierten	reparierten
enttäuschet	enttäuschet
verdreht	verdreht
Gehilfe	Gehilfe
assimilierten	assimilierten
Playlist	Playlist
blaset	blaset
Ding	Ding
ermordetet	ermordetet
Landwirt	Landwirt
Paralipse	Paralipse
verkleide	verkleide
vertiefet	vertiefet
urbanisiert	urbanisiert
brauchte	brauchte
Kunstgeschichte	Kunstgeschichte
Messies	Messies
dissentierten	dissentierten
köderte	köderte
parfümierte	parfümierte
Emmer	Emmer
Erdkruste	Erdkruste
behütetest	behütetest
weine	weine
Sorgen	Sorgen
Bleiglanzes	Bleiglanzes
Sigle	Sigle
könnet	könnet
Sündern	Sündern
entfolgst	entfolgst
installiert	installiert
Einfältigkeiten	Einfältigkeiten
Einsatz	Einsatz
spaltetest	spaltetest
Futtermitteln	Futtermitteln
prahlet	prahlet
Preisen	Preisen
Armband	Armband
Preis	Preis
bündelet	bündelet
ziere	ziere
Gepäckträger	Gepäckträger
vier	vier
Citrat	Citrat
bitten	bitten
verzögerten	verzögerten
Gummibäumen	Gummibäumen
Fischotter	Fischotter
Zipfelmütze	Zipfelmütze
Pausbacke	Pausbacke
zentrifugierst	zentrifugierst
Marokkaners	Marokkaners
Erzeugungen	Erzeugungen
pressiere	pressiere
chloroformieret	chloroformieret
verdränge	verdränge
bewässern	bewässern
verkapselt	verkapselt
Gehorcht	Gehorcht
wallte	wallte
bekehrte	bekehrte
Feierabend	Feierabend
erwärmst	erwärmst
beneidest	beneidest
Flamingo	Flamingo
Kupferkiesen	Kupferkiesen
Pflaumen	Pflaumen
fluppe	fluppe
explodierten	explodierten
zanket	zanket
weiche	weiche
finanzierest	finanzierest
negierest	negierest
erbaust	erbaust
Recitativen	Recitativen
Pfleglinge	Pfleglinge
halbierest	halbierest
Wehklagen	Wehklagen
sabbelten	sabbelten
zählten	zählten
wähnet	wähnet
Katalanen	Katalanen
Buntspechten	Buntspechten
zirpe	zirpe
schreckt	schreckt
lautete	lautete
trotzt	trotzt
addierest	addierest
sucht	sucht
Wüste	Wüste
krösest	krösest
rühmte	rühmte
hintertriebe	hintertriebe
Deutungen	Deutungen
Schwan	Schwan
begehrend	begehrend
schlängelt	schlängelt
häufe	häufe
Graphem	Graphem
lostet	lostet
Ehren	Ehren
Adventskalender	Adventskalender
Videoaufzeichnung	Videoaufzeichnung
Schläfchens	Schläfchens
nützt	nützt
überreichend	überreichend
preiset	preiset
ehrest	ehrest
bündelten	bündelten
belauere	belauere
Weh	Weh
Thioacetal	Thioacetal
haschiert	haschiert
entflieht	entflieht
erwischten	erwischten
Vesper	Vesper
begründest	begründest
kämmt	kämmt
Zuschauer	Zuschauer
Bärenfellen	Bärenfellen
unterfordern	unterfordern
Grizzlybär	Grizzlybär
Ärzteblatt	Ärzteblatt
freiwilligen	freiwilligen
Trägerwellen	Trägerwellen
Dunkelkammern	Dunkelkammern
linsten	linsten
verschont	verschont
ruhe	ruhe
Technetaten	Technetaten
Reiterschwertern	Reiterschwertern
Staatsführungen	Staatsführungen
Äquatoren	Äquatoren
Theistinnen	Theistinnen
schmuggelte	schmuggelte
verschlungen	verschlungen
feierten	feierten
Großstädtern	Großstädtern
zwang	zwang
lose	lose
kremierten	kremierten
Dachdecker	Dachdecker
Trickbetrüger	Trickbetrüger
versteckst	versteckst
protestiere	protestiere
glaubest	glaubest
tagest	tagest
Hirsche	Hirsche
abalieniertest	abalieniertest
präsentier	präsentier
Arbeitsleistung	Arbeitsleistung
merkte	merkte
watete	watete
gelobt	gelobt
blast	blast
Aussätzigen	Aussätzigen
erlöse	erlöse
Knüppeln	Knüppeln
fälle	fälle
Autokraten	Autokraten
Arsenbergwerken	Arsenbergwerken
revoltiert	revoltiert
Nanoteslan	Nanoteslan
Lehrbüchern	Lehrbüchern
Stierkämpfe	Stierkämpfe
sollst	sollst
Tukans	Tukans
dürft	dürft
amenagierst	amenagierst
imkeret	imkeret
Sogen	Sogen
steigeret	steigeret
betrübet	betrübet
flupptest	flupptest
Paradiesäpfeln	Paradiesäpfeln
gebündelt	gebündelt
babbeltet	babbeltet
klonet	klonet
Dezernat	Dezernat
verabschiedetet	verabschiedetet
knackt	knackt
watet	watet
beziehen	beziehen
transportierst	transportierst
Beschleuniger	Beschleuniger
grüntet	grüntet
mopsend	mopsend
Beziehungen	Beziehungen
karikieret	karikieret
sabbere	sabbere
erweckst	erweckst
initiierst	initiierst
blockiert	blockiert
kürze	kürze
legest	legest
Adelung	Adelung
Radiergummis	Radiergummis
Reinstoffen	Reinstoffen
schiesst	schiesst
bedingten	bedingten
Mönche	Mönche
Gegenleistungen	Gegenleistungen
gehet	gehet
geleitest	geleitest
betrübt	betrübt
fahrest	fahrest
nähret	nähret
erntete	erntete
bimmelten	bimmelten
gezügelt	gezügelt
entmineralisieret	entmineralisieret
Wollte	Wollte
Gurten	Gurten
Pudern	Pudern
Effekt	Effekt
Euter	Euter
Trümmersprache	Trümmersprache
Fragen	Fragen
Bazziten	Bazziten
Nullpunkt	Nullpunkt
Rauten	Rauten
verblieben	verblieben
pflücktet	pflücktet
Kleptokratien	Kleptokratien
belohnte	belohnte
schämet	schämet
Zeitbomben	Zeitbomben
steckte	steckte
entzweit	entzweit
schautest	schautest
erwachte	erwachte
schlaget	schlaget
begliche	begliche
maßen	maßen
vertraute	vertraute
Honigbär	Honigbär
Reichweiten	Reichweiten
besitzest	besitzest
Antitranspiranten	Antitranspiranten
frappiere	frappiere
meuterest	meuterest
schaffe	schaffe
Katamaran	Katamaran
attackieret	attackieret
teilte	teilte
Gehorsam	Gehorsam
verzieret	verzieret
Bombardierungen	Bombardierungen
Rotzinkerz	Rotzinkerz
Ringe	Ringe
Körpergeruch	Körpergeruch
werfet	werfet
beschrifteten	beschrifteten
begleicht	begleicht
kram	kram
Füchsinnen	Füchsinnen
gewarnt	gewarnt
baggerst	baggerst
tagen	tagen
Herzchen	Herzchen
Ludwigsburger	Ludwigsburger
rauben	rauben
Baiser	Baiser
sannen	sannen
Europameisters	Europameisters
enterten	enterten
Argyrodite	Argyrodite
Moren	Moren
Zwetschgen	Zwetschgen
simulierst	simulierst
spannt	spannt
Reiseleiter	Reiseleiter
Gebäcken	Gebäcken
idealisierten	idealisierten
desertiertet	desertiertet
Wembley-Toren	Wembley-Toren
Radfahrern	Radfahrern
verwechsele	verwechsele
Selbstversuche	Selbstversuche
Trägergas	Trägergas
versagt	versagt
Zinkionen	Zinkionen
entkäme	entkäme
Kurkuma	Kurkuma
Carbiden	Carbiden
Lümmeltüten	Lümmeltüten
überdenkend	überdenkend
schichteten	schichteten
extemporieret	extemporieret
Filzläusen	Filzläusen
glaubtet	glaubtet
quasselten	quasselten
Brauhaus	Brauhaus
Stiefvater	Stiefvater
härtet	härtet
Bonzen	Bonzen
Schlagzeugern	Schlagzeugern
rangierst	rangierst
Leichnamen	Leichnamen
surrst	surrst
Düften	Düften
wiederholten	wiederholten
Kristalle	Kristalle
Hahnenkämme	Hahnenkämme
Geflecktheiten	Geflecktheiten
schwebte	schwebte
Schätze	Schätze
Pforten	Pforten
vertonet	vertonet
ermahnt	ermahnt
erwache	erwache
Freizeitzentren	Freizeitzentren
bimmelte	bimmelte
stigmatisierst	stigmatisierst
Tieren	Tieren
Petersfisch	Petersfisch
Möbiusbändern	Möbiusbändern
bracht	bracht
behauptest	behauptest
nähte	nähte
entwischtet	entwischtet
Atommasse	Atommasse
Sterne	Sterne
wachen	wachen
verschlimmere	verschlimmere
Eiland	Eiland
Schrei	Schrei
verunzierte	verunzierte
producieret	producieret
habt	habt
Assistentinnen	Assistentinnen
Binden	Binden
Anfechtung	Anfechtung
betätigest	betätigest
überbewerte	überbewerte
Ebene	Ebene
Aktenkoffer	Aktenkoffer
Kakadu	Kakadu
Klaue	Klaue
wachse	wachse
glaube	glaube
verkürzte	verkürzte
schmusen	schmusen
sehnst	sehnst
Version	Version
plazierest	plazierest
begrubt	begrubt
Gelobet	Gelobet
Kälber	Kälber
ballaste	ballaste
fehlte	fehlte
Euphemismus	Euphemismus
stiftest	stiftest
beteuerest	beteuerest
Badezimmer	Badezimmer
gräbst	gräbst
Durchbruch	Durchbruch
Flamme	Flamme
Managementsystemen	Managementsystemen
kehrst	kehrst
gaffest	gaffest
Tiegel	Tiegel
Ölfasses	Ölfasses
bewahrest	bewahrest
lebet	lebet
Menschen	Menschen
fällst	fällst
Heiratsgut	Heiratsgut
knautsche	knautsche
feiert	feiert
stapften	stapften
Chlorats	Chlorats
setze	setze
entgehe	entgehe
Hochhäusern	Hochhäusern
Schneider	Schneider
säte	säte
verkapselten	verkapselten
verfehle	verfehle
schnorrtet	schnorrtet
bereuest	bereuest
langweilst	langweilst
Zwingburgen	Zwingburgen
entsetzet	entsetzet
Zwetschge	Zwetschge
Abfahrtsliste	Abfahrtsliste
Buchhalterin	Buchhalterin
Anhängseln	Anhängseln
Meinst	Meinst
erbringst	erbringst
opfern	opfern
verwirkliche	verwirkliche
Antimustern	Antimustern
Lehrkörpern	Lehrkörpern
weise	weise
verklärest	verklärest
Korrosionsschutzen	Korrosionsschutzen
Wolfesgrube	Wolfesgrube
habe	habe
knüpfte	knüpfte
verseift	verseift
Safrane	Safrane
Hast	Hast
forschet	forschet
beauftragt	beauftragt
Zirkelschlüssen	Zirkelschlüssen
Hände	Hände
zügelten	zügelten
verschonet	verschonet
Biokraftstoff	Biokraftstoff
dekompilierten	dekompilierten
kramten	kramten
Deuterium	Deuterium
preise	preise
zeichnet	zeichnet
täuschte	täuschte
berufen	berufen
empörte	empörte
Nullpunktes	Nullpunktes
vergliche	vergliche
dunkelten	dunkelten
Karikaturistinnen	Karikaturistinnen
Zeitschlitze	Zeitschlitze
pflegst	pflegst
reinige	reinige
Pforte	Pforte
Zement	Zement
fladerest	fladerest
Erfahrung	Erfahrung
Kirgisin	Kirgisin
schlachtet	schlachtet
Bajonetten	Bajonetten
Ambiguitäten	Ambiguitäten
Höhe	Höhe
gestalten	gestalten
Staatsanleihe	Staatsanleihe
Rubine	Rubine
Gewichten	Gewichten
deklarierte	deklarierte
Chasar	Chasar
Samarskite	Samarskite
ringe	ringe
ackerst	ackerst
grünten	grünten
stoße	stoße
sagt	sagt
hingeht	hingeht
feire	feire
eingehet	eingehet
dürfe	dürfe
Pater	Pater
Hornunges	Hornunges
gelobtest	gelobtest
pendelt	pendelt
Kernladungszahl	Kernladungszahl
erbringen	erbringen
Einrad	Einrad
Lazarett	Lazarett
Kurkumen	Kurkumen
Sagen	Sagen
mampfte	mampfte
verzehre	verzehre
Sternen	Sternen
hüten	hüten
Weichlote	Weichlote
Konifere	Konifere
Spektroskopie	Spektroskopie
Zwergschwan	Zwergschwan
verkauft	verkauft
tagten	tagten
Haltepunkten	Haltepunkten
Füchsin	Füchsin
Beryll	Beryll
Rücktrittbremse	Rücktrittbremse
offenbare	offenbare
Firnisse	Firnisse
nähre	nähre
fahret	fahret
Braunrallen	Braunrallen
Rechnung	Rechnung
assimiliertest	assimiliertest
speiset	speiset
neidest	neidest
weissagten	weissagten
Generation	Generation
warne	warne
Ausbeutern	Ausbeutern
treibst	treibst
verfanget	verfanget
wünsche	wünsche
versklavte	versklavte
läutetet	läutetet
Tyrannen	Tyrannen
erhöht	erhöht
Feind	Feind
Chlorwasserstoffmoleküls	Chlorwasserstoffmoleküls
Roben	Roben
lade	lade
vertrieben	vertrieben
stimmet	stimmet
kürzt	kürzt
aufstehet	aufstehet
kräuselten	kräuselten
überprüfte	überprüfte
lösten	lösten
beschotteret	beschotteret
entwendete	entwendete
verdammst	verdammst
verdammet	verdammet
malträtiert	malträtiert
Haltepunkt	Haltepunkt
klappst	klappst
schmiert	schmiert
widmest	widmest
Schamentzündungen	Schamentzündungen
dramatisiert	dramatisiert
sterilisiert	sterilisiert
Zehe	Zehe
Überziehens	Überziehens
führe	führe
beschuldigt	beschuldigt
Laubbläsern	Laubbläsern
stoppten	stoppten
belüftet	belüftet
Tausch	Tausch
gebührt	gebührt
schäumt	schäumt
herrschst	herrschst
ertragen	ertragen
winkt	winkt
Kompromiss	Kompromiss
Assistentin	Assistentin
verschafft	verschafft
Plüschtier	Plüschtier
verschmelze	verschmelze
Alkin	Alkin
Kassettenrekordern	Kassettenrekordern
zwängtet	zwängtet
planschtest	planschtest
Möbelstoff	Möbelstoff
Butike	Butike
zerrisset	zerrisset
liebtet	liebtet
konstatiere	konstatiere
Tollkirschen	Tollkirschen
Asylrechten	Asylrechten
Türkenbünden	Türkenbünden
Tatsachenbeschönigern	Tatsachenbeschönigern
löstest	löstest
wehe	wehe
genieret	genieret
verlöteten	verlöteten
Mageninhalten	Mageninhalten
bekennt	bekennt
Sportlerin	Sportlerin
transportiere	transportiere
Regenwald	Regenwald
Buntspechte	Buntspechte
Idolatrien	Idolatrien
gelobest	gelobest
Gründungsprivileg	Gründungsprivileg
Zehen	Zehen
berufe	berufe
strafte	strafte
Fahrt	Fahrt
zählend	zählend
beweisest	beweisest
listeten	listeten
Paradiesapfel	Paradiesapfel
Oxonium	Oxonium
reicht	reicht
teil	teil
verunglimpfte	verunglimpfte
Ektoplasmen	Ektoplasmen
Drachenblut	Drachenblut
plärrt	plärrt
Blockflöte	Blockflöte
Physikerinnen	Physikerinnen
verdamm	verdamm
Imperialismen	Imperialismen
Gruftis	Gruftis
Gegebenheiten	Gegebenheiten
Saiblingen	Saiblingen
Buch	Buch
vereinigte	vereinigte
strömte	strömte
Mitschuld	Mitschuld
überfällst	überfällst
Haben	Haben
Halter	Halter
liebtest	liebtest
evaluiert	evaluiert
Badezimmers	Badezimmers
Verselbstständigung	Verselbstständigung
Fett	Fett
Anliegen	Anliegen
auszieht	auszieht
lehre	lehre
hingehet	hingehet
betrüge	betrüge
rodet	rodet
tobet	tobet
seht	seht
Treibhausgasen	Treibhausgasen
schämest	schämest
Führet	Führet
stigmatisierest	stigmatisierest
Kerzenlichtern	Kerzenlichtern
Versorgungen	Versorgungen
Helden	Helden
schimmerest	schimmerest
baute	baute
Soge	Soge
Pflanzenstoff	Pflanzenstoff
Chinakohl	Chinakohl
gelobtet	gelobtet
Kommoden	Kommoden
stelle	stelle
deaktivierst	deaktivierst
fragmentiert	fragmentiert
Seelöwe	Seelöwe
reden	reden
zeugtest	zeugtest
herrschten	herrschten
Aufprall	Aufprall
zerfetzt	zerfetzt
annektierten	annektierten
klönen	klönen
schenkst	schenkst
obfuskieren	obfuskieren
pflügest	pflügest
Laib	Laib
Feinde	Feinde
wach	wach
schnattert	schnattert
Organisation	Organisation
Kleinoden	Kleinoden
bildest	bildest
Hypochlorite	Hypochlorite
geahnt	geahnt
Abschirmungen	Abschirmungen
Notärztinnen	Notärztinnen
Feldzug	Feldzug
gedächte	gedächte
Lesen	Lesen
reparieret	reparieret
schlag	schlag
Höhen	Höhen
tendiertet	tendiertet
bedürft	bedürft
stirbst	stirbst
fegst	fegst
Geigerzähler	Geigerzähler
parlieren	parlieren
Tübinger	Tübinger
Spitze	Spitze
Briefwechsel	Briefwechsel
Mops	Mops
tun	tun
verspielte	verspielte
Brettspiele	Brettspiele
vertrage	vertrage
überschnitten	überschnitten
begeben	begeben
unterwerfest	unterwerfest
Stadtbezirke	Stadtbezirke
deklarierten	deklarierten
Bleigehalten	Bleigehalten
vernichtete	vernichtete
googelten	googelten
klickte	klickte
umarbeitest	umarbeitest
hassest	hassest
zähle	zähle
kontaktieret	kontaktieret
duckmäusere	duckmäusere
Polyphosphat	Polyphosphat
Genkinit	Genkinit
Zähne	Zähne
knuffend	knuffend
Reinigungsschritten	Reinigungsschritten
Cyanat	Cyanat
Suchanfragen	Suchanfragen
unterbewertete	unterbewertete
Fingerhüte	Fingerhüte
Seehechte	Seehechte
instrumentalisierest	instrumentalisierest
scheltet	scheltet
lehren	lehren
glühten	glühten
Aerosolen	Aerosolen
zensierten	zensierten
Metallquirlen	Metallquirlen
wärme	wärme
Volkslehren	Volkslehren
Strohhälmchen	Strohhälmchen
durchwachen	durchwachen
Klotzes	Klotzes
besprichst	besprichst
pensionierest	pensionierest
charakterisiert	charakterisiert
Abflug	Abflug
Schotten	Schotten
Jungfernflug	Jungfernflug
Efeu	Efeu
grabe	grabe
Kortholt	Kortholt
Schenke	Schenke
bereits	bereits
Orgel	Orgel
erziehst	erziehst
linken	linken
betrügen	betrügen
bekennet	bekennet
grünen	grünen
beweist	beweist
Keile	Keile
Alterität	Alterität
konstatiertest	konstatiertest
scherze	scherze
stammelest	stammelest
pustet	pustet
Peptids	Peptids
Werkzeugen	Werkzeugen
lügt	lügt
balkanisierten	balkanisierten
tatet	tatet
rangieret	rangieret
zählte	zählte
Tut	Tut
besetzest	besetzest
seufzest	seufzest
Talismanen	Talismanen
stürzt	stürzt
streifte	streifte
knusperten	knusperten
egalisierten	egalisierten
mästest	mästest
stapele	stapele
spannen	spannen
schämte	schämte
verwahrst	verwahrst
naschten	naschten
sagst	sagst
abalienierest	abalienierest
verurteilen	verurteilen
Friesen	Friesen
Gurt	Gurt
zensiere	zensiere
Cyclodextrinen	Cyclodextrinen
Störe	Störe
verzierten	verzierten
Europium	Europium
verbündend	verbündend
Ärztinnen	Ärztinnen
kugelten	kugelten
Pfählen	Pfählen
Zeile	Zeile
Haarverlust	Haarverlust
nehmest	nehmest
Genetikerin	Genetikerin
Schreibtischtätern	Schreibtischtätern
verselbstständigest	verselbstständigest
Teilnehmerin	Teilnehmerin
Sauberfrauen	Sauberfrauen
Philerast	Philerast
tastet	tastet
Kuckucken	Kuckucken
musizierte	musizierte
Metallspiegel	Metallspiegel
fliehe	fliehe
erhörst	erhörst
Feierabende	Feierabende
Funkfeuern	Funkfeuern
grübelt	grübelt
schlummerte	schlummerte
spurtest	spurtest
leget	leget
Merkel-Rauten	Merkel-Rauten
knitterte	knitterte
steigest	steigest
Sphäre	Sphäre
injiziert	injiziert
älteste	älteste
Nussknackern	Nussknackern
downloadete	downloadete
reagiert	reagiert
entständen	entständen
überweise	überweise
wehre	wehre
schwadronierten	schwadronierten
Privatsachen	Privatsachen
misstrauen	misstrauen
Werken	Werken
verkröchet	verkröchet
verführtest	verführtest
Ankern	Ankern
wetzte	wetzte
helft	helft
Wiedergutmachungen	Wiedergutmachungen
Vordenkern	Vordenkern
rekrutierest	rekrutierest
überreichst	überreichst
Ackerschachtelhalm	Ackerschachtelhalm
Schal	Schal
Hardwareentwicklerin	Hardwareentwicklerin
Fokus	Fokus
lausche	lausche
Frieden	Frieden
wachsen	wachsen
klone	klone
verrostet	verrostet
boykottierten	boykottierten
betonierte	betonierte
zuteil	zuteil
helfet	helfet
Leitkegeln	Leitkegeln
unterforderten	unterforderten
schwirret	schwirret
einigst	einigst
arrivierst	arrivierst
verunglimpfen	verunglimpfen
Stilllegung	Stilllegung
Wachen	Wachen
herrschte	herrschte
blondierten	blondierten
Judenräte	Judenräte
Kapitalverkehr	Kapitalverkehr
Münzsammlung	Münzsammlung
gedachte	gedachte
labert	labert
prangest	prangest
verbündest	verbündest
wisperest	wisperest
Dochten	Dochten
Setzet	Setzet
offenbar	offenbar
dümpelt	dümpelt
Datentypen	Datentypen
Butzemann	Butzemann
Trickbetrügern	Trickbetrügern
Däumlings	Däumlings
verbüßest	verbüßest
verdammte	verdammte
hintertreiben	hintertreiben
verziehen	verziehen
Epoxide	Epoxide
fallt	fallt
erstürmet	erstürmet
bollerest	bollerest
Managementsystem	Managementsystem
Abbindebeschleuniger	Abbindebeschleuniger
verklärt	verklärt
Welteninsel	Welteninsel
tränke	tränke
Plumpse	Plumpse
gedachtest	gedachtest
Gaunern	Gaunern
schlaft	schlaft
begnügte	begnügte
ausführen	ausführen
verprügelte	verprügelte
fistete	fistete
Blattgewebe	Blattgewebe
bombardiert	bombardiert
gehöre	gehöre
bürsten	bürsten
eskalieret	eskalieret
Beiblättern	Beiblättern
Heuhaufen	Heuhaufen
Palme	Palme
schnorrest	schnorrest
verladet	verladet
gedurft	gedurft
Vaginen	Vaginen
Märtyrern	Märtyrern
Diethylether	Diethylether
bedeckest	bedeckest
Gitarrenspieler	Gitarrenspieler
Kerzenfischen	Kerzenfischen
dresche	dresche
Negermusik	Negermusik
entwickelten	entwickelten
heilte	heilte
Weinberge	Weinberge
kreieren	kreieren
Hallelujas	Hallelujas
erzürnt	erzürnt
Anhängsel	Anhängsel
Ärztin	Ärztin
Kassiteriten	Kassiteriten
kappet	kappet
formirend	formirend
Schlüchten	Schlüchten
bescheiße	bescheiße
ausgehst	ausgehst
Zebrahai	Zebrahai
Fluorgehalte	Fluorgehalte
liegst	liegst
ausfuhren	ausfuhren
fallen	fallen
Suchanfrage	Suchanfrage
Pinguinen	Pinguinen
dramatisieren	dramatisieren
bestimmten	bestimmten
Feuerteufel	Feuerteufel
verbaseln	verbaseln
gönnest	gönnest
Reststoffen	Reststoffen
finanzieret	finanzieret
schneide	schneide
Oxalaten	Oxalaten
formirte	formirte
Verbindungsdraht	Verbindungsdraht
Abbindebeschleunigern	Abbindebeschleunigern
Polarisation	Polarisation
Musters	Musters
Streichen	Streichen
baust	baust
Gedächtnisse	Gedächtnisse
Somite	Somite
Gasflaschen	Gasflaschen
schmierte	schmierte
Zapfhahn	Zapfhahn
ziehet	ziehet
Langschwanzpinguinen	Langschwanzpinguinen
Pläsieren	Pläsieren
Apotheose	Apotheose
Schwarzseherin	Schwarzseherin
Fermium	Fermium
Stempeluhren	Stempeluhren
legend	legend
Mischelementen	Mischelementen
Tollkirsche	Tollkirsche
Freunden	Freunden
zerstreuest	zerstreuest
fertig	fertig
erwärmten	erwärmten
Spießen	Spießen
verflog	verflog
mache	mache
fistet	fistet
Augengläsern	Augengläsern
verspätete	verspätete
Kalb	Kalb
Ich	Ich
Schlaraffenlandes	Schlaraffenlandes
versteigernd	versteigernd
faltest	faltest
waren	waren
pflanzte	pflanzte
Speere	Speere
Auguren	Auguren
Ehre	Ehre
entdeckst	entdeckst
Atemgas	Atemgas
Kosten	Kosten
trompetete	trompetete
Epidemie	Epidemie
Bettlers	Bettlers
Märchenbüchern	Märchenbüchern
kämmtet	kämmtet
substituieren	substituieren
kauten	kauten
verlautet	verlautet
bereitete	bereitete
kaufte	kaufte
Californium	Californium
prophezeie	prophezeie
beunruhigte	beunruhigte
zentrierest	zentrierest
führen	führen
räumen	räumen
dürfen	dürfen
konsolidierend	konsolidierend
evakuieret	evakuieret
Reißnagel	Reißnagel
zeiget	zeiget
werdet	werdet
dienet	dienet
Gefilden	Gefilden
knutschst	knutschst
puste	puste
beweiset	beweiset
betrüben	betrüben
Ausbeuter	Ausbeuter
zappten	zappten
respektieren	respektieren
malochte	malochte
geschlummert	geschlummert
Volkslehre	Volkslehre
Adamsapfel	Adamsapfel
Untiefe	Untiefe
klage	klage
Milchflaschen	Milchflaschen
verwiesen	verwiesen
gratuliere	gratuliere
Gebeten	Gebeten
überstehend	überstehend
Animation	Animation
heißest	heißest
Anwendungsgebiet	Anwendungsgebiet
Unternehmung	Unternehmung
Tische	Tische
dampfst	dampfst
losten	losten
salzen	salzen
Anfänger	Anfänger
zerstreuet	zerstreuet
zürntet	zürntet
lockerte	lockerte
Durchbruches	Durchbruches
kostet	kostet
sintertest	sintertest
begehre	begehre
Wasserquelle	Wasserquelle
Geschreis	Geschreis
mopst	mopst
bezichtigt	bezichtigt
vereinigt	vereinigt
Sprechers	Sprechers
Abbildern	Abbildern
quietsche	quietsche
glaubend	glaubend
Rückumlaute	Rückumlaute
kautest	kautest
Bevölkerungsdichten	Bevölkerungsdichten
Reinelementen	Reinelementen
belohnten	belohnten
heiß	heiß
hadertet	hadertet
Otavit	Otavit
säst	säst
Geliebte	Geliebte
mögt	mögt
beeindruckt	beeindruckt
gelobte	gelobte
funkeln	funkeln
vollendete	vollendete
Stimmen	Stimmen
Lautwandeln	Lautwandeln
schwellen	schwellen
warntest	warntest
partitionierten	partitionierten
skypst	skypst
verkündet	verkündet
Taschenwörterbuch	Taschenwörterbuch
Kalifeldspat	Kalifeldspat
Fische	Fische
vernehmest	vernehmest
Schneepflug	Schneepflug
Wandergesellen	Wandergesellen
Domänen	Domänen
Rotgüssen	Rotgüssen
Gesetzen	Gesetzen
zittere	zittere
drängst	drängst
verführten	verführten
Gefängnissen	Gefängnissen
bewässerest	bewässerest
verdrehet	verdrehet
brillierest	brillierest
Däumlingen	Däumlingen
ermordet	ermordet
putzte	putzte
Trioxiden	Trioxiden
demütiget	demütiget
Kaktusfeige	Kaktusfeige
wachte	wachte
Erstlinge	Erstlinge
Halle	Halle
Steuerwagens	Steuerwagens
weissagst	weissagst
Strafraum	Strafraum
Aktienkursen	Aktienkursen
Essigsäurechloriden	Essigsäurechloriden
gekröst	gekröst
übersehest	übersehest
kommst	kommst
rede	rede
schnitt	schnitt
Kontaktierungen	Kontaktierungen
Rasterkraftmikroskop	Rasterkraftmikroskop
bestellte	bestellte
frikassierend	frikassierend
blamierten	blamierten
rollten	rollten
lobte	lobte
lohnt	lohnt
Schanktisch	Schanktisch
Klassenzimmern	Klassenzimmern
Bildschirmfoto	Bildschirmfoto
Jungfernflüge	Jungfernflüge
Enden	Enden
Arreste	Arreste
verschicket	verschicket
schauspielert	schauspielert
Selbstsicherheit	Selbstsicherheit
Golfplätzen	Golfplätzen
wallfahrteten	wallfahrteten
dressieret	dressieret
Fingerspitze	Fingerspitze
Rundbriefe	Rundbriefe
kichert	kichert
nippend	nippend
assimilieret	assimilieret
bewies	bewies
Geschäfte	Geschäfte
Steuerbord	Steuerbord
verlötest	verlötest
Ölspur	Ölspur
dechiffrierend	dechiffrierend
hurst	hurst
Laubholz	Laubholz
ankerst	ankerst
Uteri	Uteri
schützt	schützt
Stärket	Stärket
lanciertet	lanciertet
Kompromissen	Kompromissen
parametrisierte	parametrisierte
Fluoratomen	Fluoratomen
Fiebermitteln	Fiebermitteln
verjährest	verjährest
Astat	Astat
rühmst	rühmst
sabbre	sabbre
brausen	brausen
beschottre	beschottre
arbeit	arbeit
Apportierhund	Apportierhund
Piratensendern	Piratensendern
Putschisten	Putschisten
Stoffwechselweg	Stoffwechselweg
erhöhest	erhöhest
Ångström	Ångström
füllte	füllte
reife	reife
Serverzugriffen	Serverzugriffen
Leitungsweg	Leitungsweg
höhnte	höhnte
rinnt	rinnt
verdammen	verdammen
Taschendieb	Taschendieb
tust	tust
erwachet	erwachet
stille	stille
erriet	erriet
zierte	zierte
Laiben	Laiben
schenke	schenke
Arsch	Arsch
frikassiert	frikassiert
mühte	mühte
bedurftest	bedurftest
Laufringe	Laufringe
Anmeldern	Anmeldern
Krusten	Krusten
tendierst	tendierst
verfinstert	verfinstert
Pflichten	Pflichten
Vogelscheuchen	Vogelscheuchen
Elementarzelle	Elementarzelle
Android	Android
Fotosynthese	Fotosynthese
widerlegest	widerlegest
Wiederauferstehung	Wiederauferstehung
Stör	Stör
restaurierten	restaurierten
drückte	drückte
Ackerschachtelhalme	Ackerschachtelhalme
Rechtsruck	Rechtsruck
bündelest	bündelest
Möbelstoffen	Möbelstoffen
zwingst	zwingst
ruhte	ruhte
Wache	Wache
Aprikosen	Aprikosen
schlabberten	schlabberten
Reflexionen	Reflexionen
Rekursionen	Rekursionen
Satzung	Satzung
analysiere	analysiere
Eilande	Eilande
schwebe	schwebe
Pflanzungen	Pflanzungen
reichte	reichte
Gebern	Gebern
tragest	tragest
verbärgen	verbärgen
schmeichelest	schmeichelest
schmeicheln	schmeicheln
verkleinern	verkleinern
Vorstädten	Vorstädten
Dürren	Dürren
peilst	peilst
Bund	Bund
rekonstruieret	rekonstruieret
Androiden	Androiden
ersparten	ersparten
Fußbodens	Fußbodens
haste	haste
Genies	Genies
Elektrophil	Elektrophil
reglementierte	reglementierte
sedimentiertet	sedimentiertet
knurrt	knurrt
verfolgt	verfolgt
verkriechet	verkriechet
fahrt	fahrt
holte	holte
stimmte	stimmte
Vorstoß	Vorstoß
aufrichte	aufrichte
Fluorkohlenwasserstoffe	Fluorkohlenwasserstoffe
heparinisiere	heparinisiere
Nehmet	Nehmet
Anspielungen	Anspielungen
colorierten	colorierten
Aromastoffen	Aromastoffen
Molybdit	Molybdit
sagest	sagest
sinterte	sinterte
Gibst	Gibst
Schamentzündung	Schamentzündung
zürnest	zürnest
blockierten	blockierten
Volltreffer	Volltreffer
Apostels	Apostels
Flensern	Flensern
Minimierung	Minimierung
strafe	strafe
argumentierest	argumentierest
Fingerhüten	Fingerhüten
Kairiner	Kairiner
Schaden	Schaden
sinke	sinke
Zainen	Zainen
Halbgott	Halbgott
Abbild	Abbild
segelte	segelte
Lehrkörpers	Lehrkörpers
sponsert	sponsert
Referenzen	Referenzen
Komplexionen	Komplexionen
Thioacetalen	Thioacetalen
haltest	haltest
hydrogentartrat	hydrogentartrat
schließen	schließen
Prostyloi	Prostyloi
drescht	drescht
schwächend	schwächend
desensibilisierte	desensibilisierte
Langzeichen	Langzeichen
konnotierst	konnotierst
sedimentiere	sedimentiere
sagten	sagten
Hahnenkämmen	Hahnenkämmen
gebäre	gebäre
Gläubiger	Gläubiger
türmen	türmen
explodierst	explodierst
Augur	Augur
Bällchen	Bällchen
klemmt	klemmt
Puffersystemen	Puffersystemen
Hornung	Hornung
Beobachtungen	Beobachtungen
sterilisierte	sterilisierte
Protonen	Protonen
Quelle	Quelle
wärmet	wärmet
drücke	drücke
setzest	setzest
Streife	Streife
Brüder	Brüder
Floß	Floß
weinte	weinte
Schlot	Schlot
vertreibe	vertreibe
erbest	erbest
Grenzen	Grenzen
Nährmedien	Nährmedien
Aggressoren	Aggressoren
platz	platz
fluppen	fluppen
rolltet	rolltet
Eisenkräutern	Eisenkräutern
brechet	brechet
kaufet	kaufet
duckmäuseret	duckmäuseret
Füllen	Füllen
pflügen	pflügen
verachte	verachte
wollt	wollt
überschattete	überschattete
stolze	stolze
entkörperlichte	entkörperlichte
dürften	dürften
Aase	Aase
Chlorat	Chlorat
orgelt	orgelt
Ring	Ring
zuppst	zuppst
rebelliertet	rebelliertet
spezialisiere	spezialisiere
vertrieb	vertrieb
Bilderstürmereien	Bilderstürmereien
Entsetzt	Entsetzt
gewöhnt	gewöhnt
schnappet	schnappet
frappierte	frappierte
demütigte	demütigte
Polierstählen	Polierstählen
absolviertet	absolviertet
Abschußring	Abschußring
Fußboden	Fußboden
gesellt	gesellt
Spektralbereich	Spektralbereich
Atombomben	Atombomben
Artischocken	Artischocken
Schaffnerinnen	Schaffnerinnen
klagte	klagte
still	still
losen	losen
Wehe	Wehe
beschlug	beschlug
zeugest	zeugest
enttäuschtest	enttäuschtest
lehrest	lehrest
verdamme	verdamme
dümpelte	dümpelte
Schreibern	Schreibern
heben	heben
Mopps	Mopps
Menschenhandel	Menschenhandel
Chlorid	Chlorid
unterbrächen	unterbrächen
überschatteten	überschatteten
Linguistinnen	Linguistinnen
Jünger	Jünger
folgte	folgte
Berge	Berge
faule	faule
Gedränge	Gedränge
kooperierte	kooperierte
Fusselbärten	Fusselbärten
Nachruf	Nachruf
besichert	besichert
stärket	stärket
gedenk	gedenk
aufwachte	aufwachte
vergleichet	vergleichet
spukte	spukte
Exzentriker	Exzentriker
Sanatorien	Sanatorien
keulst	keulst
Sichelzellenanämien	Sichelzellenanämien
verscheißert	verscheißert
tunet	tunet
Kornnattern	Kornnattern
umhüll	umhüll
leihe	leihe
spanne	spanne
flieh	flieh
Notständen	Notständen
sinkest	sinkest
besprachen	besprachen
Kaufkraft	Kaufkraft
Organistin	Organistin
greinet	greinet
Fettsäcken	Fettsäcken
gebühren	gebühren
hüpfest	hüpfest
Abfertigungsschalter	Abfertigungsschalter
folgtet	folgtet
schmuggele	schmuggele
Metallothioneinen	Metallothioneinen
schummelst	schummelst
gedenke	gedenke
scheiterst	scheiterst
Boten	Boten
querte	querte
verwirklicht	verwirklicht
bedrücktest	bedrücktest
Bevölkerungsdichte	Bevölkerungsdichte
posiertet	posiertet
Hochsommer	Hochsommer
piesacken	piesacken
grabbelten	grabbelten
durchzuck	durchzuck
Trinken	Trinken
tasteten	tasteten
ummantelten	ummantelten
henken	henken
Einbrecher	Einbrecher
brillieren	brillieren
verwahret	verwahret
verwechselet	verwechselet
bücktest	bücktest
Schild	Schild
Dewargefäß	Dewargefäß
erfreute	erfreute
Wembley-Tore	Wembley-Tore
trübe	trübe
Reliquiar	Reliquiar
ringele	ringele
erpress	erpress
tappst	tappst
Klärungen	Klärungen
Trichter	Trichter
entzögen	entzögen
bringet	bringet
teile	teile
gestatteten	gestatteten
spähet	spähet
Heere	Heere
bestimmst	bestimmst
steigen	steigen
setzten	setzten
christianisiere	christianisiere
Vanadaten	Vanadaten
Aspartamen	Aspartamen
berühret	berühret
danket	danket
erwürgest	erwürgest
interagierte	interagierte
stellte	stellte
bebet	bebet
bedrückest	bedrückest
weichet	weichet
erben	erben
war	war
verallgemeinerest	verallgemeinerest
Innenministerien	Innenministerien
weg	weg
erhört	erhört
schauest	schauest
Überweisung	Überweisung
verstörten	verstörten
befehle	befehle
überqueren	überqueren
besorgt	besorgt
Lob	Lob
unterstützet	unterstützet
erhebst	erhebst
lögen	lögen
Radiergummi	Radiergummi
Dorngesträuchen	Dorngesträuchen
verlobte	verlobte
emigrieret	emigrieret
Fischer	Fischer
zuppe	zuppe
Zeitüberschreitung	Zeitüberschreitung
stellet	stellet
Ringeltaube	Ringeltaube
velarisiert	velarisiert
Bettler	Bettler
Ecke	Ecke
verschickte	verschickte
schicke	schicke
kramst	kramst
nippst	nippst
balkanisierte	balkanisierte
liebest	liebest
Gläubigern	Gläubigern
weichen	weichen
Zapfhähnen	Zapfhähnen
Shortcuts	Shortcuts
Linken	Linken
Samarskit	Samarskit
NAND-Gatter	NAND-Gatter
Brieföffners	Brieföffners
zupfte	zupfte
widerrufe	widerrufe
besprächen	besprächen
gestattest	gestattest
Politologe	Politologe
stürze	stürze
Wadenbein	Wadenbein
Sexte	Sexte
protestierst	protestierst
maximierten	maximierten
Marokkanern	Marokkanern
Abfahrtslisten	Abfahrtslisten
flirtest	flirtest
Portal	Portal
schämten	schämten
erwärmte	erwärmte
Öfchen	Öfchen
Wadenbeines	Wadenbeines
Arbeitsunfähigkeit	Arbeitsunfähigkeit
Provinzen	Provinzen
Autoklaven	Autoklaven
kletteret	kletteret
zeigst	zeigst
Fanmeilen	Fanmeilen
brauche	brauche
äusserst	äusserst
treibest	treibest
Normdaten	Normdaten
Zeithorizonten	Zeithorizonten
Brechnuss	Brechnuss
sabbelt	sabbelt
Sinnen	Sinnen
kaufe	kaufe
Trotzkist	Trotzkist
Mikrometer	Mikrometer
verboten	verboten
Seetauchers	Seetauchers
öle	öle
ausführte	ausführte
leider	leider
Kerzenlichter	Kerzenlichter
schöpfe	schöpfe
Aufträgen	Aufträgen
Nukleinsäure	Nukleinsäure
schneidet	schneidet
wallfahrest	wallfahrest
pfänden	pfänden
dürfest	dürfest
unterschieden	unterschieden
Sprödmetall	Sprödmetall
Würfen	Würfen
Wechselstuben	Wechselstuben
dressierten	dressierten
erliegest	erliegest
beäugst	beäugst
Achseln	Achseln
bewahret	bewahret
bromiert	bromiert
lodert	lodert
Sonderberichte	Sonderberichte
flucht	flucht
Republikflucht	Republikflucht
Hummern	Hummern
Scheißkerl	Scheißkerl
Schneepflüge	Schneepflüge
bereiten	bereiten
knüpfen	knüpfen
Fette	Fette
brachen	brachen
Lüste	Lüste
Gipfeltreffen	Gipfeltreffen
illustriertet	illustriertet
Urheimaten	Urheimaten
feiere	feiere
Iberers	Iberers
malten	malten
Abschußringe	Abschußringe
ahne	ahne
vandalieren	vandalieren
verklagt	verklagt
stifte	stifte
verachtet	verachtet
Übelkeit	Übelkeit
Krume	Krume
Hektare	Hektare
fokussieret	fokussieret
grabest	grabest
Mitwisserschaft	Mitwisserschaft
begehrtet	begehrtet
Almanache	Almanache
Macht	Macht
Tübingern	Tübingern
folg	folg
gelobe	gelobe
betrieben	betrieben
Ionenaustauscher	Ionenaustauscher
verzehrst	verzehrst
wehr	wehr
föchten	föchten
sagen	sagen
Martyrologium	Martyrologium
Küchenmaschine	Küchenmaschine
verdammt	verdammt
vertäte	vertäte
Schwester	Schwester
ertraget	ertraget
Berufe	Berufe
Pfleglingen	Pfleglingen
Zensus	Zensus
designierst	designierst
Schober	Schober
plissiere	plissiere
Kernspaltungen	Kernspaltungen
stoppte	stoppte
Gar	Gar
ehren	ehren
hinterlege	hinterlege
frottierten	frottierten
Pardelkatze	Pardelkatze
bekotete	bekotete
enttäusche	enttäusche
Germanisten	Germanisten
Nukleinsäuren	Nukleinsäuren
Sorge	Sorge
Apfelbäumen	Apfelbäumen
Gläubige	Gläubige
Steuerwagen	Steuerwagen
Weichloten	Weichloten
schauen	schauen
Toypudeln	Toypudeln
Inder	Inder
Fettsack	Fettsack
WebHook	WebHook
aufrichtet	aufrichtet
Pentaboraten	Pentaboraten
Brüdern	Brüdern
Grüße	Grüße
quantisierte	quantisierte
höret	höret
naschst	naschst
lavierend	lavierend
fällen	fällen
addierte	addierte
Meerschweinchen	Meerschweinchen
gehorchte	gehorchte
lügen	lügen
wässerst	wässerst
Briefe	Briefe
Ochs	Ochs
überliefere	überliefere
Sexten	Sexten
fragen	fragen
Schwermetallion	Schwermetallion
Brieftaubenzüchter	Brieftaubenzüchter
foppten	foppten
Gedrängen	Gedrängen
wolle	wolle
entmineralisierst	entmineralisierst
Zitronensäften	Zitronensäften
föchte	föchte
tattert	tattert
fluppst	fluppst
bewahrheitetet	bewahrheitetet
Setzt	Setzt
Leugnungen	Leugnungen
kickend	kickend
Unterwerfungen	Unterwerfungen
Fellachinnen	Fellachinnen
fotzt	fotzt
scheuchtest	scheuchtest
Blitzen	Blitzen
beanspruchet	beanspruchet
vergaset	vergaset
dotiere	dotiere
legten	legten
dirigiert	dirigiert
Zwangsarbeiterin	Zwangsarbeiterin
Keilen	Keilen
stickten	stickten
Futur	Futur
Pest	Pest
designiertet	designiertet
bröckeln	bröckeln
möpperst	möpperst
Monarchie	Monarchie
Hehler	Hehler
Bertrandit	Bertrandit
schubset	schubset
danke	danke
bräunen	bräunen
Weichseln	Weichseln
heißt	heißt
gehorchten	gehorchten
Riegel	Riegel
gedenkest	gedenkest
flense	flense
Finanzministern	Finanzministern
begehrten	begehrten
Mittelaltermarkt	Mittelaltermarkt
Weste	Weste
schöpfest	schöpfest
setztet	setztet
Wiederauferstehungen	Wiederauferstehungen
Kernladungszahlen	Kernladungszahlen
Wurzelwachstum	Wurzelwachstum
machte	machte
schlachten	schlachten
schummelten	schummelten
aufwacht	aufwacht
sprachen	sprachen
prosteten	prosteten
Kruste	Kruste
wehrte	wehrte
wünschet	wünschet
hickste	hickste
Dattel	Dattel
gelobst	gelobst
verirrt	verirrt
Elastomer	Elastomer
Platte	Platte
begehrst	begehrst
Atommodelle	Atommodelle
erklingt	erklingt
verwirrest	verwirrest
schnitten	schnitten
heulet	heulet
konvertieren	konvertieren
Bittersüß	Bittersüß
Oberbegriff	Oberbegriff
Libelle	Libelle
Besprechungen	Besprechungen
Steigen	Steigen
Taschendiebe	Taschendiebe
regieren	regieren
rufet	rufet
aase	aase
UND-Gattern	UND-Gattern
Mop	Mop
streiten	streiten
Wüsten	Wüsten
Buche	Buche
Gehirnwelle	Gehirnwelle
Aktivist	Aktivist
fladerten	fladerten
parkierten	parkierten
lochtest	lochtest
Gesamtmengen	Gesamtmengen
pflanzet	pflanzet
Kanzlei	Kanzlei
versuchst	versuchst
Hinkelstein	Hinkelstein
Chelatkomplex	Chelatkomplex
Dünungen	Dünungen
Thioester	Thioester
Anhang	Anhang
Halsabschneidern	Halsabschneidern
Führe	Führe
erstürmt	erstürmt
Renegaten	Renegaten
Landesverräterinnen	Landesverräterinnen
wallfahrten	wallfahrten
Fellachin	Fellachin
glauben	glauben
Haarverlusten	Haarverlusten
erfahrt	erfahrt
manövrieret	manövrieret
hastete	hastete
zerstreut	zerstreut
Kanzlerinnen	Kanzlerinnen
klaget	klaget
Lümmeltüte	Lümmeltüte
kräusle	kräusle
Autoklav	Autoklav
Vergrößerungen	Vergrößerungen
jaule	jaule
inhalierest	inhalierest
gewinnen	gewinnen
Naturen	Naturen
verbot	verbot
Chasaren	Chasaren
dringen	dringen
verbrauchte	verbrauchte
Hubschraubern	Hubschraubern
Diamantringen	Diamantringen
forschte	forschte
Grabbeltisch	Grabbeltisch
Flussbetten	Flussbetten
deaktiviere	deaktiviere
Domäne	Domäne
auflöst	auflöst
Randbemerkung	Randbemerkung
regierte	regierte
sollt	sollt
faschieret	faschieret
Einrädern	Einrädern
halltet	halltet
legst	legst
verzieh	verzieh
Rotgusses	Rotgusses
Hacker	Hacker
füsilierten	füsilierten
knutschest	knutschest
Beile	Beile
führet	führet
Zeitplan	Zeitplan
gewitterte	gewitterte
steinigte	steinigte
kasernierte	kasernierte
blondiert	blondiert
surre	surre
moppst	moppst
Atombombe	Atombombe
Haarshampoos	Haarshampoos
Puffersystem	Puffersystem
Referenz	Referenz
Fusselbart	Fusselbart
generiertet	generiertet
Zeitschlitzen	Zeitschlitzen
wohnest	wohnest
Aphasie	Aphasie
verdinglichtest	verdinglichtest
verschränkest	verschränkest
Generationen	Generationen
laden	laden
Collagen	Collagen
hasset	hasset
Kindergeld	Kindergeld
initiieret	initiieret
begruben	begruben
Malaysiers	Malaysiers
Strahlentierchens	Strahlentierchens
Metallothionein	Metallothionein
krieget	krieget
verstehest	verstehest
Türklingeln	Türklingeln
Kleinode	Kleinode
fritierten	fritierten
Quellfluss	Quellfluss
unterdrücke	unterdrücke
befürchtet	befürchtet
eggte	eggte
suchten	suchten
argumentierten	argumentierten
reichet	reichet
Irrtumes	Irrtumes
Gase	Gase
besorgest	besorgest
tätowiertet	tätowiertet
peiltest	peiltest
babbelt	babbelt
Irrtümern	Irrtümern
Katz-und-Maus-Spielen	Katz-und-Maus-Spielen
verlautete	verlautete
fresse	fresse
plärrtest	plärrtest
Heeren	Heeren
instanziier	instanziier
umhüllst	umhüllst
pipettierten	pipettierten
Nanokondensatoren	Nanokondensatoren
Laken	Laken
hingehst	hingehst
Dachdeckerin	Dachdeckerin
Zunge	Zunge
Kerfe	Kerfe
Rehböcken	Rehböcken
Lobe	Lobe
blenden	blenden
Päderast	Päderast
raffinier	raffinier
Weihen	Weihen
Kontrollboxen	Kontrollboxen
gespeist	gespeist
Anwendungsgebiete	Anwendungsgebiete
handhabt	handhabt
boß	boß
Taufen	Taufen
Eissteinen	Eissteinen
Laubbaum	Laubbaum
beichten	beichten
verteidigt	verteidigt
Traubenlesen	Traubenlesen
ermahnet	ermahnet
decket	decket
zürnet	zürnet
Reinelemente	Reinelemente
verunglimpfest	verunglimpfest
benachrichtiget	benachrichtiget
Literaturen	Literaturen
changieren	changieren
Mobilfunknetzen	Mobilfunknetzen
Geldautomat	Geldautomat
Glühwürmchen	Glühwürmchen
laben	laben
Denkmünze	Denkmünze
auflegst	auflegst
werde	werde
begraben	begraben
lege	lege
häuftet	häuftet
zertifiziertest	zertifiziertest
gehören	gehören
dirigieret	dirigieret
Blumenstrauß	Blumenstrauß
Orgeln	Orgeln
trage	trage
Aktivisten	Aktivisten
Autonomie	Autonomie
Kriege	Kriege
erhöhet	erhöhet
Lehnen	Lehnen
Markisen	Markisen
löstet	löstet
radierte	radierte
Fluorgehalt	Fluorgehalt
Huren	Huren
anrührte	anrührte
erhebest	erhebest
Herbstwinde	Herbstwinde
funzt	funzt
Maultiere	Maultiere
grausten	grausten
Gedächtnissen	Gedächtnissen
massakrierte	massakrierte
erwachend	erwachend
möppertet	möppertet
Primärenergie	Primärenergie
überdenkst	überdenkst
füllen	füllen
köderet	köderet
Beobachtung	Beobachtung
Videoaufzeichnungen	Videoaufzeichnungen
Schobern	Schobern
fabulierest	fabulierest
Brandbeschleuniger	Brandbeschleuniger
hänget	hänget
verspäteten	verspäteten
Regierung	Regierung
grau	grau
pflegte	pflegte
Dezernaten	Dezernaten
wehrt	wehrt
Operationssälen	Operationssälen
Sprachraum	Sprachraum
schaben	schaben
empört	empört
revoltieren	revoltieren
Robe	Robe
erkälteten	erkälteten
Aachener	Aachener
Drohkulisse	Drohkulisse
Europameistern	Europameistern
Verwaltungsakte	Verwaltungsakte
erforschet	erforschet
Borkenkäfer	Borkenkäfer
leide	leide
grüße	grüße
kehre	kehre
gähnten	gähnten
anrichten	anrichten
ermächtige	ermächtige
betrübst	betrübst
Narkotikum	Narkotikum
Kontraindikationen	Kontraindikationen
fasse	fasse
baue	baue
Attentäter	Attentäter
alarmieren	alarmieren
obfuskierten	obfuskierten
Ypecaharalle	Ypecaharalle
stehest	stehest
Flitzer	Flitzer
Ölfässern	Ölfässern
Sprecher	Sprecher
beschlaget	beschlaget
Renegat	Renegat
lockerst	lockerst
stapfst	stapfst
Hubschrauber	Hubschrauber
Herd	Herd
bessere	bessere
Küstenwachen	Küstenwachen
puddelst	puddelst
Trägergasen	Trägergasen
Ochsen	Ochsen
stärkte	stärkte
fokussierten	fokussierten
Abschiedsbrief	Abschiedsbrief
Rehbock	Rehbock
Klärung	Klärung
Kaufhäuser	Kaufhäuser
panaschieren	panaschieren
Abnahmen	Abnahmen
härte	härte
schöpfte	schöpfte
Siglen	Siglen
kategorisierte	kategorisierte
Nährmediums	Nährmediums
loben	loben
faschierst	faschierst
verringert	verringert
Käsereiben	Käsereiben
Peptid	Peptid
Friede	Friede
Zähnen	Zähnen
bewähret	bewähret
generiert	generiert
Barschaften	Barschaften
Rotscheitelreiher	Rotscheitelreiher
Dampfschiffen	Dampfschiffen
gebet	gebet
spekuliere	spekuliere
Nigger	Nigger
bestrafe	bestrafe
überprüftest	überprüftest
Ambiguität	Ambiguität
ladest	ladest
bestellten	bestellten
Hummel	Hummel
Breiten	Breiten
haben	haben
Tetraiodide	Tetraiodide
Telefonverkäufer	Telefonverkäufer
Enthärtungen	Enthärtungen
verstrahlet	verstrahlet
Bushaltestelle	Bushaltestelle
folterte	folterte
Beten	Beten
streite	streite
Kerl	Kerl
geniertest	geniertest
konsolidierest	konsolidierest
hegt	hegt
Generatoren	Generatoren
häufte	häufte
missverstände	missverstände
schaut	schaut
Bilderstürmers	Bilderstürmers
Denkmünzen	Denkmünzen
Numerus	Numerus
verspielest	verspielest
flambierest	flambierest
Sorget	Sorget
Ranzigkeit	Ranzigkeit
funktionalisiertest	funktionalisiertest
verdränget	verdränget
grüßt	grüßt
gedächtet	gedächtet
spielen	spielen
Bildschirmfotos	Bildschirmfotos
Tintenklecksen	Tintenklecksen
rodete	rodete
greifen	greifen
downloadet	downloadet
Berufen	Berufen
zeugten	zeugten
zuppte	zuppte
verunglimpftet	verunglimpftet
Freizeitzentrum	Freizeitzentrum
verfliegest	verfliegest
Bluffs	Bluffs
kategorisierst	kategorisierst
verstecke	verstecke
Urbare	Urbare
Kohlenstoffgehalten	Kohlenstoffgehalten
Kuckucke	Kuckucke
deute	deute
leiste	leiste
bekriegtet	bekriegtet
dotierst	dotierst
leistete	leistete
Aha-Erlebnisse	Aha-Erlebnisse
Gleitzeit	Gleitzeit
Senkungen	Senkungen
Aprikose	Aprikose
koexistierten	koexistierten
manövrierte	manövrierte
Malaysierin	Malaysierin
Ratsherren	Ratsherren
kämpfet	kämpfet
wünscht	wünscht
Messiassen	Messiassen
Schnallen	Schnallen
Suffix	Suffix
lobe	lobe
Briefen	Briefen
arbeiten	arbeiten
Aspartame	Aspartame
föhnten	föhnten
Industrienation	Industrienation
Leitungswegs	Leitungswegs
Fahret	Fahret
anzeige	anzeige
emittiert	emittiert
kriegen	kriegen
streckst	streckst
verschränken	verschränken
setzt	setzt
klettert	klettert
Tiefschutz	Tiefschutz
hegten	hegten
könnten	könnten
grienest	grienest
Somiten	Somiten
reifte	reifte
installierten	installierten
Gemütes	Gemütes
verhörest	verhörest
trompete	trompete
bummelet	bummelet
Gammastrahlen	Gammastrahlen
entheiligten	entheiligten
Reiterschwert	Reiterschwert
Konzentrate	Konzentrate
murmelten	murmelten
stolz	stolz
Mähnenwolfes	Mähnenwolfes
bediene	bediene
gedenket	gedenket
stillte	stillte
entstände	entstände
Atemlüfte	Atemlüfte
emigriert	emigriert
vernickelte	vernickelte
sedimentierte	sedimentierte
gleite	gleite
Eisenkraut	Eisenkraut
sprüht	sprüht
heischten	heischten
Premieren	Premieren
massierend	massierend
glaubten	glaubten
leiden	leiden
motivierten	motivierten
wohnet	wohnet
filtern	filtern
Bienenstock	Bienenstock
verglühest	verglühest
zagt	zagt
Sippe	Sippe
beleidige	beleidige
Markise	Markise
kollidierte	kollidierte
Aussätzige	Aussätzige
schaust	schaust
bölket	bölket
Ypecaharallen	Ypecaharallen
dehydrierten	dehydrierten
mögest	mögest
verfolgst	verfolgst
weich	weich
Dreieinigkeit	Dreieinigkeit
einigte	einigte
glänzen	glänzen
binde	binde
weisen	weisen
ruhest	ruhest
Unterseite	Unterseite
benütztest	benütztest
Brieföffner	Brieföffner
Flöte	Flöte
diversifiziere	diversifiziere
ringet	ringet
exmatrikulierte	exmatrikulierte
schwächst	schwächst
Meter	Meter
Türmen	Türmen
beißt	beißt
klappen	klappen
Molybdite	Molybdite
Prüfberichten	Prüfberichten
Locken	Locken
erscheinest	erscheinest
Noseanen	Noseanen
Grabe	Grabe
Hansen	Hansen
Geliebten	Geliebten
Seehechten	Seehechten
lüge	lüge
Karer	Karer
erlauben	erlauben
verarbeite	verarbeite
ausfuhr	ausfuhr
prostete	prostete
infizieret	infizieret
durften	durften
anrührt	anrührt
gabelst	gabelst
diskutiere	diskutiere
Ärschen	Ärschen
meuternd	meuternd
Afrikaner	Afrikaner
bejubelte	bejubelte
Spielen	Spielen
vergrabest	vergrabest
kochte	kochte
sprechet	sprechet
strafen	strafen
funktionierte	funktionierte
versteckte	versteckte
Atommassen	Atommassen
amenagier	amenagier
griffe	griffe
Möbiusbänder	Möbiusbänder
ermordeten	ermordeten
Finanzministerien	Finanzministerien
wurstelten	wurstelten
verunreinigt	verunreinigt
Kleptokratie	Kleptokratie
Gemeinde	Gemeinde
hydrolysierest	hydrolysierest
sortierte	sortierte
alarmiere	alarmiere
überdenkest	überdenkest
Silbererzen	Silbererzen
Schwächung	Schwächung
stiegen	stiegen
erzürnst	erzürnst
hievten	hievten
Preisanstiegen	Preisanstiegen
Muster	Muster
Komponistinnen	Komponistinnen
Anmelder	Anmelder
verunziere	verunziere
scheinest	scheinest
regiere	regiere
Bergen	Bergen
verkaufte	verkaufte
Würzen	Würzen
besänftiget	besänftiget
fällt	fällt
drifte	drifte
Hüftgelenken	Hüftgelenken
imitiert	imitiert
Forschungen	Forschungen
Stilllegungen	Stilllegungen
gebt	gebt
Metonymie	Metonymie
Trümmersprachen	Trümmersprachen
erzwangt	erzwangt
schnürest	schnürest
Harpunen	Harpunen
gründen	gründen
Maxima	Maxima
Schnipsel	Schnipsel
erfahret	erfahret
Leitkegel	Leitkegel
Unterseiten	Unterseiten
Flaschenhälsen	Flaschenhälsen
lauschte	lauschte
glawbten	glawbten
verwaiset	verwaiset
desertierst	desertierst
Carbids	Carbids
zerstreust	zerstreust
hängen	hängen
simuliertet	simuliertet
blamierest	blamierest
aufrichten	aufrichten
mischst	mischst
hoben	hoben
herrschen	herrschen
inspirierten	inspirierten
verglühte	verglühte
Rhabarbern	Rhabarbern
erkennest	erkennest
Blutgefäß	Blutgefäß
evakuierte	evakuierte
erschüttere	erschüttere
löste	löste
Botokuden	Botokuden
wichste	wichste
beäugen	beäugen
Drohkulissen	Drohkulissen
flöteten	flöteten
gewinne	gewinne
Elementen	Elementen
Frage	Frage
wichsten	wichsten
verewiget	verewiget
gestatte	gestatte
erntest	erntest
widerriefe	widerriefe
Maultier	Maultier
grünte	grünte
fasset	fasset
Zubrötchen	Zubrötchen
schätzte	schätzte
egge	egge
verringeret	verringeret
reifen	reifen
Lotterien	Lotterien
pflanze	pflanze
verbaselt	verbaselt
laufe	laufe
suchte	suchte
verführte	verführte
Fischen	Fischen
Äther	Äther
tabuisierten	tabuisierten
Flöten	Flöten
verließen	verließen
segeln	segeln
parametrisierst	parametrisierst
beansprucht	beansprucht
kennet	kennet
steige	steige
grause	grause
gründe	gründe
hämmerte	hämmerte
impfte	impfte
Fanmeile	Fanmeile
harmonierte	harmonierte
Metaphern	Metaphern
absolviere	absolviere
seufzt	seufzt
Pumpellyiten	Pumpellyiten
Jagdbomber	Jagdbomber
Rundbriefen	Rundbriefen
Alkine	Alkine
Einsätzen	Einsätzen
freiwillige	freiwillige
Reinigungsschrittes	Reinigungsschrittes
bescheißt	bescheißt
bekehrten	bekehrten
drillte	drillte
Meldezettel	Meldezettel
Beiblätter	Beiblätter
feiern	feiern
Schatten	Schatten
herrschet	herrschet
Chemikerinnen	Chemikerinnen
spezialisierst	spezialisierst
Rumänin	Rumänin
klicket	klicket
folget	folget
Fledermaus	Fledermaus
rebellieret	rebellieret
entdecket	entdecket
vermutest	vermutest
wollte	wollte
webte	webte
Hure	Hure
Urologe	Urologe
Campingplatzes	Campingplatzes
schauend	schauend
Magiern	Magiern
defragmentierten	defragmentierten
mißverstehet	mißverstehet
Deutung	Deutung
bewährt	bewährt
predig	predig
speisest	speisest
erklinge	erklinge
Aromastoffe	Aromastoffe
kooperierst	kooperierst
bewieset	bewieset
eggt	eggt
frohlocke	frohlocke
füllst	füllst
hüte	hüte
ölt	ölt
fehlet	fehlet
Spitzen	Spitzen
Rutheniumkomplexen	Rutheniumkomplexen
belüftete	belüftete
speicherten	speicherten
dechiffriere	dechiffriere
sortierest	sortierest
nagelest	nagelest
Greyerzern	Greyerzern
Basilisken	Basilisken
vereinbaren	vereinbaren
Hinterwäldlern	Hinterwäldlern
reichen	reichen
erwähnet	erwähnet
Freibergits	Freibergits
geleiteten	geleiteten
imprägniere	imprägniere
Landstreichereien	Landstreichereien
Elementarzellen	Elementarzellen
Buntwaschmittel	Buntwaschmittel
Arbeitsgruppen	Arbeitsgruppen
Gerücht	Gerücht
konnotieret	konnotieret
Aderhäuten	Aderhäuten
amenagieren	amenagieren
Adenosin	Adenosin
verhalten	verhalten
Signal	Signal
Atomphysikern	Atomphysikern
Wegen	Wegen
Ionen	Ionen
folgend	folgend
unterwerft	unterwerft
beklagte	beklagte
Schwirrvögel	Schwirrvögel
Ahnen	Ahnen
vermeße	vermeße
Futtermittel	Futtermittel
prostet	prostet
verdammten	verdammten
Vetter	Vetter
attestierten	attestierten
bromiertet	bromiertet
gedenkt	gedenkt
gleitest	gleitest
Kerzenfische	Kerzenfische
Lärchen	Lärchen
Klauen	Klauen
Vogelscheuche	Vogelscheuche
bombardiertet	bombardiertet
webet	webet
jappten	jappten
borgst	borgst
mikrominiaturisiere	mikrominiaturisiere
Kopfsalaten	Kopfsalaten
Eutektikum	Eutektikum
Denunziationen	Denunziationen
oxidierte	oxidierte
schauspieleren	schauspieleren
zittertest	zittertest
stiege	stiege
Dorngesträuch	Dorngesträuch
schwöre	schwöre
bewässerst	bewässerst
Sauberfrau	Sauberfrau
Einfältigkeit	Einfältigkeit
Loparite	Loparite
Asthenosphäre	Asthenosphäre
geräuchert	geräuchert
opferte	opferte
Schleppern	Schleppern
läuten	läuten
enträtselst	enträtselst
vermutet	vermutet
Bestechungsgelder	Bestechungsgelder
bekehret	bekehret
inszenierst	inszenierst
Isobar	Isobar
bemerket	bemerket
verwaisten	verwaisten
Astats	Astats
preisen	preisen
amputierten	amputierten
urbanisier	urbanisier
Heiratsgütern	Heiratsgütern
sezierst	sezierst
frottier	frottier
ermutigte	ermutigte
liebend	liebend
kristallisiertest	kristallisiertest
verkürztet	verkürztet
erziehen	erziehen
pflanzest	pflanzest
Prüfbericht	Prüfbericht
Kissenschlacht	Kissenschlacht
Dithiolan	Dithiolan
verifizierten	verifizierten
Verwaltungsakten	Verwaltungsakten
Bärenfelle	Bärenfelle
Silbergeschirr	Silbergeschirr
veranstalten	veranstalten
flehte	flehte
umarmet	umarmet
Pflaume	Pflaume
Flame	Flame
überfischte	überfischte
sprühend	sprühend
kugele	kugele
diskutierst	diskutierst
mogelten	mogelten
Großfürst	Großfürst
Rhodochrosite	Rhodochrosite
pflügten	pflügten
sedimentieret	sedimentieret
Pinguin	Pinguin
verschaffte	verschaffte
Dithiolane	Dithiolane
Tore	Tore
Besuch	Besuch
hämmerst	hämmerst
Türme	Türme
Zahnfleischentzündung	Zahnfleischentzündung
schlabbere	schlabbere
widerlegte	widerlegte
Honigbären	Honigbären
Grufti	Grufti
hupet	hupet
narren	narren
fladerst	fladerst
sollten	sollten
klumpe	klumpe
entmineralisieren	entmineralisieren
Schätzen	Schätzen
