bekannt	bekannt
Setzt	Setzt
erschrickt	erschrickt
lauf	lauf
zierte	zierte
Speere	Speere
tief	tief
Grase	Grase
holst	holst
gehörte	gehörte
Schafe	Schafe
laufe	laufe
Ecken	Ecken
losen	losen
zudeckte	zudeckte
wiederkamt	wiederkamt
erfüllt	erfüllt
hausen	hausen
freuet	freuet
wälzt	wälzt
Ränke	Ränke
Seil	Seil
Fellen	Fellen
Könige	Könige
hänge	hänge
verlasse	verlasse
bedeckt	bedeckt
esset	esset
jene	jene
laut	laut
nötige	nötige
stimmen	stimmen
Lasten	Lasten
Jünglinge	Jünglinge
auszögen	auszögen
springen	springen
gießest	gießest
schläfst	schläfst
verkündigest	verkündigest
Monate	Monate
Tyrannen	Tyrannen
fünfte	fünfte
begehrte	begehrte
huren	huren
deinem	deinem
Feiertage	Feiertage
laden	laden
dein	dein
Jahre	Jahre
Gefängnisse	Gefängnisse
rächest	rächest
brause	brause
wache	wache
Tiefe	Tiefe
Rehe	Rehe
entsetzt	entsetzt
plagen	plagen
Zäume	Zäume
Gebärden	Gebärden
esse	esse
hatte	hatte
erschrickst	erschrickst
bringet	bringet
Laufet	Laufet
bauten	bauten
erbaust	erbaust
griechischen	griechischen
erfüllet	erfüllet
hineingehst	hineingehst
führest	führest
welche	welche
scheue	scheue
Bleibe	Bleibe
spracht	spracht
abtrünnigen	abtrünnigen
Hälse	Hälse
Schleife	Schleife
Schätzen	Schätzen
Halle	Halle
taufte	taufte
bringest	bringest
weine	weine
untertretet	untertretet
Warten	Warten
Schuhen	Schuhen
sich	sich
stehst	stehst
Habe	Habe
Köpfe	Köpfe
schweiget	schweiget
vergessest	vergessest
Trübsal	Trübsal
zerbrichst	zerbrichst
geratest	geratest
vergießest	vergießest
sichten	sichten
Dans	Dans
irre	irre
vermagst	vermagst
sagte	sagte
Einheimischen	Einheimischen
beider	beider
seufzest	seufzest
Lehnen	Lehnen
Höfen	Höfen
Wäre	Wäre
streuen	streuen
schreibst	schreibst
kurze	kurze
mögt	mögt
stillest	stillest
trieben	trieben
heulte	heulte
laben	laben
Entsetzen	Entsetzen
binde	binde
Werde	Werde
eines	eines
Heben	Heben
gelobten	gelobten
stahl	stahl
zählte	zählte
aufwacht	aufwacht
beharret	beharret
baute	baute
merkte	merkte
Bube	Bube
Stücken	Stücken
zuhörte	zuhörte
Satzung	Satzung
Haben	Haben
War	War
Joche	Joche
gebrauchte	gebrauchte
verständig	verständig
Jochen	Jochen
Machet	Machet
Sorget	Sorget
leuchten	leuchten
Diese	Diese
aufstanden	aufstanden
gehörten	gehörten
weichet	weichet
Flöte	Flöte
diente	diente
Kaufleute	Kaufleute
scheinet	scheinet
Leiste	Leiste
Recht	Recht
erwürgt	erwürgt
Sinnen	Sinnen
schreist	schreist
heißet	heißet
Welche	Welche
Gebärde	Gebärde
zeigte	zeigte
Wirst	Wirst
beides	beides
preiset	preiset
reizest	reizest
Bienen	Bienen
dienst	dienst
Weichet	Weichet
beiden	beiden
Mäuse	Mäuse
vergibt	vergibt
nütze	nütze
zeugte	zeugte
Werken	Werken
Acht	Acht
bekehret	bekehret
füllen	füllen
ringen	ringen
zerreißest	zerreißest
regiere	regiere
fastete	fastete
sieht	sieht
heiligest	heiligest
abzieht	abzieht
strafst	strafst
Hunde	Hunde
Sollst	Sollst
taufen	taufen
Anschlägen	Anschlägen
erlaubte	erlaubte
ihren	ihren
Rabe	Rabe
setzest	setzest
Heuschrecke	Heuschrecke
Schneide	Schneide
entsetzte	entsetzte
bricht	bricht
Tieren	Tieren
Malen	Malen
weinst	weinst
Vorhäute	Vorhäute
beweise	beweise
absagen	absagen
Pferde	Pferde
hause	hause
erzeigest	erzeigest
Banden	Banden
vermahnet	vermahnet
anzeigen	anzeigen
einführte	einführte
ringst	ringst
blasen	blasen
aufsteht	aufsteht
Bäumen	Bäumen
steig	steig
vertilgest	vertilgest
fehlte	fehlte
vertilgten	vertilgten
verkaufte	verkaufte
junge	junge
müßt	müßt
Glauben	Glauben
keines	keines
anbetet	anbetet
merket	merket
wären	wären
Feinden	Feinden
gefällst	gefällst
angehöret	angehöret
Christ	Christ
Heiden	Heiden
bewahrt	bewahrt
tat	tat
schließen	schließen
leuchtete	leuchtete
mehr	mehr
schmelzt	schmelzt
Zäumen	Zäumen
erbet	erbet
wirfst	wirfst
ziere	ziere
wehre	wehre
Lob	Lob
eher	eher
Wehre	Wehre
rufest	rufest
verkriechst	verkriechst
konntest	konntest
all	all
aufstehst	aufstehst
Gedanken	Gedanken
Buch	Buch
Gebete	Gebete
Worten	Worten
fülle	fülle
amen	amen
verzweifelt	verzweifelt
Gefilde	Gefilde
reife	reife
umbrächte	umbrächte
Tanne	Tanne
Tat	Tat
trügen	trügen
verkehre	verkehre
Wissen	Wissen
wälzet	wälzet
wurdet	wurdet
Erstlinge	Erstlinge
Speeren	Speeren
Binde	Binde
Verwundeten	Verwundeten
treibest	treibest
erhörest	erhörest
seine	seine
lachte	lachte
Reizen	Reizen
Keiner	Keiner
Armen	Armen
reden	reden
Ratet	Ratet
besitzet	besitzet
grüßt	grüßt
liegst	liegst
anrichte	anrichte
fange	fange
vertilgen	vertilgen
durchläuterte	durchläuterte
fragest	fragest
murmelte	murmelte
gut	gut
befehlt	befehlt
reifen	reifen
aufkäme	aufkäme
räumen	räumen
könnest	könnest
küsse	küsse
heftete	heftete
rufst	rufst
stolze	stolze
Herde	Herde
glaube	glaube
Ei	Ei
leset	leset
dürfe	dürfe
Empörung	Empörung
erwürget	erwürget
besitzt	besitzt
wälzte	wälzte
jeder	jeder
wünschte	wünschte
fassest	fassest
Teppiche	Teppiche
schlaft	schlaft
sitzet	sitzet
brennen	brennen
liebest	liebest
Rufen	Rufen
nähre	nähre
empfange	empfange
versteckt	versteckt
übest	übest
kämpfet	kämpfet
Letzte	Letzte
anrührt	anrührt
Meines	Meines
würze	würze
Rehen	Rehen
sprachen	sprachen
erben	erben
Empörungen	Empörungen
tretest	tretest
wohnst	wohnst
fangt	fangt
fehle	fehle
hinausgehst	hinausgehst
erhebst	erhebst
teilte	teilte
Fällt	Fällt
fresse	fresse
verbergest	verbergest
Schwänzen	Schwänzen
schöpfen	schöpfen
lösest	lösest
Sabbatjahre	Sabbatjahre
preisen	preisen
Gängen	Gängen
wiederkommt	wiederkommt
lose	lose
gelobet	gelobet
erzeigen	erzeigen
standet	standet
schrecke	schrecke
Trübsale	Trübsale
wiederkommst	wiederkommst
lehnen	lehnen
aßest	aßest
auszieht	auszieht
Augen	Augen
Basilisk	Basilisk
Schiffen	Schiffen
schlafe	schlafe
übte	übte
verdammten	verdammten
Grenzen	Grenzen
Ihr	Ihr
Wehr	Wehr
Sagte	Sagte
Fallen	Fallen
griffe	griffe
Ränken	Ränken
anrichtet	anrichtet
Sieb	Sieb
Gebote	Gebote
bist	bist
vermahne	vermahne
neige	neige
verziehen	verziehen
erforscht	erforscht
schätzen	schätzen
ältesten	ältesten
löst	löst
möget	möget
verbergt	verbergt
Wirte	Wirte
Seine	Seine
zeugst	zeugst
gesellt	gesellt
wurden	wurden
empörte	empörte
Festen	Festen
zuhöret	zuhöret
unsere	unsere
kranken	kranken
urteilte	urteilte
Gefängnissen	Gefängnissen
Berge	Berge
hilft	hilft
weichen	weichen
blase	blase
gelangt	gelangt
zerreißt	zerreißt
schnell	schnell
beschuldigt	beschuldigt
schmückte	schmückte
aufnahmt	aufnahmt
Leichname	Leichname
wachen	wachen
zerstückte	zerstückte
verlobte	verlobte
Frommen	Frommen
erhöhst	erhöhst
aufhobt	aufhobt
fragen	fragen
gereicht	gereicht
Gemeinde	Gemeinde
Drachen	Drachen
erkannte	erkannte
Narren	Narren
Hälsen	Hälsen
verstehet	verstehet
heilte	heilte
erhöhest	erhöhest
schicke	schicke
verwahret	verwahret
warst	warst
offenbar	offenbar
warte	warte
säte	säte
befragten	befragten
Sabbatjahr	Sabbatjahr
brach	brach
weiden	weiden
bestellte	bestellte
falle	falle
Sprüche	Sprüche
anfinge	anfinge
aller	aller
wohnet	wohnet
bringst	bringst
Quellen	Quellen
austilge	austilge
stahlen	stahlen
erfahrt	erfahrt
Dichten	Dichten
stillte	stillte
gelangte	gelangte
zerbrecht	zerbrecht
solch	solch
Sinne	Sinne
seist	seist
male	male
Hörst	Hörst
wer	wer
Leiden	Leiden
besäet	besäet
bereitet	bereitet
Äxte	Äxte
regte	regte
werte	werte
leiden	leiden
beschädigten	beschädigten
Kleinoden	Kleinoden
hörst	hörst
sollte	sollte
heiligem	heiligem
gehörst	gehörst
Würze	Würze
jammern	jammern
Schafen	Schafen
zerstücken	zerstücken
glühende	glühende
Anfechtungen	Anfechtungen
bleiben	bleiben
meine	meine
verkehrte	verkehrte
vorn	vorn
solcher	solcher
Reichen	Reichen
zweiten	zweiten
füllst	füllst
Königen	Königen
anders	anders
Als	Als
mahlen	mahlen
freute	freute
mühe	mühe
Schläge	Schläge
hüte	hüte
vier	vier
übrigbleibt	übrigbleibt
achte	achte
Teppichen	Teppichen
Wache	Wache
wärme	wärme
jungen	jungen
berufen	berufen
abtrünnige	abtrünnige
Bäche	Bäche
speiet	speiet
baue	baue
solches	solches
brauchst	brauchst
Lüste	Lüste
täuschet	täuschet
verhalten	verhalten
Dieben	Dieben
Dinge	Dinge
Wir	Wir
Wehklagen	Wehklagen
Bund	Bund
Ställen	Ställen
Schalen	Schalen
angehöre	angehöre
Weile	Weile
wild	wild
streite	streite
hinaufgehst	hinaufgehst
schaffe	schaffe
wegführen	wegführen
logen	logen
meinem	meinem
Deutungen	Deutungen
Feste	Feste
gebest	gebest
schmücket	schmücket
erhalte	erhalte
kämpfte	kämpfte
Maultieren	Maultieren
Morden	Morden
glaubte	glaubte
lange	lange
außen	außen
Geräte	Geräte
links	links
dritte	dritte
Stühle	Stühle
zwölften	zwölften
Hunderten	Hunderten
fraget	fraget
halten	halten
Räte	Räte
schwebe	schwebe
jemand	jemand
murmeln	murmeln
Sei	Sei
besser	besser
sehest	sehest
folgte	folgte
Zweigen	Zweigen
ehrst	ehrst
durfte	durfte
freiwillige	freiwillige
besät	besät
Essen	Essen
Teil	Teil
auflegte	auflegte
schenken	schenken
wachte	wachte
Ende	Ende
deine	deine
essest	essest
Befehle	Befehle
Weinstöcken	Weinstöcken
gelangen	gelangen
kehren	kehren
trieb	trieb
Meinem	Meinem
Reizt	Reizt
banden	banden
Hirt	Hirt
Schaden	Schaden
Edelsteine	Edelsteine
kühl	kühl
Fallt	Fallt
Gehorcht	Gehorcht
bezahlt	bezahlt
Sekten	Sekten
schmiert	schmiert
Klüfte	Klüfte
Lobgesängen	Lobgesängen
ansehet	ansehet
plagte	plagte
schrecken	schrecken
Elfen	Elfen
stellen	stellen
steinigst	steinigst
Hebet	Hebet
flucht	flucht
schießen	schießen
lang	lang
verzieht	verzieht
verstörte	verstörte
stellte	stellte
verstehest	verstehest
dritten	dritten
eigenen	eigenen
backen	backen
Held	Held
Laien	Laien
besehet	besehet
stand	stand
messe	messe
stolz	stolz
verführt	verführt
Grüßet	Grüßet
verwahrt	verwahrt
Hin	Hin
Höfe	Höfe
Zöpfe	Zöpfe
gründen	gründen
bezahlst	bezahlst
hörest	hörest
Märkten	Märkten
Reif	Reif
Kleinode	Kleinode
lieb	lieb
könnte	könnte
begrabest	begrabest
abweichest	abweichest
dingte	dingte
Solcher	Solcher
Binden	Binden
Kohle	Kohle
hieben	hieben
vertilge	vertilge
messen	messen
Ärgernissen	Ärgernissen
liebe	liebe
tust	tust
bis	bis
Rühmst	Rühmst
könne	könne
lobte	lobte
geselle	geselle
scheinen	scheinen
trinkst	trinkst
ihr	ihr
dichten	dichten
grüße	grüße
demütige	demütige
Solchen	Solchen
Zerstreut	Zerstreut
stehet	stehet
Wogen	Wogen
Zäunen	Zäunen
klagte	klagte
plagest	plagest
Zeugnissen	Zeugnissen
Stufen	Stufen
bereits	bereits
Eingeweiden	Eingeweiden
Linken	Linken
Sternen	Sternen
Gelobet	Gelobet
vergleiche	vergleiche
verstand	verstand
Eine	Eine
machte	machte
gewinnet	gewinnet
wir	wir
eng	eng
offenbart	offenbart
Abhänge	Abhänge
Halte	Halte
vertrieb	vertrieb
kaufet	kaufet
betrübt	betrübt
Sucht	Sucht
Licht	Licht
freiwilligen	freiwilligen
verwirren	verwirren
Tragt	Tragt
Alle	Alle
gewöhnt	gewöhnt
wilden	wilden
Gefäßen	Gefäßen
versöhnet	versöhnet
verstopft	verstopft
durchläutert	durchläutert
vertilgt	vertilgt
bekennt	bekennt
Fülle	Fülle
rede	rede
Gedanke	Gedanke
gebietet	gebietet
Keilen	Keilen
befestigte	befestigte
leihst	leihst
suchen	suchen
Stimmen	Stimmen
Sprüchen	Sprüchen
regieret	regieret
mache	mache
verlobt	verlobt
mein	mein
Tagen	Tagen
Wänden	Wänden
denen	denen
Fragen	Fragen
verkauften	verkauften
Kehre	Kehre
heißest	heißest
tote	tote
fällen	fällen
wolle	wolle
Pflanzungen	Pflanzungen
Satzungen	Satzungen
Maultier	Maultier
kommst	kommst
ruhte	ruhte
reiche	reiche
Töpfen	Töpfen
Leid	Leid
Gewürzen	Gewürzen
Amt	Amt
wert	wert
verzehre	verzehre
verkriechet	verkriechet
stimmte	stimmte
Obrigkeit	Obrigkeit
Trinket	Trinket
Rufe	Rufe
fasset	fasset
ärger	ärger
gelobst	gelobst
einsammelte	einsammelte
wachset	wachset
hüten	hüten
brausen	brausen
gleich	gleich
ander	ander
Tyrann	Tyrann
Glaubet	Glaubet
feiert	feiert
Knabe	Knabe
Könnet	Könnet
aufkämen	aufkämen
rührte	rührte
unser	unser
mahle	mahle
verdeckst	verdeckst
Tage	Tage
schreiet	schreiet
Sage	Sage
Folget	Folget
Name	Name
rühmet	rühmet
versuche	versuche
verstörten	verstörten
tuest	tuest
wechselte	wechselte
beschädigte	beschädigte
Ratsherr	Ratsherr
irrte	irrte
Taufe	Taufe
ermahnt	ermahnt
Ring	Ring
greifen	greifen
Löwe	Löwe
Stufe	Stufe
Hände	Hände
Weg	Weg
tatet	tatet
Weh	Weh
einerntest	einerntest
reizen	reizen
zerstört	zerstört
Zähne	Zähne
brachen	brachen
fromme	fromme
Wüsten	Wüsten
kochte	kochte
gehorchte	gehorchte
Ordnung	Ordnung
Regenten	Regenten
macht	macht
Reihe	Reihe
erbaut	erbaut
ihrem	ihrem
entsetzten	entsetzten
raubet	raubet
jammerte	jammerte
schießt	schießt
Maßen	Maßen
Maultiere	Maultiere
beweiset	beweiset
begehre	begehre
verdammst	verdammst
viele	viele
Sollte	Sollte
keine	keine
Fette	Fette
Meine	Meine
regierest	regierest
Reihen	Reihen
währet	währet
eine	eine
Stricken	Stricken
lieget	lieget
nahe	nahe
hieltet	hieltet
Frösche	Frösche
weinte	weinte
zeugest	zeugest
raubest	raubest
wehren	wehren
wünschet	wünschet
Hunden	Hunden
speisest	speisest
traut	traut
willst	willst
Altäre	Altäre
nehmt	nehmt
harret	harret
Pfeifen	Pfeifen
brauste	brauste
verstanden	verstanden
verwirft	verwirft
Pfunden	Pfunden
werten	werten
könnten	könnten
ausführen	ausführen
eingehet	eingehet
alle	alle
tobte	tobte
nützt	nützt
Obrigkeiten	Obrigkeiten
Erstlingen	Erstlingen
hörte	hörte
Kriegsknechte	Kriegsknechte
Testamenten	Testamenten
stoßet	stoßet
Feiertagen	Feiertagen
Bächen	Bächen
treibst	treibst
Bette	Bette
wegen	wegen
bedenken	bedenken
seit	seit
Nehmet	Nehmet
kommest	kommest
wachse	wachse
Raube	Raube
Loben	Loben
vergibst	vergibst
Wolle	Wolle
Bergen	Bergen
Fröschen	Fröschen
Zerstreuten	Zerstreuten
sitze	sitze
steige	steige
linke	linke
pflügen	pflügen
ansehen	ansehen
höhnest	höhnest
versucht	versucht
trinket	trinket
Fahrt	Fahrt
Stolze	Stolze
deren	deren
erschreckten	erschreckten
hoffet	hoffet
anrufe	anrufe
fehlen	fehlen
maßen	maßen
jedes	jedes
sündiget	sündiget
jagte	jagte
erste	erste
Bote	Bote
Kühen	Kühen
schaffen	schaffen
Palästen	Palästen
Wille	Wille
vermöge	vermöge
schlafet	schlafet
Wüste	Wüste
betrügen	betrügen
erbte	erbte
vertrauet	vertrauet
gehöre	gehöre
Teilen	Teilen
weiten	weiten
wärmte	wärmte
ihre	ihre
ausführt	ausführt
Heeren	Heeren
siegen	siegen
Leuchten	Leuchten
schöpfte	schöpfte
gehorcht	gehorcht
Eile	Eile
haust	haust
sündigt	sündigt
lehre	lehre
Knechten	Knechten
ziert	ziert
Monde	Monde
Toten	Toten
Weihe	Weihe
rechte	rechte
Füllen	Füllen
stiegen	stiegen
lügst	lügst
stirbt	stirbt
küssen	küssen
Herzen	Herzen
Säcke	Säcke
Sagen	Sagen
Gesellen	Gesellen
Verheißung	Verheißung
umkommst	umkommst
zerrüttet	zerrüttet
hauest	hauest
sorget	sorget
jedem	jedem
gelobt	gelobt
elften	elften
Gevierte	Gevierte
Kreuze	Kreuze
währte	währte
Ärgernisse	Ärgernisse
mangelte	mangelte
Weinet	Weinet
Perlen	Perlen
Tausenden	Tausenden
Lobgesänge	Lobgesänge
Höhlen	Höhlen
Seit	Seit
unseres	unseres
brichst	brichst
gebot	gebot
würde	würde
Gebirgen	Gebirgen
Regiert	Regiert
Abtrünnigen	Abtrünnigen
reich	reich
absagt	absagt
bekehrst	bekehrst
wachsen	wachsen
versuchen	versuchen
Seile	Seile
brecht	brecht
mußten	mußten
Spanne	Spanne
Propheten	Propheten
Gut	Gut
Funke	Funke
trefft	trefft
Klaue	Klaue
weisest	weisest
allem	allem
stoßt	stoßt
verkaufe	verkaufe
Spaltung	Spaltung
anrichten	anrichten
Brüsten	Brüsten
arm	arm
Geviert	Geviert
webte	webte
verklärest	verklärest
forschen	forschen
Schenke	Schenke
hassest	hassest
Same	Same
Pfeile	Pfeile
Mäusen	Mäusen
eilet	eilet
trotze	trotze
brechet	brechet
fälle	fälle
träge	träge
Gefäße	Gefäße
wog	wog
Tiefen	Tiefen
hurst	hurst
Fels	Fels
wirft	wirft
Herren	Herren
Fäusten	Fäusten
Türme	Türme
weisen	weisen
schmückst	schmückst
deinen	deinen
möchte	möchte
decken	decken
Skorpionen	Skorpionen
warten	warten
trüge	trüge
wirst	wirst
befehle	befehle
Aussätzige	Aussätzige
gießet	gießet
nehmet	nehmet
kaufe	kaufe
Töpfe	Töpfe
Röhre	Röhre
bemühst	bemühst
vielen	vielen
weg	weg
Hundert	Hundert
gehört	gehört
blast	blast
Neumonden	Neumonden
kühle	kühle
Grenze	Grenze
Sabbaten	Sabbaten
besitze	besitze
ein	ein
wende	wende
legte	legte
blitzen	blitzen
zählst	zählst
versöhnt	versöhnt
Hecken	Hecken
Fromme	Fromme
Entsetzet	Entsetzet
anruft	anruft
betrüge	betrüge
Äxten	Äxten
verlaß	verlaß
seinem	seinem
grünte	grünte
hättest	hättest
Toren	Toren
heile	heile
teilen	teilen
widerstand	widerstand
wehrte	wehrte
Dienet	Dienet
weich	weich
Schreien	Schreien
rauben	rauben
Sterne	Sterne
entgegenkamen	entgegenkamen
trauten	trauten
vergesset	vergesset
rühmst	rühmst
Kaufleuten	Kaufleuten
suchst	suchst
trotzt	trotzt
Unglaube	Unglaube
Feinde	Feinde
Schilde	Schilde
preist	preist
Gehör	Gehör
dankte	dankte
stärken	stärken
aufhoben	aufhoben
sitzest	sitzest
Hallen	Hallen
krieget	krieget
Habt	Habt
webet	webet
Eure	Eure
vermöget	vermöget
bewahrest	bewahrest
untertreten	untertreten
ausbreitete	ausbreitete
Rühmet	Rühmet
der	der
speist	speist
arbeit	arbeit
Den	Den
Prophet	Prophet
Geliebten	Geliebten
pflanze	pflanze
bestand	bestand
verstecke	verstecke
bauet	bauet
versagen	versagen
Bitten	Bitten
diese	diese
halte	halte
opferte	opferte
ausführe	ausführe
einst	einst
pflügte	pflügte
verlasset	verlasset
aufhörte	aufhörte
beschwöre	beschwöre
Heide	Heide
fallen	fallen
nähret	nähret
hasse	hasse
trübe	trübe
bestimmte	bestimmte
vergießt	vergießt
Händen	Händen
erschrecket	erschrecket
trägst	trägst
koche	koche
Dein	Dein
Pauke	Pauke
verkündigt	verkündigt
Keile	Keile
Ach	Ach
werdest	werdest
haben	haben
versagt	versagt
stiege	stiege
weist	weist
Fische	Fische
Schenken	Schenken
Kohlen	Kohlen
wissest	wissest
Steigen	Steigen
frommen	frommen
stellet	stellet
gebäre	gebäre
Lichte	Lichte
durchbohrt	durchbohrt
aufhebt	aufhebt
jaget	jaget
Leiche	Leiche
halbe	halbe
Gerichte	Gerichte
beißt	beißt
spricht	spricht
keinen	keinen
Staube	Staube
Wände	Wände
Regieren	Regieren
predigten	predigten
loben	loben
Kräften	Kräften
verschonet	verschonet
vertrieben	vertrieben
feierte	feierte
reichen	reichen
Brote	Brote
erforschet	erforschet
räumet	räumet
ziehst	ziehst
Wehret	Wehret
jenen	jenen
schweigen	schweigen
Kommet	Kommet
Führet	Führet
Türkis	Türkis
Namen	Namen
glaubst	glaubst
Winde	Winde
einnehmest	einnehmest
verlieren	verlieren
greife	greife
Schleifen	Schleifen
zuschließet	zuschließet
vergleichen	vergleichen
gewöhnte	gewöhnte
Gelobt	Gelobt
Vorstädte	Vorstädte
Plagen	Plagen
unschuldigen	unschuldigen
laute	laute
zerstreute	zerstreute
bewahret	bewahret
verwirfst	verwirfst
Herr	Herr
Laie	Laie
kämpfe	kämpfe
schlafest	schlafest
wirkte	wirkte
Freunden	Freunden
erlösen	erlösen
Woge	Woge
offenbare	offenbare
Orte	Orte
Monaten	Monaten
Ein	Ein
wärst	wärst
Stricke	Stricke
zweite	zweite
erfreuest	erfreuest
Dingen	Dingen
bekannte	bekannte
suche	suche
jauchzte	jauchzte
wurdest	wurdest
Ebenen	Ebenen
Alte	Alte
verderbet	verderbet
schenkest	schenkest
kühlen	kühlen
sollten	sollten
wurde	wurde
außer	außer
bitte	bitte
Eines	Eines
strafet	strafet
unehret	unehret
schwelle	schwelle
jemanden	jemanden
kehrst	kehrst
Zeugen	Zeugen
Grab	Grab
grüne	grüne
Aller	Aller
schaffest	schaffest
Perle	Perle
scheiden	scheiden
predigte	predigte
übrigbleibet	übrigbleibet
werfet	werfet
gehorchest	gehorchest
fliege	fliege
alles	alles
Steinen	Steinen
begehret	begehret
ihn	ihn
schenkst	schenkst
heiligten	heiligten
Unsere	Unsere
malen	malen
Glaubst	Glaubst
Arme	Arme
ausziehst	ausziehst
Haut	Haut
Schlägst	Schlägst
Gesetze	Gesetze
stiften	stiften
wäre	wäre
Lehren	Lehren
still	still
Tore	Tore
predigst	predigst
gedenket	gedenket
ernte	ernte
lade	lade
keiner	keiner
stille	stille
brechen	brechen
Tritt	Tritt
verdeckte	verdeckte
prüfest	prüfest
Alles	Alles
beben	beben
Würzen	Würzen
erwerben	erwerben
entsündigten	entsündigten
bedeckest	bedeckest
Quelle	Quelle
aufstand	aufstand
einernten	einernten
sorgte	sorgte
Fäuste	Fäuste
abziehen	abziehen
Steine	Steine
spalten	spalten
Befehlen	Befehlen
ausgeht	ausgeht
hatten	hatten
Esset	Esset
rächte	rächte
widerstanden	widerstanden
Räten	Räten
frevler	frevler
steigen	steigen
Füßen	Füßen
übet	übet
spielte	spielte
Kristalle	Kristalle
Blitzen	Blitzen
ehe	ehe
wollten	wollten
Altären	Altären
verkündige	verkündige
vergebet	vergebet
herrschest	herrschest
Felle	Felle
Sorgen	Sorgen
sollt	sollt
bekehrt	bekehrt
lebet	lebet
einen	einen
steckte	steckte
Meinen	Meinen
zürnte	zürnte
Unserer	Unserer
am	am
heiliget	heiliget
gefällt	gefällt
durchbohrte	durchbohrte
aßet	aßet
beide	beide
nehmest	nehmest
Schneiden	Schneiden
Verheißungen	Verheißungen
kommet	kommet
Narr	Narr
batet	batet
sollst	sollst
mal	mal
Führe	Führe
mußt	mußt
rittest	rittest
rühmest	rühmest
Wachen	Wachen
Schwänze	Schwänze
ritt	ritt
Märkte	Märkte
Trage	Trage
wärmet	wärmet
lobet	lobet
Tannen	Tannen
handhabt	handhabt
scheute	scheute
Raten	Raten
gewinne	gewinne
rechten	rechten
ratschlaget	ratschlaget
Verwundete	Verwundete
Worte	Worte
verkündigte	verkündigte
holte	holte
wehte	wehte
weise	weise
Kreisen	Kreisen
kriegte	kriegte
ausrufen	ausrufen
Majestät	Majestät
brauchte	brauchte
säst	säst
Taube	Taube
mögest	mögest
Kost	Kost
meines	meines
band	band
Gesetzen	Gesetzen
Werkzeuge	Werkzeuge
höret	höret
berufe	berufe
fragst	fragst
batest	batest
Forschet	Forschet
Ding	Ding
fließt	fließt
taufet	taufet
Freunde	Freunde
beißet	beißet
geboten	geboten
Höhe	Höhe
Entsetzt	Entsetzt
leiten	leiten
gedacht	gedacht
seinen	seinen
umbringt	umbringt
nimmt	nimmt
würdet	würdet
Gehilfe	Gehilfe
drückte	drückte
soll	soll
nachwandeln	nachwandeln
denkst	denkst
mehrte	mehrte
lehrte	lehrte
ringe	ringe
hadere	hadere
Aussätzigen	Aussätzigen
Plage	Plage
Königreichen	Königreichen
kein	kein
Unrecht	Unrecht
Kleinod	Kleinod
säumen	säumen
Weinen	Weinen
anzeigest	anzeigest
möchtest	möchtest
Reiche	Reiche
hänget	hänget
wilde	wilde
allen	allen
hineinbrächten	hineinbrächten
Unrechten	Unrechten
Deinen	Deinen
aufkommen	aufkommen
Sabbate	Sabbate
Ordnungen	Ordnungen
bezahlest	bezahlest
fahrt	fahrt
ausgereckten	ausgereckten
schenket	schenket
schonte	schonte
Schale	Schale
Dank	Dank
Fliegen	Fliegen
begehrt	begehrt
enge	enge
konnte	konnte
Fahret	Fahret
lehren	lehren
grüßen	grüßen
bekennst	bekennst
vor	vor
triebe	triebe
spiele	spiele
Hirsche	Hirsche
heftetest	heftetest
lehnte	lehnte
Sehe	Sehe
sonderte	sonderte
Schmiede	Schmiede
überführen	überführen
Buchen	Buchen
flehst	flehst
Schaffet	Schaffet
pflanzte	pflanzte
nimmst	nimmst
Herden	Herden
müsse	müsse
ausfuhren	ausfuhren
Huren	Huren
aufrichtet	aufrichtet
bange	bange
beweist	beweist
geraten	geraten
aufnahmen	aufnahmen
war	war
Bunde	Bunde
zählet	zählet
Meinet	Meinet
Garten	Garten
schon	schon
gehorchten	gehorchten
Raben	Raben
Reich	Reich
leite	leite
ausrottest	ausrottest
hinaufgeht	hinaufgeht
Kannst	Kannst
bedeckst	bedeckst
pflüget	pflüget
gründe	gründe
fastetest	fastetest
dienest	dienest
Regent	Regent
Fischen	Fischen
Weiche	Weiche
hilfst	hilfst
ärgere	ärgere
wehe	wehe
verlähmt	verlähmt
liege	liege
auflöste	auflöste
stelle	stelle
Deinem	Deinem
Weinberge	Weinberge
Königreiche	Königreiche
Ästen	Ästen
erhöht	erhöht
wach	wach
Briefen	Briefen
Tiere	Tiere
blitzt	blitzt
Streiten	Streiten
ziehest	ziehest
fastetet	fastetet
Rauben	Rauben
sondern	sondern
streckte	streckte
ausgereckte	ausgereckte
Euren	Euren
austilgen	austilgen
Zweige	Zweige
halben	halben
Gemeinden	Gemeinden
Deutung	Deutung
glänzte	glänzte
naht	naht
vereinigt	vereinigt
tobst	tobst
kämpfen	kämpfen
zerstreuten	zerstreuten
verbannet	verbannet
Meinst	Meinst
vierte	vierte
klaget	klaget
Solche	Solche
einer	einer
unserer	unserer
armen	armen
hättet	hättet
füllte	füllte
stäupten	stäupten
verkauft	verkauft
heißt	heißt
andere	andere
Schwellen	Schwellen
untergeht	untergeht
Pflanzung	Pflanzung
aber	aber
liebet	liebet
leer	leer
seufzte	seufzte
letzten	letzten
Erden	Erden
Anfechtung	Anfechtung
habt	habt
behaltest	behaltest
Seines	Seines
Anklagen	Anklagen
dingten	dingten
Städte	Städte
Säcken	Säcken
Tischen	Tischen
Bäume	Bäume
anzeigte	anzeigte
Buche	Buche
strafe	strafe
Gute	Gute
erzürnt	erzürnt
Gebot	Gebot
Diesen	Diesen
fällst	fällst
fließen	fließen
Alten	Alten
weichst	weichst
demütiget	demütiget
verbot	verbot
irgendein	irgendein
trotzest	trotzest
Enden	Enden
lest	lest
Pauken	Pauken
verzweifelten	verzweifelten
Weihen	Weihen
arbeiten	arbeiten
Höhle	Höhle
vertraute	vertraute
feierten	feierten
säumet	säumet
Ringe	Ringe
Schade	Schade
erwerbe	erwerbe
Tote	Tote
Wollte	Wollte
rühmte	rühmte
ratschlagen	ratschlagen
erschreckte	erschreckte
graben	graben
tragest	tragest
Eiche	Eiche
Ochs	Ochs
sterbt	sterbt
Schuld	Schuld
strafte	strafte
kennst	kennst
verkürzest	verkürzest
fertige	fertige
ab	ab
folget	folget
hasset	hasset
befragt	befragt
irren	irren
befestigt	befestigt
schwimmen	schwimmen
Macht	Macht
auflegt	auflegt
steinigest	steinigest
faul	faul
fetten	fetten
Kosten	Kosten
besitzest	besitzest
stürzen	stürzen
entgegenkamst	entgegenkamst
entsündigte	entsündigte
betrübte	betrübte
Röcken	Röcken
verdammte	verdammte
Ehre	Ehre
forschte	forschte
erweckest	erweckest
erlösest	erlösest
einführt	einführt
taufst	taufst
stürzest	stürzest
herrschet	herrschet
stoßest	stoßest
bewahrst	bewahrst
feiern	feiern
haltest	haltest
kehret	kehret
zuschließt	zuschließt
brauche	brauche
gleiche	gleiche
nächsten	nächsten
gern	gern
sprichst	sprichst
aufmachte	aufmachte
erniedrigt	erniedrigt
stürzte	stürzte
heiligte	heiligte
Für	Für
Ältesten	Ältesten
Decket	Decket
schnitt	schnitt
aufmacht	aufmacht
rauschen	rauschen
vertrage	vertrage
Lobet	Lobet
All	All
schätzte	schätzte
Willen	Willen
verklärt	verklärt
preise	preise
sündigte	sündigte
Ihre	Ihre
Beinen	Beinen
Leide	Leide
Merket	Merket
bleibe	bleibe
hell	hell
deines	deines
ladest	ladest
beschwören	beschwören
gedachten	gedachten
gebet	gebet
weide	weide
Steiget	Steiget
zerstreuet	zerstreuet
löste	löste
säume	säume
erdacht	erdacht
spannen	spannen
Wer	Wer
versteckst	versteckst
hingehst	hingehst
begehrten	begehrten
reizte	reizte
Gründen	Gründen
wiederkamen	wiederkamen
Gefangene	Gefangene
oben	oben
rote	rote
Einer	Einer
Kristallen	Kristallen
leere	leere
Vorstädten	Vorstädten
gibt	gibt
müsset	müsset
Bitte	Bitte
behalte	behalte
bedürft	bedürft
Weinstöcke	Weinstöcke
konnten	konnten
Jüngern	Jüngern
hätte	hätte
schmelzen	schmelzen
Tische	Tische
austilgest	austilgest
weinet	weinet
anhanget	anhanget
Helme	Helme
gebühren	gebühren
borgst	borgst
Erbe	Erbe
waren	waren
Wert	Wert
Säue	Säue
meinte	meinte
ehrest	ehrest
lehret	lehret
er	er
pflanzen	pflanzen
Christen	Christen
verstehst	verstehst
Welchen	Welchen
vertilgst	vertilgst
pflanzet	pflanzet
Bürde	Bürde
lieben	lieben
Jahren	Jahren
anzöge	anzöge
Wesen	Wesen
hingeht	hingeht
Stämme	Stämme
Einheimische	Einheimische
fliegen	fliegen
eingeht	eingeht
regieren	regieren
Menschen	Menschen
gedenkest	gedenkest
hure	hure
zeiget	zeiget
schaute	schaute
liebte	liebte
Ecke	Ecke
hineingeht	hineingeht
erkannten	erkannten
Grieche	Grieche
gebären	gebären
unseren	unseren
schnitten	schnitten
sei	sei
schämst	schämst
bestellt	bestellt
Füchse	Füchse
linken	linken
einführen	einführen
neigest	neigest
beseht	beseht
Predigt	Predigt
schmierte	schmierte
steckst	steckst
Riesen	Riesen
meinst	meinst
erhöhet	erhöhet
schätzt	schätzt
Merke	Merke
stellst	stellst
Wehen	Wehen
los	los
Junge	Junge
weite	weite
erlöst	erlöst
gedenkst	gedenkst
schließe	schließe
Wegen	Wegen
berühret	berühret
Tauben	Tauben
bleibet	bleibet
spaltete	spaltete
Fliege	Fliege
Seilen	Seilen
erhebest	erhebest
aufwachte	aufwachte
Wärt	Wärt
inneren	inneren
Wachet	Wachet
vermahnt	vermahnt
fahrest	fahrest
Maße	Maße
dürfest	dürfest
Stämmen	Stämmen
Söhne	Söhne
wünschen	wünschen
suchest	suchest
Frage	Frage
Broten	Broten
hängte	hängte
Geboten	Geboten
Majestäten	Majestäten
Buben	Buben
vermögen	vermögen
spielen	spielen
Band	Band
Bete	Bete
blitzte	blitzte
springst	springst
eingehst	eingehst
Ehren	Ehren
sage	sage
jagst	jagst
dürft	dürft
teilet	teilet
ermahnet	ermahnet
stäupt	stäupt
Schild	Schild
schreckt	schreckt
leben	leben
befehlen	befehlen
kehre	kehre
Krieg	Krieg
halt	halt
Zähnen	Zähnen
sagest	sagest
ratet	ratet
anrührte	anrührte
elfte	elfte
Stücke	Stücke
greifet	greifet
Bahnen	Bahnen
sagen	sagen
Beten	Beten
Mensch	Mensch
erfahrest	erfahrest
Werte	Werte
Seiten	Seiten
diesen	diesen
behaltet	behaltet
redete	redete
Meeren	Meeren
Fett	Fett
Letzten	Letzten
zweifelte	zweifelte
Streite	Streite
wenden	wenden
Stäben	Stäben
übrigbleiben	übrigbleiben
begrabet	begrabet
Hecke	Hecke
müßte	müßte
träumte	träumte
zerbricht	zerbricht
bewährt	bewährt
legst	legst
Gäste	Gäste
ungefälschter	ungefälschter
Schätze	Schätze
ehret	ehret
anrufen	anrufen
verkündigst	verkündigst
salz	salz
Köpfen	Köpfen
stiftete	stiftete
erkennst	erkennst
mangeln	mangeln
versöhnst	versöhnst
schweigst	schweigst
beharrt	beharrt
versuchst	versuchst
Kriegen	Kriegen
Heuschrecken	Heuschrecken
Gibst	Gibst
umkehrte	umkehrte
Stärket	Stärket
haderte	haderte
Werke	Werke
zudeckt	zudeckt
bestanden	bestanden
Gebeten	Gebeten
ungehorsame	ungehorsame
Laufen	Laufen
trüb	trüb
Haue	Haue
drücke	drücke
heilet	heilet
zeugen	zeugen
verliere	verliere
Klüften	Klüften
stärkte	stärkte
raten	raten
teile	teile
urteile	urteile
Knaben	Knaben
Speisen	Speisen
eures	eures
fallet	fallet
Spannt	Spannt
verbannt	verbannt
Seinen	Seinen
Halt	Halt
Sorge	Sorge
Weiß	Weiß
Eingeweide	Eingeweide
Sekte	Sekte
einsammelst	einsammelst
Schar	Schar
ach	ach
ausführte	ausführte
beten	beten
brenne	brenne
Edelsteinen	Edelsteinen
Lobe	Lobe
reizt	reizt
merke	merke
lernet	lernet
Urteil	Urteil
Friede	Friede
zerstückt	zerstückt
lesen	lesen
zeuge	zeuge
schätze	schätze
glühenden	glühenden
auszogen	auszogen
Diebe	Diebe
Ängsten	Ängsten
ihres	ihres
gibst	gibst
fluchet	fluchet
würdest	würdest
verbirgst	verbirgst
älteste	älteste
Pfunde	Pfunde
lachet	lachet
bekannten	bekannten
knüpfst	knüpfst
beschwerst	beschwerst
umkehret	umkehret
spannte	spannte
nötigte	nötigte
unehrt	unehrt
seines	seines
klagen	klagen
Einem	Einem
Füße	Füße
lache	lache
wachet	wachet
erhört	erhört
raubte	raubte
warnte	warnte
Dienst	Dienst
Saget	Saget
Bürden	Bürden
verständige	verständige
glauben	glauben
verwahrst	verwahrst
Eilet	Eilet
Am	Am
mühte	mühte
fremde	fremde
weh	weh
Spießen	Spießen
fertigte	fertigte
faule	faule
solche	solche
solle	solle
umkämen	umkämen
schaffte	schaffte
Rudern	Rudern
empfanget	empfanget
kaufte	kaufte
verhalte	verhalte
euren	euren
beugte	beugte
schlagest	schlagest
bemüht	bemüht
Fremden	Fremden
schlag	schlag
speise	speise
Soll	Soll
Geschäfte	Geschäfte
heulet	heulet
heiligt	heiligt
frage	frage
Betten	Betten
Jünger	Jünger
Male	Male
Fetten	Fetten
fahret	fahret
vermahnten	vermahnten
unsres	unsres
Blitze	Blitze
schlage	schlage
untergehst	untergehst
setzte	setzte
möge	möge
Bist	Bist
verunreinigt	verunreinigt
täuschte	täuschte
haut	haut
Bär	Bär
wehen	wehen
sagst	sagst
erst	erst
Mein	Mein
essen	essen
Gebeine	Gebeine
Hat	Hat
nachwandelst	nachwandelst
löset	löset
erntete	erntete
Gebt	Gebt
eile	eile
Hast	Hast
bestimmt	bestimmt
begehrst	begehrst
zürnst	zürnst
Gerät	Gerät
unterrichtet	unterrichtet
bekennet	bekennet
Kein	Kein
wechseln	wechseln
meinen	meinen
stäupte	stäupte
Samen	Samen
taufe	taufe
zankte	zankte
schöpfest	schöpfest
gehet	gehet
eins	eins
Briefe	Briefe
toten	toten
Denen	Denen
taten	taten
folgen	folgen
streckst	streckst
Ersten	Ersten
erniedrigst	erniedrigst
steiget	steiget
heiß	heiß
ob	ob
Klauen	Klauen
pflanzest	pflanzest
Schau	Schau
müssest	müssest
beweisest	beweisest
Trinkgefäße	Trinkgefäße
Nehmt	Nehmt
schauest	schauest
stirbst	stirbst
möchten	möchten
Sollten	Sollten
gebührt	gebührt
fette	fette
Gebirge	Gebirge
werdet	werdet
Schulden	Schulden
eure	eure
Geschäften	Geschäften
Steige	Steige
verführe	verführe
fällte	fällte
Tausend	Tausend
demütig	demütig
bestimmst	bestimmst
gebraucht	gebraucht
angehören	angehören
seien	seien
harrte	harrte
unsrer	unsrer
morden	morden
gehören	gehören
verkehrt	verkehrt
schämte	schämte
predigt	predigt
ehre	ehre
Skorpione	Skorpione
übrigbleibe	übrigbleibe
Dich	Dich
Fittichen	Fittichen
Röhren	Röhren
rührst	rührst
Scharen	Scharen
heil	heil
schneiden	schneiden
tiefe	tiefe
Gibt	Gibt
leget	leget
Funken	Funken
Danket	Danket
verführen	verführen
Flammen	Flammen
ersten	ersten
achten	achten
hieltest	hieltest
Zöpfen	Zöpfen
Schuhe	Schuhe
strecke	strecke
Bahn	Bahn
dingt	dingt
Kehret	Kehret
hebe	hebe
wacht	wacht
rufe	rufe
verdammt	verdammt
entsetzet	entsetzet
Anklage	Anklage
Hie	Hie
Falle	Falle
Werden	Werden
Könnt	Könnt
spannt	spannt
fresset	fresset
wärt	wärt
Gläubigen	Gläubigen
Grüße	Grüße
Wären	Wären
Flamme	Flamme
Leset	Leset
Dann	Dann
ausgereckt	ausgereckt
siehst	siehst
trage	trage
holet	holet
Zeug	Zeug
jede	jede
grabe	grabe
Ärzte	Ärzte
bereite	bereite
zuhört	zuhört
erlasset	erlasset
sorge	sorge
bekehrten	bekehrten
solchem	solchem
Mache	Mache
helfest	helfest
verkündiget	verkündiget
Hirten	Hirten
kennest	kennest
rate	rate
wisset	wisset
machst	machst
Ställe	Ställe
rotten	rotten
Aufsätze	Aufsätze
Tritte	Tritte
backe	backe
ruhest	ruhest
drücken	drücken
rüstetet	rüstetet
erhörst	erhörst
streiten	streiten
schlagt	schlagt
Drache	Drache
müßten	müßten
speiest	speiest
lügen	lügen
ehren	ehren
baust	baust
Wehe	Wehe
ernten	ernten
Sehnen	Sehnen
vertrauten	vertrauten
weinest	weinest
Werdet	Werdet
bekehrte	bekehrte
besuche	besuche
trinken	trinken
Wisset	Wisset
ausfuhr	ausfuhr
werden	werden
empört	empört
Leuchte	Leuchte
beschwert	beschwert
verzehrst	verzehrst
fallt	fallt
strafen	strafen
Lehne	Lehne
vermahnte	vermahnte
anhangen	anhangen
kriegen	kriegen
Schauet	Schauet
Bärte	Bärte
Kreise	Kreise
decket	decket
ratschlagte	ratschlagte
Fällen	Fällen
Seht	Seht
anfingst	anfingst
erhebet	erhebet
Helden	Helden
Kräfte	Kräfte
Weil	Weil
Ängste	Ängste
Orten	Orten
nahest	nahest
sucht	sucht
bestimmten	bestimmten
drängte	drängte
scheu	scheu
denket	denket
flehte	flehte
nächste	nächste
zerbrechest	zerbrechest
pflegte	pflegte
verkündigten	verkündigten
betrübten	betrübten
siegte	siegte
eingehest	eingehest
verlaßt	verlaßt
Türkise	Türkise
zuteilte	zuteilte
eurem	eurem
baten	baten
Gebeinen	Gebeinen
kaufst	kaufst
Schreiet	Schreiet
Gründe	Gründe
treffen	treffen
frevles	frevles
rauschte	rauschte
Fürst	Fürst
schwellen	schwellen
Unglauben	Unglauben
wallet	wallet
Frieden	Frieden
Aas	Aas
fertig	fertig
knüpfte	knüpfte
nachwandelte	nachwandelte
Solches	Solches
Speise	Speise
schreiben	schreiben
aufkommt	aufkommt
Boten	Boten
Türmen	Türmen
grüßet	grüßet
Tier	Tier
eilte	eilte
hebet	hebet
vergebt	vergebt
Auge	Auge
lobe	lobe
pflanzt	pflanzt
erkennest	erkennest
könnet	könnet
Hauen	Hauen
Gänge	Gänge
Arm	Arm
Leisten	Leisten
neigte	neigte
bang	bang
messet	messet
recke	recke
auszöge	auszöge
auflegst	auflegst
binden	binden
Fittiche	Fittiche
konntet	konntet
umbrächten	umbrächten
manche	manche
urteilen	urteilen
Rechten	Rechten
Spitzen	Spitzen
verziehst	verziehst
Zäune	Zäune
krähen	krähen
wehret	wehret
breche	breche
zanket	zanket
verwirrt	verwirrt
möchtet	möchtet
haltet	haltet
Taufen	Taufen
sitzt	sitzt
erdachten	erdachten
werde	werde
verfolgst	verfolgst
Rechte	Rechte
bauest	bauest
Früchten	Früchten
Blechen	Blechen
Strömen	Strömen
haue	haue
borgte	borgte
leider	leider
Aufsätzen	Aufsätzen
Spieße	Spieße
stürze	stürze
helft	helft
innere	innere
ungeistlichen	ungeistlichen
Weißt	Weißt
bleibest	bleibest
gerne	gerne
reichet	reichet
säet	säet
Folge	Folge
jeden	jeden
weinen	weinen
Deine	Deine
umbringet	umbringet
demütigst	demütigst
spielet	spielet
nötig	nötig
zerschlaget	zerschlaget
Graben	Graben
schauen	schauen
trotzet	trotzet
glaubet	glaubet
Waren	Waren
merken	merken
gießt	gießt
leihet	leihet
reckte	reckte
Maß	Maß
Kommst	Kommst
krähte	krähte
jauchzt	jauchzt
suchet	suchet
lehrst	lehrst
Decke	Decke
Ochsen	Ochsen
Rufet	Rufet
ausrichtest	ausrichtest
besorgt	besorgt
Testamente	Testamente
sprecht	sprecht
Stimme	Stimme
Jungen	Jungen
Ströme	Ströme
Röcke	Röcke
berührt	berührt
zerstreut	zerstreut
Teile	Teile
zerstreust	zerstreust
habe	habe
Einen	Einen
Vorhäuten	Vorhäuten
zerrüttete	zerrüttete
kurz	kurz
Forsche	Forsche
mehret	mehret
umkommt	umkommt
backt	backt
erfüllst	erfüllst
schaffet	schaffet
einnehmet	einnehmet
legest	legest
saget	saget
dürfte	dürfte
anzeigt	anzeigt
Söhnen	Söhnen
sprechet	sprechet
Buchstaben	Buchstaben
anhangt	anhangt
willen	willen
forschet	forschet
labe	labe
führen	führen
Schlangen	Schlangen
wollest	wollest
Füchsen	Füchsen
Mal	Mal
Ihren	Ihren
Kriege	Kriege
Leichnamen	Leichnamen
manchen	manchen
Last	Last
keinem	keinem
steinigte	steinigte
Fallet	Fallet
schlaf	schlaf
Klage	Klage
Grabe	Grabe
schläft	schläft
bessere	bessere
gereichte	gereichte
hebräischen	hebräischen
welchen	welchen
Brüste	Brüste
Büsche	Büsche
lebest	lebest
zeigst	zeigst
beweisen	beweisen
gebieten	gebieten
Wege	Wege
Füllet	Füllet
gute	gute
frisch	frisch
Erste	Erste
Winden	Winden
Früchte	Früchte
entsündigt	entsündigt
verkehrten	verkehrten
Setzet	Setzet
verschont	verschont
demütigte	demütigte
fehlet	fehlet
Ruder	Ruder
verstört	verstört
schließt	schließt
ruhe	ruhe
lüge	lüge
Riese	Riese
Lehre	Lehre
lehrest	lehrest
bleibst	bleibst
blende	blende
herrschte	herrschte
fremden	fremden
drängst	drängst
redetet	redetet
erhaltet	erhaltet
Suchet	Suchet
abweichet	abweichet
anzeige	anzeige
schlaget	schlaget
erweckst	erweckst
arme	arme
verderbest	verderbest
hebst	hebst
unterrichte	unterrichte
könnt	könnt
Träume	Träume
klage	klage
Elle	Elle
Buchstabe	Buchstabe
Griechen	Griechen
koste	koste
wegführe	wegführe
log	log
Ratsherren	Ratsherren
betrübst	betrübst
hieb	hieb
versuchet	versuchet
lassest	lassest
nahte	nahte
Sehne	Sehne
fällt	fällt
liebst	liebst
niemand	niemand
machet	machet
reif	reif
Gläubige	Gläubige
Meere	Meere
Anschläge	Anschläge
dienet	dienet
weiche	weiche
führst	führst
drängten	drängten
Monden	Monden
würzen	würzen
Leichen	Leichen
glänzt	glänzt
hattest	hattest
leid	leid
fluche	fluche
scheinest	scheinest
Schiffe	Schiffe
erzeigte	erzeigte
besucht	besucht
seufzt	seufzt
Paläste	Paläste
wogen	wogen
Felsen	Felsen
verbirgt	verbirgt
Bis	Bis
Ärzten	Ärzten
Feind	Feind
hingehet	hingehet
bete	bete
auszogst	auszogst
verstopften	verstopften
aufrichtest	aufrichtest
stäupen	stäupen
erzeigten	erzeigten
Heiße	Heiße
sterbet	sterbet
strecken	strecken
decke	decke
ausrichtet	ausrichtet
Abhängen	Abhängen
Trübsalen	Trübsalen
ihnen	ihnen
Geliebte	Geliebte
wollt	wollt
Sägen	Sägen
verlähmte	verlähmte
suchte	suchte
gehorchst	gehorchst
bestellten	bestellten
Götzen	Götzen
Reife	Reife
unterrichten	unterrichten
Predigten	Predigten
begrabt	begrabt
Bleibet	Bleibet
vertraut	vertraut
bewähret	bewähret
Strafen	Strafen
Helmen	Helmen
Keine	Keine
traget	traget
Herrn	Herrn
beugst	beugst
kennet	kennet
Tut	Tut
kehrte	kehrte
Spaltungen	Spaltungen
auflöst	auflöst
zerrütteten	zerrütteten
Flöten	Flöten
Rubine	Rubine
erzürnet	erzürnet
den	den
fluchten	fluchten
tut	tut
würden	würden
Wunden	Wunden
lebst	lebst
Lüsten	Lüsten
Knechte	Knechte
zerstreuest	zerstreuest
ratschlagten	ratschlagten
Elf	Elf
Älteste	Älteste
Klagen	Klagen
wunderte	wunderte
stoße	stoße
frische	frische
Ebene	Ebene
befestigten	befestigten
ratschlagt	ratschlagt
deckst	deckst
Bleche	Bleche
Kriegsknechten	Kriegsknechten
stärket	stärket
aufstehet	aufstehet
hätten	hätten
aufhört	aufhört
verstecken	verstecken
trägt	trägt
schickte	schickte
handhaben	handhaben
Kreuz	Kreuz
reizet	reizet
empörten	empörten
erzürnst	erzürnst
Kannen	Kannen
fasse	fasse
Säge	Säge
erkennet	erkennet
selbst	selbst
aufrichte	aufrichte
Erde	Erde
Trinken	Trinken
rufen	rufen
Gras	Gras
Jahr	Jahr
anderen	anderen
verkürzt	verkürzt
verunreinigst	verunreinigst
erzeigt	erzeigt
laufet	laufet
ringet	ringet
durften	durften
Tust	Tust
Gehorchet	Gehorchet
ausrottet	ausrottet
Wehklage	Wehklage
opfern	opfern
reichte	reichte
gebiete	gebiete
niemanden	niemanden
nachwandelt	nachwandelt
salzen	salzen
vertilgte	vertilgte
zerschlagt	zerschlagt
Werkzeugen	Werkzeugen
besorgte	besorgte
Gefangenen	Gefangenen
Stühlen	Stühlen
bitten	bitten
Tun	Tun
danket	danket
habet	habet
Zehen	Zehen
prediget	prediget
schwebte	schwebte
befragte	befragte
fluchte	fluchte
tragen	tragen
aufheben	aufheben
Ha	Ha
erlassen	erlassen
ausrufest	ausrufest
Sieben	Sieben
erkanntet	erkanntet
Höhen	Höhen
griffen	griffen
gehest	gehest
beschädigt	beschädigt
führe	führe
grüßte	grüßte
heben	heben
Gar	Gar
erbest	erbest
hebräisch	hebräisch
Gästen	Gästen
ungefälschtem	ungefälschtem
Gehörst	Gehörst
Schilden	Schilden
eigene	eigene
ausgerecktem	ausgerecktem
hattet	hattet
Kühe	Kühe
vermag	vermag
heiße	heiße
anbetest	anbetest
glaubest	glaubest
langte	langte
wallte	wallte
unsre	unsre
zürnet	zürnet
helle	helle
Wunde	Wunde
gewinnen	gewinnen
regiert	regiert
setzet	setzet
gelobte	gelobte
vermahnen	vermahnen
Pferden	Pferden
eurer	eurer
nährte	nährte
Jünglingen	Jünglingen
wohnte	wohnte
Westen	Westen
ausbreitet	ausbreitet
umkäme	umkäme
hängen	hängen
gebt	gebt
meinet	meinet
schnelle	schnelle
spanne	spanne
leide	leide
rüstete	rüstete
Gerichten	Gerichten
Spitze	Spitze
Juden	Juden
kaufest	kaufest
handhabest	handhabest
Weinbergen	Weinbergen
morde	morde
teil	teil
Strafe	Strafe
Amen	Amen
Fremde	Fremde
wirket	wirket
aufrichten	aufrichten
Hure	Hure
Erben	Erben
selber	selber
Eichen	Eichen
steigest	steigest
schenke	schenke
Städten	Städten
erfreut	erfreut
unschuldige	unschuldige
stürzt	stürzt
lernst	lernst
Schaffe	Schaffe
machest	machest
besäen	besäen
wart	wart
betrübet	betrübet
zürnest	zürnest
höhnte	höhnte
zerstörst	zerstörst
zuteil	zuteil
ziehet	ziehet
danke	danke
ungeistlich	ungeistlich
verzehrt	verzehrt
Hirte	Hirte
schauet	schauet
weichest	weichest
hinausgeht	hinausgeht
Denn	Denn
Zeuge	Zeuge
einem	einem
solchen	solchen
Gesell	Gesell
Urteile	Urteile
Höret	Höret
Äste	Äste
wünsche	wünsche
wirkst	wirkst
kostet	kostet
sündigst	sündigst
ausgereckter	ausgereckter
wohnest	wohnest
zweifel	zweifel
vierten	vierten
Decken	Decken
irgendeine	irgendeine
verboten	verboten
fern	fern
Schlägen	Schlägen
setzt	setzt
ehrte	ehrte
bedürfet	bedürfet
verkaufst	verkaufst
stehest	stehest
Gehilfen	Gehilfen
schau	schau
verziehe	verziehe
pflegst	pflegst
schreie	schreie
ritten	ritten
wehklage	wehklage
erforschest	erforschest
tretet	tretet
lachen	lachen
verdeckt	verdeckt
aufhebest	aufhebest
drängest	drängest
vertraget	vertraget
suchten	suchten
redetest	redetest
speisen	speisen
Schauen	Schauen
verliert	verliert
Pfeilen	Pfeilen
hebräische	hebräische
Zehe	Zehe
beschuldiget	beschuldiget
werft	werft
tragt	tragt
schämet	schämet
grün	grün
Schmieden	Schmieden
Eins	Eins
anzögen	anzögen
seht	seht
zwölfte	zwölfte
folge	folge
wundere	wundere
Hirschen	Hirschen
mußte	mußte
Biene	Biene
verfolgt	verfolgt
Aase	Aase
lernte	lernte
erlöse	erlöse
hauen	hauen
Rubinen	Rubinen
Linke	Linke
fragte	fragte
hineinbrächte	hineinbrächte
entsetzen	entsetzen
zieren	zieren
schenkte	schenkte
bracht	bracht
erlöset	erlöset
Neumonde	Neumonde
gelang	gelang
blaset	blaset
warnst	warnst
lauten	lauten
Wollt	Wollt
stärke	stärke
Ellen	Ellen
verdeckten	verdeckten
Suche	Suche
umkehrt	umkehrt
Willst	Willst
fließe	fließe
Stolz	Stolz
sterbest	sterbest
trinkest	trinkest
frevle	frevle
bat	bat
ungehorsam	ungehorsam
liegen	liegen
gehorchet	gehorchet
Löwen	Löwen
blenden	blenden
Büschen	Büschen
erschreckt	erschreckt
Bären	Bären
habest	habest
grünen	grünen
wahre	wahre
lauft	lauft
Säuen	Säuen
Lesen	Lesen
griff	griff
Weine	Weine
Schlange	Schlange
Götze	Götze
Morde	Morde
erfahret	erfahret
hoffte	hoffte
Gebet	Gebet
sehet	sehet
sitzen	sitzen
Taten	Taten
denn	denn
rufet	rufet
Gewürze	Gewürze
helfet	helfet
ausgehst	ausgehst
entsündigen	entsündigen
Jude	Jude
Staub	Staub
maß	maß
träumen	träumen
prüfst	prüfst
führte	führte
bedenket	bedenket
prüfet	prüfet
griechisch	griechisch
kosten	kosten
aufwachst	aufwachst
Gefilden	Gefilden
braust	braust
verzieh	verzieh
Pfeife	Pfeife
Stäbe	Stäbe
scheide	scheide
zeuget	zeuget
dich	dich
Ringen	Ringen
vereinigte	vereinigte
unserem	unserem
Schwelle	Schwelle
Warte	Warte
wehklagen	wehklagen
Heißt	Heißt
lasset	lasset
Trinkgefäßen	Trinkgefäßen
Abtrünnige	Abtrünnige
erzeige	erzeige
schaffst	schaffst
fressen	fressen
Stärke	Stärke
erweckt	erweckt
erbauet	erbauet
gebäret	gebäret
streute	streute
letzte	letzte
Basilisken	Basilisken
ferne	ferne
Beine	Beine
pflege	pflege
krank	krank
erlaubt	erlaubt
sündigten	sündigten
Solch	Solch
sorgen	sorgen
zweifeln	zweifeln
fünften	fünften
verderben	verderben
regen	regen
schneide	schneide
bebte	bebte
deckte	deckte
Ochse	Ochse
Sehet	Sehet
besuchen	besuchen
schwimmst	schwimmst
schreien	schreien
Zeugnisse	Zeugnisse
gehst	gehst
überführt	überführt
wisse	wisse
fallest	fallest
Heere	Heere
Hebe	Hebe
wahr	wahr
Träumen	Träumen
besäest	besäest
Werk	Werk
führet	führet
wollte	wollte
Herz	Herz
schöpfe	schöpfe
Bande	Bande
lebte	lebte
