wehre	wehre
bereitet	bereitet
Sorge	Sorge
Name	Name
fällen	fällen
heulet	heulet
unser	unser
erzürnt	erzürnt
schläft	schläft
lobet	lobet
Bist	Bist
harrte	harrte
Ihren	Ihren
erbaut	erbaut
fremde	fremde
Spanne	Spanne
Sehet	Sehet
zerstücken	zerstücken
Schleife	Schleife
befragt	befragt
verzweifelten	verzweifelten
Ärzten	Ärzten
gehest	gehest
gießet	gießet
Gebot	Gebot
trägt	trägt
stillest	stillest
Junge	Junge
demütigte	demütigte
trefft	trefft
möchten	möchten
besitzest	besitzest
vertraut	vertraut
Fremden	Fremden
reichet	reichet
vertilge	vertilge
Schwelle	Schwelle
anhangt	anhangt
Weine	Weine
tragt	tragt
trügen	trügen
mache	mache
Schiffe	Schiffe
erdacht	erdacht
Lüsten	Lüsten
Freunden	Freunden
bestimmte	bestimmte
beugte	beugte
Plagen	Plagen
bestimmst	bestimmst
fehle	fehle
treffen	treffen
erfahrt	erfahrt
hattest	hattest
Strömen	Strömen
welche	welche
wollest	wollest
fällt	fällt
Frommen	Frommen
stürzen	stürzen
Lehre	Lehre
versuchet	versuchet
übest	übest
Reihen	Reihen
ihres	ihres
Bitten	Bitten
demütig	demütig
logen	logen
Gebirge	Gebirge
waren	waren
untertretet	untertretet
wissest	wissest
erhebet	erhebet
Dann	Dann
bezahlest	bezahlest
schaffe	schaffe
vermahnt	vermahnt
anrichtet	anrichtet
zuteil	zuteil
sollte	sollte
lügst	lügst
schickte	schickte
eines	eines
Funken	Funken
vergießest	vergießest
ihren	ihren
haltest	haltest
sollt	sollt
Werk	Werk
glänzte	glänzte
erkennst	erkennst
reizte	reizte
rate	rate
wehret	wehret
Rühmet	Rühmet
Ratsherren	Ratsherren
Verheißungen	Verheißungen
handhabt	handhabt
geselle	geselle
Grab	Grab
durchläutert	durchläutert
Gehilfen	Gehilfen
reizet	reizet
ringet	ringet
griff	griff
versuchen	versuchen
liebst	liebst
War	War
sterbest	sterbest
Folget	Folget
Wisset	Wisset
Tage	Tage
bewähret	bewähret
Freunde	Freunde
loben	loben
folgen	folgen
spannt	spannt
Prophet	Prophet
nahte	nahte
werdet	werdet
erhörst	erhörst
Heere	Heere
erzeige	erzeige
zerstreut	zerstreut
schlafe	schlafe
Bande	Bande
jemanden	jemanden
jagst	jagst
zweifeln	zweifeln
willen	willen
halt	halt
ratschlaget	ratschlaget
inneren	inneren
lade	lade
könne	könne
einsammelst	einsammelst
mußten	mußten
sündiget	sündiget
einsammelte	einsammelte
Buchstaben	Buchstaben
nütze	nütze
Gebt	Gebt
Rufet	Rufet
Rubinen	Rubinen
urteile	urteile
Hunderten	Hunderten
hüten	hüten
heißet	heißet
denkst	denkst
verkriechet	verkriechet
glauben	glauben
klagen	klagen
versagen	versagen
teilet	teilet
lauft	lauft
aufwacht	aufwacht
vertilgte	vertilgte
gehören	gehören
Gehilfe	Gehilfe
scheinest	scheinest
bedeckst	bedeckst
leere	leere
besitzt	besitzt
hineinbrächte	hineinbrächte
Herde	Herde
Acht	Acht
gehorchst	gehorchst
fehlet	fehlet
viele	viele
sagest	sagest
vermahne	vermahne
erhöhest	erhöhest
jungen	jungen
tote	tote
versöhnst	versöhnst
verstand	verstand
Höhlen	Höhlen
reizest	reizest
Befehlen	Befehlen
zeiget	zeiget
zählet	zählet
verunreinigst	verunreinigst
ziehet	ziehet
Funke	Funke
Kühe	Kühe
Forschet	Forschet
deckst	deckst
schließt	schließt
stehest	stehest
wärt	wärt
Heuschrecke	Heuschrecke
erschrickst	erschrickst
kochte	kochte
Zeugnisse	Zeugnisse
liegst	liegst
jede	jede
frommen	frommen
rüstetet	rüstetet
Buben	Buben
zählst	zählst
teile	teile
wiederkommt	wiederkommt
schreiet	schreiet
begehrten	begehrten
gießt	gießt
Ei	Ei
erschreckt	erschreckt
wisse	wisse
Bächen	Bächen
dritte	dritte
Zöpfen	Zöpfen
tut	tut
Herz	Herz
Denen	Denen
trübe	trübe
Sorget	Sorget
bestanden	bestanden
entsetzte	entsetzte
bemüht	bemüht
Schaffet	Schaffet
Türkise	Türkise
abziehen	abziehen
schwellen	schwellen
verkauften	verkauften
gelangt	gelangt
ungehorsam	ungehorsam
begehrt	begehrt
pflanze	pflanze
heiß	heiß
Regenten	Regenten
Werde	Werde
labe	labe
Perlen	Perlen
suchet	suchet
umbringet	umbringet
Zöpfe	Zöpfe
Jünglinge	Jünglinge
trinkest	trinkest
berufe	berufe
bedeckest	bedeckest
Kreuze	Kreuze
messet	messet
aufnahmen	aufnahmen
Kleinoden	Kleinoden
Heiße	Heiße
wehklage	wehklage
fluche	fluche
zanket	zanket
schaffen	schaffen
Steinen	Steinen
Schauen	Schauen
Ärgernissen	Ärgernissen
anzeigt	anzeigt
Höret	Höret
Steiget	Steiget
zuhöret	zuhöret
Füchse	Füchse
braust	braust
still	still
wegführen	wegführen
Gebärde	Gebärde
Deutung	Deutung
Denn	Denn
bereits	bereits
lieben	lieben
Gehorcht	Gehorcht
spannen	spannen
kehrst	kehrst
wache	wache
beweiset	beweiset
jene	jene
urteilen	urteilen
kriegen	kriegen
Eines	Eines
irren	irren
schaute	schaute
feiert	feiert
Rufen	Rufen
bringst	bringst
ausgehst	ausgehst
Klaue	Klaue
Tanne	Tanne
fremden	fremden
geraten	geraten
legte	legte
vereinigt	vereinigt
Pferden	Pferden
Hure	Hure
gehört	gehört
Reich	Reich
Sorgen	Sorgen
Trage	Trage
versöhnet	versöhnet
schaffest	schaffest
Pfunden	Pfunden
aufsteht	aufsteht
besäen	besäen
zuschließt	zuschließt
vereinigte	vereinigte
Spitzen	Spitzen
erschrecket	erschrecket
auflegte	auflegte
auszogst	auszogst
Klauen	Klauen
hurst	hurst
säte	säte
mühe	mühe
Hirsche	Hirsche
ringst	ringst
den	den
Morden	Morden
leben	leben
Grieche	Grieche
Ruder	Ruder
hell	hell
vermahnte	vermahnte
Feiertage	Feiertage
Spieße	Spieße
fließe	fließe
reifen	reifen
besehet	besehet
könnest	könnest
weise	weise
reizen	reizen
untergehst	untergehst
anfingst	anfingst
stellst	stellst
erzeigten	erzeigten
zierte	zierte
wog	wog
weinet	weinet
kennst	kennst
ziehest	ziehest
schrecke	schrecke
besucht	besucht
verkaufte	verkaufte
predigst	predigst
Erde	Erde
scheute	scheute
aufrichte	aufrichte
wehklagen	wehklagen
Dienet	Dienet
abtrünnige	abtrünnige
berührt	berührt
erzeigen	erzeigen
Gibst	Gibst
habe	habe
Führet	Führet
Pferde	Pferde
sitzest	sitzest
erforschet	erforschet
blitzt	blitzt
ratschlagten	ratschlagten
Ochs	Ochs
Trübsal	Trübsal
Hunde	Hunde
könnten	könnten
Leiden	Leiden
schenke	schenke
stürzest	stürzest
unterrichte	unterrichte
Wäre	Wäre
holst	holst
stärke	stärke
trinkst	trinkst
vermögen	vermögen
Graben	Graben
Zweigen	Zweigen
Sprüche	Sprüche
Gefilden	Gefilden
leihet	leihet
hüte	hüte
brennen	brennen
wurde	wurde
Hälsen	Hälsen
kosten	kosten
fertig	fertig
Schreien	Schreien
erzeigte	erzeigte
schneide	schneide
wachsen	wachsen
aufstanden	aufstanden
nachwandelte	nachwandelte
Jungen	Jungen
Sinne	Sinne
entsetzen	entsetzen
eurem	eurem
jammern	jammern
frevles	frevles
ach	ach
stehst	stehst
Berge	Berge
verkehre	verkehre
Meine	Meine
ausgereckten	ausgereckten
Früchte	Früchte
gute	gute
schreist	schreist
unterrichtet	unterrichtet
verzweifelt	verzweifelt
Lobe	Lobe
erst	erst
Sollten	Sollten
rühmest	rühmest
erkannten	erkannten
Euren	Euren
mehr	mehr
ziert	ziert
weinte	weinte
Fällen	Fällen
Köpfen	Köpfen
unsre	unsre
Schlange	Schlange
beißet	beißet
stäupen	stäupen
weist	weist
freiwillige	freiwillige
Biene	Biene
Solchen	Solchen
Schuld	Schuld
fluchet	fluchet
Gästen	Gästen
Frage	Frage
Lasten	Lasten
Weg	Weg
warten	warten
Jahre	Jahre
empfange	empfange
beschuldiget	beschuldiget
nähre	nähre
zuteilte	zuteilte
Ratsherr	Ratsherr
Lobet	Lobet
grabe	grabe
griechisch	griechisch
Fürst	Fürst
murmelte	murmelte
wilde	wilde
Reizt	Reizt
ansehet	ansehet
Fromme	Fromme
Last	Last
Hie	Hie
zerrüttete	zerrüttete
ehrte	ehrte
zankte	zankte
zerbrechest	zerbrechest
beweist	beweist
müsset	müsset
Tragt	Tragt
älteste	älteste
schätzt	schätzt
Lobgesängen	Lobgesängen
möget	möget
Einheimischen	Einheimischen
verklärest	verklärest
Könnet	Könnet
Bäche	Bäche
Majestäten	Majestäten
plagte	plagte
Entsetzet	Entsetzet
Kleinod	Kleinod
Zähne	Zähne
Meere	Meere
schaffte	schaffte
Deinen	Deinen
krank	krank
Gefängnisse	Gefängnisse
Edelsteinen	Edelsteinen
wirfst	wirfst
Geviert	Geviert
recke	recke
solches	solches
Erden	Erden
nächsten	nächsten
bitte	bitte
schnitt	schnitt
vergibt	vergibt
denen	denen
gereicht	gereicht
sprachen	sprachen
spielte	spielte
binden	binden
backen	backen
rührst	rührst
Stolze	Stolze
Gar	Gar
drängten	drängten
verständige	verständige
erlaubte	erlaubte
Spaltungen	Spaltungen
vielen	vielen
umkäme	umkäme
Toten	Toten
Satzungen	Satzungen
achte	achte
Räte	Räte
zerstreuet	zerstreuet
säst	säst
preisen	preisen
wart	wart
letzte	letzte
Gefangene	Gefangene
begrabt	begrabt
predigt	predigt
verlähmte	verlähmte
einnehmet	einnehmet
außer	außer
seines	seines
Hände	Hände
unsres	unsres
dienst	dienst
Bete	Bete
speise	speise
spiele	spiele
vertraget	vertraget
Raube	Raube
alles	alles
währte	währte
Haut	Haut
zählte	zählte
langte	langte
eingehst	eingehst
möchtet	möchtet
Teppichen	Teppichen
wünschen	wünschen
hättest	hättest
leset	leset
abzieht	abzieht
Hebet	Hebet
schämte	schämte
sei	sei
heiligten	heiligten
aufwachst	aufwachst
Heeren	Heeren
verkehrt	verkehrt
danke	danke
Gebärden	Gebärden
vermagst	vermagst
verlasse	verlasse
einer	einer
freuet	freuet
Teppiche	Teppiche
lehrst	lehrst
bestellten	bestellten
Schneiden	Schneiden
zweifelte	zweifelte
Händen	Händen
brauchst	brauchst
Ring	Ring
rächest	rächest
widerstand	widerstand
Fülle	Fülle
klagte	klagte
Wehklage	Wehklage
befehlen	befehlen
deine	deine
bekennst	bekennst
vertilgen	vertilgen
leuchtete	leuchtete
lachen	lachen
hingehet	hingehet
Anschläge	Anschläge
Woge	Woge
Solche	Solche
Vorhäute	Vorhäute
Schau	Schau
Einer	Einer
Same	Same
mehrte	mehrte
abtrünnigen	abtrünnigen
streckst	streckst
anbetest	anbetest
widerstanden	widerstanden
gut	gut
weh	weh
entsündigen	entsündigen
krieget	krieget
gebet	gebet
gehörst	gehörst
Fett	Fett
pflanzest	pflanzest
räumet	räumet
aufrichtest	aufrichtest
stärket	stärket
verstörte	verstörte
schicke	schicke
redetest	redetest
begrabet	begrabet
schnelle	schnelle
Schleifen	Schleifen
beharret	beharret
unehrt	unehrt
anrichten	anrichten
Helme	Helme
schlag	schlag
wurden	wurden
weichst	weichst
fern	fern
erhört	erhört
Band	Band
leid	leid
lebet	lebet
verziehen	verziehen
siegen	siegen
zerstört	zerstört
pflügte	pflügte
speisen	speisen
gehorchte	gehorchte
Streite	Streite
Nehmt	Nehmt
aufhört	aufhört
Tritt	Tritt
fällte	fällte
verstecken	verstecken
bete	bete
taufet	taufet
Tauben	Tauben
treibst	treibst
könnt	könnt
lehret	lehret
gleich	gleich
Hunden	Hunden
glaubet	glaubet
Sterne	Sterne
hingehst	hingehst
verbirgt	verbirgt
nachwandeln	nachwandeln
schwelle	schwelle
bezahlt	bezahlt
sahet	sahet
Gibt	Gibt
kämpfet	kämpfet
Pfeifen	Pfeifen
Gevierte	Gevierte
Tut	Tut
Fallen	Fallen
innere	innere
scheinen	scheinen
dürft	dürft
dingt	dingt
Gründe	Gründe
nehmest	nehmest
säumen	säumen
anzeigte	anzeigte
solch	solch
einerntest	einerntest
fromme	fromme
linke	linke
lernst	lernst
ihrem	ihrem
bist	bist
vergesset	vergesset
deinen	deinen
haltet	haltet
Kriegsknechten	Kriegsknechten
Schuhen	Schuhen
bedeckt	bedeckt
rufst	rufst
fragen	fragen
selbst	selbst
mögt	mögt
Unrecht	Unrecht
Gewürze	Gewürze
Kannen	Kannen
bewahrst	bewahrst
strafe	strafe
zudeckt	zudeckt
steinigest	steinigest
erhebst	erhebst
hörst	hörst
strafen	strafen
gehorchten	gehorchten
weine	weine
dingten	dingten
bezahlst	bezahlst
Hecken	Hecken
Aussätzigen	Aussätzigen
Hat	Hat
erschrickt	erschrickt
seufzt	seufzt
Basilisken	Basilisken
am	am
klage	klage
dankte	dankte
besitze	besitze
neige	neige
verkürzest	verkürzest
zeugest	zeugest
zeigst	zeigst
anbetet	anbetet
Heuschrecken	Heuschrecken
Macht	Macht
irre	irre
glühende	glühende
ritt	ritt
aufwachte	aufwachte
Grüße	Grüße
pflüget	pflüget
heiße	heiße
vertrage	vertrage
Beinen	Beinen
diente	diente
anrufe	anrufe
ungefälschtem	ungefälschtem
Weinet	Weinet
fette	fette
würdest	würdest
vergessest	vergessest
merke	merke
schwimmen	schwimmen
Wollte	Wollte
sondern	sondern
warte	warte
Trinket	Trinket
bewährt	bewährt
erhalte	erhalte
Urteile	Urteile
Ellen	Ellen
Gründen	Gründen
absagen	absagen
erlösen	erlösen
erben	erben
ansehen	ansehen
scheinet	scheinet
Fremde	Fremde
verstehest	verstehest
ziehst	ziehst
Dieben	Dieben
Stärke	Stärke
unseren	unseren
Trinkgefäße	Trinkgefäße
Propheten	Propheten
besorgte	besorgte
wärmet	wärmet
saht	saht
schaffet	schaffet
austilgest	austilgest
Kaufleuten	Kaufleuten
Vorstädten	Vorstädten
Steige	Steige
verkündigest	verkündigest
Wänden	Wänden
Narr	Narr
weichen	weichen
suchst	suchst
laden	laden
oben	oben
hinausgehst	hinausgehst
verlaßt	verlaßt
Bäumen	Bäumen
deines	deines
ferne	ferne
untertreten	untertreten
Decke	Decke
erlöse	erlöse
erzürnet	erzürnet
Halte	Halte
bestellte	bestellte
Kosten	Kosten
schon	schon
hänget	hänget
herrschet	herrschet
rittest	rittest
Boten	Boten
Gras	Gras
reichte	reichte
Bleche	Bleche
Rehe	Rehe
Alle	Alle
Unglauben	Unglauben
Ängsten	Ängsten
Flöten	Flöten
webte	webte
links	links
Skorpione	Skorpione
jeden	jeden
Warte	Warte
dürfest	dürfest
Knabe	Knabe
fetten	fetten
eine	eine
Wege	Wege
küssen	küssen
Verheißung	Verheißung
brauchte	brauchte
gelobet	gelobet
beweise	beweise
trotzt	trotzt
besät	besät
Steigen	Steigen
unserem	unserem
verlobt	verlobt
erfüllst	erfüllst
Bleibe	Bleibe
Hast	Hast
aufhebest	aufhebest
blitzte	blitzte
herrschte	herrschte
Entsetzt	Entsetzt
schauen	schauen
holte	holte
erfüllet	erfüllet
bauest	bauest
hänge	hänge
gebühren	gebühren
stürze	stürze
Wüsten	Wüsten
Schlangen	Schlangen
binde	binde
Leiste	Leiste
Grenzen	Grenzen
fange	fange
Schuhe	Schuhe
Abtrünnige	Abtrünnige
Verwundeten	Verwundeten
Am	Am
Herden	Herden
rotten	rotten
Verwundete	Verwundete
heben	heben
batest	batest
angehört	angehört
frische	frische
dein	dein
tretest	tretest
Weihen	Weihen
steig	steig
ein	ein
Dein	Dein
Zweige	Zweige
suchest	suchest
stoße	stoße
Ringe	Ringe
erhöhst	erhöhst
trieb	trieb
Bahnen	Bahnen
Taube	Taube
befehlt	befehlt
elfte	elfte
rechten	rechten
Zäune	Zäune
beten	beten
brechen	brechen
besitzet	besitzet
einst	einst
Sternen	Sternen
Röhre	Röhre
opferte	opferte
Flöte	Flöte
Linken	Linken
lache	lache
Knechten	Knechten
betrübet	betrübet
Haue	Haue
zerstreust	zerstreust
verzehrst	verzehrst
Stricken	Stricken
lest	lest
sehet	sehet
arm	arm
Seiten	Seiten
Monaten	Monaten
ehre	ehre
Schwellen	Schwellen
Perle	Perle
Eichen	Eichen
übte	übte
Werden	Werden
gibst	gibst
Majestät	Majestät
liegen	liegen
setzet	setzet
fehlen	fehlen
Festen	Festen
ab	ab
jemand	jemand
fertige	fertige
Lichte	Lichte
Broten	Broten
kommest	kommest
brausen	brausen
gereichte	gereichte
aufstehet	aufstehet
Schreiet	Schreiet
wälzet	wälzet
Meinen	Meinen
brecht	brecht
vermahnen	vermahnen
bringest	bringest
vierten	vierten
Sieb	Sieb
verwirfst	verwirfst
aufstehst	aufstehst
Decken	Decken
sterbet	sterbet
Falle	Falle
Pflanzung	Pflanzung
begehrst	begehrst
Fahrt	Fahrt
rührte	rührte
Aufsätzen	Aufsätzen
träumen	träumen
Tagen	Tagen
regiere	regiere
geratest	geratest
fertigte	fertigte
rote	rote
seit	seit
begehrte	begehrte
Erbe	Erbe
Christen	Christen
vorn	vorn
Deinem	Deinem
Keile	Keile
helfet	helfet
gehet	gehet
merken	merken
Gehorchet	Gehorchet
Gefangenen	Gefangenen
verstopft	verstopft
Zerstreut	Zerstreut
seinem	seinem
Helden	Helden
trägst	trägst
Weile	Weile
stärken	stärken
Tieren	Tieren
aller	aller
verlähmt	verlähmt
Sehnen	Sehnen
jaget	jaget
verkündigst	verkündigst
würden	würden
mahle	mahle
Tannen	Tannen
werdest	werdest
warst	warst
haust	haust
Solcher	Solcher
Laien	Laien
spricht	spricht
wären	wären
hineinbrächten	hineinbrächten
Götze	Götze
drängst	drängst
nächste	nächste
Augen	Augen
redetet	redetet
Sehe	Sehe
Enden	Enden
heile	heile
schließe	schließe
sprechet	sprechet
Dans	Dans
fehlte	fehlte
gebt	gebt
gern	gern
meinst	meinst
vermöge	vermöge
fastete	fastete
regieren	regieren
Ordnungen	Ordnungen
steinigte	steinigte
möge	möge
meinet	meinet
Pauke	Pauke
koste	koste
Haben	Haben
befragte	befragte
lehren	lehren
lange	lange
weg	weg
messe	messe
wirket	wirket
fülle	fülle
schreien	schreien
Schmiede	Schmiede
anzeigen	anzeigen
Schenke	Schenke
Sucht	Sucht
schaffst	schaffst
denn	denn
Ältesten	Ältesten
lehrte	lehrte
leiten	leiten
Wolle	Wolle
Hirt	Hirt
gelangen	gelangen
scheiden	scheiden
Alten	Alten
vermag	vermag
beugst	beugst
Weinstöcke	Weinstöcke
gießest	gießest
kehren	kehren
wisset	wisset
fasset	fasset
Ach	Ach
Kohlen	Kohlen
drängte	drängte
hause	hause
Krieg	Krieg
anhanget	anhanget
Bahn	Bahn
wenden	wenden
schlafest	schlafest
Wären	Wären
regen	regen
erkannte	erkannte
Gesetze	Gesetze
bleibe	bleibe
tretet	tretet
Eilet	Eilet
aufhobt	aufhobt
Merket	Merket
zerrüttet	zerrüttet
werfet	werfet
ausführe	ausführe
Merke	Merke
verdammte	verdammte
teilte	teilte
heil	heil
grüße	grüße
hebräische	hebräische
Bürde	Bürde
Einheimische	Einheimische
Soll	Soll
enge	enge
vertilgst	vertilgst
übrigbleibet	übrigbleibet
rauben	rauben
zerbricht	zerbricht
verführt	verführt
bedürft	bedürft
morde	morde
Spaltung	Spaltung
reckte	reckte
keinen	keinen
stelle	stelle
willst	willst
räumen	räumen
täuschet	täuschet
weinest	weinest
Wunden	Wunden
streiten	streiten
zeugen	zeugen
Märkte	Märkte
all	all
erbte	erbte
prüfst	prüfst
beschwerst	beschwerst
bekannten	bekannten
lasset	lasset
Zerstreuten	Zerstreuten
schlaget	schlaget
Königreiche	Königreiche
letzten	letzten
bestimmten	bestimmten
erbauet	erbauet
Regiert	Regiert
diese	diese
zürnet	zürnet
unterrichten	unterrichten
Scharen	Scharen
reiche	reiche
keines	keines
gebraucht	gebraucht
Sabbate	Sabbate
hattet	hattet
knüpfst	knüpfst
dritten	dritten
einführte	einführte
blende	blende
Schaden	Schaden
tat	tat
verkaufst	verkaufst
schnitten	schnitten
Beten	Beten
eilte	eilte
Weil	Weil
bebte	bebte
träumte	träumte
führe	führe
Ebenen	Ebenen
Werken	Werken
Höhle	Höhle
Sabbatjahr	Sabbatjahr
beide	beide
seufzest	seufzest
überführt	überführt
diesen	diesen
ringen	ringen
beschuldigt	beschuldigt
übet	übet
Christ	Christ
Ding	Ding
behaltet	behaltet
lösest	lösest
ausgerecktem	ausgerecktem
vertilgten	vertilgten
Aas	Aas
Leuchte	Leuchte
rächte	rächte
Edelsteine	Edelsteine
Herren	Herren
werft	werft
umkommst	umkommst
gewinnet	gewinnet
ehrest	ehrest
Löwe	Löwe
entsetzt	entsetzt
setzest	setzest
flehst	flehst
austilge	austilge
Sage	Sage
heiligest	heiligest
unserer	unserer
Altären	Altären
würzen	würzen
schneiden	schneiden
Herzen	Herzen
merkte	merkte
blaset	blaset
brach	brach
Sagte	Sagte
Weinbergen	Weinbergen
gehst	gehst
stärkte	stärkte
Grabe	Grabe
suchen	suchen
leuchten	leuchten
Fette	Fette
weisest	weisest
wehrte	wehrte
gründen	gründen
habest	habest
ausgereckter	ausgereckter
Büschen	Büschen
Glauben	Glauben
Letzte	Letzte
Mäuse	Mäuse
sitzt	sitzt
bekehrt	bekehrt
schöpfest	schöpfest
erhebest	erhebest
Knaben	Knaben
hängte	hängte
gedachten	gedachten
Saget	Saget
teilen	teilen
übrigbleiben	übrigbleiben
verdeckten	verdeckten
vor	vor
versagt	versagt
raten	raten
stirbst	stirbst
verkürzt	verkürzt
Räten	Räten
verbergest	verbergest
Säge	Säge
ausziehst	ausziehst
Fellen	Fellen
bleibest	bleibest
vergibst	vergibst
Stolz	Stolz
rühmte	rühmte
Stämmen	Stämmen
Geliebten	Geliebten
ihn	ihn
weite	weite
keiner	keiner
stürzte	stürzte
kehret	kehret
Kaufleute	Kaufleute
verbot	verbot
handhabest	handhabest
trinken	trinken
eilet	eilet
Bäume	Bäume
stahlen	stahlen
verkündigt	verkündigt
decke	decke
Esset	Esset
gebührt	gebührt
speiest	speiest
lehnte	lehnte
gehörten	gehörten
Schneide	Schneide
spannte	spannte
Felle	Felle
wogen	wogen
austilgen	austilgen
umbrächte	umbrächte
schwebe	schwebe
Herr	Herr
Türme	Türme
gebot	gebot
siegte	siegte
eng	eng
solchen	solchen
berühret	berühret
ausbreitete	ausbreitete
gehorchet	gehorchet
versuche	versuche
Zäunen	Zäunen
Forsche	Forsche
bekehrst	bekehrst
erforschest	erforschest
konnte	konnte
ruhe	ruhe
raubet	raubet
anderen	anderen
Weißt	Weißt
preiset	preiset
Gemeinde	Gemeinde
anhangen	anhangen
Reif	Reif
Köpfe	Köpfe
Monden	Monden
zerstörst	zerstörst
Kommst	Kommst
Weh	Weh
Ästen	Ästen
wäre	wäre
frisch	frisch
ruhte	ruhte
Nehmet	Nehmet
Vorstädte	Vorstädte
Ränke	Ränke
Seht	Seht
vertraute	vertraute
Höfen	Höfen
ermahnt	ermahnt
reife	reife
teil	teil
zieren	zieren
trage	trage
fluchten	fluchten
tiefe	tiefe
schreibst	schreibst
Flammen	Flammen
Jochen	Jochen
pflegte	pflegte
Gerichte	Gerichte
Staube	Staube
vermahnet	vermahnet
stiege	stiege
irrte	irrte
zweifel	zweifel
vierte	vierte
Schlägen	Schlägen
Meinem	Meinem
raubest	raubest
Laufet	Laufet
kühle	kühle
besser	besser
griechischen	griechischen
Tore	Tore
Hälse	Hälse
Werdet	Werdet
Tischen	Tischen
ob	ob
jenen	jenen
gelang	gelang
fastetet	fastetet
hoffet	hoffet
taten	taten
hebst	hebst
Riese	Riese
Unserer	Unserer
folget	folget
forschte	forschte
wallte	wallte
siehst	siehst
welchen	welchen
amen	amen
Elf	Elf
Bitte	Bitte
Zeug	Zeug
Träume	Träume
wehe	wehe
Namen	Namen
Hirten	Hirten
fallt	fallt
maß	maß
verfolgst	verfolgst
mein	mein
log	log
wachse	wachse
führst	führst
Befehle	Befehle
schließen	schließen
vertrauet	vertrauet
schämst	schämst
Ratet	Ratet
könnet	könnet
Paläste	Paläste
zweiten	zweiten
unschuldige	unschuldige
Leide	Leide
Schale	Schale
keinem	keinem
halte	halte
Schwänzen	Schwänzen
gedacht	gedacht
Flamme	Flamme
sucht	sucht
Schätzen	Schätzen
Stämme	Stämme
konntet	konntet
vertrieb	vertrieb
höret	höret
müssest	müssest
Fröschen	Fröschen
deinem	deinem
blase	blase
verkriechst	verkriechst
verderbest	verderbest
schmelzt	schmelzt
Seines	Seines
besäest	besäest
Predigten	Predigten
verführen	verführen
verwirren	verwirren
trinket	trinket
gründe	gründe
Wogen	Wogen
Leichen	Leichen
Armen	Armen
Pauken	Pauken
hätten	hätten
los	los
Diese	Diese
ihnen	ihnen
wollt	wollt
kommst	kommst
empfanget	empfanget
Decket	Decket
merket	merket
spanne	spanne
ausgereckt	ausgereckt
verdeckst	verdeckst
Gedanke	Gedanke
Leichname	Leichname
grüßte	grüßte
dürfte	dürfte
prediget	prediget
ausrottet	ausrottet
bekehrte	bekehrte
Schulden	Schulden
lügen	lügen
Amen	Amen
ziere	ziere
scheue	scheue
weichet	weichet
fallen	fallen
fassest	fassest
Fliege	Fliege
vergebet	vergebet
manchen	manchen
aßet	aßet
Kannst	Kannst
Hirte	Hirte
Mal	Mal
lebte	lebte
lebst	lebst
brachen	brachen
baute	baute
Würze	Würze
ruhest	ruhest
Jahr	Jahr
ausfuhren	ausfuhren
Loben	Loben
Skorpionen	Skorpionen
behaltest	behaltest
Pfunde	Pfunde
forschet	forschet
ärgere	ärgere
erlöst	erlöst
heulte	heulte
auszögen	auszögen
zuhörte	zuhörte
verkündige	verkündige
beweisen	beweisen
stirbt	stirbt
Tausend	Tausend
hängen	hängen
drücken	drücken
ausführt	ausführt
erfahrest	erfahrest
Gemeinden	Gemeinden
lachte	lachte
Bette	Bette
Grüßet	Grüßet
springst	springst
aufhörte	aufhörte
backe	backe
Ärzte	Ärzte
wünsche	wünsche
Setzt	Setzt
deren	deren
bauet	bauet
säet	säet
Brote	Brote
fraget	fraget
Schauet	Schauet
möchte	möchte
jammerte	jammerte
Sägen	Sägen
verständig	verständig
wallet	wallet
Gängen	Gängen
ungehorsame	ungehorsame
grün	grün
schenkte	schenkte
Werke	Werke
vergleichen	vergleichen
gebären	gebären
ausführen	ausführen
hure	hure
streckte	streckte
allem	allem
eures	eures
Zeuge	Zeuge
verdammt	verdammt
laut	laut
Fischen	Fischen
schenkest	schenkest
Abtrünnigen	Abtrünnigen
steigest	steigest
heiligt	heiligt
Plage	Plage
erlöset	erlöset
sieht	sieht
lauf	lauf
verboten	verboten
Weiche	Weiche
sitze	sitze
wehte	wehte
Tat	Tat
Feind	Feind
Röcken	Röcken
Blitze	Blitze
Säue	Säue
wachset	wachset
kennet	kennet
trüb	trüb
Werte	Werte
Aussätzige	Aussätzige
durften	durften
Ebene	Ebene
Vorhäuten	Vorhäuten
empörte	empörte
schmierte	schmierte
Wunde	Wunde
Fäusten	Fäusten
Kreisen	Kreisen
schöpfte	schöpfte
strecke	strecke
Jüngern	Jüngern
haut	haut
Geschäften	Geschäften
stellen	stellen
macht	macht
Altäre	Altäre
Sabbaten	Sabbaten
sündigst	sündigst
Glaubet	Glaubet
fällst	fällst
Jünger	Jünger
vergebt	vergebt
verunreinigt	verunreinigt
Joche	Joche
bleibst	bleibst
Pfeile	Pfeile
Halle	Halle
Sollte	Sollte
hebet	hebet
bestand	bestand
erfüllt	erfüllt
ratschlagt	ratschlagt
bewahrest	bewahrest
ihre	ihre
Fische	Fische
verlaß	verlaß
ratschlagen	ratschlagen
verdeckt	verdeckt
tatet	tatet
Eingeweiden	Eingeweiden
Schalen	Schalen
Wehret	Wehret
zeigte	zeigte
Erstlingen	Erstlingen
auflöst	auflöst
Drachen	Drachen
beben	beben
einen	einen
umkämen	umkämen
Obrigkeit	Obrigkeit
Trübsalen	Trübsalen
Wesen	Wesen
Ochsen	Ochsen
legst	legst
solle	solle
zwölfte	zwölfte
wälzt	wälzt
glaubst	glaubst
vergießt	vergießt
stille	stille
wurdest	wurdest
Erstlinge	Erstlinge
verdeckte	verdeckte
euren	euren
stolze	stolze
zerrütteten	zerrütteten
Taufe	Taufe
Gefilde	Gefilde
Staub	Staub
besuche	besuche
ausgereckte	ausgereckte
verhalten	verhalten
strafst	strafst
Gute	Gute
Fällt	Fällt
machest	machest
Tun	Tun
werte	werte
empört	empört
betrügen	betrügen
Bis	Bis
Kreise	Kreise
wende	wende
Würzen	Würzen
Höhe	Höhe
nötige	nötige
demütige	demütige
taufe	taufe
Schwänze	Schwänze
aufhoben	aufhoben
seufzte	seufzte
seht	seht
Hörst	Hörst
eurer	eurer
erfreut	erfreut
hieltet	hieltet
achten	achten
kämpfe	kämpfe
schlafet	schlafet
zeuget	zeuget
Seinen	Seinen
denket	denket
mangeln	mangeln
baten	baten
eigenen	eigenen
Füße	Füße
Regieren	Regieren
Obrigkeiten	Obrigkeiten
Maultiere	Maultiere
Teil	Teil
stellte	stellte
Zehen	Zehen
Kommet	Kommet
Heben	Heben
verbannet	verbannet
glänzt	glänzt
gefällt	gefällt
hinaufgeht	hinaufgeht
wohnet	wohnet
glaubte	glaubte
warnst	warnst
umkehrt	umkehrt
greifet	greifet
tragen	tragen
predigten	predigten
trieben	trieben
Tritte	Tritte
vertrauten	vertrauten
kühl	kühl
grüßen	grüßen
Keiner	Keiner
heiligte	heiligte
Stäben	Stäben
tief	tief
preist	preist
habt	habt
kehrte	kehrte
machst	machst
faul	faul
soll	soll
Tyrannen	Tyrannen
Stücke	Stücke
vertilgt	vertilgt
wiederkamt	wiederkamt
decken	decken
Buchen	Buchen
arbeit	arbeit
umbringt	umbringt
Fallet	Fallet
begehret	begehret
Gebeine	Gebeine
erhaltet	erhaltet
berufen	berufen
verderbet	verderbet
folge	folge
reif	reif
Kriegen	Kriegen
kaufe	kaufe
erniedrigt	erniedrigt
eingehest	eingehest
reich	reich
wehren	wehren
eingeht	eingeht
Wüste	Wüste
erkennest	erkennest
Seil	Seil
Wert	Wert
salz	salz
Schilde	Schilde
verkauft	verkauft
säumet	säumet
Bote	Bote
Aufsätze	Aufsätze
Schafe	Schafe
zuhört	zuhört
gewinnen	gewinnen
Röcke	Röcke
müßt	müßt
löst	löst
verschonet	verschonet
möchtest	möchtest
zürnst	zürnst
ausbreitet	ausbreitet
zerstreuten	zerstreuten
irgendein	irgendein
ernten	ernten
rauschen	rauschen
Schilden	Schilden
heftetest	heftetest
Stufe	Stufe
banden	banden
Kehre	Kehre
lernte	lernte
hörte	hörte
könnte	könnte
Spitze	Spitze
forschen	forschen
salzen	salzen
band	band
mal	mal
Gebirgen	Gebirgen
durchläuterte	durchläuterte
lebest	lebest
Schafen	Schafen
Hecke	Hecke
Lehren	Lehren
nahe	nahe
löste	löste
verdammst	verdammst
entsündigten	entsündigten
meinte	meinte
scheide	scheide
schrecken	schrecken
ausrufen	ausrufen
ungefälschter	ungefälschter
lernet	lernet
Sekten	Sekten
sprecht	sprecht
unsere	unsere
Kriege	Kriege
aufrichten	aufrichten
brenne	brenne
erkanntet	erkanntet
begrabest	begrabest
angehören	angehören
Laie	Laie
erschreckten	erschreckten
regiert	regiert
stolz	stolz
Diebe	Diebe
pflanzet	pflanzet
vermahnten	vermahnten
erweckt	erweckt
würde	würde
schätze	schätze
besäet	besäet
Erben	Erben
kühlen	kühlen
gebieten	gebieten
bringet	bringet
fahrt	fahrt
Abhänge	Abhänge
Kleinode	Kleinode
Bärte	Bärte
bedenket	bedenket
sagte	sagte
spielen	spielen
Städte	Städte
pflanzt	pflanzt
Friede	Friede
Empörungen	Empörungen
beißt	beißt
Ecken	Ecken
Kristallen	Kristallen
Testamente	Testamente
vertrieben	vertrieben
nehmt	nehmt
weichest	weichest
graben	graben
Juden	Juden
ernte	ernte
beiden	beiden
führen	führen
Weihe	Weihe
Malen	Malen
Raten	Raten
rechte	rechte
Sehne	Sehne
Dank	Dank
anrichte	anrichte
gewinne	gewinne
wälzte	wälzte
Deine	Deine
Halt	Halt
Westen	Westen
Knechte	Knechte
heftete	heftete
unehret	unehret
Eingeweide	Eingeweide
zwölften	zwölften
erlösest	erlösest
suchte	suchte
Gewürzen	Gewürzen
Unrechten	Unrechten
stand	stand
webet	webet
aufnahmt	aufnahmt
wechseln	wechseln
aufstand	aufstand
Sei	Sei
Elle	Elle
Kriegsknechte	Kriegsknechte
anfinge	anfinge
Beine	Beine
beschädigt	beschädigt
taufst	taufst
Monde	Monde
Gläubigen	Gläubigen
Bienen	Bienen
Ränken	Ränken
griffe	griffe
betrübten	betrübten
eigene	eigene
sündigt	sündigt
gehörte	gehörte
nachwandelt	nachwandelt
kostet	kostet
verwahrt	verwahrt
erlassen	erlassen
befehle	befehle
fangt	fangt
versöhnt	versöhnt
schreie	schreie
Lob	Lob
schlagest	schlagest
führest	führest
verkündigten	verkündigten
solcher	solcher
haue	haue
verwahrst	verwahrst
gelobten	gelobten
Gebeinen	Gebeinen
nimmst	nimmst
trüge	trüge
schauest	schauest
falle	falle
wärmte	wärmte
Höhen	Höhen
pflügen	pflügen
sagen	sagen
ausrottest	ausrottest
durfte	durfte
taufen	taufen
gebäre	gebäre
Alte	Alte
frage	frage
Stimmen	Stimmen
besorgt	besorgt
Sinnen	Sinnen
meines	meines
Fragen	Fragen
Gänge	Gänge
Füchsen	Füchsen
hebräisch	hebräisch
verführe	verführe
fliegen	fliegen
zweite	zweite
Trinken	Trinken
erwürgt	erwürgt
traget	traget
Worten	Worten
schmückte	schmückte
weiden	weiden
elften	elften
sage	sage
trotzet	trotzet
fallet	fallet
solchem	solchem
speisest	speisest
Kehret	Kehret
entsetzet	entsetzet
grüßt	grüßt
Reizen	Reizen
stiegen	stiegen
Äste	Äste
ausgeht	ausgeht
Als	Als
Zehe	Zehe
sehest	sehest
werten	werten
rufe	rufe
Brüsten	Brüsten
auszieht	auszieht
befragten	befragten
Kühen	Kühen
wärst	wärst
wachet	wachet
Königen	Königen
beides	beides
Schade	Schade
sagst	sagst
angehöre	angehöre
zeugte	zeugte
reden	reden
verzieh	verzieh
leiden	leiden
Pflanzungen	Pflanzungen
schlaf	schlaf
hilfst	hilfst
mußte	mußte
Türmen	Türmen
wachte	wachte
Keine	Keine
Gerichten	Gerichten
würdet	würdet
Speisen	Speisen
Gesellen	Gesellen
weiten	weiten
anzeige	anzeige
lehrest	lehrest
bat	bat
Schläge	Schläge
Raben	Raben
Bunde	Bunde
Rühmst	Rühmst
leer	leer
Gefäße	Gefäße
raubte	raubte
Stäbe	Stäbe
Arme	Arme
wohnte	wohnte
folgte	folgte
Bube	Bube
holet	holet
trotze	trotze
Garten	Garten
aufrichtet	aufrichtet
aber	aber
Wachen	Wachen
wilden	wilden
grünen	grünen
laute	laute
Neumonden	Neumonden
Schiffen	Schiffen
lobe	lobe
gerne	gerne
Löwen	Löwen
angehöret	angehöret
neigte	neigte
Tiere	Tiere
Streiten	Streiten
Schätze	Schätze
Wehe	Wehe
meinem	meinem
lassest	lassest
wild	wild
Kristalle	Kristalle
steige	steige
übrigbleibe	übrigbleibe
Worte	Worte
grüßet	grüßet
Röhren	Röhren
bewahret	bewahret
Eiche	Eiche
Testamenten	Testamenten
Orten	Orten
einführen	einführen
mußt	mußt
Stimme	Stimme
decket	decket
Hauen	Hauen
Säuen	Säuen
faule	faule
schweigen	schweigen
zerstreuest	zerstreuest
Kräften	Kräften
Königreichen	Königreichen
wolle	wolle
kämpfen	kämpfen
gelobst	gelobst
Wachet	Wachet
leider	leider
schlagt	schlagt
batet	batet
Lehnen	Lehnen
verstecke	verstecke
zürnte	zürnte
übrigbleibt	übrigbleibt
ungeistlichen	ungeistlichen
ehren	ehren
bessere	bessere
erfahret	erfahret
Weiß	Weiß
steckst	steckst
feiern	feiern
bleiben	bleiben
abweichest	abweichest
All	All
werde	werde
konnten	konnten
essen	essen
bekannte	bekannte
fresse	fresse
Schmieden	Schmieden
Zeugen	Zeugen
Unglaube	Unglaube
sündigten	sündigten
Huren	Huren
strafet	strafet
suche	suche
vermöget	vermöget
Sprüchen	Sprüchen
Kein	Kein
bekannt	bekannt
blitzen	blitzen
bereite	bereite
fließt	fließt
Jünglingen	Jünglingen
fressen	fressen
Basilisk	Basilisk
wechselte	wechselte
Den	Den
stoßet	stoßet
ehe	ehe
wiederkamen	wiederkamen
taufte	taufte
Narren	Narren
erweckst	erweckst
Danket	Danket
Linke	Linke
ausfuhr	ausfuhr
verbergt	verbergt
Predigt	Predigt
handhaben	handhaben
Schlägst	Schlägst
Mein	Mein
losen	losen
schießt	schießt
alle	alle
Jahren	Jahren
predigte	predigte
preise	preise
hinaufgehst	hinaufgehst
erbaust	erbaust
springen	springen
Höfe	Höfe
erzeigt	erzeigt
besuchen	besuchen
schämet	schämet
Rauben	Rauben
nötig	nötig
Tiefe	Tiefe
gebiete	gebiete
Tyrann	Tyrann
verkehrte	verkehrte
auflegst	auflegst
Leuchten	Leuchten
lachet	lachet
kurz	kurz
Wehre	Wehre
auszöge	auszöge
erntete	erntete
Wille	Wille
Könnt	Könnt
Türkis	Türkis
murmeln	murmeln
ihr	ihr
Folge	Folge
aufkommen	aufkommen
kennest	kennest
Wände	Wände
schmückst	schmückst
fragte	fragte
prüfet	prüfet
leide	leide
ehret	ehret
Wegen	Wegen
krähen	krähen
Drache	Drache
hatten	hatten
regte	regte
Ärgernisse	Ärgernisse
bemühst	bemühst
verdammten	verdammten
andere	andere
wirkst	wirkst
offenbar	offenbar
demütiget	demütiget
halben	halben
krähte	krähte
liebe	liebe
lose	lose
dienest	dienest
verwirrt	verwirrt
hättet	hättet
eure	eure
Meines	Meines
Entsetzen	Entsetzen
Grenze	Grenze
grüne	grüne
bis	bis
verwahret	verwahret
entsetzten	entsetzten
speiet	speiet
erwerbe	erwerbe
umkehrte	umkehrte
befestigten	befestigten
erzürnst	erzürnst
Dinge	Dinge
schlage	schlage
Anklage	Anklage
Banden	Banden
huren	huren
haderte	haderte
Gehör	Gehör
bekehrten	bekehrten
Äxte	Äxte
ladest	ladest
Briefen	Briefen
schmücket	schmücket
Gebote	Gebote
eingehet	eingehet
redete	redete
Könige	Könige
Fetten	Fetten
Ehren	Ehren
Arm	Arm
male	male
fallest	fallest
rühmst	rühmst
kehre	kehre
Empörung	Empörung
leihst	leihst
schonte	schonte
ander	ander
zerschlagt	zerschlagt
wacht	wacht
Hirschen	Hirschen
Gesetzen	Gesetzen
jedem	jedem
nehmet	nehmet
zerstückt	zerstückt
müßte	müßte
Tausenden	Tausenden
Keilen	Keilen
Warten	Warten
offenbare	offenbare
Buchstabe	Buchstabe
Gebeten	Gebeten
schnell	schnell
Willst	Willst
Riesen	Riesen
fälle	fälle
aufkommt	aufkommt
sollten	sollten
Rudern	Rudern
aufmachte	aufmachte
stiftete	stiftete
versucht	versucht
entgegenkamst	entgegenkamst
auflöste	auflöste
messen	messen
Städten	Städten
Ehre	Ehre
beweisest	beweisest
seien	seien
laufet	laufet
betrüge	betrüge
Essen	Essen
Seit	Seit
Tote	Tote
Neumonde	Neumonde
Tust	Tust
flucht	flucht
Orte	Orte
betrübt	betrübt
Anfechtungen	Anfechtungen
Urteil	Urteil
ermahnet	ermahnet
verlieren	verlieren
Laufen	Laufen
Strafen	Strafen
verliere	verliere
Stärket	Stärket
heilige	heilige
kranken	kranken
Fahret	Fahret
stoßest	stoßest
habet	habet
Reiche	Reiche
Maultier	Maultier
glaube	glaube
hauest	hauest
Ställe	Ställe
erweckest	erweckest
Gebet	Gebet
hingeht	hingeht
erhörest	erhörest
heißest	heißest
aufheben	aufheben
lauten	lauten
hausen	hausen
hebe	hebe
bekennet	bekennet
anzöge	anzöge
Frösche	Frösche
Ängste	Ängste
Aase	Aase
drücke	drücke
entgegenkamen	entgegenkamen
Gefängnissen	Gefängnissen
Kost	Kost
Sieben	Sieben
kaufet	kaufet
erlaubt	erlaubt
breche	breche
Kreuz	Kreuz
auflegt	auflegt
jagte	jagte
frevler	frevler
trauten	trauten
Klüfte	Klüfte
weisen	weisen
unseres	unseres
Blechen	Blechen
kaufst	kaufst
Fäuste	Fäuste
Welche	Welche
Fels	Fels
bange	bange
ratet	ratet
Früchten	Früchten
werden	werden
triebe	triebe
verzehrt	verzehrt
seinen	seinen
regieret	regieret
müsse	müsse
Zäume	Zäume
fragest	fragest
rede	rede
Menschen	Menschen
heiligem	heiligem
Morde	Morde
niemand	niemand
tragest	tragest
opfern	opfern
Frieden	Frieden
tust	tust
Meeren	Meeren
Ströme	Ströme
wert	wert
begehre	begehre
trotzest	trotzest
Bär	Bär
Deutungen	Deutungen
höhnte	höhnte
greifen	greifen
mahlen	mahlen
Rabe	Rabe
knüpfte	knüpfte
führte	führte
Setzet	Setzet
Klüften	Klüften
unschuldigen	unschuldigen
Ihr	Ihr
Eine	Eine
niemanden	niemanden
plagen	plagen
lüge	lüge
schenken	schenken
stillte	stillte
Klage	Klage
schießen	schießen
saget	saget
Ha	Ha
Älteste	Älteste
lehnen	lehnen
gehorchest	gehorchest
Abhängen	Abhängen
Götzen	Götzen
erschreckte	erschreckte
wirft	wirft
beharrt	beharrt
liebet	liebet
Brüste	Brüste
Speeren	Speeren
Winde	Winde
Ordnung	Ordnung
streuen	streuen
Stricke	Stricke
zerstückte	zerstückte
glaubest	glaubest
Zähnen	Zähnen
stimmen	stimmen
machte	machte
Tier	Tier
küsse	küsse
spalten	spalten
schweigst	schweigst
nahest	nahest
glühenden	glühenden
konntest	konntest
gedenkst	gedenkst
nötigte	nötigte
drückte	drückte
ärger	ärger
fluchte	fluchte
schätzte	schätzte
weich	weich
überführen	überführen
verbannt	verbannt
fließen	fließen
borgte	borgte
Hebe	Hebe
borgst	borgst
bang	bang
vertilgest	vertilgest
Gedanken	Gedanken
Söhnen	Söhnen
jauchzt	jauchzt
Schild	Schild
Sollst	Sollst
Hundert	Hundert
toten	toten
Gut	Gut
Spießen	Spießen
Erste	Erste
schweiget	schweiget
pflegst	pflegst
greife	greife
wegführe	wegführe
empörten	empörten
aufkäme	aufkäme
Auge	Auge
traut	traut
Meinst	Meinst
freiwilligen	freiwilligen
Rubine	Rubine
stäupte	stäupte
wahr	wahr
danket	danket
nimmt	nimmt
gefällst	gefällst
Seile	Seile
nützt	nützt
malen	malen
gewöhnt	gewöhnt
verstehet	verstehet
Kräfte	Kräfte
Stufen	Stufen
Rehen	Rehen
versuchst	versuchst
strecken	strecken
streute	streute
höhnest	höhnest
Sabbatjahre	Sabbatjahre
rufest	rufest
wahre	wahre
kämpfte	kämpfte
meinen	meinen
halten	halten
fastetest	fastetest
mangelte	mangelte
Solches	Solches
hassest	hassest
ringe	ringe
verliert	verliert
anrührte	anrührte
aßest	aßest
fünften	fünften
zürnest	zürnest
Binden	Binden
lang	lang
verziehe	verziehe
weide	weide
drängest	drängest
ratschlagte	ratschlagte
fahrest	fahrest
nährte	nährte
schenket	schenket
hätte	hätte
einnehmest	einnehmest
außen	außen
erzeigest	erzeigest
sterbt	sterbt
Weichet	Weichet
hauen	hauen
helfest	helfest
Aller	Aller
gleiche	gleiche
wohnest	wohnest
setzt	setzt
Betten	Betten
Toren	Toren
Hallen	Hallen
Sagen	Sagen
aufmacht	aufmacht
bleibet	bleibet
helft	helft
bestellt	bestellt
erfreuest	erfreuest
arme	arme
anders	anders
zerreißest	zerreißest
einem	einem
säume	säume
kaufest	kaufest
Leset	Leset
Strafe	Strafe
solche	solche
esse	esse
abweichet	abweichet
gedenkest	gedenkest
spielet	spielet
junge	junge
Anfechtung	Anfechtung
Heißt	Heißt
ausrufest	ausrufest
Leid	Leid
liege	liege
leget	leget
mögest	mögest
Weinberge	Weinberge
Schenken	Schenken
rauschte	rauschte
beider	beider
Stühlen	Stühlen
Trübsale	Trübsale
Reihe	Reihe
gehöre	gehöre
Einen	Einen
pflege	pflege
legest	legest
schätzen	schätzen
Diesen	Diesen
beschwert	beschwert
Maß	Maß
Gesell	Gesell
stehet	stehet
gelangte	gelangte
erforscht	erforscht
allen	allen
bauten	bauten
wehen	wehen
standet	standet
durchbohrt	durchbohrt
unsrer	unsrer
feierte	feierte
durchbohrte	durchbohrte
ausrichtest	ausrichtest
hörest	hörest
Male	Male
beschädigte	beschädigte
Seine	Seine
Griechen	Griechen
Rechten	Rechten
kaufte	kaufte
verstanden	verstanden
Mäusen	Mäusen
Letzten	Letzten
behalte	behalte
sollst	sollst
Leisten	Leisten
Führe	Führe
Töpfe	Töpfe
Gäste	Gäste
Seilen	Seilen
Ringen	Ringen
zeugst	zeugst
Taufen	Taufen
anzögen	anzögen
Regent	Regent
schöpfe	schöpfe
esset	esset
Welchen	Welchen
Werkzeugen	Werkzeugen
absagt	absagt
heißt	heißt
Winden	Winden
untergeht	untergeht
Meinet	Meinet
Briefe	Briefe
schreiben	schreiben
nähret	nähret
Maultieren	Maultieren
liebest	liebest
steiget	steiget
Pfeife	Pfeife
tuest	tuest
spracht	spracht
ehrst	ehrst
Habt	Habt
verwirft	verwirft
kein	kein
fasse	fasse
brause	brause
frevle	frevle
harret	harret
stäupten	stäupten
sprichst	sprichst
wollte	wollte
schmelzen	schmelzen
Hin	Hin
schreckt	schreckt
nachwandelst	nachwandelst
sorget	sorget
Stücken	Stücken
morden	morden
Ein	Ein
Lesen	Lesen
hoffte	hoffte
aufhebt	aufhebt
Habe	Habe
wegen	wegen
anruft	anruft
schläfst	schläfst
lieget	lieget
verlobte	verlobte
wirkte	wirkte
Buche	Buche
lesen	lesen
hasse	hasse
zuschließet	zuschließet
dingte	dingte
rufen	rufen
Schar	Schar
Jude	Jude
Wehen	Wehen
erdachten	erdachten
Held	Held
Ende	Ende
sorge	sorge
Töpfen	Töpfen
jeder	jeder
fragst	fragst
Sekte	Sekte
Glaubst	Glaubst
kurze	kurze
sonderte	sonderte
Spannt	Spannt
Licht	Licht
schwebte	schwebte
schenkst	schenkst
beschädigten	beschädigten
hieben	hieben
Speise	Speise
speist	speist
Lüste	Lüste
schmiert	schmiert
jedes	jedes
blenden	blenden
zeuge	zeuge
maßen	maßen
rüstete	rüstete
neigest	neigest
bestimmt	bestimmt
gelobte	gelobte
bedenken	bedenken
Säcken	Säcken
fünfte	fünfte
der	der
sorgen	sorgen
bitten	bitten
erlasset	erlasset
regierest	regierest
Zeugnissen	Zeugnissen
bracht	bracht
wünschte	wünschte
eher	eher
zerbrecht	zerbrecht
umkehret	umkehret
auszogen	auszogen
verstehst	verstehst
gebietet	gebietet
ausrichtet	ausrichtet
zerbrichst	zerbrichst
selber	selber
gehorcht	gehorcht
stimmte	stimmte
Dingen	Dingen
Solch	Solch
Für	Für
griffen	griffen
hieb	hieb
verbirgst	verbirgst
Äxten	Äxten
verhalte	verhalte
hineingeht	hineingeht
Geschäfte	Geschäfte
suchten	suchten
mühte	mühte
Lobgesänge	Lobgesänge
weiche	weiche
kriegte	kriegte
helle	helle
scheu	scheu
steckte	steckte
blasen	blasen
Eins	Eins
Steine	Steine
heilet	heilet
wärme	wärme
Waren	Waren
verstopften	verstopften
Taten	Taten
Pfeilen	Pfeilen
baust	baust
sorgte	sorgte
fresset	fresset
Klagen	Klagen
Fallt	Fallt
Helmen	Helmen
steigen	steigen
Eure	Eure
wachen	wachen
versteckt	versteckt
Fittichen	Fittichen
brauste	brauste
bekehret	bekehret
stäupt	stäupt
Feste	Feste
pflanzen	pflanzen
Suche	Suche
Gerät	Gerät
strafte	strafte
Weinstöcken	Weinstöcken
Buch	Buch
irgendeine	irgendeine
dienet	dienet
tobte	tobte
umbrächten	umbrächten
wurdet	wurdet
zudeckte	zudeckte
Gelobet	Gelobet
Schaffe	Schaffe
spaltete	spaltete
erhöht	erhöht
wunderte	wunderte
ersten	ersten
eile	eile
Quellen	Quellen
Palästen	Palästen
erwürget	erwürget
Ihre	Ihre
befestigt	befestigt
schau	schau
seist	seist
pflanzte	pflanzte
Ochse	Ochse
entsündigt	entsündigt
erhöhet	erhöhet
fahret	fahret
reichen	reichen
verkehrten	verkehrten
Tische	Tische
Fliegen	Fliegen
füllst	füllst
würze	würze
verstörten	verstörten
Unsere	Unsere
anrührt	anrührt
Binde	Binde
rühmet	rühmet
lieb	lieb
währet	währet
Bürden	Bürden
Bergen	Bergen
Satzung	Satzung
hinausgeht	hinausgeht
dürfe	dürfe
sitzet	sitzet
gelobt	gelobt
verlasset	verlasset
Felsen	Felsen
hineingehst	hineingehst
Füßen	Füßen
linken	linken
verkündigte	verkündigte
füllte	füllte
hatte	hatte
Geboten	Geboten
Säcke	Säcke
Ecke	Ecke
brauche	brauche
Trinkgefäßen	Trinkgefäßen
Wärt	Wärt
Reife	Reife
plagest	plagest
bekennt	bekennt
Kohle	Kohle
flehte	flehte
geboten	geboten
wohnst	wohnst
stellet	stellet
feierten	feierten
einernten	einernten
bricht	bricht
treibest	treibest
vergleiche	vergleiche
arbeiten	arbeiten
Mache	Mache
führet	führet
Amt	Amt
brichst	brichst
Herrn	Herrn
gibt	gibt
herrschest	herrschest
anzeigest	anzeigest
grünte	grünte
erbet	erbet
verkaufe	verkaufe
einführt	einführt
Elfen	Elfen
Blitzen	Blitzen
Leichnamen	Leichnamen
Anklagen	Anklagen
Maße	Maße
stahl	stahl
eins	eins
weinen	weinen
Stühle	Stühle
gedenket	gedenket
Alles	Alles
hadere	hadere
mehret	mehret
Suchet	Suchet
urteilte	urteilte
ältesten	ältesten
koche	koche
Wehr	Wehr
Eile	Eile
löset	löset
Wissen	Wissen
Mensch	Mensch
haben	haben
Monate	Monate
Einem	Einem
verfolgt	verfolgt
Leiche	Leiche
Fittiche	Fittiche
hasset	hasset
wach	wach
Märkten	Märkten
lobte	lobte
hieltest	hieltest
wundere	wundere
Reichen	Reichen
brechet	brechet
bedürfet	bedürfet
verklärt	verklärt
heiliget	heiliget
aufkämen	aufkämen
befestigte	befestigte
kommet	kommet
warnte	warnte
keine	keine
stürzt	stürzt
füllen	füllen
Feinden	Feinden
verschont	verschont
hebräischen	hebräischen
gesellt	gesellt
er	er
armen	armen
demütigst	demütigst
backt	backt
leite	leite
Lehne	Lehne
beschwören	beschwören
halbe	halbe
seine	seine
Anschlägen	Anschlägen
Ersten	Ersten
manche	manche
verzehre	verzehre
versteckst	versteckst
Gebete	Gebete
ritten	ritten
anrufen	anrufen
tobst	tobst
täuschte	täuschte
Teilen	Teilen
erbest	erbest
betrübte	betrübte
Wollt	Wollt
streite	streite
stiften	stiften
wünschet	wünschet
steinigst	steinigst
Quelle	Quelle
erwerben	erwerben
sitzen	sitzen
Zäumen	Zäumen
zerschlaget	zerschlaget
schöpfen	schöpfen
zerreißt	zerreißt
Gefäßen	Gefäßen
stoßt	stoßt
reizt	reizt
gewöhnte	gewöhnte
umkommt	umkommt
Speere	Speere
meine	meine
Grase	Grase
beseht	beseht
fliege	fliege
essest	essest
Feiertagen	Feiertagen
Weinen	Weinen
war	war
gebäret	gebäret
ausführte	ausführte
schlaft	schlaft
offenbart	offenbart
blast	blast
hilft	hilft
Gehörst	Gehörst
verkündiget	verkündiget
zerstreute	zerstreute
Träumen	Träumen
Büsche	Büsche
Willen	Willen
Heide	Heide
Teile	Teile
freute	freute
wiederkommst	wiederkommst
Gläubige	Gläubige
Tiefen	Tiefen
müßten	müßten
prüfest	prüfest
deckte	deckte
betrübst	betrübst
sündigte	sündigte
Samen	Samen
erniedrigst	erniedrigst
verderben	verderben
setzte	setzte
Recht	Recht
beschwöre	beschwöre
verzieht	verzieht
heilte	heilte
wollten	wollten
baue	baue
laben	laben
erkennet	erkennet
machet	machet
laufe	laufe
Rechte	Rechte
naht	naht
klaget	klaget
Machet	Machet
gebest	gebest
Bleibet	Bleibet
Maßen	Maßen
Bären	Bären
Füllet	Füllet
lehre	lehre
Ställen	Ställen
Dienst	Dienst
Wehklagen	Wehklagen
verstört	verstört
Werkzeuge	Werkzeuge
erste	erste
verziehst	verziehst
Heiden	Heiden
ungeistlich	ungeistlich
Bund	Bund
Füllen	Füllen
Geräte	Geräte
Geliebte	Geliebte
entsündigte	entsündigte
schwimmst	schwimmst
Söhne	Söhne
Rufe	Rufe
bewahrt	bewahrt
jauchzte	jauchzte
Gelobt	Gelobt
rufet	rufet
gebrauchte	gebrauchte
Feinde	Feinde
schauet	schauet
vier	vier
Wache	Wache
weinst	weinst
liebte	liebte
