отцах	отцах
лукавым	лукавым
забыли	забыли
мех	мех
нечистым	нечистым
золотого	золотого
явить	явить
уснуть	уснуть
бесноватым	бесноватым
составили	составили
посохом	посохом
мною	мною
жди	жди
серебре	серебре
поднял	поднял
оцепенении	оцепенении
разбудила	разбудила
имея	имея
озере	озере
вскормила	вскормила
рубили	рубили
имеете	имеете
отринь	отринь
стану	стану
Возлюбленный	Возлюбленный
тысячам	тысячам
рассвирепел	рассвирепел
мне	мне
восстать	восстать
наказывай	наказывай
знакомого	знакомого
научите	научите
весами	весами
искушали	искушали
ждали	ждали
подул	подул
победить	победить
наступив	наступив
взяло	взяло
Свой	Свой
купила	купила
дереве	дереве
померк	померк
пояса	пояса
поразить	поразить
замечать	замечать
показать	показать
невежды	невежды
твердая	твердая
чтили	чтили
постигла	постигла
вылитая	вылитая
Хвалите	Хвалите
отнимите	отнимите
прибыл	прибыл
считайте	считайте
спите	спите
сестрою	сестрою
восклицайте	восклицайте
простертая	простертая
фараону	фараону
Буду	Буду
покрывали	покрывали
приветствуй	приветствуй
убийством	убийством
поникли	поникли
призывать	призывать
скверною	скверною
утвердить	утвердить
показывай	показывай
мухе	мухе
возливать	возливать
бичом	бичом
покрывал	покрывал
испытывайте	испытывайте
убить	убить
осенила	осенила
полюби	полюби
совершили	совершили
приносить	приносить
таланту	таланту
помышляйте	помышляйте
молодую	молодую
мозгом	мозгом
остановили	остановили
подтверди	подтверди
оказать	оказать
своем	своем
мертво	мертво
столпе	столпе
оценить	оценить
воздали	воздали
случай	случай
налагать	налагать
страх	страх
возбуди	возбуди
обложили	обложили
вознеси	вознеси
жили	жили
строите	строите
поспешив	поспешив
тленного	тленного
золоте	золоте
меньше	меньше
звезда	звезда
думать	думать
потонуло	потонуло
дщери	дщери
принимала	принимала
Тысячу	Тысячу
затрубите	затрубите
меча	меча
какую	какую
чтить	чтить
благословила	благословила
доказать	доказать
исходит	исходит
пас	пас
выбрасывайте	выбрасывайте
померкло	померкло
бесславии	бесславии
мухи	мухи
кадила	кадила
выступив	выступив
бывшую	бывшую
столом	столом
обличить	обличить
скованный	скованный
одетого	одетого
выгнать	выгнать
отнесли	отнесли
погубить	погубить
пересказала	пересказала
жемчугом	жемчугом
убогие	убогие
расслабленным	расслабленным
болоте	болоте
научен	научен
имело	имело
можем	можем
получила	получила
натянуть	натянуть
читать	читать
напасти	напасти
рассказывай	рассказывай
птичку	птичку
предложить	предложить
растерзали	растерзали
госпожи	госпожи
безумным	безумным
Царя	Царя
внуши	внуши
жали	жали
тесните	тесните
овладеть	овладеть
принеси	принеси
посети	посети
похули	похули
разбудить	разбудить
уведомить	уведомить
сладкого	сладкого
затыкает	затыкает
Хочет	Хочет
возгласите	возгласите
богами	богами
можете	можете
Которой	Которой
низложи	низложи
человеческую	человеческую
могу	могу
страсть	страсть
паре	паре
возвестите	возвестите
Кис	Кис
напоминай	напоминай
доброю	доброю
свободные	свободные
прямые	прямые
легкие	легкие
устроить	устроить
исполним	исполним
переносит	переносит
землетрясением	землетрясением
лежите	лежите
теле	теле
низринь	низринь
Возьмет	Возьмет
преступить	преступить
изблюешь	изблюешь
заменили	заменили
малых	малых
одру	одру
собрали	собрали
пригласили	пригласили
скот	скот
появлением	появлением
призванных	призванных
перехватите	перехватите
снабдили	снабдили
собранным	собранным
негодованием	негодованием
ненавидели	ненавидели
высохли	высохли
смертные	смертные
сел	сел
покровом	покровом
Мне	Мне
учите	учите
подняла	подняла
научить	научить
води	води
Знайте	Знайте
находим	находим
согласного	согласного
призывали	призывали
доставляло	доставляло
попросили	попросили
почтили	почтили
любимое	любимое
предавали	предавали
спрятать	спрятать
хотите	хотите
продолжай	продолжай
возносите	возносите
скоту	скоту
забирать	забирать
образом	образом
страшного	страшного
учили	учили
Сене	Сене
добыче	добыче
подпали	подпали
оскорбляли	оскорбляли
лукавого	лукавого
вывело	вывело
помнили	помнили
выведите	выведите
нами	нами
пребывать	пребывать
наполняй	наполняй
призовем	призовем
обитая	обитая
Святом	Святом
волах	волах
бесчестить	бесчестить
изгонять	изгонять
почитаю	почитаю
тверда	тверда
похорони	похорони
сознаю	сознаю
дать	дать
ваш	ваш
возгласи	возгласи
изменит	изменит
желающий	желающий
удерживайте	удерживайте
собирать	собирать
следовать	следовать
укрепить	укрепить
сходи	сходи
божествах	божествах
обманула	обманула
точило	точило
посмеянием	посмеянием
любили	любили
помилуйте	помилуйте
покрывать	покрывать
приносили	приносили
нынешнем	нынешнем
искать	искать
семь	семь
сухой	сухой
помнила	помнила
горькая	горькая
сказывали	сказывали
веса	веса
Кому	Кому
скале	скале
убийцу	убийцу
найдем	найдем
одолеть	одолеть
истребите	истребите
козлу	козлу
принадлежащую	принадлежащую
слове	слове
манна	манна
откормленного	откормленного
правых	правых
всесожжении	всесожжении
голосом	голосом
узнают	узнают
тверды	тверды
напоили	напоили
Израильской	Израильской
восхотел	восхотел
вступили	вступили
испортите	испортите
условии	условии
узнали	узнали
звездам	звездам
льстить	льстить
любимую	любимую
рождать	рождать
приступить	приступить
языческой	языческой
первые	первые
унизить	унизить
наги	наги
сосчитайте	сосчитайте
топтать	топтать
чадо	чадо
слушало	слушало
одре	одре
отложи	отложи
велят	велят
убийца	убийца
ночевать	ночевать
сохранили	сохранили
братьями	братьями
звала	звала
хранили	хранили
развалинах	развалинах
завтрашнем	завтрашнем
оробели	оробели
родившая	родившая
раздирающий	раздирающий
скрытых	скрытых
разрывают	разрывают
попроси	попроси
претерпели	претерпели
снегом	снегом
царски	царски
смири	смири
располагая	располагая
отнятое	отнятое
вноси	вноси
отступив	отступив
поговорив	поговорив
слушай	слушай
имущества	имущества
заклятого	заклятого
приветствуют	приветствуют
рассмотри	рассмотри
обходили	обходили
Иудину	Иудину
главы	главы
молоти	молоти
разрушить	разрушить
был	был
убийстве	убийстве
покрывало	покрывало
медлить	медлить
объяснили	объяснили
козлами	козлами
рак	рак
избранный	избранный
беременною	беременною
пролить	пролить
полу	полу
тысяче	тысяче
открытом	открытом
управляй	управляй
преступлении	преступлении
пророчествуйте	пророчествуйте
открыт	открыт
главные	главные
свои	свои
открытых	открытых
пленным	пленным
разодрала	разодрала
начать	начать
враждовали	враждовали
пронзила	пронзила
жилищу	жилищу
сверкающий	сверкающий
Велик	Велик
принять	принять
мои	мои
оставляйте	оставляйте
обвязывать	обвязывать
разбирайте	разбирайте
переходите	переходите
ела	ела
отняли	отняли
язвах	язвах
хромой	хромой
схоронить	схоронить
почти	почти
неправ	неправ
чужая	чужая
хотела	хотела
покоился	покоился
новой	новой
потаенные	потаенные
возлюбите	возлюбите
Бела	Бела
ожить	ожить
черных	черных
скакали	скакали
пожелали	пожелали
восходили	восходили
благовествуйте	благовествуйте
губи	губи
предавать	предавать
разговаривал	разговаривал
злословить	злословить
отлучите	отлучите
известила	известила
первым	первым
смешанные	смешанные
нового	нового
презирали	презирали
города	города
святого	святого
Духом	Духом
рога	рога
Киса	Киса
спроси	спроси
посвящать	посвящать
сознает	сознает
произнесли	произнесли
Цари	Цари
проходить	проходить
заколите	заколите
веди	веди
родословных	родословных
преступите	преступите
блуждать	блуждать
заговорит	заговорит
двором	двором
платили	платили
бросили	бросили
посадили	посадили
восполнить	восполнить
роптали	роптали
уразумейте	уразумейте
труби	труби
избирали	избирали
похитить	похитить
сложили	сложили
никакой	никакой
дорогой	дорогой
обществе	обществе
возненавидели	возненавидели
саранче	саранче
веруйте	веруйте
отложите	отложите
приложите	приложите
жемчуга	жемчуга
священнодействовать	священнодействовать
познает	познает
позвали	позвали
истреби	истреби
претерпеть	претерпеть
творите	творите
сердечным	сердечным
выкупить	выкупить
отрезали	отрезали
отведи	отведи
целом	целом
делили	делили
возвестили	возвестили
последуйте	последуйте
подбирала	подбирала
утопает	утопает
оставляли	оставляли
приготовить	приготовить
оскудела	оскудела
раздражен	раздражен
теснить	теснить
уповать	уповать
возделывать	возделывать
лег	лег
изгнали	изгнали
белых	белых
зиму	зиму
любимая	любимая
немых	немых
разложили	разложили
одинокую	одинокую
жертву	жертву
святом	святом
видите	видите
уставом	уставом
досадовали	досадовали
узнаете	узнаете
заклятым	заклятым
глухие	глухие
стражами	стражами
погряз	погряз
вскорми	вскорми
домом	домом
наступить	наступить
повторите	повторите
искусили	искусили
умножили	умножили
взалкали	взалкали
жребии	жребии
возрос	возрос
половина	половина
возноси	возноси
уходите	уходите
защитить	защитить
превозмогли	превозмогли
затыкали	затыкали
выводи	выводи
нынешнему	нынешнему
жившая	жившая
глазу	глазу
изменила	изменила
приводите	приводите
поводом	поводом
считать	считать
открытую	открытую
подносят	подносят
отделите	отделите
замерло	замерло
предложили	предложили
пострадал	пострадал
возвратить	возвратить
наложите	наложите
стерегла	стерегла
взалкал	взалкал
воплем	воплем
добром	добром
взглянул	взглянул
нечистоту	нечистоту
людях	людях
выбросили	выбросили
Христе	Христе
протоки	протоки
подражали	подражали
открывайте	открывайте
бич	бич
разбила	разбила
головами	головами
повис	повис
признали	признали
сходила	сходила
пробыл	пробыл
небольшой	небольшой
согласные	согласные
разрывал	разрывал
рыдайте	рыдайте
ставить	ставить
избранная	избранная
оставила	оставила
возлюбленных	возлюбленных
исходили	исходили
пьющий	пьющий
напоить	напоить
приняли	приняли
леса	леса
овце	овце
крылом	крылом
левою	левою
звездах	звездах
ввела	ввела
лежали	лежали
какое	какое
пристал	пристал
воплю	воплю
безумных	безумных
послужив	послужив
стоите	стоите
разори	разори
образуем	образуем
саранчи	саранчи
творили	творили
управляющий	управляющий
старою	старою
точила	точила
птенцов	птенцов
дозволяй	дозволяй
сокрушить	сокрушить
уснули	уснули
раскрытую	раскрытую
судился	судился
худом	худом
запретить	запретить
сходите	сходите
показывали	показывали
твои	твои
молока	молока
сторожам	сторожам
наследуешь	наследуешь
восклицать	восклицать
вознегодовали	вознегодовали
сходим	сходим
Силе	Силе
утихли	утихли
выдай	выдай
неверным	неверным
тысячами	тысячами
разорили	разорили
своротила	своротила
пернатые	пернатые
вопроси	вопроси
выдавали	выдавали
имеем	имеем
обещать	обещать
обветшали	обветшали
избранных	избранных
главных	главных
поступили	поступили
поручен	поручен
Словом	Словом
малом	малом
вине	вине
раба	раба
томить	томить
извести	извести
устранить	устранить
разделила	разделила
преследовала	преследовала
помнить	помнить
выдавать	выдавать
заграждай	заграждай
наступите	наступите
внутреннему	внутреннему
повреди	повреди
надевать	надевать
злом	злом
страшное	страшное
возлюбили	возлюбили
пугал	пугал
воспитывала	воспитывала
созрела	созрела
сатаны	сатаны
свекровь	свекровь
строишь	строишь
числом	числом
внушили	внушили
левши	левши
поглотили	поглотили
предшествовали	предшествовали
нехороша	нехороша
выполняла	выполняла
посадить	посадить
рассказывали	рассказывали
очисти	очисти
сберегите	сберегите
побила	побила
отказывай	отказывай
нанять	нанять
называть	называть
напасть	напасть
Теми	Теми
топтали	топтали
второе	второе
смешанное	смешанное
половинах	половинах
убедили	убедили
уснул	уснул
свободным	свободным
юношах	юношах
тысячах	тысячах
овнами	овнами
достать	достать
силу	силу
похитила	похитила
выбрасывать	выбрасывать
мертвою	мертвою
желали	желали
всю	всю
отдала	отдала
хранить	хранить
пару	пару
открытое	открытое
сладкою	сладкою
пожалуй	пожалуй
пить	пить
молодого	молодого
взирать	взирать
которая	которая
предложи	предложи
мытаря	мытаря
разорить	разорить
вводить	вводить
заперли	заперли
половины	половины
суди	суди
богатый	богатый
захватить	захватить
страха	страха
вложи	вложи
натянули	натянули
глядеть	глядеть
откормленных	откормленных
испекла	испекла
святою	святою
Тысяча	Тысяча
рулем	рулем
рассмотрите	рассмотрите
чужое	чужое
берем	берем
выговори	выговори
восстановить	восстановить
убитого	убитого
сидеть	сидеть
жило	жило
желала	желала
похулили	похулили
дополните	дополните
бесчести	бесчести
почетных	почетных
уговаривать	уговаривать
змею	змею
сказывай	сказывай
преступили	преступили
принята	принята
онемело	онемело
святую	святую
строят	строят
выбросите	выбросите
нехороши	нехороши
строили	строили
жертве	жертве
окружите	окружите
пристали	пристали
пища	пища
скотом	скотом
Лазарь	Лазарь
Благословите	Благословите
отвозят	отвозят
устройстве	устройстве
выводить	выводить
выливайте	выливайте
жив	жив
пленных	пленных
мешки	мешки
изменили	изменили
Благо	Благо
лишили	лишили
имуществом	имуществом
мутить	мутить
которое	которое
умирать	умирать
Твою	Твою
благом	благом
возделывали	возделывали
напоен	напоен
потерпела	потерпела
бегу	бегу
ищи	ищи
обе	обе
избавляйте	избавляйте
устраните	устраните
разбросали	разбросали
молчали	молчали
заставить	заставить
произноси	произноси
покрывала	покрывала
родят	родят
избранной	избранной
твоем	твоем
Приветствуют	Приветствуют
оплакивала	оплакивала
благодарив	благодарив
взирали	взирали
выказать	выказать
разграбили	разграбили
окончила	окончила
ели	ели
проходили	проходили
велик	велик
отпирали	отпирали
перемените	перемените
граде	граде
камня	камня
пленные	пленные
ослабеть	ослабеть
плачу	плачу
образовали	образовали
землетрясении	землетрясении
любите	любите
снохи	снохи
иссохли	иссохли
онемеешь	онемеешь
выкупи	выкупи
Свои	Свои
твердою	твердою
духовным	духовным
рта	рта
приклонить	приклонить
возбудить	возбудить
простирай	простирай
вонзили	вонзили
превозносите	превозносите
называли	называли
мешке	мешке
обманывай	обманывай
жертвою	жертвою
зарыдали	зарыдали
мучился	мучился
выбежал	выбежал
отягощай	отягощай
будут	будут
правым	правым
выпало	выпало
предупреди	предупреди
язвы	язвы
поворотить	поворотить
воспойте	воспойте
дала	дала
городом	городом
скрепите	скрепите
черпать	черпать
хвали	хвали
извратили	извратили
написанные	написанные
Начала	Начала
ударила	ударила
добре	добре
начала	начала
сделали	сделали
посмеянии	посмеянии
благочестием	благочестием
Хвали	Хвали
поддерживала	поддерживала
быть	быть
перестал	перестал
разрешите	разрешите
срубить	срубить
язвами	язвами
учить	учить
тысячу	тысячу
горькие	горькие
привозить	привозить
ночное	ночное
владычествовать	владычествовать
торгу	торгу
разбогатеть	разбогатеть
числе	числе
исправить	исправить
опьянел	опьянел
протоках	протоках
ином	ином
сопровождали	сопровождали
литое	литое
привела	привела
смотрите	смотрите
учи	учи
привезли	привезли
варили	варили
орудием	орудием
путевые	путевые
завещаю	завещаю
онемеют	онемеют
блаженного	блаженного
всякая	всякая
выносили	выносили
дворе	дворе
старейшины	старейшины
открыли	открыли
знакомых	знакомых
убили	убили
сделанный	сделанный
объяснить	объяснить
напоминать	напоминать
находила	находила
твердое	твердое
крестился	крестился
духом	духом
разбит	разбит
были	были
ворона	ворона
поя	поя
распростерла	распростерла
возливайте	возливайте
смертного	смертного
заграждали	заграждали
глядели	глядели
Галилейской	Галилейской
опротивел	опротивел
окружить	окружить
сотвори	сотвори
могут	могут
ослабели	ослабели
правого	правого
сокрушили	сокрушили
Тиром	Тиром
погубите	погубите
приложить	приложить
пара	пара
утих	утих
малый	малый
приступив	приступив
верить	верить
подняли	подняли
схватила	схватила
определить	определить
прогоните	прогоните
исцеляйте	исцеляйте
дозволяйте	дозволяйте
откажи	откажи
благодарили	благодарили
пребыл	пребыл
убитые	убитые
брани	брани
твой	твой
пробыли	пробыли
переходит	переходит
платить	платить
свекрови	свекрови
представляла	представляла
налагала	налагала
разорите	разорите
две	две
уразуметь	уразуметь
изгнать	изгнать
погрешили	погрешили
приказывали	приказывали
насадила	насадила
окончили	окончили
срубили	срубили
Который	Который
тверд	тверд
избавить	избавить
возлюбленной	возлюбленной
человеческой	человеческой
взыскать	взыскать
отыщи	отыщи
убитых	убитых
вешать	вешать
правый	правый
спешить	спешить
отнял	отнял
рассеянный	рассеянный
ввели	ввели
передвигай	передвигай
огорчить	огорчить
цари	цари
Стань	Стань
скованного	скованного
увели	увели
козлах	козлах
свари	свари
помни	помни
преследовали	преследовали
лукавых	лукавых
посрами	посрами
познайте	познайте
славила	славила
войске	войске
вспоминай	вспоминай
взять	взять
поглотить	поглотить
лица	лица
внимали	внимали
сбить	сбить
принятые	принятые
вам	вам
сокруши	сокруши
бесноватых	бесноватых
пали	пали
страшных	страшных
приехал	приехал
змеи	змеи
растворить	растворить
прогони	прогони
белый	белый
находят	находят
возлагать	возлагать
исследовать	исследовать
множеством	множеством
можешь	можешь
написать	написать
избирай	избирай
призванный	призванный
сей	сей
творить	творить
воздухе	воздухе
простертым	простертым
возьмешь	возьмешь
унывайте	унывайте
любить	любить
имущество	имущество
головах	головах
проходит	проходит
разводить	разводить
имейте	имейте
намерен	намерен
благословите	благословите
начало	начало
обгорелою	обгорелою
выкопали	выкопали
торжествуйте	торжествуйте
губить	губить
похороните	похороните
хулить	хулить
принят	принят
приходить	приходить
тестом	тестом
Свою	Свою
умерщвляй	умерщвляй
предавала	предавала
век	век
приветствовал	приветствовал
выи	выи
Раба	Раба
расслабленный	расслабленный
возросли	возросли
собранный	собранный
открывай	открывай
внуки	внуки
подстерегали	подстерегали
затрепетал	затрепетал
Твои	Твои
блаженных	блаженных
скрывай	скрывай
опусти	опусти
заговоришь	заговоришь
переменить	переменить
садили	садили
признать	признать
прямых	прямых
столп	столп
поцелуй	поцелуй
ослепила	ослепила
искушать	искушать
имеющий	имеющий
жилой	жилой
будешь	будешь
страшные	страшные
наняли	наняли
плечом	плечом
разным	разным
сосчитать	сосчитать
доводит	доводит
даруй	даруй
чужого	чужого
ослабела	ослабела
спрашивай	спрашивай
отгадать	отгадать
испытанного	испытанного
исправлять	исправлять
внука	внука
полированную	полированную
значить	значить
двумя	двумя
яви	яви
проезжал	проезжал
заплати	заплати
развязала	развязала
украсить	украсить
благословлять	благословлять
крестишь	крестишь
открывали	открывали
воздала	воздала
разводите	разводите
пленный	пленный
потаенных	потаенных
открытым	открытым
отнесла	отнесла
чудовища	чудовища
словом	словом
духу	духу
молодая	молодая
золотой	золотой
познаешь	познаешь
познаете	познаете
умертви	умертви
преступлением	преступлением
хулили	хулили
срамили	срамили
мала	мала
святые	святые
Соляной	Соляной
уразумел	уразумел
скорую	скорую
рассуждали	рассуждали
зеленого	зеленого
отягощали	отягощали
ходили	ходили
духам	духам
прославить	прославить
отменить	отменить
запрети	запрети
умышлять	умышлять
Знаем	Знаем
поверили	поверили
обещали	обещали
золотою	золотою
умертвите	умертвите
исходят	исходят
ничтожества	ничтожества
возлюбленный	возлюбленный
сухую	сухую
одолело	одолело
отвели	отвели
крыло	крыло
порядку	порядку
детях	детях
Сия	Сия
навыком	навыком
сруби	сруби
положите	положите
одолела	одолела
призвать	призвать
простерли	простерли
дало	дало
честные	честные
мучили	мучили
посылала	посылала
негодовании	негодовании
отделили	отделили
продолжали	продолжали
одолели	одолели
припал	припал
покройте	покройте
допускать	допускать
членом	членом
смешанной	смешанной
литых	литых
избранным	избранным
Апостол	Апостол
Которого	Которого
отказывал	отказывал
оных	оных
видимою	видимою
совратить	совратить
подняты	подняты
сосчитай	сосчитай
приклонили	приклонили
голодный	голодный
оказала	оказала
нага	нага
произносили	произносили
позвала	позвала
удивлении	удивлении
произнеси	произнеси
Сделай	Сделай
больным	больным
написанных	написанных
скрывала	скрывала
освятите	освятите
отвозили	отвозили
прилагать	прилагать
мечу	мечу
отошлите	отошлите
одет	одет
погреби	погреби
пою	пою
граду	граду
засели	засели
изливайте	изливайте
стояли	стояли
твоя	твоя
распростерли	распростерли
неверен	неверен
подвиг	подвиг
станом	станом
отвори	отвори
этой	этой
Ханаанскою	Ханаанскою
повод	повод
считай	считай
рогом	рогом
разделите	разделите
внимать	внимать
возвестила	возвестила
большая	большая
погуби	погуби
завладеть	завладеть
сатану	сатану
ним	ним
бел	бел
разгласили	разгласили
познают	познают
благослови	благослови
оплакивали	оплакивали
неправы	неправы
блудила	блудила
обитать	обитать
множестве	множестве
обманывайте	обманывайте
Моем	Моем
узнай	узнай
свитком	свитком
слепой	слепой
поднять	поднять
читали	читали
пило	пило
освободи	освободи
значила	значила
говорить	говорить
перейди	перейди
большом	большом
прислуги	прислуги
служанке	служанке
срамить	срамить
отсчитайте	отсчитайте
дохни	дохни
прибавлять	прибавлять
верха	верха
принесли	принесли
чудное	чудное
полы	полы
роптать	роптать
переходи	переходи
мог	мог
поступить	поступить
молоком	молоком
избивать	избивать
уходить	уходить
святых	святых
изнеженных	изнеженных
перестать	перестать
уменьшить	уменьшить
вспомнили	вспомнили
наполнить	наполнить
козлы	козлы
выслушать	выслушать
затрубили	затрубили
последовать	последовать
беременным	беременным
хочу	хочу
Возлюбленного	Возлюбленного
сделать	сделать
нечистота	нечистота
река	река
облаке	облаке
приучили	приучили
огорчили	огорчили
владеть	владеть
матери	матери
языку	языку
принудить	принудить
одержимого	одержимого
чудные	чудные
лице	лице
узнаешь	узнаешь
бесноватого	бесноватого
жилищах	жилищах
рассуждать	рассуждать
голодного	голодного
упросила	упросила
вносить	вносить
простирала	простирала
растила	растила
Начало	Начало
языке	языке
страдающий	страдающий
брак	брак
животным	животным
льстили	льстили
оставляй	оставляй
бога	бога
живого	живого
глазом	глазом
легкое	легкое
позавидовали	позавидовали
поднято	поднято
восполнили	восполнили
опьянейте	опьянейте
поручи	поручи
хулите	хулите
целого	целого
облегчи	облегчи
всяком	всяком
наши	наши
пострадать	пострадать
расположили	расположили
жала	жала
повторили	повторили
венце	венце
замышляй	замышляй
растянули	растянули
спорили	спорили
живой	живой
убийцы	убийцы
проси	проси
взывайте	взывайте
сравните	сравните
опустошен	опустошен
приняты	приняты
допустили	допустили
будете	будете
духовных	духовных
вызывать	вызывать
сотворила	сотворила
вином	вином
заплатите	заплатите
нечестии	нечестии
Аду	Аду
беременной	беременной
поникло	поникло
трубили	трубили
прославлять	прославлять
среды	среды
намерены	намерены
воскликнул	воскликнул
голодные	голодные
мертвым	мертвым
содержите	содержите
скалу	скалу
открытою	открытою
отходят	отходят
мучить	мучить
велико	велико
обольстили	обольстили
проводили	проводили
трава	трава
тайна	тайна
предстал	предстал
язычески	язычески
испортили	испортили
варить	варить
убитой	убитой
пьяные	пьяные
доходит	доходит
отступите	отступите
помилуй	помилуй
всякою	всякою
отпустила	отпустила
потерпели	потерпели
перехватили	перехватили
показывать	показывать
пути	пути
красный	красный
умертвила	умертвила
Твоя	Твоя
два	два
мертвых	мертвых
ртом	ртом
сейте	сейте
прокаженных	прокаженных
населенного	населенного
вызывали	вызывали
оказывай	оказывай
великою	великою
познала	познала
пьяный	пьяный
замечайте	замечайте
укрепляй	укрепляй
слепые	слепые
сторож	сторож
верх	верх
жилищами	жилищами
слушать	слушать
стояла	стояла
спали	спали
разрушили	разрушили
купить	купить
легли	легли
исполни	исполни
позавидовал	позавидовал
Иудин	Иудин
подвигли	подвигли
почитайте	почитайте
великой	великой
твари	твари
осмолила	осмолила
очистите	очистите
темных	темных
Какой	Какой
коленом	коленом
соорудили	соорудили
пожалели	пожалели
страшилищ	страшилищ
белом	белом
произвела	произвела
которой	которой
утверди	утверди
прибыли	прибыли
храни	храни
откройте	откройте
влекли	влекли
восстали	восстали
заразою	заразою
прославляли	прославляли
доставить	доставить
Сделали	Сделали
хоронили	хоронили
бабке	бабке
саранчу	саранчу
схватили	схватили
уступи	уступи
искало	искало
избить	избить
принимай	принимай
судили	судили
поспешили	поспешили
устрашили	устрашили
столах	столах
молодым	молодым
смело	смело
чужие	чужие
утвердили	утвердили
разговаривают	разговаривают
бесславием	бесславием
гола	гола
отпускать	отпускать
пронзить	пронзить
поношением	поношением
фараон	фараон
спустила	спустила
отходили	отходили
раздирать	раздирать
осадили	осадили
владычествовали	владычествовали
странствующий	странствующий
выбери	выбери
управляли	управляли
стеснили	стеснили
испытывали	испытывали
влез	влез
восемь	восемь
обратила	обратила
привезла	привезла
долга	долга
обратить	обратить
Духу	Духу
предсказывайте	предсказывайте
сожги	сожги
страдать	страдать
венца	венца
реки	реки
саранчою	саранчою
пророчествуй	пророчествуй
попускаете	попускаете
одинокою	одинокою
написанного	написанного
злаков	злаков
сынах	сынах
провозгласили	провозгласили
торга	торга
немой	немой
наложили	наложили
держите	держите
омывали	омывали
отослали	отослали
обирал	обирал
подражайте	подражайте
находили	находили
отнята	отнята
укрепите	укрепите
гусеница	гусеница
ночного	ночного
Дину	Дину
реке	реке
мысли	мысли
среду	среду
стоит	стоит
родит	родит
аспиды	аспиды
приобрела	приобрела
пустую	пустую
Воздайте	Воздайте
преподала	преподала
снисходите	снисходите
возлюбленную	возлюбленную
побивали	побивали
прославили	прославили
осматривали	осматривали
пили	пили
положила	положила
наполнила	наполнила
представлять	представлять
ослепили	ослепили
принудили	принудили
позвать	позвать
положили	положили
подходить	подходить
страшилищем	страшилищем
чудных	чудных
Богом	Богом
Слушайте	Слушайте
войском	войском
обольстить	обольстить
дополнить	дополнить
приношением	приношением
осади	осади
обманули	обманули
возносили	возносили
исправили	исправили
нашли	нашли
воевать	воевать
добыча	добыча
вступите	вступите
юноше	юноше
умирающий	умирающий
написали	написали
стоишь	стоишь
поверить	поверить
Нем	Нем
отнято	отнято
кругу	кругу
почитать	почитать
голубого	голубого
сварили	сварили
лицо	лицо
рождайте	рождайте
утаить	утаить
убитым	убитым
принесло	принесло
сверкали	сверкали
оскудели	оскудели
блудить	блудить
преследуйте	преследуйте
посвятили	посвятили
празднуйте	празднуйте
жабах	жабах
ослабевать	ослабевать
приходите	приходите
увещевай	увещевай
Мои	Мои
изгоняли	изгоняли
распознает	распознает
восхвалили	восхвалили
раскрытая	раскрытая
посылать	посылать
пожалел	пожалел
победит	победит
выслушали	выслушали
входите	входите
большую	большую
письме	письме
искусить	искусить
причинили	причинили
камнем	камнем
сухая	сухая
изнеженная	изнеженная
молодые	молодые
преподать	преподать
воротился	воротился
растерзать	растерзать
сокрытой	сокрытой
насади	насади
белые	белые
страхом	страхом
Одно	Одно
Реву	Реву
осадить	осадить
поместить	поместить
богам	богам
повредили	повредили
призванным	призванным
отвалят	отвалят
говори	говори
богов	богов
всходили	всходили
стеснен	стеснен
смешанный	смешанный
поправили	поправили
кормила	кормила
называй	называй
пил	пил
растянула	растянула
грешите	грешите
исходила	исходила
простите	простите
сковали	сковали
Матери	Матери
Это	Это
соляным	соляным
дома	дома
вызывающий	вызывающий
обесчестили	обесчестили
упоминать	упоминать
нечиста	нечиста
изливали	изливали
изменить	изменить
жаб	жаб
обирай	обирай
воскури	воскури
вытрут	вытрут
расслабленных	расслабленных
вину	вину
откажу	откажу
избавили	избавили
литого	литого
Которым	Которым
бедного	бедного
сошло	сошло
извратить	извратить
постиг	постиг
садите	садите
бесовскую	бесовскую
садился	садился
трогать	трогать
беззаконии	беззаконии
немало	немало
пропало	пропало
приветствуйте	приветствуйте
морскую	морскую
упросить	упросить
приняла	приняла
сирот	сирот
выводили	выводили
невеждам	невеждам
воздать	воздать
выступили	выступили
просили	просили
постыдить	постыдить
бесчестили	бесчестили
болотом	болотом
заходи	заходи
судите	судите
морем	морем
начерпали	начерпали
выстроили	выстроили
девяноста	девяноста
чад	чад
послужили	послужили
воздай	воздай
камни	камни
отводили	отводили
требуйте	требуйте
счета	счета
выдавайте	выдавайте
поднимите	поднимите
питали	питали
приступили	приступили
объедал	объедал
выходила	выходила
победили	победили
тайны	тайны
нечистой	нечистой
держали	держали
растаяло	растаяло
последуй	последуй
добра	добра
пригласи	пригласи
похоронен	похоронен
пример	пример
возвысили	возвысили
овну	овну
читай	читай
тьмы	тьмы
исправляли	исправляли
потускли	потускли
наклони	наклони
воздайте	воздайте
заключила	заключила
вымерла	вымерла
аспидов	аспидов
прямой	прямой
остановила	остановила
смутить	смутить
Нему	Нему
отвалит	отвалит
погрязли	погрязли
назвала	назвала
стража	стража
лицах	лицах
открой	открой
Ком	Ком
снимите	снимите
сложить	сложить
воспитанный	воспитанный
умоляй	умоляй
доводите	доводите
продать	продать
человеческою	человеческою
отцов	отцов
стражи	стражи
Дина	Дина
вводили	вводили
прибыла	прибыла
противостал	противостал
выказала	выказала
приехали	приехали
твою	твою
живые	живые
сим	сим
удерживай	удерживай
гусеницы	гусеницы
заколи	заколи
ненадежно	ненадежно
подкрепить	подкрепить
обольстила	обольстила
возлюбленною	возлюбленною
ходите	ходите
отвратить	отвратить
запрудите	запрудите
лизали	лизали
царю	царю
допускали	допускали
объяви	объяви
которых	которых
били	били
пожирать	пожирать
выходят	выходят
заменим	заменим
Твоем	Твоем
пожелал	пожелал
нему	нему
всесожжением	всесожжением
жилищ	жилищ
возьмете	возьмете
образу	образу
уверен	уверен
начале	начале
исчисли	исчисли
развалинам	развалинам
Одного	Одного
возливала	возливала
села	села
простертою	простертою
решите	решите
управлять	управлять
глухою	глухою
Одни	Одни
носили	носили
меньшая	меньшая
новым	новым
вари	вари
доносят	доносят
переходили	переходили
сказало	сказало
наложить	наложить
никакого	никакого
рассуди	рассуди
налагали	налагали
чужую	чужую
влезли	влезли
рада	рада
запрудили	запрудили
живою	живою
голоса	голоса
добычу	добычу
затрепетали	затрепетали
нарушили	нарушили
скал	скал
член	член
выговорить	выговорить
скалами	скалами
дохну	дохну
отвален	отвален
лгите	лгите
завладел	завладел
Господнем	Господнем
скрепить	скрепить
выросли	выросли
силе	силе
положен	положен
убеди	убеди
жертвам	жертвам
ходить	ходить
видимо	видимо
встать	встать
заключить	заключить
рой	рой
серебром	серебром
благословили	благословили
заходить	заходить
повороти	повороти
Можете	Можете
служили	служили
производили	производили
объясни	объясни
твердо	твердо
подумали	подумали
черные	черные
воззовем	воззовем
убит	убит
соляною	соляною
погубили	погубили
перерезали	перерезали
благословляйте	благословляйте
простираете	простираете
горькою	горькою
умер	умер
отняты	отняты
сатане	сатане
посвятите	посвятите
провозгласить	провозгласить
произошли	произошли
сокрыт	сокрыт
приняло	приняло
наскучили	наскучили
развалиною	развалиною
вынесли	вынесли
отсеки	отсеки
злак	злак
одинокая	одинокая
заключите	заключите
пленили	пленили
благодарите	благодарите
темным	темным
духовные	духовные
спорите	спорите
потерянною	потерянною
Израилеву	Израилеву
выслушай	выслушай
имевшая	имевшая
обозрели	обозрели
садить	садить
одетым	одетым
сделало	сделало
молите	молите
немого	немого
образа	образа
даровать	даровать
лев	лев
удалить	удалить
неверных	неверных
предсказывали	предсказывали
замер	замер
овцою	овцою
ожесточи	ожесточи
уходит	уходит
скверны	скверны
птичка	птичка
подкрепите	подкрепите
Боге	Боге
варите	варите
преуспевать	преуспевать
появлении	появлении
утомленных	утомленных
кадить	кадить
пухла	пухла
осквернила	осквернила
поникла	поникла
произносите	произносите
отсекли	отсекли
пой	пой
возвратите	возвратите
тысяча	тысяча
замышляли	замышляли
оставили	оставили
нагой	нагой
исполнила	исполнила
зимой	зимой
зло	зло
голодных	голодных
хоронить	хоронить
молился	молился
громом	громом
берет	берет
выведи	выведи
признаешь	признаешь
сему	сему
обозреть	обозреть
лгали	лгали
почитали	почитали
пребывайте	пребывайте
тени	тени
Был	Был
отнятых	отнятых
наставили	наставили
уповали	уповали
вывез	вывез
Своем	Своем
навестить	навестить
спрятала	спрятала
какой	какой
объясним	объясним
замолчу	замолчу
красоты	красоты
рыдать	рыдать
Святых	Святых
уведомили	уведомили
вопросить	вопросить
дерзновением	дерзновением
содержали	содержали
подтвердить	подтвердить
желало	желало
мой	мой
понять	понять
призывайте	призывайте
образ	образ
язвам	язвам
Душа	Душа
пропали	пропали
выпал	выпал
пасли	пасли
носильщиками	носильщиками
Дан	Дан
больные	больные
преданный	преданный
горькой	горькой
затворили	затворили
считал	считал
блуждали	блуждали
вынеси	вынеси
отсек	отсек
нашу	нашу
исполнили	исполнили
пересказывать	пересказывать
нам	нам
исчислить	исчислить
известили	известили
научи	научи
кадили	кадили
Приветствует	Приветствует
приветствующий	приветствующий
духи	духи
смешанною	смешанною
обгорела	обгорела
строить	строить
начал	начал
исследуйте	исследуйте
простирает	простирает
издерживали	издерживали
сокрытую	сокрытую
никакою	никакою
заперла	заперла
срубите	срубите
воспрепятствовали	воспрепятствовали
отличить	отличить
новое	новое
поясом	поясом
второю	второю
будем	будем
вина	вина
обрезывали	обрезывали
уменьши	уменьши
разделить	разделить
благую	благую
мстить	мстить
пишем	пишем
предложила	предложила
гусенице	гусенице
сердечной	сердечной
превознесем	превознесем
охраняй	охраняй
захватила	захватила
Вила	Вила
тварь	тварь
хотим	хотим
показали	показали
увеличили	увеличили
доставили	доставили
чем	чем
уговори	уговори
выдать	выдать
забирали	забирали
петля	петля
бедные	бедные
возвестим	возвестим
прогнать	прогнать
торжествуй	торжествуй
исцеляла	исцеляла
заключи	заключи
одушевленное	одушевленное
обирать	обирать
приводили	приводили
стерегли	стерегли
осудили	осудили
верили	верили
выходите	выходите
хочет	хочет
напоминайте	напоминайте
яме	яме
слезу	слезу
окропи	окропи
вешали	вешали
животные	животные
грешили	грешили
начертали	начертали
подули	подули
низкою	низкою
обгорел	обгорел
стояло	стояло
оказывали	оказывали
проходите	проходите
сироты	сироты
воевали	воевали
овладел	овладел
беременных	беременных
выполняйте	выполняйте
переходят	переходят
сотворите	сотворите
жертва	жертва
проходила	проходила
страсти	страсти
объявила	объявила
враждовать	враждовать
связанного	связанного
унизили	унизили
пустою	пустою
возвратили	возвратили
пожалело	пожалело
произвело	произвело
выдавай	выдавай
одела	одела
обвинить	обвинить
питай	питай
будь	будь
Этого	Этого
своротить	своротить
зла	зла
сими	сими
образовала	образовала
восстановим	восстановим
молили	молили
посмотрите	посмотрите
рабы	рабы
проток	проток
онемел	онемел
отстали	отстали
обладайте	обладайте
прозрели	прозрели
молодых	молодых
освятить	освятить
низложить	низложить
сделанной	сделанной
замолчи	замолчи
золото	золото
отнятого	отнятого
скрыли	скрыли
высох	высох
матерь	матерь
спрашивали	спрашивали
выслать	выслать
вырос	вырос
пребыло	пребыло
заплатить	заплатить
Возлюбленном	Возлюбленном
надел	надел
животное	животное
черный	черный
слышим	слышим
Сию	Сию
успокоить	успокоить
потом	потом
жернова	жернова
устроен	устроен
раздирайте	раздирайте
этого	этого
смотри	смотри
голубой	голубой
родившие	родившие
облаком	облаком
исполнить	исполнить
убийце	убийце
терпите	терпите
накормили	накормили
глухого	глухого
изделием	изделием
черного	черного
нехорош	нехорош
черным	черным
сторожу	сторожу
пойте	пойте
омыть	омыть
пересказывай	пересказывай
носите	носите
белою	белою
засохло	засохло
узнаю	узнаю
забыла	забыла
теснился	теснился
стоим	стоим
левша	левша
уха	уха
отстать	отстать
славить	славить
умерли	умерли
провозгласите	провозгласите
живым	живым
спешите	спешите
кровопролитием	кровопролитием
овладели	овладели
раскинули	раскинули
спросите	спросите
влекло	влекло
сказала	сказала
почетного	почетного
оцепенением	оцепенением
перестали	перестали
возливай	возливай
верующий	верующий
хромые	хромые
аспида	аспида
почернели	почернели
одушевленных	одушевленных
мстите	мстите
помет	помет
подносить	подносить
любила	любила
Галилейскую	Галилейскую
Иудиной	Иудиной
раздражить	раздражить
выходили	выходили
разодрали	разодрали
горд	горд
одною	одною
трогай	трогай
тьме	тьме
празднуй	празднуй
разбить	разбить
обличи	обличи
прислугу	прислугу
искушай	искушай
воспела	воспела
блаженный	блаженный
успокоили	успокоили
отведите	отведите
пьяных	пьяных
проводите	проводите
глядела	глядела
поразили	поразили
распознать	распознать
объявили	объявили
сестры	сестры
начертай	начертай
первых	первых
обществом	обществом
сковать	сковать
добыч	добыч
засохла	засохла
деревом	деревом
преданного	преданного
подпал	подпал
спросила	спросила
отпали	отпали
просить	просить
бедных	бедных
новорожденного	новорожденного
верху	верху
осветила	осветила
поправить	поправить
желчи	желчи
родишь	родишь
каплют	каплют
замедлить	замедлить
пьяным	пьяным
берег	берег
тельцам	тельцам
соорудить	соорудить
схоронили	схоронили
ввело	ввело
служи	служи
заключили	заключили
написанное	написанное
призвали	призвали
созвали	созвали
произносить	произносить
твердые	твердые
малое	малое
спустили	спустили
написала	написала
сатаною	сатаною
гумном	гумном
миновали	миновали
поступите	поступите
Какое	Какое
сказывайте	сказывайте
забытых	забытых
царях	царях
какая	какая
почитаете	почитаете
подходите	подходите
Богу	Богу
получить	получить
града	града
искали	искали
умолять	умолять
поселить	поселить
держу	держу
Дине	Дине
умерщвляйте	умерщвляйте
которую	которую
страдали	страдали
женщиною	женщиною
переносить	переносить
отошли	отошли
увела	увела
подарили	подарили
уходят	уходят
кругом	кругом
старых	старых
призвала	призвала
Велики	Велики
вопрошали	вопрошали
отложили	отложили
располагает	располагает
впал	впал
золотом	золотом
объявите	объявите
горды	горды
призови	призови
утихло	утихло
подкрепили	подкрепили
прославляй	прославляй
одержимая	одержимая
ними	ними
безумные	безумные
продали	продали
истребить	истребить
опустошили	опустошили
отплыл	отплыл
простираешь	простираешь
увещевали	увещевали
получите	получите
свободный	свободный
бабки	бабки
целовали	целовали
мало	мало
старого	старого
отмени	отмени
иных	иных
укреплять	укреплять
выстрелили	выстрелили
скакать	скакать
доставляй	доставляй
ожидали	ожидали
возлюбленные	возлюбленные
приноси	приноси
родным	родным
обвязывай	обвязывай
простирал	простирал
сохрани	сохрани
второй	второй
служила	служила
оказывать	оказывать
приклони	приклони
уходи	уходи
проходи	проходи
отнеси	отнеси
расположи	расположи
тайною	тайною
понесло	понесло
отказать	отказать
испытанный	испытанный
наливай	наливай
окончи	окончи
украсила	украсила
весу	весу
богатого	богатого
покрова	покрова
страшным	страшным
похоронили	похоронили
Моя	Моя
похвалили	похвалили
избранные	избранные
теста	теста
скорым	скорым
погрешите	погрешите
созрели	созрели
языков	языков
произвели	произвели
испеки	испеки
начинали	начинали
выросло	выросло
взывали	взывали
живых	живых
отрезать	отрезать
прозрел	прозрел
возьмем	возьмем
извратила	извратила
порази	порази
вострепетал	вострепетал
другие	другие
похвалить	похвалить
обходите	обходите
имеют	имеют
объявить	объявить
царя	царя
представляй	представляй
отправить	отправить
крыле	крыле
скалах	скалах
познаем	познаем
исполняй	исполняй
ступите	ступите
устроили	устроили
подумал	подумал
Духе	Духе
огорчен	огорчен
вымойте	вымойте
передвигают	передвигают
носить	носить
палить	палить
души	души
ночные	ночные
соблазнили	соблазнили
слепым	слепым
роста	роста
повисла	повисла
малы	малы
смешанных	смешанных
жабами	жабами
найди	найди
истребили	истребили
спешит	спешит
разбудили	разбудили
пищи	пищи
пугать	пугать
личном	личном
наушника	наушника
умышляли	умышляли
прикрепила	прикрепила
управляем	управляем
венцом	венцом
кропить	кропить
виден	виден
посмотри	посмотри
упоена	упоена
взглянуть	взглянуть
приветствовала	приветствовала
требовать	требовать
набрали	набрали
котлов	котлов
соблазнить	соблазнить
душе	душе
зданием	зданием
семейством	семейством
отяготили	отяготили
пухли	пухли
удалите	удалите
вредить	вредить
здании	здании
мыслите	мыслите
прости	прости
укрепи	укрепи
колене	колене
всякое	всякое
чужды	чужды
посвятить	посвятить
возлагай	возлагай
родила	родила
округ	округ
нечистых	нечистых
горькую	горькую
скрытые	скрытые
пролили	пролили
вопросите	вопросите
лукавые	лукавые
Апостолом	Апостолом
выберем	выберем
возврати	возврати
обновить	обновить
кричите	кричите
возложили	возложили
вылитых	вылитых
кропили	кропили
постыди	постыди
берега	берега
воле	воле
умерло	умерло
произносила	произносила
одетый	одетый
проклятые	проклятые
мной	мной
братьям	братьям
посетить	посетить
встретили	встретили
сокрой	сокрой
века	века
избранного	избранного
потаенном	потаенном
пересчитайте	пересчитайте
началом	началом
воссиял	воссиял
избирать	избирать
будет	будет
ваша	ваша
вили	вили
выбросить	выбросить
лицами	лицами
прям	прям
протяни	протяни
пух	пух
духа	духа
отделить	отделить
щадите	щадите
мечом	мечом
привели	привели
смирен	смирен
поддерживали	поддерживали
отдали	отдали
встретила	встретила
осквернили	осквернили
строит	строит
головою	головою
отправляйте	отправляйте
царскою	царскою
пожалуйте	пожалуйте
уступили	уступили
соблюди	соблюди
худа	худа
расти	расти
поместила	поместила
святая	святая
семи	семи
вами	вами
котлом	котлом
выполнить	выполнить
немалую	немалую
почитал	почитал
пары	пары
переночевать	переночевать
исчислили	исчислили
отяготить	отяготить
отворили	отворили
вымыла	вымыла
развязать	развязать
привалили	привалили
определили	определили
желчь	желчь
столпом	столпом
пожирали	пожирали
сия	сия
богатых	богатых
потекло	потекло
вдовою	вдовою
подними	подними
стереги	стереги
Царю	Царю
страшился	страшился
внимайте	внимайте
погребен	погребен
червю	червю
открытого	открытого
воспрепятствовал	воспрепятствовал
противостать	противостать
собранные	собранные
ревнуй	ревнуй
красного	красного
черта	черта
крестить	крестить
ехидна	ехидна
отослать	отослать
осудить	осудить
уразумели	уразумели
вымой	вымой
разрушен	разрушен
препроводить	препроводить
ходи	ходи
лиц	лиц
двум	двум
снисходить	снисходить
сказывать	сказывать
пребыли	пребыли
разбирать	разбирать
полагали	полагали
утомленный	утомленный
принадлежащие	принадлежащие
запрет	запрет
доставляла	доставляла
уцелел	уцелел
пленила	пленила
пьяною	пьяною
наполнили	наполнили
поднятою	поднятою
убила	убила
войска	войска
другом	другом
воспитывайте	воспитывайте
восстанови	восстанови
награбили	награбили
слушающий	слушающий
почтить	почтить
награбило	награбило
аспидом	аспидом
припали	припали
возложила	возложила
умоляла	умоляла
благоговели	благоговели
исследовали	исследовали
дрогнуло	дрогнуло
надевай	надевай
дух	дух
Хочешь	Хочешь
допустила	допустила
целовала	целовала
прочитайте	прочитайте
Марка	Марка
языческую	языческую
стражу	стражу
теснили	теснили
Святого	Святого
спорить	спорить
завтрашнему	завтрашнему
известите	известите
трубите	трубите
издерживать	издерживать
ожил	ожил
возьмут	возьмут
надели	надели
творила	творила
благословить	благословить
голодным	голодным
променять	променять
госпоже	госпоже
надеть	надеть
слышали	слышали
засохли	засохли
нем	нем
чужд	чужд
пророчестве	пророчестве
язва	язва
лицу	лицу
пар	пар
может	может
заходят	заходят
проклинайте	проклинайте
мертвые	мертвые
отяжелели	отяжелели
рассказывайте	рассказывайте
чудовище	чудовище
лесом	лесом
отлучить	отлучить
населенные	населенные
буду	буду
гвозди	гвозди
следовали	следовали
духе	духе
низком	низком
собою	собою
сели	сели
язв	язв
ставила	ставила
покрыла	покрыла
молодой	молодой
дал	дал
налагайте	налагайте
снохе	снохе
отделен	отделен
новорожденные	новорожденные
молотить	молотить
верхом	верхом
преданным	преданным
скрыла	скрыла
приготовили	приготовили
ночных	ночных
Вся	Вся
новые	новые
допускала	допускала
Христу	Христу
вступить	вступить
рад	рад
питать	питать
славили	славили
почитай	почитай
поворотили	поворотили
печь	печь
Рабы	Рабы
язвою	язвою
рабою	рабою
возносить	возносить
растить	растить
искупи	искупи
переносим	переносим
аспид	аспид
воссиять	воссиять
разбогатели	разбогатели
окончить	окончить
было	было
моя	моя
счетом	счетом
отпустили	отпустили
слепых	слепых
возьму	возьму
всем	всем
это	это
находился	находился
выгнали	выгнали
имеешь	имеешь
облегчить	облегчить
известить	известить
возлюбила	возлюбила
отсчитай	отсчитай
сокройте	сокройте
сходить	сходить
правосудием	правосудием
спаси	спаси
никакая	никакая
Воздай	Воздай
принесла	принесла
другой	другой
второго	второго
померкли	померкли
больного	больного
придворным	придворным
одержимых	одержимых
призрак	призрак
письмом	письмом
оставить	оставить
Тобой	Тобой
хочешь	хочешь
вывели	вывели
велите	велите
кормите	кормите
звезд	звезд
образует	образует
рака	рака
прочитай	прочитай
первого	первого
овладейте	овладейте
одели	одели
заплатили	заплатили
принимали	принимали
мстили	мстили
избранное	избранное
рабе	рабе
уговорить	уговорить
спешила	спешила
молчите	молчите
похоронить	похоронить
Жертва	Жертва
нашла	нашла
встретить	встретить
отринут	отринут
Мало	Мало
называйте	называйте
возложите	возложите
восстал	восстал
слушала	слушала
вскричал	вскричал
злою	злою
бил	бил
звезду	звезду
составлять	составлять
блуди	блуди
окружила	окружила
пьяного	пьяного
благодарить	благодарить
исполните	исполните
Белы	Белы
познай	познай
выдайте	выдайте
прямою	прямою
оживлять	оживлять
расслабленного	расслабленного
первом	первом
судить	судить
истребила	истребила
Какая	Какая
мутите	мутите
дворах	дворах
отсчитать	отсчитать
вороти	вороти
предстали	предстали
отпустить	отпустить
препроводили	препроводили
сирота	сирота
превозносили	превозносили
вдовы	вдовы
хвалить	хвалить
живом	живом
Было	Было
томился	томился
твори	твори
свитке	свитке
берете	берете
четвертую	четвертую
послужить	послужить
нарекли	нарекли
вложили	вложили
перебили	перебили
подражать	подражать
богатым	богатым
призванные	призванные
услышите	услышите
звать	звать
поешь	поешь
грабили	грабили
погнали	погнали
погасить	погасить
почерпнули	почерпнули
половину	половину
забытая	забытая
помните	помните
Христом	Христом
рассудить	рассудить
отпустим	отпустим
поспешите	поспешите
обложи	обложи
Может	Может
прокаженные	прокаженные
ваши	ваши
лесах	лесах
почиет	почиет
совершила	совершила
сии	сии
бросить	бросить
превознесли	превознесли
захотели	захотели
была	была
чада	чада
оживляй	оживляй
возросло	возросло
сложи	сложи
вышло	вышло
чему	чему
фараоном	фараоном
оба	оба
убитою	убитою
исполняйте	исполняйте
черпали	черпали
поручите	поручите
отдайте	отдайте
родословные	родословные
Силу	Силу
жало	жало
упоминайте	упоминайте
вмещать	вмещать
целое	целое
Соляную	Соляную
ворону	ворону
вывезли	вывезли
схватите	схватите
блудили	блудили
разит	разит
рубите	рубите
благ	благ
вспоминали	вспоминали
сохраняйте	сохраняйте
поставила	поставила
требовали	требовали
простить	простить
благовествуй	благовествуй
мал	мал
проводит	проводит
телом	телом
сладкие	сладкие
воронов	воронов
испекли	испекли
спит	спит
благословляли	благословляли
осмоли	осмоли
заклятое	заклятое
защищать	защищать
кончен	кончен
откормленные	откормленные
удержали	удержали
умножила	умножила
завещал	завещал
губили	губили
благочестии	благочестии
весе	весе
провозгласи	провозгласи
вносите	вносите
вопрошающий	вопрошающий
травы	травы
согрешить	согрешить
жару	жару
уцелело	уцелело
объедать	объедать
дети	дети
разложите	разложите
сохраняла	сохраняла
вынимали	вынимали
возвести	возвести
презирать	презирать
затворила	затворила
Христов	Христов
оскорблять	оскорблять
вострепетали	вострепетали
медлите	медлите
фараона	фараона
выходит	выходит
нарекла	нарекла
подарила	подарила
созвать	созвать
даровала	даровала
отступили	отступили
упоены	упоены
дайте	дайте
возвысить	возвысить
поехали	поехали
страху	страху
молила	молила
страже	страже
удерживать	удерживать
отходит	отходит
проклят	проклят
озером	озером
скрывайте	скрывайте
тысяч	тысяч
возмутить	возмутить
закричали	закричали
отвратите	отвратите
истукан	истукан
побили	побили
вечера	вечера
избавлять	избавлять
сказать	сказать
прикрепи	прикрепи
точил	точил
бесноватые	бесноватые
браните	браните
унывали	унывали
удерживали	удерживали
покрыли	покрыли
взяла	взяла
изгоняйте	изгоняйте
обнови	обнови
жернов	жернов
вопрошать	вопрошать
ней	ней
беременную	беременную
свободных	свободных
сем	сем
ожидать	ожидать
связанных	связанных
сходят	сходят
хотел	хотел
пробыть	пробыть
собирайте	собирайте
сердечною	сердечною
потонули	потонули
мужчины	мужчины
грешить	грешить
вороные	вороные
невежд	невежд
причинить	причинить
проводить	проводить
змей	змей
утре	утре
вспомните	вспомните
сказывала	сказывала
Будь	Будь
цвет	цвет
налетели	налетели
засыпать	засыпать
платите	платите
узнала	узнала
всякого	всякого
сделай	сделай
одержимый	одержимый
изблюет	изблюет
просите	просите
точиле	точиле
сбили	сбили
слепого	слепого
Нового	Нового
омыли	омыли
побивать	побивать
полированной	полированной
отходить	отходить
выкупите	выкупите
вмещала	вмещала
беременная	беременная
останови	останови
снискала	снискала
восклицали	восклицали
малого	малого
оправдать	оправдать
получили	получили
срывали	срывали
обветшала	обветшала
реши	реши
поем	поем
смутили	смутили
возлегло	возлегло
жабам	жабам
цвета	цвета
устрашить	устрашить
порти	порти
очистили	очистили
красота	красота
сострадали	сострадали
сокрушите	сокрушите
принесем	принесем
закричал	закричал
страшить	страшить
пройди	пройди
всходите	всходите
местом	местом
откажет	откажет
бабкам	бабкам
говорила	говорила
поднята	поднята
царствовали	царствовали
имели	имели
лично	лично
наливала	наливала
своя	своя
мою	мою
ослабевайте	ослабевайте
небе	небе
дали	дали
согрешите	согрешите
бог	бог
жил	жил
превозмогла	превозмогла
плече	плече
перерезал	перерезал
неверные	неверные
открыть	открыть
исчислите	исчислите
приготовила	приготовила
столе	столе
выкопай	выкопай
воспитанные	воспитанные
посетили	посетили
четвертой	четвертой
вытащи	вытащи
замесила	замесила
первое	первое
хромым	хромым
козлам	козлам
преуспевали	преуспевали
новом	новом
выступить	выступить
жертвы	жертвы
научили	научили
звали	звали
сокрытый	сокрытый
счете	счете
духами	духами
спросили	спросили
Божием	Божием
ваше	ваше
целые	целые
благе	благе
било	било
бесчестите	бесчестите
проклинать	проклинать
выносите	выносите
тысячи	тысячи
пернатых	пернатых
охраняющий	охраняющий
простертой	простертой
последовали	последовали
составить	составить
благотворить	благотворить
разбили	разбили
раскинуть	раскинуть
рули	рули
вела	вела
желай	желай
рассвирепели	рассвирепели
закрыли	закрыли
богу	богу
Стану	Стану
приносите	приносите
изливай	изливай
отпусти	отпусти
оправдай	оправдай
очистим	очистим
поселили	поселили
почерпнула	почерпнула
завладели	завладели
человекоубийц	человекоубийц
протоками	протоками
Приветствуйте	Приветствуйте
запри	запри
продолжало	продолжало
обгорело	обгорело
переночевали	переночевали
попирали	попирали
любим	любим
вторых	вторых
оказывайте	оказывайте
заграждать	заграждать
выходи	выходи
кормили	кормили
золота	золота
посадите	посадите
проклятых	проклятых
наш	наш
сестре	сестре
увеличить	увеличить
нечистые	нечистые
дерзновении	дерзновении
усилили	усилили
вывези	вывези
привалите	привалите
приведи	приведи
познали	познали
срывать	срывать
желать	желать
духов	духов
производите	производите
построили	построили
посох	посох
взглянули	взглянули
отяжелело	отяжелело
фараоне	фараоне
срывай	срывай
разить	разить
ожесточили	ожесточили
навести	навести
тельцов	тельцов
втором	втором
хотели	хотели
вы	вы
любимой	любимой
ворон	ворон
иное	иное
пересказали	пересказали
поручили	поручили
долгом	долгом
отдало	отдало
ожили	ожили
накормить	накормить
благословляй	благословляй
вспоминать	вспоминать
согрешив	согрешив
округа	округа
защищайте	защищайте
мертвый	мертвый
преуспевайте	преуспевайте
шипа	шипа
наполните	наполните
обложила	обложила
подкрепи	подкрепи
превозносить	превозносить
повредить	повредить
простирали	простирали
соединить	соединить
примером	примером
старые	старые
начерпала	начерпала
собой	собой
воскликнули	воскликнули
вспомнила	вспомнила
переменили	переменили
согрешили	согрешили
ненадежное	ненадежное
ростом	ростом
сходишь	сходишь
твердой	твердой
гумне	гумне
пребывали	пребывали
одни	одни
сладкое	сладкое
доносили	доносили
попросите	попросите
языком	языком
выполним	выполним
жила	жила
котором	котором
отказал	отказал
Господню	Господню
ухом	ухом
погасили	погасили
выломали	выломали
владейте	владейте
продай	продай
укрепили	укрепили
Будет	Будет
всходить	всходить
вынимать	вынимать
какого	какого
невежда	невежда
назвали	назвали
составляли	составляли
собирала	собирала
ничтожество	ничтожество
пригласите	пригласите
шестом	шестом
снискать	снискать
лукавый	лукавый
отворила	отворила
бери	бери
подняло	подняло
право	право
целую	целую
пощади	пощади
твердую	твердую
засевайте	засевайте
занятые	занятые
спрашивать	спрашивать
большой	большой
вашу	вашу
вытру	вытру
продолжала	продолжала
доходила	доходила
возлегли	возлегли
слез	слез
обрезывай	обрезывай
нечист	нечист
шипов	шипов
глухой	глухой
проходишь	проходишь
жертв	жертв
судив	судив
набрала	набрала
Тире	Тире
Вил	Вил
воспитывали	воспитывали
жертвах	жертвах
рождали	рождали
лишить	лишить
снегу	снегу
тьмою	тьмою
яму	яму
светили	светили
сотворили	сотворили
Души	Души
раскрыла	раскрыла
этом	этом
могли	могли
запретили	запретили
Рев	Рев
челе	челе
думайте	думайте
совершите	совершите
сокрушен	сокрушен
носильщиков	носильщиков
сделала	сделала
пиши	пиши
подумайте	подумайте
сравнить	сравнить
выливай	выливай
блаженным	блаженным
окропили	окропили
дорогою	дорогою
обещал	обещал
предавайте	предавайте
свободного	свободного
дороге	дороге
нею	нею
взял	взял
Благослови	Благослови
красоту	красоту
божеству	божеству
узнает	узнает
обратили	обратили
охраняйте	охраняйте
бросила	бросила
мечи	мечи
трубить	трубить
сухие	сухие
нечестием	нечестием
отвела	отвела
гвоздем	гвоздем
манны	манны
кончили	кончили
мытарь	мытарь
лишен	лишен
счету	счету
камнях	камнях
замедли	замедли
поехал	поехал
умножить	умножить
оскверните	оскверните
проходят	проходят
временное	временное
жилы	жилы
прибавляй	прибавляй
поставили	поставили
поглотила	поглотила
производить	производить
приходили	приходили
разделили	разделили
боком	боком
девяносто	девяносто
возложить	возложить
признает	признает
возложи	возложи
поцелую	поцелую
сосчитали	сосчитали
выслали	выслали
родных	родных
спрятали	спрятали
мехе	мехе
ударить	ударить
кровопролитии	кровопролитии
Богов	Богов
могла	могла
храните	храните
влекла	влекла
доводить	доводить
Мою	Мою
отправили	отправили
возливали	возливали
змея	змея
растаяли	растаяли
носила	носила
осматривать	осматривать
попускаешь	попускаешь
тленным	тленным
слушайте	слушайте
погнать	погнать
дрогнули	дрогнули
нашем	нашем
Божию	Божию
еси	еси
иссох	иссох
притвору	притвору
подложи	подложи
вкусить	вкусить
считают	считают
переспит	переспит
внушить	внушить
предупредили	предупредили
случая	случая
страж	страж
белы	белы
нечисты	нечисты
умирали	умирали
рубить	рубить
наг	наг
пожалеть	пожалеть
благотворите	благотворите
люби	люби
делить	делить
изливать	изливать
сию	сию
тельца	тельца
чужою	чужою
дщерь	дщерь
ослепить	ослепить
вытащили	вытащили
накорми	накорми
уходили	уходили
сохраните	сохраните
налетело	налетело
козлом	козлом
служанкою	служанкою
главного	главного
узнать	узнать
принимайте	принимайте
зле	зле
пропасти	пропасти
защити	защити
наскучил	наскучил
сошли	сошли
злодействе	злодействе
возлег	возлег
эта	эта
траву	траву
ждите	ждите
презирайте	презирайте
располагал	располагал
семействе	семействе
вели	вели
населенный	населенный
избивали	избивали
ужин	ужин
засевай	засевай
пол	пол
сказали	сказали
спросить	спросить
молодом	молодом
Сии	Сии
приношении	приношении
временные	временные
путем	путем
приучила	приучила
Силом	Силом
птичкою	птичкою
которою	которою
отврати	отврати
Бог	Бог
небольшую	небольшую
Израилевой	Израилевой
привозили	привозили
сожгли	сожгли
видим	видим
обрели	обрели
худо	худо
растворила	растворила
рыдали	рыдали
создали	создали
брака	брака
богатые	богатые
знакомые	знакомые
палит	палит
уповайте	уповайте
преследовать	преследовать
выбежали	выбежали
считаешь	считаешь
замеси	замеси
взывать	взывать
новых	новых
жилища	жилища
молоке	молоке
вонзила	вонзила
думали	думали
возлюби	возлюби
целовать	целовать
возлагали	возлагали
какие	какие
оказали	оказали
вредили	вредили
посылали	посылали
Всем	Всем
саранча	саранча
Слушай	Слушай
мозгов	мозгов
имеет	имеет
преподали	преподали
долги	долги
похитили	похитили
помышляли	помышляли
находить	находить
поношении	поношении
жертвами	жертвами
беззаконием	беззаконием
отягощать	отягощать
эту	эту
учился	учился
начали	начали
лицом	лицом
тьма	тьма
ревнуйте	ревнуйте
наставить	наставить
никакое	никакое
проклинали	проклинали
сироте	сироте
убогого	убогого
вторым	вторым
заразы	заразы
язык	язык
звезде	звезде
достали	достали
разграбить	разграбить
покоить	покоить
сделайте	сделайте
сходит	сходит
всякой	всякой
беременные	беременные
наполни	наполни
восходить	восходить
кадите	кадите
вопили	вопили
отгадали	отгадали
прогнали	прогнали
выходишь	выходишь
заняты	заняты
больных	больных
считаете	считаете
познать	познать
душа	душа
купите	купите
принимать	принимать
выводит	выводит
пострадали	пострадали
сокрытые	сокрытые
строился	строился
чужой	чужой
обветшало	обветшало
прожили	прожили
очистить	очистить
талант	талант
последовало	последовало
осквернить	осквернить
поступи	поступи
создать	создать
смели	смели
расслабленные	расслабленные
сохранить	сохранить
всякую	всякую
призраку	призраку
неверующие	неверующие
ненавидела	ненавидела
вин	вин
запустении	запустении
поняли	поняли
блага	блага
вопросили	вопросили
изделии	изделии
любимы	любимы
начинай	начинай
почитают	почитают
отрезал	отрезал
отходите	отходите
смешанного	смешанного
устройством	устройством
приведем	приведем
гордо	гордо
вопить	вопить
правосудии	правосудии
пели	пели
любимым	любимым
владели	владели
Адам	Адам
последовала	последовала
соверши	соверши
досадовать	досадовать
бесовской	бесовской
матерях	матерях
Богами	Богами
захватили	захватили
восемью	восемью
возненавидела	возненавидела
внутреннем	внутреннем
фараонов	фараонов
открывать	открывать
поноси	поноси
мешка	мешка
обрела	обрела
ослабело	ослабело
разрешить	разрешить
перебило	перебило
животных	животных
начинайте	начинайте
протянут	протянут
камню	камню
чтите	чтите
родили	родили
воссияло	воссияло
простертого	простертого
вознесли	вознесли
вело	вело
половине	половине
поносили	поносили
славословить	славословить
душу	душу
права	права
полагай	полагай
купи	купи
весах	весах
хромого	хромого
восхотели	восхотели
находит	находит
обвини	обвини
отними	отними
вознегодовал	вознегодовал
Израильскою	Израильскою
посвятила	посвятила
бесноватый	бесноватый
сидели	сидели
одетые	одетые
скоте	скоте
разгласите	разгласите
человекоубийца	человекоубийца
разные	разные
вороны	вороны
тьму	тьму
набрать	набрать
месте	месте
пропасть	пропасть
каком	каком
опустили	опустили
почиешь	почиешь
отнят	отнят
половиною	половиною
почернела	почернела
выходим	выходим
красные	красные
выпали	выпали
напоены	напоены
умертвить	умертвить
мертвого	мертвого
променяй	променяй
язву	язву
бегите	бегите
совратили	совратили
ставили	ставили
сопровождать	сопровождать
возроптали	возроптали
сынов	сынов
благоговеть	благоговеть
изнеженный	изнеженный
предшествовать	предшествовать
расположите	расположите
больше	больше
обратите	обратите
возопил	возопил
поту	поту
ступили	ступили
воспоминать	воспоминать
почитает	почитает
большого	большого
зарыдал	зарыдал
старое	старое
прилагай	прилагай
наушник	наушник
отправлять	отправлять
переспим	переспим
нечистою	нечистою
постигли	постигли
прочитать	прочитать
велишь	велишь
говорили	говорили
сатана	сатана
следующем	следующем
ищем	ищем
превозносился	превозносился
побить	побить
Благ	Благ
передвигает	передвигает
придворных	придворных
правою	правою
отягощала	отягощала
наполняло	наполняло
возьмет	возьмет
язве	язве
потерянной	потерянной
восстало	восстало
моря	моря
проезжая	проезжая
развалинами	развалинами
поразила	поразила
строим	строим
женщиной	женщиной
ведите	ведите
обесчестить	обесчестить
отворить	отворить
низринут	низринут
растили	растили
кричали	кричали
рассудили	рассудили
возлюбленным	возлюбленным
истуканом	истуканом
служить	служить
Бога	Бога
подстерегать	подстерегать
впала	впала
познаю	познаю
орудии	орудии
поносить	поносить
выходить	выходить
схватить	схватить
налагай	налагай
меха	меха
медлили	медлили
возлюбленном	возлюбленном
соедини	соедини
любимый	любимый
хром	хром
услышали	услышали
затворив	затворив
омывать	омывать
встали	встали
затворите	затворите
обрати	обрати
принято	принято
крестит	крестит
приклоните	приклоните
воскурить	воскурить
берегу	берегу
занято	занято
Новы	Новы
добро	добро
пройду	пройду
опротивело	опротивело
оценили	оценили
обнажи	обнажи
козлов	козлов
опустошить	опустошить
рассудите	рассудите
стоят	стоят
градом	градом
жившую	жившую
вымыли	вымыли
обладать	обладать
испытанных	испытанных
выстроить	выстроить
рассеянных	рассеянных
красных	красных
внукам	внукам
расспросите	расспросите
богах	богах
настаивали	настаивали
большою	большою
дворами	дворами
выслушайте	выслушайте
Будут	Будут
восходите	восходите
хвалился	хвалился
черви	черви
поднятых	поднятых
разговаривали	разговаривали
отпустите	отпустите
написал	написал
наказывали	наказывали
покрою	покрою
закрою	закрою
слушали	слушали
постановить	постановить
пожирала	пожирала
сходили	сходили
путевой	путевой
гордою	гордою
бить	бить
пощадили	пощадили
переходишь	переходишь
простирать	простирать
прикрепили	прикрепили
целых	целых
отыщите	отыщите
засыпали	засыпали
противоречить	противоречить
сухою	сухою
наклонили	наклонили
запустением	запустением
произошло	произошло
святым	святым
птенцах	птенцах
кормить	кормить
нарушить	нарушить
вымерли	вымерли
восстановили	восстановили
пробыла	пробыла
подбирать	подбирать
освятили	освятили
пила	пила
жары	жары
мучила	мучила
красоте	красоте
терпи	терпи
разбросайте	разбросайте
торжествующий	торжествующий
наследует	наследует
портить	портить
вспомни	вспомни
пристало	пристало
голов	голов
вскричали	вскричали
отпускайте	отпускайте
меньшие	меньшие
бедным	бедным
держи	держи
узнаем	узнаем
превратить	превратить
построить	построить
устав	устав
иссохло	иссохло
благи	благи
доказали	доказали
ужина	ужина
собрать	собрать
навык	навык
захотела	захотела
уверить	уверить
немым	немым
лизать	лизать
сироту	сироту
наследуйте	наследуйте
весом	весом
скала	скала
славословили	славословили
усилить	усилить
Слове	Слове
литые	литые
соблюдите	соблюдите
посвяти	посвяти
воспылал	воспылал
отдать	отдать
овнов	овнов
взыскали	взыскали
родить	родить
закрыла	закрыла
потекли	потекли
проклятого	проклятого
превозмогло	превозмогло
снега	снега
морскою	морскою
вышли	вышли
главу	главу
бедный	бедный
любимых	любимых
ожесточите	ожесточите
воронам	воронам
Дух	Дух
открытый	открытый
купили	купили
истукану	истукану
одну	одну
Мал	Мал
наполняйте	наполняйте
вес	вес
посвящали	посвящали
оробел	оробел
полагать	полагать
ехидны	ехидны
убедила	убедила
открыла	открыла
нагою	нагою
проклятою	проклятою
смертный	смертный
твердых	твердых
оном	оном
попирать	попирать
глаза	глаза
Мой	Мой
Велика	Велика
Котором	Котором
утром	утром
Приветствуй	Приветствуй
утвердите	утвердите
образе	образе
град	град
проклятую	проклятую
избрала	избрала
явили	явили
созывайте	созывайте
челах	челах
посылайте	посылайте
дай	дай
переноси	переноси
смертным	смертным
манною	манною
смел	смел
восхвалите	восхвалите
умоляли	умоляли
исследуй	исследуй
убийц	убийц
выносит	выносит
отдай	отдай
счет	счет
сторожа	сторожа
Ханаанскую	Ханаанскую
воспоминайте	воспоминайте
пересчитай	пересчитай
которые	которые
отводит	отводит
переносят	переносят
распознаем	распознаем
пчелы	пчелы
покров	покров
изнеженную	изнеженную
веке	веке
странствуйте	странствуйте
говорите	говорите
разговаривать	разговаривать
понесли	понесли
Христа	Христа
вечером	вечером
открыто	открыто
взяли	взяли
собирай	собирай
избили	избили
признаю	признаю
пьем	пьем
чудным	чудным
рассеянным	рассеянным
порядке	порядке
отправляли	отправляли
вводите	вводите
обходить	обходить
есть	есть
помышлять	помышлять
обнажен	обнажен
оставлять	оставлять
постанови	постанови
избрали	избрали
замолчали	замолчали
разреши	разреши
уговаривали	уговаривали
отпирать	отпирать
устроила	устроила
рождала	рождала
раздели	раздели
звезды	звезды
избрать	избрать
иного	иного
Твой	Твой
твердым	твердым
отплыли	отплыли
мужчинах	мужчинах
приложили	приложили
воззови	воззови
закрой	закрой
привалив	привалив
завладейте	завладейте
знаком	знаком
благо	благо
направили	направили
просила	просила
ночевали	ночевали
посвящай	посвящай
миновать	миновать
перейдем	перейдем
приветствуете	приветствуете
злодейством	злодейством
встал	встал
осени	осени
освети	освети
узнайте	узнайте
откормленный	откормленный
исследовал	исследовал
жабы	жабы
отпал	отпал
поднят	поднят
изменишь	изменишь
вытащить	вытащить
напоила	напоила
освободить	освободить
шестой	шестой
Даном	Даном
нехорошо	нехорошо
утаили	утаили
жилами	жилами
иным	иным
положить	положить
бела	бела
живая	живая
главным	главным
вороной	вороной
проповедуй	проповедуй
имевшие	имевшие
наполняла	наполняла
поддерживайте	поддерживайте
направить	направить
превратили	превратили
прокаженным	прокаженным
смирите	смирите
цвете	цвете
пола	пола
Возьму	Возьму
худ	худ
скрытая	скрытая
злословили	злословили
рассеянного	рассеянного
убитый	убитый
променяли	променяли
приветствовали	приветствовали
божество	божество
заходит	заходит
признайте	признайте
противоречили	противоречили
пронзили	пронзили
священнодействовали	священнодействовали
сними	сними
Жертвы	Жертвы
утру	утру
возбудите	возбудите
наступили	наступили
малым	малым
выломать	выломать
удержи	удержи
голове	голове
отходила	отходила
другого	другого
жребием	жребием
Тем	Тем
проповедуйте	проповедуйте
левый	левый
хромых	хромых
избило	избило
Тобою	Тобою
светить	светить
воспой	воспой
поставить	поставить
положи	положи
удалили	удалили
малые	малые
возроптал	возроптал
петли	петли
сострадать	сострадать
сварите	сварите
терпим	терпим
вкусите	вкусите
строила	строила
носился	носился
тельцами	тельцами
засел	засел
которым	которым
отличен	отличен
увещевать	увещевать
простерла	простерла
спасу	спасу
выступите	выступите
проводив	проводив
слеп	слеп
кому	кому
переходить	переходить
стражам	стражам
зеленых	зеленых
унывать	унывать
нечистоте	нечистоте
остановить	остановить
созывать	созывать
пчеле	пчеле
искушайте	искушайте
рабу	рабу
водить	водить
расспроси	расспроси
искала	искала
поразите	поразите
освяти	освяти
возьми	возьми
покрыло	покрыло
разбогател	разбогател
сделанным	сделанным
укрепляли	укрепляли
царствовать	царствовать
Будете	Будете
животного	животного
обитали	обитали
воспели	воспели
исцели	исцели
черту	черту
Святым	Святым
затворить	затворить
приобрели	приобрели
мыслить	мыслить
посрамить	посрамить
Марком	Марком
возбудили	возбудили
проклинай	проклинай
заключен	заключен
нареки	нареки
отступить	отступить
перебить	перебить
выстрели	выстрели
доходили	доходили
белого	белого
построила	построила
притворы	притворы
честным	честным
Можешь	Можешь
связанные	связанные
божества	божества
вложить	вложить
которого	которого
обитаем	обитаем
правые	правые
голою	голою
искупить	искупить
возмутили	возмутили
хотят	хотят
смирить	смирить
приказывала	приказывала
петь	петь
смешанная	смешанная
вил	вил
воспылали	воспылали
Мною	Мною
приводить	приводить
обмануть	обмануть
люди	люди
исцелить	исцелить
восстановите	восстановите
полюбила	полюбила
тельцу	тельцу
совершить	совершить
бывшая	бывшая
подходили	подходили
белым	белым
прожил	прожил
Лазаря	Лазаря
траве	траве
обгорели	обгорели
бока	бока
скрывать	скрывать
грабить	грабить
поддерживать	поддерживать
считает	считает
твердом	твердом
великую	великую
Духа	Духа
святой	святой
поговорить	поговорить
ком	ком
громов	громов
Сеном	Сеном
подбирай	подбирай
раздражили	раздражили
заставили	заставили
собирали	собирали
немые	немые
рабах	рабах
входить	входить
следующему	следующему
хвалите	хвалите
скрытое	скрытое
головы	головы
пророчеством	пророчеством
могло	могло
вкусили	вкусили
прямым	прямым
неверующая	неверующая
печи	печи
умертвили	умертвили
отдели	отдели
раздражите	раздражите
попускал	попускал
возопили	возопили
открытой	открытой
удивлением	удивлением
который	который
потаенного	потаенного
снабди	снабди
морю	морю
окружили	окружили
утомленного	утомленного
молотили	молотили
возлюбленного	возлюбленного
богом	богом
утопать	утопать
входили	входили
постигло	постигло
подложили	подложили
даруешь	даруешь
сбереги	сбереги
расположен	расположен
подносили	подносили
сади	сади
рои	рои
требуй	требуй
сердечные	сердечные
тень	тень
разных	разных
почетном	почетном
предавай	предавай
устранили	устранили
прилагайте	прилагайте
вся	вся
вечере	вечере
раскрыли	раскрыли
давили	давили
приносила	приносила
условие	условие
давить	давить
светила	светила
помета	помета
служите	служите
плачем	плачем
признают	признают
лесу	лесу
воздух	воздух
какою	какою
жилищам	жилищам
отвратили	отвратили
моем	моем
Матерь	Матерь
потускло	потускло
настаивал	настаивал
страхе	страхе
щади	щади
проводят	проводят
поступив	поступив
цветами	цветами
возвестить	возвестить
покрой	покрой
преследуй	преследуй
червь	червь
каплет	каплет
затворит	затворит
иные	иные
чужом	чужом
старейшинах	старейшинах
небом	небом
порядка	порядка
подтвердили	подтвердили
