мстить	мстить
дал	дал
полюбуется	полюбуется
ходить	ходить
моря	моря
жертв	жертв
кровопролитное	кровопролитное
удерживали	удерживали
окутает	окутает
волнолом	волнолом
вами	вами
заклянете	заклянете
жертвами	жертвами
проломил	проломил
делённый	делённый
приобрела	приобрела
коррективом	коррективом
склоняют	склоняют
золотого	золотого
бесславии	бесславии
черпали	черпали
забив	забив
столпу	столпу
изменить	изменить
начислению	начислению
Вила	Вила
заглавия	заглавия
сверить	сверить
выкопали	выкопали
личном	личном
зажаривав	зажаривав
выносил	выносил
колбочку	колбочку
всякую	всякую
сработай	сработай
решимости	решимости
следующем	следующем
всем	всем
правою	правою
новоиспечённой	новоиспечённой
попускаете	попускаете
срачей	срачей
хвалить	хвалить
шубе	шубе
блузкам	блузкам
зачерпнешь	зачерпнешь
починают	починают
грешите	грешите
смелеть	смелеть
наги	наги
говори	говори
красота	красота
плату	плату
развеянный	развеянный
прибавлять	прибавлять
приобрели	приобрели
погоняющийся	погоняющийся
цари	цари
привели	привели
выкупите	выкупите
охраняющий	охраняющий
сходных	сходных
точило	точило
давира	давира
потаенном	потаенном
миниатюрные	миниатюрные
антисоветскую	антисоветскую
ломтика	ломтика
главврачи	главврачи
спрятала	спрятала
голове	голове
трогать	трогать
искома	искома
васильку	васильку
обёрткам	обёрткам
родословными	родословными
табуреток	табуреток
возмутить	возмутить
соли	соли
раздирающий	раздирающий
бункер	бункер
нормальны	нормальны
бронхит	бронхит
убила	убила
поселить	поселить
атмосферное	атмосферное
смешанное	смешанное
животному	животному
спросить	спросить
потускло	потускло
натру	натру
скрытые	скрытые
упырей	упырей
заключить	заключить
делаем	делаем
отдели	отдели
браните	браните
воспитывали	воспитывали
пожалуй	пожалуй
причастия	причастия
призвать	призвать
духовное	духовное
обставливаете	обставливаете
потерпели	потерпели
тестировав	тестировав
перебрасывав	перебрасывав
благ	благ
приноси	приноси
удивлением	удивлением
пузырьковое	пузырьковое
благовестием	благовестием
владели	владели
кенотафом	кенотафом
загородят	загородят
попкорн	попкорн
византийца	византийца
помилуйте	помилуйте
Сам	Сам
возношу	возношу
отдать	отдать
безвластной	безвластной
отворачивал	отворачивал
восстали	восстали
он	он
пространственной	пространственной
наказывай	наказывай
Господню	Господню
взаимодействуй	взаимодействуй
соевую	соевую
избранным	избранным
питали	питали
презирайте	презирайте
превознося	превознося
двудольному	двудольному
противодействующую	противодействующую
жабы	жабы
Теми	Теми
возвести	возвести
траву	траву
нечиста	нечиста
земляку	земляку
ночевали	ночевали
известить	известить
помогите	помогите
Свою	Свою
пристал	пристал
признаю	признаю
смущали	смущали
зло	зло
блага	блага
превозмогли	превозмогли
ослабела	ослабела
ращу	ращу
собственной	собственной
дугообразный	дугообразный
кидару	кидару
сухая	сухая
моделирования	моделирования
называй	называй
послужишь	послужишь
филолога	филолога
скрытое	скрытое
налагать	налагать
взыскали	взыскали
брить	брить
образцов	образцов
изгнали	изгнали
получить	получить
поднята	поднята
сладкого	сладкого
тихвинским	тихвинским
умышляли	умышляли
оробели	оробели
уразумел	уразумел
мысли	мысли
отрапортуй	отрапортуй
снисходить	снисходить
блудодействуете	блудодействуете
абляции	абляции
допускала	допускала
возвращали	возвращали
рабы	рабы
беден	беден
гордо	гордо
выкаливая	выкаливая
сторожить	сторожить
несмысленный	несмысленный
временное	временное
кипчаков	кипчаков
накренись	накренись
открыли	открыли
нахмурьтесь	нахмурьтесь
литого	литого
начертай	начертай
трубить	трубить
камня	камня
мобильники	мобильники
назидайте	назидайте
сию	сию
минует	минует
соорудим	соорудим
увела	увела
влекла	влекла
бедные	бедные
приготовили	приготовили
лешими	лешими
саранчу	саранчу
погнать	погнать
двое	двое
рассвирепели	рассвирепели
частой	частой
толки	толки
превозносил	превозносил
поединках	поединках
видеозаписи	видеозаписи
гол	гол
неутешительную	неутешительную
бойлеру	бойлеру
жилой	жилой
использовывающий	использовывающий
социал-демократическую	социал-демократическую
награбили	награбили
змеи	змеи
недопивать	недопивать
посинение	посинение
консульством	консульством
убийца	убийца
бросали	бросали
обвисали	обвисали
зипунам	зипунам
чешу	чешу
выносим	выносим
нетронутой	нетронутой
автотомией	автотомией
разрушили	разрушили
вселяющий	вселяющий
утихли	утихли
собой	собой
презирать	презирать
горькие	горькие
Который	Который
пайком	пайком
проклинать	проклинать
обирай	обирай
обогатила	обогатила
списало	списало
страшное	страшное
портативных	портативных
признать	признать
зачерпнуть	зачерпнуть
держи	держи
уверить	уверить
пусти	пусти
завещевал	завещевал
четвереньках	четвереньках
позвать	позвать
лесопарка	лесопарка
кирковые	кирковые
узнать	узнать
уповайте	уповайте
искушай	искушай
примиряющийся	примиряющийся
грешке	грешке
встали	встали
поём	поём
пел	пел
ромбиком	ромбиком
просек	просек
замазке	замазке
омыли	омыли
освежаете	освежаете
твой	твой
стереги	стереги
ожидать	ожидать
этого	этого
совратили	совратили
смело	смело
погнали	погнали
смешанного	смешанного
левши	левши
разузнавал	разузнавал
умоляй	умоляй
жокейское	жокейское
подними	подними
возрастных	возрастных
пребывали	пребывали
разговаривать	разговаривать
пораженцами	пораженцами
выведенный	выведенный
привился	привился
Твоем	Твоем
посмеянием	посмеянием
согрешали	согрешали
развели	развели
явками	явками
поднятых	поднятых
вспоминай	вспоминай
приняло	приняло
устных	устных
гекконов	гекконов
крахмальную	крахмальную
приручайте	приручайте
поспешили	поспешили
аудиторское	аудиторское
нормативным	нормативным
радикальный	радикальный
правосудии	правосудии
женственным	женственным
петь	петь
уставляются	уставляются
отлучить	отлучить
жили	жили
безволосого	безволосого
постыдился	постыдился
сотрудничество	сотрудничество
унывать	унывать
немых	немых
вытянетесь	вытянетесь
разговаривают	разговаривают
вскричал	вскричал
скрывайте	скрывайте
заколать	заколать
разить	разить
раздражили	раздражили
обитали	обитали
частичке	частичке
подходящий	подходящий
решите	решите
девяноста	девяноста
обрезывай	обрезывай
соделала	соделала
постигла	постигла
аденоидам	аденоидам
надстройтесь	надстройтесь
зипуны	зипуны
областеначальникам	областеначальникам
китайское	китайское
простецкому	простецкому
завистлив	завистлив
всесожжении	всесожжении
сохраняйте	сохраняйте
зачаровали	зачаровали
оказывай	оказывай
любимое	любимое
выпало	выпало
гей-парадах	гей-парадах
кормили	кормили
посмеянии	посмеянии
железобетонный	железобетонный
голосистых	голосистых
над	над
немо	немо
подставу	подставу
ожидальне	ожидальне
обветшала	обветшала
женевском	женевском
конкретная	конкретная
решающей	решающей
нечистоте	нечистоте
бедным	бедным
одарённостями	одарённостями
бордовой	бордовой
проводите	проводите
неверующие	неверующие
сверх	сверх
набрала	набрала
заколал	заколал
будете	будете
расслабили	расслабили
плётки	плётки
воззови	воззови
усилить	усилить
потаённые	потаённые
цепной	цепной
жертву	жертву
смотрите	смотрите
хвалю	хвалю
здании	здании
жертва	жертва
отягощали	отягощали
красоте	красоте
зажаривал	зажаривал
гумнам	гумнам
растила	растила
поникло	поникло
налагали	налагали
мины-ловушки	мины-ловушки
называйте	называйте
Мал	Мал
бы	бы
получали	получали
объединяясь	объединяясь
обжорах	обжорах
нечистой	нечистой
упросить	упросить
претерпеть	претерпеть
другое	другое
избило	избило
жребии	жребии
издёвке	издёвке
производили	производили
снискать	снискать
ортодоксальным	ортодоксальным
изменит	изменит
продемонстрировавшись	продемонстрировавшись
открытой	открытой
приносила	приносила
Как	Как
вострепетали	вострепетали
маклере	маклере
досадовать	досадовать
корольком	корольком
добром	добром
увели	увели
благодарить	благодарить
гувернантку	гувернантку
грязей	грязей
гуманные	гуманные
приветствовал	приветствовал
немом	немом
саранче	саранче
лизать	лизать
осложняя	осложняя
укрепите	укрепите
трое	трое
бегите	бегите
сокрушить	сокрушить
мстите	мстите
божество	божество
сейте	сейте
взываем	взываем
наклонился	наклонился
Цари	Цари
убитых	убитых
аквамаринам	аквамаринам
исполни	исполни
офигенностям	офигенностям
рыдание	рыдание
возвестив	возвестив
иною	иною
плюхайся	плюхайся
спустила	спустила
сестрою	сестрою
спутаться	спутаться
царишь	царишь
полиций	полиций
попирать	попирать
Твои	Твои
растерзать	растерзать
почитать	почитать
дети	дети
перебило	перебило
ушибая	ушибая
отважился	отважился
длинно	длинно
пас	пас
пока	пока
второй	второй
посулила	посулила
мной	мной
панической	панической
заключите	заключите
почётна	почётна
славя	славя
окинь	окинь
заграждать	заграждать
дочерним	дочерним
превозносят	превозносят
полагай	полагай
подозрительной	подозрительной
расплату	расплату
язвами	язвами
стабильная	стабильная
нечисты	нечисты
копали	копали
гуслистов	гуслистов
саранчи	саранчи
подул	подул
отрезать	отрезать
ванилинов	ванилинов
отдёргиваете	отдёргиваете
приручать	приручать
согласные	согласные
подаяния	подаяния
живой	живой
Приветствуют	Приветствуют
перечеркнуть	перечеркнуть
поядать	поядать
сводом	сводом
одели	одели
Мою	Мою
поспособствует	поспособствует
исполните	исполните
автомашины	автомашины
храни	храни
рениями	рениями
полиуретановой	полиуретановой
нормальные	нормальные
свесите	свесите
оставила	оставила
лоснились	лоснились
тырит	тырит
немая	немая
разорим	разорим
арменист	арменист
отнято	отнято
бил	бил
Возлюбленного	Возлюбленного
чужими	чужими
уразуметь	уразуметь
спрашивать	спрашивать
неправ	неправ
торжествуй	торжествуй
допытывайся	допытывайся
нечистые	нечистые
променяй	променяй
нездоровой	нездоровой
баллотируйся	баллотируйся
снисходительная	снисходительная
ядро	ядро
голень	голень
сироты	сироты
изрекали	изрекали
брюхи	брюхи
геккона	геккона
уповать	уповать
вызывающий	вызывающий
прогнали	прогнали
вин	вин
правами	правами
рассеявший	рассеявший
родившие	родившие
оробел	оробел
напрягайтесь	напрягайтесь
выведите	выведите
окинуть	окинуть
вредителями	вредителями
мотыжу	мотыжу
помнить	помнить
выносит	выносит
оптимистических	оптимистических
женевское	женевское
фундаментальной	фундаментальной
разузнаёте	разузнаёте
шведская	шведская
приняты	приняты
рекомендовались	рекомендовались
рения	рения
нашла	нашла
сравнишь	сравнишь
целовала	целовала
реке	реке
ритмическая	ритмическая
апоптозы	апоптозы
открытого	открытого
объёмы	объёмы
заклятым	заклятым
ракообразном	ракообразном
рождали	рождали
Которой	Которой
прикую	прикую
покрою	покрою
погромщицу	погромщицу
возопили	возопили
грохочущий	грохочущий
замазкам	замазкам
заклеймили	заклеймили
имеем	имеем
отчаялось	отчаялось
девяносто	девяносто
собирала	собирала
возненавидела	возненавидела
первою	первою
Какая	Какая
сожигает	сожигает
оставляйте	оставляйте
произноси	произноси
почитали	почитали
троюродных	троюродных
бабёнке	бабёнке
сожигания	сожигания
поднят	поднят
абитуриентского	абитуриентского
золотом	золотом
послуживший	послуживший
знакомых	знакомых
почитал	почитал
оборвемся	оборвемся
убедишь	убедишь
обручу	обручу
несмысленные	несмысленные
Хвалите	Хвалите
австралийку	австралийку
подвигли	подвигли
соделал	соделал
моя	моя
имеете	имеете
поядающий	поядающий
малым	малым
соблюли	соблюли
мертвым	мертвым
выи	выи
будничному	будничному
глядели	глядели
отсечете	отсечете
рассказывай	рассказывай
приоткроемся	приоткроемся
отпускать	отпускать
нута	нута
Нему	Нему
гениальна	гениальна
попускал	попускал
переключаемся	переключаемся
стоишь	стоишь
качествам	качествам
расслабишь	расслабишь
до	до
выслушайте	выслушайте
вопрошали	вопрошали
щадишь	щадишь
преследовать	преследовать
ношений	ношений
пою	пою
губите	губите
пойнтерам	пойнтерам
поступали	поступали
опалам	опалам
внутренние	внутренние
терпим	терпим
ревнуйте	ревнуйте
расслабивший	расслабивший
вопить	вопить
убедила	убедила
разбудить	разбудить
дельтаплану	дельтаплану
долгих	долгих
спали	спали
сканеры	сканеры
магазинчик	магазинчик
спросивший	спросивший
ушибайте	ушибайте
принимала	принимала
любим	любим
изгнаниях	изгнаниях
садить	садить
приводите	приводите
возлюбленных	возлюбленных
вносите	вносите
головы	головы
терафимы	терафимы
предавайте	предавайте
подгруппа	подгруппа
Мне	Мне
распростерла	распростерла
дала	дала
изымайте	изымайте
осквернила	осквернила
ночуют	ночуют
распахать	распахать
черпать	черпать
устроили	устроили
издевающийся	издевающийся
высох	высох
половинки	половинки
рождайте	рождайте
долог	долог
заклянут	заклянут
охраняйте	охраняйте
столпе	столпе
хранит	хранит
рушиться	рушиться
Явился	Явился
переправили	переправили
гарантировал	гарантировал
дворовый	дворовый
вынимали	вынимали
нездоровы	нездоровы
изгоняйте	изгоняйте
долгие	долгие
пробрал	пробрал
поют	поют
давить	давить
котором	котором
подвёртывайтесь	подвёртывайтесь
мытарь	мытарь
пересчитай	пересчитай
разматывал	разматывал
ненадежное	ненадежное
бери	бери
марафонам	марафонам
требуй	требуй
блузка	блузка
унывайте	унывайте
согрешим	согрешим
помышляйте	помышляйте
скрытом	скрытом
старых	старых
меньшая	меньшая
благотворить	благотворить
поступив	поступив
похоронили	похоронили
ослабеете	ослабеете
партией	партией
Всем	Всем
оборвавшись	оборвавшись
имевшая	имевшая
Стань	Стань
отправляйте	отправляйте
изливайте	изливайте
вносить	вносить
поднять	поднять
встроенная	встроенная
печатниками	печатниками
написанного	написанного
светя	светя
вцепляйтесь	вцепляйтесь
переночевать	переночевать
надеть	надеть
возносите	возносите
лекарю	лекарю
отступить	отступить
чужою	чужою
глухою	глухою
выпускаетесь	выпускаетесь
изменениях	изменениях
веришь	веришь
приветствуйте	приветствуйте
безоговорочных	безоговорочных
погребен	погребен
пробуждал	пробуждал
прекратился	прекратился
асимметричные	асимметричные
выводят	выводят
раздосадованных	раздосадованных
сделайте	сделайте
дерзновением	дерзновением
ваше	ваше
ждать	ждать
уведомляла	уведомляла
собранных	собранных
отключила	отключила
нынешнем	нынешнем
буду	буду
сестёр	сестёр
апорий	апорий
рули	рули
пассивной	пассивной
зданием	зданием
языческой	языческой
возвратился	возвратился
лотерея	лотерея
ненецким	ненецким
червю	червю
Какой	Какой
хлопотливых	хлопотливых
превышаешь	превышаешь
всякой	всякой
возьмем	возьмем
автострады	автострады
схоже	схоже
антисоветском	антисоветском
приведем	приведем
Буду	Буду
завладейте	завладейте
родословных	родословных
провожали	провожали
совладаете	совладаете
всходить	всходить
приехал	приехал
открыла	открыла
сделало	сделало
непостоянного	непостоянного
амбициозное	амбициозное
зла	зла
возлюбленные	возлюбленные
выудила	выудила
перейдем	перейдем
скверных	скверных
освободи	освободи
предкрылке	предкрылке
первом	первом
унизили	унизили
имущества	имущества
воздевающий	воздевающий
возливай	возливай
снисходительный	снисходительный
журчало	журчало
обогатить	обогатить
обновишься	обновишься
променять	променять
ждала	ждала
половину	половину
собирать	собирать
развалинами	развалинами
целого	целого
преподало	преподало
заковывать	заковывать
эти	эти
возвестится	возвестится
дубинки	дубинки
актёрское	актёрское
углублениями	углублениями
нею	нею
коллекционировал	коллекционировал
Этого	Этого
аттометрам	аттометрам
напрягался	напрягался
продолжай	продолжай
возвысили	возвысили
предоставится	предоставится
превозносимый	превозносимый
немноги	немноги
ходили	ходили
возливайте	возливайте
стильный	стильный
подходить	подходить
немое	немое
заклёпке	заклёпке
когереры	когереры
проклят	проклят
преклонился	преклонился
возьмет	возьмет
затворив	затворив
твердой	твердой
превратить	превратить
возросло	возросло
кенотафу	кенотафу
марсу	марсу
иные	иные
разбить	разбить
компьютерной	компьютерной
претерпели	претерпели
безволосой	безволосой
озадаченной	озадаченной
наливала	наливала
вводить	вводить
лужичанина	лужичанина
испытанную	испытанную
срывай	срывай
честолюбив	честолюбив
человекоубийц	человекоубийц
пьяных	пьяных
могут	могут
исполнила	исполнила
будешь	будешь
большую	большую
ввязывался	ввязывался
излишком	излишком
неуёмные	неуёмные
образовала	образовала
раздражите	раздражите
засыпали	засыпали
признает	признает
язву	язву
блуждали	блуждали
принесли	принесли
засыхали	засыхали
реки	реки
сердечно-сосудистым	сердечно-сосудистым
оврагом	оврагом
поговорив	поговорив
прокаженных	прокаженных
возросли	возросли
приветствовала	приветствовала
отговаривают	отговаривают
святые	святые
веруйте	веруйте
принятым	принятым
астраханское	астраханское
встретился	встретился
Дине	Дине
открытом	открытом
щегол	щегол
свернуться	свернуться
манжеты	манжеты
Будет	Будет
успокоился	успокоился
бить	бить
лишился	лишился
держите	держите
судился	судился
москвитянами	москвитянами
чреватым	чреватым
пол	пол
неподдельных	неподдельных
горьком	горьком
каждою	каждою
сказуемым	сказуемым
любимым	любимым
свету	свету
сплющила	сплющила
впитанного	впитанного
бесперспективным	бесперспективным
растаяли	растаяли
отнят	отнят
предпредпоследни	предпредпоследни
региональную	региональную
колу	колу
убогого	убогого
выводили	выводили
перестал	перестал
каучуковой	каучуковой
располагая	располагая
передвигает	передвигает
померкнешь	померкнешь
лоботрясах	лоботрясах
намерены	намерены
познаешь	познаешь
кирковое	кирковое
наполнили	наполнили
славило	славило
предметные	предметные
мытаря	мытаря
легкие	легкие
рифмы	рифмы
прорицателе	прорицателе
воду	воду
гувернанток	гувернанток
говорящий	говорящий
Одно	Одно
иссох	иссох
широкоплечего	широкоплечего
заколения	заколения
ненавидели	ненавидели
разбудили	разбудили
удалили	удалили
давире	давире
сопровождали	сопровождали
захватив	захватив
буркаешь	буркаешь
обыграет	обыграет
несмысленное	несмысленное
занимательного	занимательного
умалился	умалился
томился	томился
живая	живая
вышли	вышли
оплодотворяешь	оплодотворяешь
скатившийся	скатившийся
чёрта	чёрта
ухнули	ухнули
ослабело	ослабело
лососёвым	лососёвым
хоккейного	хоккейного
собранья	собранья
отсчитайте	отсчитайте
автоматизирована	автоматизирована
неординарной	неординарной
теми	теми
Приветствуйте	Приветствуйте
любите	любите
которую	которую
начинай	начинай
стесняет	стесняет
даем	даем
привезла	привезла
ночуете	ночуете
рыдайте	рыдайте
успокоить	успокоить
целое	целое
положила	положила
благодарите	благодарите
бесславием	бесславием
драгоценной	драгоценной
соорудило	соорудило
собранном	собранном
первым	первым
топтали	топтали
царе	царе
создать	создать
потаенных	потаенных
исландце	исландце
возвестивший	возвестивший
разным	разным
назидается	назидается
благочестии	благочестии
мстили	мстили
изволила	изволила
смешанные	смешанные
полированным	полированным
романское	романское
разбогатели	разбогатели
святых	святых
шведских	шведских
отрапортовало	отрапортовало
лицом	лицом
отяготишь	отяготишь
выпучив	выпучив
реабилитациям	реабилитациям
со	со
случая	случая
чину	чину
отнятое	отнятое
прищуриваешься	прищуриваешься
окутали	окутали
поручите	поручите
потаённой	потаённой
вытеснял	вытеснял
сквозные	сквозные
составить	составить
потускли	потускли
нареки	нареки
обреку	обреку
чада	чада
заклянет	заклянет
каком	каком
выведя	выведя
утихнете	утихнете
пило	пило
раздирайте	раздирайте
полое	полое
первого	первого
тяготящий	тяготящий
родословное	родословное
расслабите	расслабите
отвела	отвела
осложняете	осложняете
ампутацией	ампутацией
принят	принят
умножить	умножить
нужников	нужников
освободился	освободился
Будь	Будь
издевавшись	издевавшись
ткнусь	ткнусь
обгорелою	обгорелою
расслаблю	расслаблю
изготавливайтесь	изготавливайтесь
тайна	тайна
продай	продай
двудолен	двудолен
считал	считал
соделай	соделай
скакать	скакать
избавить	избавить
замер	замер
хранила	хранила
собранное	собранное
желанным	желанным
сведущие	сведущие
укреплять	укреплять
начинайте	начинайте
обратить	обратить
созвать	созвать
маятники	маятники
мотыжить	мотыжить
исцеляйте	исцеляйте
воскликнули	воскликнули
убедить	убедить
назидает	назидает
послужу	послужу
мертвою	мертвою
призывником	призывником
литыми	литыми
причитающийся	причитающийся
Сделай	Сделай
каждой	каждой
перестали	перестали
припекаем	припекаем
показать	показать
сербской	сербской
Лазарь	Лазарь
ослабеешь	ослабеешь
блудодействуя	блудодействуя
животные	животные
пинаемый	пинаемый
вероятной	вероятной
петли	петли
уславливаемся	уславливаемся
препроводили	препроводили
неясного	неясного
звали	звали
отправился	отправился
родят	родят
исцелился	исцелился
послужили	послужили
подставах	подставах
которым	которым
констебля	констебля
заколи	заколи
логотипах	логотипах
избили	избили
превозмогло	превозмогло
журчав	журчав
кенотафе	кенотафе
познаю	познаю
села	села
подумывай	подумывай
выстрелив	выстрелив
поменялось	поменялось
астробиологиях	астробиологиях
продать	продать
угодная	угодная
померкший	померкший
иной	иной
раздражали	раздражали
послужим	послужим
металлургическом	металлургическом
встал	встал
ноздри	ноздри
поднимите	поднимите
сокрыт	сокрыт
Самой	Самой
следовать	следовать
положить	положить
целую	целую
производить	производить
исследовать	исследовать
достали	достали
выводите	выводите
напоены	напоены
изморозях	изморозях
пленила	пленила
глухие	глухие
поя	поя
анонимности	анонимности
гребне	гребне
остановила	остановила
добрейшая	добрейшая
потерпела	потерпела
сербскохорватские	сербскохорватские
которая	которая
альманахе	альманахе
сокрушили	сокрушили
вы	вы
написала	написала
уповали	уповали
вооружился	вооружился
отстать	отстать
советчика	советчика
подбирать	подбирать
ничтожества	ничтожества
отстрелялась	отстрелялась
червовый	червовый
выводила	выводила
поющий	поющий
слезу	слезу
возвещённый	возвещённый
уронила	уронила
семинаром	семинаром
экстрадиции	экстрадиции
мгновенном	мгновенном
чужд	чужд
убили	убили
пловцом	пловцом
пристало	пристало
целовать	целовать
малых	малых
клинкеров	клинкеров
платили	платили
ревнуй	ревнуй
Тысяча	Тысяча
наливай	наливай
пролетай	пролетай
немыми	немыми
очистим	очистим
образу	образу
чувяке	чувяке
возлегло	возлегло
шлёпанцы	шлёпанцы
звезда	звезда
прожили	прожили
выдам	выдам
павильонам	павильонам
лично	лично
утешении	утешении
повстречавший	повстречавший
горькое	горькое
тысяченачальник	тысяченачальник
предшествовали	предшествовали
аннексии	аннексии
забирали	забирали
троюродным	троюродным
бесстрастному	бесстрастному
выудило	выудило
Самый	Самый
вступился	вступился
утвердился	утвердился
примечательного	примечательного
ищем	ищем
прозрели	прозрели
Божию	Божию
воспылал	воспылал
позавидовали	позавидовали
ромбика	ромбика
нечётны	нечётны
сосчитайте	сосчитайте
вызывать	вызывать
изумился	изумился
несмысленным	несмысленным
потаенные	потаенные
антигельминтное	антигельминтное
обладайте	обладайте
давир	давир
животном	животном
полированную	полированную
подпустят	подпустят
вытесняла	вытесняла
письмам	письмам
жил	жил
поешь	поешь
изготавливаемся	изготавливаемся
комментаторе	комментаторе
привалили	привалили
поступи	поступи
встречали	встречали
примечателен	примечателен
выбрасывать	выбрасывать
жребием	жребием
предпредпоследняя	предпредпоследняя
пойнтер	пойнтер
заграждали	заграждали
дошкольным	дошкольным
простился	простился
заколите	заколите
вознеси	вознеси
вывези	вывези
отнимали	отнимали
отговариваемый	отговариваемый
разводите	разводите
ремонта	ремонта
поношении	поношении
переберет	переберет
славистике	славистике
утехе	утехе
натёрло	натёрло
колет	колет
добре	добре
парализуешь	парализуешь
простить	простить
тьму	тьму
прудику	прудику
отборный	отборный
Лазаря	Лазаря
исполнился	исполнился
красочные	красочные
побивать	побивать
кинофильмах	кинофильмах
нем	нем
исцелить	исцелить
познает	познает
испытывали	испытывали
ваша	ваша
мои	мои
социал-демократическими	социал-демократическими
садите	садите
второе	второе
созрей	созрей
Иудин	Иудин
жилищах	жилищах
пожалеть	пожалеть
захватите	захватите
возлюбленную	возлюбленную
написанных	написанных
появлением	появлением
начислением	начислением
да	да
сокруши	сокруши
звезду	звезду
ослабейте	ослабейте
пазниках	пазниках
материалами	материалами
настаивал	настаивал
горькой	горькой
австрийцев	австрийцев
выводить	выводить
выросло	выросло
возлюбленною	возлюбленною
составляли	составляли
бедно	бедно
приняли	приняли
взалкали	взалкали
щади	щади
обманула	обманула
отложи	отложи
налагай	налагай
левою	левою
призвала	призвала
откормленного	откормленного
известим	известим
вымыли	вымыли
допевайте	допевайте
царя	царя
отправляли	отправляли
влепляет	влепляет
долгими	долгими
малы	малы
утехи	утехи
лгите	лгите
почитают	почитают
побивали	побивали
освежали	освежали
зачарованный	зачарованный
отверженному	отверженному
умерщвляйте	умерщвляйте
фторам	фторам
пропали	пропали
спаси	спаси
нейтралитетам	нейтралитетам
меньшие	меньшие
завладел	завладел
царски	царски
сладкое	сладкое
стакеров	стакеров
несдержанностью	несдержанностью
сошло	сошло
соделаю	соделаю
погряз	погряз
сантиментов	сантиментов
лесистости	лесистости
спекуляции	спекуляции
проповедуй	проповедуй
внимайте	внимайте
молила	молила
каждое	каждое
избранных	избранных
святой	святой
экстрадицию	экстрадицию
уснули	уснули
билах	билах
расположился	расположился
считаешь	считаешь
принятое	принятое
летите	летите
расползаюсь	расползаюсь
животное	животное
Израилеву	Израилеву
топчусь	топчусь
выбежали	выбежали
открытую	открытую
посолят	посолят
одолела	одолела
прельстился	прельстился
захоронений	захоронений
нейтралитеты	нейтралитеты
симфоническим	симфоническим
калачами	калачами
носильщику	носильщику
открывай	открывай
оказали	оказали
считает	считает
страшным	страшным
Слушайте	Слушайте
родным	родным
соединить	соединить
трепетного	трепетного
почерпнули	почерпнули
искушали	искушали
живого	живого
сексуальной	сексуальной
получила	получила
минам-ловушкам	минам-ловушкам
убегу	убегу
смири	смири
злосчастного	злосчастного
Которым	Которым
умножали	умножали
условие	условие
выговоришь	выговоришь
сфинксам	сфинксам
совершите	совершите
озеленениям	озеленениям
призывать	призывать
избирай	избирай
спросила	спросила
умер	умер
кадите	кадите
приверженцу	приверженцу
накреняла	накреняла
забормочете	забормочете
прославить	прославить
возлюбленного	возлюбленного
воздевала	воздевала
отпали	отпали
стабильных	стабильных
сей	сей
занятые	занятые
блудодействуешь	блудодействуешь
гениального	гениального
обмануть	обмануть
бесчести	бесчести
обгорело	обгорело
считайте	считайте
автострад	автострад
пощадивший	пощадивший
отделили	отделили
одушевленное	одушевленное
делила	делила
колпак	колпак
произнеси	произнеси
открытый	открытый
ветвях	ветвях
десяти	десяти
избивали	избивали
пробыла	пробыла
совладаешь	совладаешь
большакам	большакам
раскрытых	раскрытых
начало	начало
старые	старые
раздражен	раздражен
ратифицируемый	ратифицируемый
неуёмных	неуёмных
вещи	вещи
призывника	призывника
передались	передались
возрастной	возрастной
выговариваетесь	выговариваетесь
половины	половины
хулю	хулю
мережку	мережку
прилагайте	прилагайте
сосчитай	сосчитай
она	она
грешили	грешили
молодым	молодым
гордою	гордою
притвору	притвору
пробыли	пробыли
прославляли	прославляли
необрезанный	необрезанный
возврати	возврати
универсам	универсам
моем	моем
отказывай	отказывай
мокра	мокра
тысяч	тысяч
пой	пой
входить	входить
ширить	ширить
шерстяная	шерстяная
скрепился	скрепился
большевикам	большевикам
простерла	простерла
затворит	затворит
выкупи	выкупи
вытянувшийся	вытянувшийся
каждую	каждую
думали	думали
чтить	чтить
юркнуть	юркнуть
неверующая	неверующая
вывели	вывели
малое	малое
Какое	Какое
вымерли	вымерли
хваля	хваля
отличился	отличился
бедное	бедное
святую	святую
отряхивавшись	отряхивавшись
сожги	сожги
тройнях	тройнях
кругозором	кругозором
сближаетесь	сближаетесь
носите	носите
маньякам	маньякам
реабилитируя	реабилитируя
угловых	угловых
наступив	наступив
пропало	пропало
родился	родился
Моя	Моя
долгом	долгом
отнимите	отнимите
скопцы	скопцы
подняло	подняло
сделать	сделать
заклятого	заклятого
оно	оно
овце	овце
офигенности	офигенности
твои	твои
известят	известят
поем	поем
гигантов	гигантов
щадите	щадите
сверкания	сверкания
благодарив	благодарив
печатка	печатка
прихлёбнутый	прихлёбнутый
рубя	рубя
вели	вели
веривший	веривший
произносите	произносите
свои	свои
женщиною	женщиною
кидай	кидай
уцелел	уцелел
утолить	утолить
приложили	приложили
развязать	развязать
Моисеевы	Моисеевы
сделали	сделали
торжествующий	торжествующий
вещичкой	вещичкой
расслабил	расслабил
известив	известив
другая	другая
долгого	долгого
отсчитать	отсчитать
держу	держу
второго	второго
мурлычет	мурлычет
тысяченачальники	тысяченачальники
Трое	Трое
служили	служили
расположите	расположите
ненецкие	ненецкие
вторичны	вторичны
принуждали	принуждали
лепок	лепок
соделается	соделается
какою	какою
держали	держали
нашу	нашу
налетели	налетели
служанкою	служанкою
свечу	свечу
иного	иного
принципиальными	принципиальными
каучуковое	каучуковое
пчела	пчела
чужую	чужую
далёкого	далёкого
отсчитай	отсчитай
пребыл	пребыл
обосретесь	обосретесь
пожирать	пожирать
обманули	обманули
изводивший	изводивший
причёсанный	причёсанный
иное	иное
выговорить	выговорить
бедная	бедная
принесем	принесем
немалой	немалой
отплыли	отплыли
стоят	стоят
рентабельных	рентабельных
простирал	простирал
старом	старом
любимой	любимой
корчишься	корчишься
намерен	намерен
взял	взял
превозносив	превозносив
избавлять	избавлять
обозрели	обозрели
постройкой	постройкой
измерительных	измерительных
выполю	выполю
заключительный	заключительный
летали	летали
впал	впал
бейте	бейте
этой	этой
давали	давали
гили	гили
отправили	отправили
воскрешает	воскрешает
знаком	знаком
верни	верни
посылайте	посылайте
ампутации	ампутации
отрезали	отрезали
ожить	ожить
медвежатниками	медвежатниками
обрати	обрати
необрезан	необрезан
шалей	шалей
радиопередатчиков	радиопередатчиков
слепце	слепце
сквозняк	сквозняк
хвалите	хвалите
беды	беды
хотел	хотел
негодовал	негодовал
стеллажу	стеллажу
выстроилась	выстроилась
приклонить	приклонить
никакой	никакой
пила	пила
воздали	воздали
принимай	принимай
возвестим	возвестим
изводя	изводя
открыть	открыть
разговорчивое	разговорчивое
избавило	избавило
наполняла	наполняла
увеличить	увеличить
умудрить	умудрить
допевать	допевать
вникая	вникая
укрепляли	укрепляли
слепым	слепым
констебли	констебли
избирались	избирались
отсечет	отсечет
прошивав	прошивав
божеству	божеству
почитаете	почитаете
взывайте	взывайте
восходить	восходить
помните	помните
стакер	стакер
славянским	славянским
высохли	высохли
свирели	свирели
отстреляетесь	отстреляетесь
арматурам	арматурам
зиму	зиму
выносите	выносите
произвольной	произвольной
взаимности	взаимности
померкли	померкли
увеличили	увеличили
узнайте	узнайте
подходили	подходили
вскричали	вскричали
неразговорчива	неразговорчива
спарываете	спарываете
поддерживайте	поддерживайте
просили	просили
умерло	умерло
благословляли	благословляли
змей	змей
ободрился	ободрился
стервятнике	стервятнике
тьме	тьме
кадили	кадили
поддерживать	поддерживать
прости	прости
родили	родили
убийцу	убийцу
томила	томила
стоит	стоит
утомился	утомился
добрейшим	добрейшим
сторожей	сторожей
спорить	спорить
наступите	наступите
проберет	проберет
приступить	приступить
вцепляться	вцепляться
права	права
последовать	последовать
поникла	поникла
огорчили	огорчили
ваш	ваш
аденоидов	аденоидов
морем	морем
рукополагать	рукополагать
ручник	ручник
обновитесь	обновитесь
отделен	отделен
Мною	Мною
древневерхненемецкому	древневерхненемецкому
воздайте	воздайте
изумили	изумили
разговаривал	разговаривал
воспламенили	воспламенили
шторы	шторы
захваченный	захваченный
разоблачался	разоблачался
согрешили	согрешили
возносило	возносило
судив	судив
возьмешь	возьмешь
возненавидели	возненавидели
мертво	мертво
молите	молите
расползаются	расползаются
безлюдным	безлюдным
выбрасывайте	выбрасывайте
овладел	овладел
половинах	половинах
показывай	показывай
преуспевали	преуспевали
тайны	тайны
светили	светили
размышлению	размышлению
соблюдем	соблюдем
списали	списали
выстрелила	выстрелила
досадовали	досадовали
влекли	влекли
наскучил	наскучил
соавторстве	соавторстве
сквознякам	сквознякам
подчинился	подчинился
податливом	податливом
взглянули	взглянули
вооружаюсь	вооружаюсь
стеллажам	стеллажам
язве	язве
старое	старое
смирился	смирился
превратили	превратили
призвали	призвали
игумену	игумену
замещениях	замещениях
подпустите	подпустите
се	се
прямою	прямою
начерпали	начерпали
обваляем	обваляем
принимайте	принимайте
страшных	страшных
тяжестью	тяжестью
путем	путем
сажен	сажен
самостоятельности	самостоятельности
оказывали	оказывали
упился	упился
делало	делало
образовали	образовали
избавив	избавив
вопили	вопили
отсеки	отсеки
лексикона	лексикона
каждые	каждые
бедного	бедного
минимумах	минимумах
выстоите	выстоите
неверное	неверное
городовая	городовая
новом	новом
превозношу	превозношу
фурункул	фурункул
головами	головами
сберегите	сберегите
четвертую	четвертую
предназначения	предназначения
одетого	одетого
обозвавший	обозвавший
овладели	овладели
посчитай	посчитай
нагой	нагой
ваши	ваши
приехали	приехали
молчали	молчали
потонуло	потонуло
священнодействовать	священнодействовать
снимали	снимали
подпал	подпал
парусами	парусами
партере	партере
томили	томили
накрыться	накрыться
маслобойке	маслобойке
нага	нага
известила	известила
посрамить	посрамить
иссохло	иссохло
лесоводческими	лесоводческими
Пила	Пила
перерезали	перерезали
располагал	располагал
избирать	избирать
жала	жала
мобильника	мобильника
возроптал	возроптал
призовое	призовое
нагромождали	нагромождали
ксерокопированию	ксерокопированию
изделии	изделии
отяготило	отяготило
немалому	немалому
неради	неради
орудием	орудием
будет	будет
предстал	предстал
показывали	показывали
неверном	неверном
живые	живые
разделился	разделился
накреняя	накреняя
переберут	переберут
рубленный	рубленный
померк	померк
аромунку	аромунку
нечистым	нечистым
избрать	избрать
нерадите	нерадите
будем	будем
неверные	неверные
духовен	духовен
пищи	пищи
монумента	монумента
опустошен	опустошен
автоматизированного	автоматизированного
чью	чью
убеди	убеди
выведи	выведи
благую	благую
мальчишка	мальчишка
гусенице	гусенице
батутом	батутом
подкрепить	подкрепить
горд	горд
осетинки	осетинки
выливай	выливай
ожидальню	ожидальню
поручен	поручен
снабжали	снабжали
бронхита	бронхита
избирателями	избирателями
священнодействовали	священнодействовали
долгому	долгому
сохранить	сохранить
взаимозависимость	взаимозависимость
замышляли	замышляли
взглянул	взглянул
отделите	отделите
ослабел	ослабел
жабах	жабах
назвали	назвали
шурупов	шурупов
имперфекту	имперфекту
комплектация	комплектация
светить	светить
разоривший	разоривший
лица	лица
вывести	вывести
почитай	почитай
Сия	Сия
шкотиках	шкотиках
смирите	смирите
преследовала	преследовала
голени	голени
смешанных	смешанных
этом	этом
покушаясь	покушаясь
испытанным	испытанным
рождать	рождать
отложили	отложили
распространённая	распространённая
твердою	твердою
перетекала	перетекала
скрывала	скрывала
преследуй	преследуй
пророчествуйте	пророчествуйте
отняли	отняли
подняты	подняты
обещали	обещали
обатуров	обатуров
помни	помни
половцев	половцев
кормила	кормила
приходить	приходить
тропосферах	тропосферах
столпы	столпы
азиатка	азиатка
поединки	поединки
изморозь	изморозь
надстроившийся	надстроившийся
византиец	византиец
убедив	убедив
прищурят	прищурят
добавлениям	добавлениям
мыслите	мыслите
сирот	сирот
увивать	увивать
подвох	подвох
носился	носился
пиши	пиши
духовности	духовности
разделите	разделите
возлег	возлег
отложите	отложите
угодной	угодной
прямые	прямые
большая	большая
почётные	почётные
схоронить	схоронить
будут	будут
устаиваясь	устаиваясь
засохли	засохли
отдёргиваешь	отдёргиваешь
ножиками	ножиками
хлопотливым	хлопотливым
царствовать	царствовать
нечистота	нечистота
воспой	воспой
приложился	приложился
Будут	Будут
упоены	упоены
разрушить	разрушить
разговаривали	разговаривали
поддерживала	поддерживала
разные	разные
дубинок	дубинок
преодолениями	преодолениями
крупинок	крупинок
запоминаний	запоминаний
втором	втором
скапливал	скапливал
сухую	сухую
звезды	звезды
абакумычами	абакумычами
считай	считай
подули	подули
возлагать	возлагать
последовало	последовало
отрыгиваю	отрыгиваю
несмысленного	несмысленного
побудишь	побудишь
одела	одела
твоем	твоем
одарённости	одарённости
направили	направили
вил	вил
слез	слез
хоронили	хоронили
вымыла	вымыла
автографы	автографы
лишить	лишить
субботний	субботний
четвёртым	четвёртым
приклони	приклони
саранча	саранча
углубление	углубление
хаосах	хаосах
Бруклин	Бруклин
злом	злом
половине	половине
вселял	вселял
чтите	чтите
выдавали	выдавали
ехидной	ехидной
бризом	бризом
заграждай	заграждай
чёртом	чёртом
маятника	маятника
золовке	золовке
сирота	сирота
разводное	разводное
сферы	сферы
изложений	изложений
пересказала	пересказала
восстало	восстало
шестой	шестой
сказуемом	сказуемом
сработав	сработав
губленный	губленный
проводили	проводили
настаивали	настаивали
отослали	отослали
ахроматизме	ахроматизме
разорит	разорит
делаться	делаться
возьмут	возьмут
откормленных	откормленных
обыски	обыски
возвестите	возвестите
овладеть	овладеть
необрезанным	необрезанным
приближению	приближению
страшные	страшные
расспросы	расспросы
желтками	желтками
вредителем	вредителем
автограф	автограф
растаяло	растаяло
нечестием	нечестием
испекла	испекла
отказал	отказал
возносимый	возносимый
откажет	откажет
почетном	почетном
познали	познали
столпов	столпов
произошли	произошли
избавился	избавился
грызам	грызам
пролился	пролился
сморкавший	сморкавший
собою	собою
уклонял	уклонял
обличить	обличить
благовествуйте	благовествуйте
болеутоляющ	болеутоляющ
сверкающим	сверкающим
опьянейте	опьянейте
познай	познай
лепками	лепками
полициям	полициям
левша	левша
спарывая	спарывая
издёвкам	издёвкам
засевайте	засевайте
тырьте	тырьте
превышений	превышений
древневерхненемецком	древневерхненемецком
погромщицы	погромщицы
приветствуют	приветствуют
завихрение	завихрение
княгинь	княгинь
трава	трава
конное	конное
могла	могла
взалкал	взалкал
щеглёнка	щеглёнка
грамотности	грамотности
зле	зле
подоспейте	подоспейте
другую	другую
вылитых	вылитых
самая	самая
транспортировка	транспортировка
благе	благе
разбила	разбила
золота	золота
откажи	откажи
вступили	вступили
нечётной	нечётной
убийства	убийства
изложением	изложением
раздробляющий	раздробляющий
сердив	сердив
согрешит	согрешит
приклонили	приклонили
готским	готским
веди	веди
ступеньки	ступеньки
задержках	задержках
цепенел	цепенел
воевали	воевали
почерпнула	почерпнула
духовность	духовность
сокрытый	сокрытый
змея	змея
превозносился	превозносился
набиваешься	набиваешься
иррациональна	иррациональна
сила	сила
потаённом	потаённом
ослабевать	ослабевать
внутри	внутри
раскатала	раскатала
дынях	дынях
бегу	бегу
объёмами	объёмами
всходил	всходил
некрасивых	некрасивых
упырями	упырями
горьким	горьким
выводило	выводило
наступить	наступить
испеки	испеки
сытую	сытую
удила	удила
упоминай	упоминай
выстроили	выстроили
променяли	променяли
посылать	посылать
молодую	молодую
чужое	чужое
еси	еси
завещевает	завещевает
алунитах	алунитах
накал	накал
владейте	владейте
удержанием	удержанием
постыдить	постыдить
килобайту	килобайту
зазвонив	зазвонив
воспрепятствовали	воспрепятствовали
метровым	метровым
голою	голою
приложите	приложите
животного	животного
вынимать	вынимать
обещал	обещал
стенали	стенали
томить	томить
приветствующий	приветствующий
зеленых	зеленых
посвящали	посвящали
возвестило	возвестило
обвисал	обвисал
портативного	портативного
приглаживая	приглаживая
пожалуйте	пожалуйте
молодая	молодая
никакою	никакою
губить	губить
развей	развей
проклятою	проклятою
известишь	известишь
лексиконе	лексиконе
призывайте	призывайте
сказало	сказало
рулем	рулем
прибыл	прибыл
дать	дать
горькая	горькая
садился	садился
возлагай	возлагай
запри	запри
познаете	познаете
рубце	рубце
предвыборным	предвыборным
предстали	предстали
согласился	согласился
тороплива	тороплива
изымаем	изымаем
пористых	пористых
родить	родить
пребывать	пребывать
вселитесь	вселитесь
приходили	приходили
золотою	золотою
приношении	приношении
завистливому	завистливому
влекло	влекло
латинизация	латинизация
Дина	Дина
скатитесь	скатитесь
возлюбленный	возлюбленный
асимметричной	асимметричной
коварства	коварства
соделали	соделали
блюют	блюют
почитает	почитает
своди	своди
булавки	булавки
испёкшись	испёкшись
перебили	перебили
белы	белы
посолите	посолите
сожигай	сожигай
прямых	прямых
паёк	паёк
качку	качку
обитаем	обитаем
воспылали	воспылали
петый	петый
выдерните	выдерните
податлива	податлива
отключило	отключило
отнятых	отнятых
убегали	убегали
закрыли	закрыли
точила	точила
привалите	привалите
запустением	запустением
пудреным	пудреным
натапливает	натапливает
растят	растят
новых	новых
чья	чья
найдем	найдем
Слушай	Слушай
песнопение	песнопение
духовного	духовного
располагает	располагает
заклята	заклята
вороной	вороной
каплет	каплет
звездой	звездой
отверженный	отверженный
семь	семь
молился	молился
изнеможете	изнеможете
выносишь	выносишь
экспертизу	экспертизу
партеров	партеров
карфагенянам	карфагенянам
засыхай	засыхай
напустила	напустила
умудрился	умудрился
беззащитных	беззащитных
пожирала	пожирала
конденсатами	конденсатами
вспыхивало	вспыхивало
лицу	лицу
лучницу	лучницу
приветствуете	приветствуете
временных	временных
самаркандские	самаркандские
двойственность	двойственность
утих	утих
правосудием	правосудием
рыданию	рыданию
покрывать	покрывать
научился	научился
поцелую	поцелую
полтергейстами	полтергейстами
которою	которою
перлов	перлов
повозочной	повозочной
медвежатникам	медвежатникам
ахроматизм	ахроматизм
терминах	терминах
решился	решился
литом	литом
задумываем	задумываем
Три	Три
имеешь	имеешь
сторож	сторож
вела	вела
Киса	Киса
собранному	собранному
рассеките	рассеките
самую	самую
принужден	принужден
бухлу	бухлу
язвах	язвах
суди	суди
изменили	изменили
возносив	возносив
птичка	птичка
обличи	обличи
схожим	схожим
табуреткам	табуреткам
дали	дали
абаданец	абаданец
превозносящий	превозносящий
судить	судить
каждый	каждый
слепых	слепых
телефонной	телефонной
выдай	выдай
изволя	изволя
обновите	обновите
избранное	избранное
царствовали	царствовали
постыди	постыди
инертных	инертных
померкнув	померкнув
выступив	выступив
вывожу	вывожу
поникли	поникли
рукопашную	рукопашную
отрекитесь	отрекитесь
честолюбивые	честолюбивые
кадках	кадках
излишки	излишки
жилами	жилами
поджигая	поджигая
обмундированиями	обмундированиями
обе	обе
завладеть	завладеть
стремнистых	стремнистых
разбогател	разбогател
жаб	жаб
прудики	прудики
девчат	девчат
выслали	выслали
видимо	видимо
вытрите	вытрите
противодействующих	противодействующих
бесчестите	бесчестите
право	право
святая	святая
Над	Над
негодованием	негодованием
раздели	раздели
приклоните	приклоните
обновишь	обновишь
родила	родила
предсмертном	предсмертном
зеваем	зеваем
встревожили	встревожили
выбери	выбери
нарыве	нарыве
нарушали	нарушали
прямой	прямой
клипер	клипер
вылечивавший	вылечивавший
согрешишь	согрешишь
злы	злы
сожигать	сожигать
княгине	княгине
чтокаешь	чтокаешь
разбросайте	разбросайте
прославился	прославился
литой	литой
одушевленных	одушевленных
летев	летев
добыча	добыча
налагающий	налагающий
цели	цели
рада	рада
привалив	привалив
ничтожество	ничтожество
отдай	отдай
перебить	перебить
блудодействуют	блудодействуют
пленный	пленный
старта	старта
славянские	славянские
пленных	пленных
заручится	заручится
отпал	отпал
возрос	возрос
сами	сами
досадном	досадном
спасали	спасали
невеждам	невеждам
убить	убить
избавлю	избавлю
вспыхивал	вспыхивал
гумну	гумну
раскрытая	раскрытая
простираешь	простираешь
запустении	запустении
щеголом	щеголом
пролили	пролили
таитянин	таитянин
берет	берет
телеведущего	телеведущего
устроен	устроен
извещу	извещу
разбили	разбили
выказала	выказала
изгнать	изгнать
переправился	переправился
обгорела	обгорела
сверху	сверху
внутреннему	внутреннему
пожирали	пожирали
обгорел	обгорел
доказать	доказать
твердую	твердую
поморщилось	поморщилось
отягощай	отягощай
голов	голов
отворачивающий	отворачивающий
лесопарк	лесопарк
упоминаете	упоминаете
хотят	хотят
предъявляющийся	предъявляющийся
пожалел	пожалел
притворы	притворы
каждом	каждом
Они	Они
чьи	чьи
внимать	внимать
положи	положи
радикальных	радикальных
соделает	соделает
лицах	лицах
тесните	тесните
киноаппарат	киноаппарат
половиною	половиною
увещевали	увещевали
содержите	содержите
огорчить	огорчить
камню	камню
наняли	наняли
позавидовал	позавидовал
падишаха	падишаха
вывезли	вывезли
силуэтам	силуэтам
тысячи	тысячи
захотели	захотели
убывайте	убывайте
предавай	предавай
отрабатывал	отрабатывал
рукопашные	рукопашные
автомашинам	автомашинам
приукрашивает	приукрашивает
корму	корму
вина	вина
хранивший	хранивший
неровности	неровности
выть	выть
оградам	оградам
кадке	кадке
осквернился	осквернился
благовествуй	благовествуй
присоединяюсь	присоединяюсь
вмещать	вмещать
упоминавший	упоминавший
долгой	долгой
переложило	переложило
поддерживали	поддерживали
бакинцами	бакинцами
генерал-майора	генерал-майора
приведи	приведи
ждавший	ждавший
расплат	расплат
зафиксируете	зафиксируете
ножонкам	ножонкам
отличить	отличить
простецкую	простецкую
сели	сели
вытрут	вытрут
гневи	гневи
поспешив	поспешив
святым	святым
адвокате	адвокате
издерживать	издерживать
женьшенями	женьшенями
шлёпанцами	шлёпанцами
дошкольное	дошкольное
оставить	оставить
заключили	заключили
полу	полу
аннексией	аннексией
долгопятов	долгопятов
натянули	натянули
литому	литому
сторожах	сторожах
проводит	проводит
превозносите	превозносите
рубите	рубите
могу	могу
критической	критической
пели	пели
превозносила	превозносила
самодельной	самодельной
каждая	каждая
гумна	гумна
горек	горек
парижан	парижан
посохом	посохом
разгневали	разгневали
составили	составили
выбежал	выбежал
охраняй	охраняй
когереру	когереру
мою	мою
чувствительностью	чувствительностью
повелений	повелений
утвердите	утвердите
сбереги	сбереги
предсказывайте	предсказывайте
поправив	поправив
разожмем	разожмем
правых	правых
посерьезнеешь	посерьезнеешь
твою	твою
подходите	подходите
борщи	борщи
отборен	отборен
простираете	простираете
начали	начали
ЗАГСы	ЗАГСы
угробь	угробь
твердые	твердые
матерью	матерью
потаенного	потаенного
иссякало	иссякало
покройте	покройте
влезли	влезли
искала	искала
пред	пред
звать	звать
пустота	пустота
заключила	заключила
отлучился	отлучился
проводить	проводить
сказать	сказать
оцепенением	оцепенением
затыкали	затыкали
рассуждать	рассуждать
доставляла	доставляла
рассвирепел	рассвирепел
выносив	выносив
Тысячу	Тысячу
выстроить	выстроить
почитаю	почитаю
скверному	скверному
архиереям	архиереям
подбору	подбору
комментатором	комментатором
весёлым	весёлым
мокрую	мокрую
Котором	Котором
инертна	инертна
превознесли	превознесли
непродолжительна	непродолжительна
водовозным	водовозным
вводили	вводили
Нем	Нем
воспойте	воспойте
скоростного	скоростного
открытое	открытое
матерями	матерями
очищали	очищали
чужды	чужды
познайте	познайте
Мои	Мои
лицо	лицо
зенитчику	зенитчику
абакумыче	абакумыче
древесине	древесине
люди	люди
убывал	убывал
надо	надо
негодовании	негодовании
прогревать	прогревать
были	были
кровопролитием	кровопролитием
обжор	обжор
соблюди	соблюди
постигли	постигли
произвольный	произвольный
затыкает	затыкает
болеутоляющи	болеутоляющи
исполнительского	исполнительского
знойного	знойного
Которого	Которого
женевский	женевский
раскатанный	раскатанный
разбирайте	разбирайте
отвели	отвели
городовую	городовую
укрепился	укрепился
массировав	массировав
приблизить	приблизить
тысяча	тысяча
очистите	очистите
неподкупным	неподкупным
дай	дай
отделился	отделился
предавать	предавать
требовали	требовали
почернела	почернела
оставится	оставится
натапливавший	натапливавший
слепые	слепые
пьем	пьем
реабилитация	реабилитация
тьма	тьма
булавочных	булавочных
мыслить	мыслить
упросила	упросила
сагитировали	сагитировали
одаряйте	одаряйте
ракообразных	ракообразных
низринут	низринут
никакого	никакого
устроила	устроила
привела	привела
фторы	фторы
рубца	рубца
отвалят	отвалят
аншлюсах	аншлюсах
усилился	усилился
погонялась	погонялась
низринь	низринь
песнопениями	песнопениями
подаянию	подаянию
Дину	Дину
разорю	разорю
учили	учили
отдайте	отдайте
любить	любить
перетекая	перетекая
золото	золото
надевай	надевай
печатниках	печатниках
вооружите	вооружите
сосчитать	сосчитать
поехал	поехал
предавали	предавали
какая	какая
приспособился	приспособился
мифологии	мифологии
жокейская	жокейская
подкрепите	подкрепите
рубила	рубила
гумном	гумном
просите	просите
миновать	миновать
скакало	скакало
региональной	региональной
аминокислоту	аминокислоту
амстердамцы	амстердамцы
приверженцем	приверженцем
шоу-бизнесы	шоу-бизнесы
сведущего	сведущего
по	по
грабах	грабах
растапливаю	растапливаю
делали	делали
астробиологии	астробиологии
затрепетал	затрепетал
хранить	хранить
ширишь	ширишь
новой	новой
принадлежащую	принадлежащую
всходила	всходила
рассею	рассею
подражать	подражать
обнажен	обнажен
Лилия	Лилия
стартами	стартами
пловцы	пловцы
подняли	подняли
бордового	бордового
чужих	чужих
скакала	скакала
австралиек	австралиек
питай	питай
старому	старому
гражданско-правовых	гражданско-правовых
смолчав	смолчав
изменила	изменила
упали	упали
латинянину	латинянину
били	били
натянуть	натянуть
дыне	дыне
пил	пил
приготовить	приготовить
братьям	братьям
отдала	отдала
потребы	потребы
гномы	гномы
занято	занято
направить	направить
обесчестили	обесчестили
проводят	проводят
проводив	проводив
нерадит	нерадит
лев	лев
пухли	пухли
заваривают	заваривают
бесславить	бесславить
ожили	ожили
проклятого	проклятого
эту	эту
звёздами	звёздами
гражданско-правового	гражданско-правового
устное	устное
брани	брани
подпускав	подпускав
крестятся	крестятся
целых	целых
уничижали	уничижали
оном	оном
оздоровительной	оздоровительной
вопрошающий	вопрошающий
согрешить	согрешить
смешанный	смешанный
Иудину	Иудину
вьюгами	вьюгами
скуют	скуют
воздухоочиститель	воздухоочиститель
отделить	отделить
Твою	Твою
даровала	даровала
фазу	фазу
брюхе	брюхе
выговаривавшийся	выговаривавшийся
корявого	корявого
злою	злою
удалился	удалился
оврага	оврага
открывать	открывать
четверенькам	четверенькам
сфинкс	сфинкс
исполнительской	исполнительской
разведку	разведку
жилы	жилы
всходим	всходим
принесло	принесло
камнях	камнях
вколете	вколете
избирали	избирали
локализовала	локализовала
спорили	спорили
Марком	Марком
покрывали	покрывали
калужским	калужским
отринут	отринут
поджигала	поджигала
лотереи	лотереи
слизистое	слизистое
всемогущее	всемогущее
Матери	Матери
вычитания	вычитания
перенаселение	перенаселение
разделительным	разделительным
беззащитным	беззащитным
зуммерами	зуммерами
прогнать	прогнать
кричали	кричали
распространённое	распространённое
программой	программой
враждовать	враждовать
огибает	огибает
отличен	отличен
идентичным	идентичным
оскудели	оскудели
теснился	теснился
ввело	ввело
Яви	Яви
заразою	заразою
завещевали	завещевали
добро	добро
моли	моли
чужая	чужая
кончился	кончился
обатуре	обатуре
утечке	утечке
массируя	массируя
сверкание	сверкание
желанный	желанный
губишь	губишь
красные	красные
неправы	неправы
наступили	наступили
возьму	возьму
вишнёвого	вишнёвого
выгнали	выгнали
замерло	замерло
убедит	убедит
далёкому	далёкому
роду	роду
бесчестить	бесчестить
всякое	всякое
избрали	избрали
отплыл	отплыл
воспоминайте	воспоминайте
унизить	унизить
неотложек	неотложек
похвалился	похвалился
благословляй	благословляй
лучинами	лучинами
считаете	считаете
Пи	Пи
изгонять	изгонять
лесоводческий	лесоводческий
мальчишке	мальчишке
признайте	признайте
каждого	каждого
рассеянного	рассеянного
изумишь	изумишь
ступенька	ступенька
стильные	стильные
молчите	молчите
преследуйте	преследуйте
своем	своем
пустотам	пустотам
замедлите	замедлите
ксерокопией	ксерокопией
уговаривать	уговаривать
зол	зол
славите	славите
совершали	совершали
разит	разит
пудреном	пудреном
подгруппам	подгруппам
имело	имело
тысяченачальниками	тысяченачальниками
исполняй	исполняй
Бруклину	Бруклину
восклицать	восклицать
замечайте	замечайте
австрийском	австрийском
литая	литая
служи	служи
проклинайте	проклинайте
тройню	тройню
неувязки	неувязки
изменитесь	изменитесь
проклятых	проклятых
хвалили	хвалили
Израилевой	Израилевой
апокалипсису	апокалипсису
выговаривающий	выговаривающий
передвигают	передвигают
литых	литых
нахмурилась	нахмурилась
Мало	Мало
вознегодовал	вознегодовал
всемогущих	всемогущих
рассуждали	рассуждали
переспал	переспал
поняли	поняли
желала	желала
спасу	спасу
умалить	умалить
растите	растите
звезд	звезд
отаве	отаве
бутылями	бутылями
специальности	специальности
слагаю	слагаю
щадил	щадил
спорите	спорите
отавы	отавы
разгонись	разгонись
удалите	удалите
отведите	отведите
худ	худ
беременных	беременных
вредит	вредит
спрашивай	спрашивай
окружила	окружила
красоты	красоты
локализовав	локализовав
хвалился	хвалился
вспоминать	вспоминать
отключает	отключает
помнили	помнили
заинтересованность	заинтересованность
низине	низине
чувствительности	чувствительности
обесчестить	обесчестить
раздолья	раздолья
эпитафия	эпитафия
выдавай	выдавай
пасхальна	пасхальна
погребали	погребали
ножонок	ножонок
завершалась	завершалась
совершился	совершился
оказывайте	оказывайте
преподала	преподала
изменится	изменится
выпали	выпали
привить	привить
заковываю	заковываю
расположили	расположили
обваляй	обваляй
посвящай	посвящай
выводимый	выводимый
успокоили	успокоили
среды	среды
Сила	Сила
неверным	неверным
гуслист	гуслист
причинный	причинный
соевых	соевых
спрятали	спрятали
древесина	древесина
презирали	презирали
забирать	забирать
желающий	желающий
гарантирует	гарантирует
имея	имея
низина	низина
Кис	Кис
напился	напился
требовать	требовать
половина	половина
издавшись	издавшись
хоккейное	хоккейное
истощила	истощила
нему	нему
отыщите	отыщите
выполняла	выполняла
подражали	подражали
забыла	забыла
выводишь	выводишь
аболиционистской	аболиционистской
теснить	теснить
потухшего	потухшего
наши	наши
которых	которых
растянули	растянули
худом	худом
удовлетворилась	удовлетворилась
закричали	закричали
сделай	сделай
засел	засел
засохла	засохла
ветеркам	ветеркам
питать	питать
ожесточили	ожесточили
продолжали	продолжали
выстрелили	выстрелили
пасхальные	пасхальные
закрой	закрой
подняла	подняла
нехорошо	нехорошо
оплакивала	оплакивала
кидаре	кидаре
сравнить	сравнить
имущество	имущество
домбре	домбре
раздавали	раздавали
светило	светило
подстерегали	подстерегали
гола	гола
ними	ними
пьяною	пьяною
топтать	топтать
воссияло	воссияло
набрать	набрать
одетым	одетым
терафимов	терафимов
возвестила	возвестила
срывать	срывать
славящий	славящий
рассейте	рассейте
тематических	тематических
возьми	возьми
стекаются	стекаются
благословлять	благословлять
метрового	метрового
жилище	жилище
круиза	круиза
считают	считают
почетных	почетных
приказывала	приказывала
захлёстываниям	захлёстываниям
китайского	китайского
сказала	сказала
пузырьковую	пузырьковую
святом	святом
адвокатах	адвокатах
которой	которой
провожу	провожу
тюленёнка	тюленёнка
вылезаю	вылезаю
чужого	чужого
засвечиваюсь	засвечиваюсь
вешать	вешать
бюрократизма	бюрократизма
подбирай	подбирай
сатаны	сатаны
спустился	спустился
рабах	рабах
месте	месте
отрёкшийся	отрёкшийся
тверд	тверд
всходили	всходили
вили	вили
обнажи	обнажи
растил	растил
произвело	произвело
подвёртывался	подвёртывался
рукополагал	рукополагал
холодную	холодную
подходящей	подходящей
внучка	внучка
отошли	отошли
наг	наг
запоминания	запоминания
подумал	подумал
хулив	хулив
переложил	переложил
была	была
утешился	утешился
пожалели	пожалели
фотопулемёт	фотопулемёт
бубновые	бубновые
юркнет	юркнет
апории	апории
споры	споры
шести	шести
ножики	ножики
созывало	созывало
мал	мал
убедили	убедили
вызывали	вызывали
тестируют	тестируют
благоговели	благоговели
пробыть	пробыть
препроводить	препроводить
полюбовавшийся	полюбовавшийся
старческие	старческие
произвели	произвели
спроси	спроси
нечистою	нечистою
пылу	пылу
потекло	потекло
твоя	твоя
кровопролитен	кровопролитен
слеп	слеп
великую	великую
золотой	золотой
Твой	Твой
обрела	обрела
Самом	Самом
длинного	длинного
аккомпанементах	аккомпанементах
вещичку	вещичку
извратила	извратила
атмосферные	атмосферные
вступите	вступите
пьющий	пьющий
устрашили	устрашили
исполнительскую	исполнительскую
могло	могло
поручился	поручился
местом	местом
очищен	очищен
ожесточи	ожесточи
собранным	собранным
дайте	дайте
невежд	невежд
подбирала	подбирала
аквамарине	аквамарине
хоронить	хоронить
никакое	никакое
белых	белых
адепты	адепты
питает	питает
присоединяемся	присоединяемся
убит	убит
прискорбная	прискорбная
сказывай	сказывай
открывайте	открывайте
копить	копить
послужить	послужить
столпа	столпа
отними	отними
баллотировался	баллотировался
сожигают	сожигают
об	об
лизали	лизали
узнаю	узнаю
далёкую	далёкую
называть	называть
пребыли	пребыли
прямую	прямую
налагав	налагав
повторился	повторился
заклятыми	заклятыми
стекается	стекается
сионизм	сионизм
абляций	абляций
амстердамцев	амстердамцев
проезжая	проезжая
Одни	Одни
чиновнице	чиновнице
сухою	сухою
стену	стену
помышлять	помышлять
мертвых	мертвых
углового	углового
завершаться	завершаться
будь	будь
тысяченачальнику	тысяченачальнику
уставляйся	уставляйся
сгрузите	сгрузите
избираюсь	избираюсь
ожил	ожил
ветерка	ветерка
встретили	встретили
страноведению	страноведению
торту	торту
отвесно	отвесно
привозить	привозить
испытанного	испытанного
вешали	вешали
маслобойки	маслобойки
бранило	бранило
буера	буера
вылезал	вылезал
очисти	очисти
бела	бела
попкорнов	попкорнов
убийство	убийство
выпросили	выпросили
объедал	объедал
мельтешнях	мельтешнях
явили	явили
гербарии	гербарии
ином	ином
среди	среди
взывать	взывать
килобайт	килобайт
абаданцах	абаданцах
бутыли	бутыли
заколют	заколют
приходите	приходите
страноведением	страноведением
правые	правые
жребия	жребия
наполните	наполните
заразы	заразы
взаимозависимости	взаимозависимости
пища	пища
свекровь	свекровь
рубить	рубить
теснили	теснили
страдали	страдали
проповедуйте	проповедуйте
животных	животных
затишья	затишья
накалы	накалы
похорони	похорони
посох	посох
обозреть	обозреть
поладит	поладит
червонцы	червонцы
долгоносике	долгоносике
пораженцам	пораженцам
умилостивить	умилостивить
беременною	беременною
примиряемся	примиряемся
десятой	десятой
потребило	потребило
астраханском	астраханском
подвохи	подвохи
начинали	начинали
саранчою	саранчою
гадолиний	гадолиний
четвертой	четвертой
исцели	исцели
бесстрастным	бесстрастным
благовестить	благовестить
областеначальником	областеначальником
лирической	лирической
интегрируешься	интегрируешься
отыщи	отыщи
выберем	выберем
выломали	выломали
блёванный	блёванный
укативший	укативший
извратили	извратили
изготавливаются	изготавливаются
избрала	избрала
даровать	даровать
беззаконии	беззаконии
лад	лад
винное	винное
комнатушке	комнатушке
встревожился	встревожился
посчитанный	посчитанный
спидометры	спидометры
родишь	родишь
сопровождать	сопровождать
пробыл	пробыл
думайте	думайте
лежите	лежите
шоу-бизнесам	шоу-бизнесам
приписывают	приписывают
церкой	церкой
воплю	воплю
громоздили	громоздили
принимали	принимали
перечеркнула	перечеркнула
аппаратные	аппаратные
Иудиной	Иудиной
носили	носили
поправьте	поправьте
агванцев	агванцев
отнята	отнята
кутал	кутал
благочестием	благочестием
страшился	страшился
сторожа	сторожа
уснуть	уснуть
писакам	писакам
зарыдали	зарыдали
омывали	омывали
рыдали	рыдали
стесняющий	стесняющий
возделывали	возделывали
давиром	давиром
содержали	содержали
губящий	губящий
сомнительном	сомнительном
судебную	судебную
подкрепи	подкрепи
образ	образ
партий	партий
драматургами	драматургами
письма	письма
смутили	смутили
отсек	отсек
оказала	оказала
нечестии	нечестии
скрыли	скрыли
замечать	замечать
развалиною	развалиною
било	било
потекли	потекли
глядела	глядела
раскинули	раскинули
убийцы	убийцы
гаркнете	гаркнете
ослабели	ослабели
человекоубийца	человекоубийца
помогали	помогали
сердобольная	сердобольная
вологодским	вологодским
посрамился	посрамился
взыскать	взыскать
изменениям	изменениям
посерьёзнели	посерьёзнели
всякая	всякая
разрушен	разрушен
заваривали	заваривали
удивлении	удивлении
москвитянах	москвитянах
предметное	предметное
запоминались	запоминались
заключительной	заключительной
палит	палит
молодой	молодой
благотворите	благотворите
слепцами	слепцами
повеления	повеления
простирали	простирали
перекаливать	перекаливать
взирать	взирать
нечистых	нечистых
избранной	избранной
Лилиях	Лилиях
явился	явился
мог	мог
монополисту	монополисту
извратить	извратить
говорить	говорить
надел	надел
изнеженных	изнеженных
начал	начал
исследуй	исследуй
померкло	померкло
жилищами	жилищами
сквозного	сквозного
всевозможные	всевозможные
раба	раба
кураже	кураже
пух	пух
умилостивился	умилостивился
умножила	умножила
нарушить	нарушить
считать	считать
оборотили	оборотили
ненадежно	ненадежно
наихудшей	наихудшей
поехали	поехали
Приветствуй	Приветствуй
согрешив	согрешив
устремился	устремился
решали	решали
захлёстыванием	захлёстыванием
упоминать	упоминать
генитального	генитального
собрать	собрать
Моисееву	Моисееву
аудиторский	аудиторский
женственный	женственный
дозволяйте	дозволяйте
сидели	сидели
заклеймённый	заклеймённый
стоим	стоим
немой	немой
одолело	одолело
немало	немало
авторизацией	авторизацией
видимою	видимою
распознает	распознает
прочитайте	прочитайте
любимую	любимую
сироту	сироту
губим	губим
морю	морю
говорите	говорите
устремили	устремили
комплектации	комплектации
скрытого	скрытого
разрывал	разрывал
учился	учился
рассекали	рассекали
реабилитировал	реабилитировал
чьем	чьем
чадо	чадо
Будете	Будете
хулите	хулите
открыт	открыт
уподобился	уподобился
завихрениях	завихрениях
принципиальных	принципиальных
обветшало	обветшало
жив	жив
пристали	пристали
правильное	правильное
остановили	остановили
чем	чем
уклоняю	уклоняю
бедны	бедны
очистился	очистился
изготавливаюсь	изготавливаюсь
мною	мною
лоснимся	лоснимся
Царю	Царю
потребите	потребите
пути	пути
кокетничав	кокетничав
родных	родных
страдать	страдать
каков	каков
развратили	развратили
другого	другого
богатейшего	богатейшего
который	который
честным	честным
временным	временным
разности	разности
исполнили	исполнили
крыло	крыло
переставивший	переставивший
внимали	внимали
выкаливаете	выкаливаете
пузырьковым	пузырьковым
собирайте	собирайте
сохраняла	сохраняла
раздавить	раздавить
насадишь	насадишь
тысячам	тысячам
дозволяй	дозволяй
всплеска	всплеска
абсорбируешься	абсорбируешься
агломераты	агломераты
умножило	умножило
размышление	размышление
подумывают	подумывают
выполняйте	выполняйте
известит	известит
несмысленны	несмысленны
арматур	арматур
Надо	Надо
повторили	повторили
грызе	грызе
игумены	игумены
захуярив	захуярив
немалую	немалую
развеяла	развеяла
оборотился	оборотился
малые	малые
восстать	восстать
напечатавший	напечатавший
вытру	вытру
уподобить	уподобить
точил	точил
сими	сими
излить	излить
наш	наш
избирателей	избирателей
нестабильным	нестабильным
обирать	обирать
тяготили	тяготили
представляй	представляй
влепляющий	влепляющий
стерегла	стерегла
они	они
прекрати	прекрати
тысяченачальником	тысяченачальником
вынесли	вынесли
накренятся	накренятся
звёздам	звёздам
пасть	пасть
рассеете	рассеете
припали	припали
наполняйте	наполняйте
умножили	умножили
разбирать	разбирать
закричал	закричал
гидравлического	гидравлического
слизистые	слизистые
известите	известите
водить	водить
исследуйте	исследуйте
отягощать	отягощать
апокалипсисов	апокалипсисов
ним	ним
возвысился	возвысился
землетрясением	землетрясением
мультиком	мультиком
рассеяла	рассеяла
избивать	избивать
цепную	цепную
светите	светите
обгорели	обгорели
спите	спите
почётная	почётная
солнцестояний	солнцестояний
агульские	агульские
конденсатах	конденсатах
палить	палить
непродолжительную	непродолжительную
обставливает	обставливает
ввела	ввела
возвеличить	возвеличить
печаткой	печаткой
спросит	спросит
долгое	долгое
клиперами	клиперами
великой	великой
авторизаций	авторизаций
измерительную	измерительную
убийству	убийству
принятые	принятые
испытанные	испытанные
неверной	неверной
сладкие	сладкие
сим	сим
восстал	восстал
простите	простите
оцепенении	оцепенении
самаркандское	самаркандское
Моисеевым	Моисеевым
запрет	запрет
требуйте	требуйте
молодые	молодые
превознесем	превознесем
обратное	обратное
Святым	Святым
лотерей	лотерей
это	это
открыто	открыто
солении	солении
наполнила	наполнила
изменился	изменился
стервятников	стервятников
юливший	юливший
распознать	распознать
шали	шали
неординарен	неординарен
сатану	сатану
мультика	мультика
оставили	оставили
обмундированиям	обмундированиям
терафим	терафим
прибираю	прибираю
приобщимся	приобщимся
смели	смели
ожесточился	ожесточился
научили	научили
убогие	убогие
возносить	возносить
благом	благом
всю	всю
возносят	возносят
сестра	сестра
возвеличился	возвеличился
три	три
борщам	борщам
огибаю	огибаю
добыч	добыч
безоговорочна	безоговорочна
кинофильмами	кинофильмами
Жертва	Жертва
консульству	консульству
пленным	пленным
видали	видали
миллисекунды	миллисекунды
оных	оных
виден	виден
сумкообразном	сумкообразном
необрезаны	необрезаны
Господнем	Господнем
нехороша	нехороша
снискала	снискала
устрашился	устрашился
укрепи	укрепи
хулят	хулят
починайте	починайте
сковали	сковали
шкотиком	шкотиком
голыми	голыми
шапка	шапка
видим	видим
изливай	изливай
чужие	чужие
тверды	тверды
обзовет	обзовет
самодельного	самодельного
Возьму	Возьму
бедной	бедной
бедном	бедном
завозен	завозен
соделать	соделать
сытый	сытый
изливать	изливать
Тем	Тем
потерянною	потерянною
ловкостями	ловкостями
принадлежащие	принадлежащие
спросили	спросили
перенаселениях	перенаселениях
анкх	анкх
вьюгах	вьюгах
парализуя	парализуя
принимать	принимать
взаимностях	взаимностях
храню	храню
хранят	хранят
Твоя	Твоя
терпите	терпите
отступали	отступали
сатане	сатане
сосуществований	сосуществований
позвали	позвали
багами	багами
вноси	вноси
взглянуть	взглянуть
омывать	омывать
начертали	начертали
следующему	следующему
тихвинскому	тихвинскому
убийце	убийце
непостоянный	непостоянный
хордах	хордах
драгоценных	драгоценных
нарыва	нарыва
влез	влез
собраньях	собраньях
заглавие	заглавие
приземлишься	приземлишься
женщиной	женщиной
воспоминать	воспоминать
темных	темных
творили	творили
драматургам	драматургам
обручился	обручился
взяло	взяло
припомнишь	припомнишь
колбочкам	колбочкам
сформируемся	сформируемся
нажучу	нажучу
избавляйте	избавляйте
суставное	суставное
целовали	целовали
распашете	распашете
архиереями	архиереями
поручали	поручали
подсластители	подсластители
умерли	умерли
жилищ	жилищ
сумкообразный	сумкообразный
крылышке	крылышке
проломали	проломали
ассоциировала	ассоциировала
большевика	большевика
горькому	горькому
пластины	пластины
сосчитали	сосчитали
спросите	спросите
направился	направился
запоминаюсь	запоминаюсь
красоту	красоту
вещь	вещь
злого	злого
отгадать	отгадать
винных	винных
славив	славив
рассеяли	рассеяли
взяла	взяла
обличились	обличились
укрепить	укрепить
самом	самом
свекрови	свекрови
царями	царями
сему	сему
убитою	убитою
испытывайте	испытывайте
контролировавшийся	контролировавшийся
преследовали	преследовали
корчимся	корчимся
закрыла	закрыла
пожелали	пожелали
исполнить	исполнить
совету	совету
неутешительной	неутешительной
загорожу	загорожу
прославили	прославили
красного	красного
нуту	нуту
совершили	совершили
фанатами	фанатами
Тобою	Тобою
лирическое	лирическое
небесного	небесного
женевской	женевской
оправдать	оправдать
вколов	вколов
булавок	булавок
расположи	расположи
павильоном	павильоном
угробьте	угробьте
среду	среду
жутике	жутике
хотели	хотели
затворить	затворить
рассеку	рассеку
достаем	достаем
если	если
пустую	пустую
иррациональная	иррациональная
образе	образе
наполнить	наполнить
склоняй	склоняй
анкхи	анкхи
допытывалось	допытывалось
ядру	ядру
сидеть	сидеть
досадной	досадной
смешанною	смешанною
предъявляться	предъявляться
головою	головою
обрезывали	обрезывали
больше	больше
громоздите	громоздите
вине	вине
краны	краны
укрепили	укрепили
известили	известили
Сию	Сию
самый	самый
созреют	созреют
царям	царям
разгневал	разгневал
неправая	неправая
гаркнут	гаркнут
грабам	грабам
пролить	пролить
умножьте	умножьте
схоронили	схоронили
гадолиния	гадолиния
условливается	условливается
глядеть	глядеть
язвам	язвам
последовали	последовали
неба	неба
исправляли	исправляли
большой	большой
был	был
выдавайте	выдавайте
утихло	утихло
свесило	свесило
прям	прям
австрийским	австрийским
умоляли	умоляли
реши	реши
вмещала	вмещала
возвратить	возвратить
обирал	обирал
пребыло	пребыло
железобетонному	железобетонному
наполняй	наполняй
поступить	поступить
развалинам	развалинам
Хвали	Хвали
предоставитесь	предоставитесь
пистолете-пулемёте	пистолете-пулемёте
бел	бел
проклятую	проклятую
напоить	напоить
сестры	сестры
подумали	подумали
вложишься	вложишься
трубите	трубите
голосистая	голосистая
термины	термины
превозносили	превозносили
хранили	хранили
жребиев	жребиев
грохотала	грохотала
всесожжением	всесожжением
ехидного	ехидного
загнал	загнал
профессорами	профессорами
яви	яви
искушайте	искушайте
разбился	разбился
василька	василька
берете	берете
мертвого	мертвого
ехидное	ехидное
колпакам	колпакам
раскрытой	раскрытой
лицами	лицами
творить	творить
возопил	возопил
разодрали	разодрали
прорицателей	прорицателей
оставлять	оставлять
мамонтов	мамонтов
два	два
ободри	ободри
влепило	влепило
утвердили	утвердили
краткостью	краткостью
запекавшийся	запекавшийся
сожигали	сожигали
превозноси	превозноси
побратиму	побратиму
закрою	закрою
хребтами	хребтами
управляющий	управляющий
превозносит	превозносит
тысячах	тысячах
лучниками	лучниками
кругозоры	кругозоры
ладой	ладой
никакая	никакая
сострадать	сострадать
полагали	полагали
приблизился	приблизился
спецификаций	спецификаций
празднества	празднества
отыгрывающий	отыгрывающий
алхимику	алхимику
буркаете	буркаете
кульминациями	кульминациями
принесла	принесла
захвачу	захвачу
профессора	профессора
эгоист	эгоист
вам	вам
спутавшийся	спутавшийся
просила	просила
расслабленный	расслабленный
ненаказанно	ненаказанно
остригали	остригали
привозили	привозили
проклинай	проклинай
разбогатеть	разбогатеть
представляла	представляла
объявлялся	объявлялся
наказывали	наказывали
призовем	призовем
окружить	окружить
подчинен	подчинен
царях	царях
какой	какой
немы	немы
финиширующий	финиширующий
безлюдную	безлюдную
электродиагностика	электродиагностика
последовала	последовала
клинкерах	клинкерах
рехнулся	рехнулся
сообщества	сообщества
обратила	обратила
входное	входное
решающее	решающее
любимы	любимы
замедлили	замедлили
всякою	всякою
чтокая	чтокая
проломленный	проломленный
продолжало	продолжало
терпи	терпи
искало	искало
сокрытую	сокрытую
появлении	появлении
выдайте	выдайте
изгоняли	изгоняли
откормленный	откормленный
отнесла	отнесла
томлении	томлении
Марка	Марка
рассеянным	рассеянным
хлестну	хлестну
желать	желать
огорчали	огорчали
возделывать	возделывать
бросить	бросить
кончен	кончен
полупустое	полупустое
брюхоногого	брюхоногого
первые	первые
удовлетворился	удовлетворился
отнятого	отнятого
крылом	крылом
приносите	приносите
хорда	хорда
ждите	ждите
умирать	умирать
фундаментальный	фундаментальный
Мать	Мать
нечаянного	нечаянного
осетинке	осетинке
заняты	заняты
далёкой	далёкой
молили	молили
духовная	духовная
золовки	золовки
похоронен	похоронен
одною	одною
возливала	возливала
тысяче	тысяче
певший	певший
напоминайте	напоминайте
вышло	вышло
странствуя	странствуя
воздала	воздала
апатридах	апатридах
начать	начать
стерегли	стерегли
исследовали	исследовали
полтергейст	полтергейст
фаворитов	фаворитов
азиатки	азиатки
отняты	отняты
бакинцев	бакинцев
спецификации	спецификации
ослабеть	ослабеть
удерживай	удерживай
вероятным	вероятным
статуэтке	статуэтке
половинками	половинками
трогай	трогай
фаната	фаната
хлестнув	хлестнув
лоботрясом	лоботрясом
радиопередатчике	радиопередатчике
разорите	разорите
завладели	завладели
легкое	легкое
Возлюбленном	Возлюбленном
кидары	кидары
сексуальным	сексуальным
чему	чему
вынеси	вынеси
греческие	греческие
покачивать	покачивать
оба	оба
напоминать	напоминать
сохранили	сохранили
скрепите	скрепите
полы	полы
расплющивающий	расплющивающий
пасли	пасли
упоминало	упоминало
храбрец	храбрец
согрешу	согрешу
приводили	приводили
носить	носить
подпали	подпали
избить	избить
мамонте	мамонте
побудили	побудили
ожесточите	ожесточите
подумайте	подумайте
поёт	поёт
ксерокопированием	ксерокопированием
греческой	греческой
умышлять	умышлять
жребий	жребий
идентичной	идентичной
остановился	остановился
твори	твори
думать	думать
своя	своя
грешков	грешков
шестом	шестом
всходящий	всходящий
ратифицируете	ратифицируете
шапки	шапки
повысивший	повысивший
служите	служите
тематического	тематического
живом	живом
убедил	убедил
агванцам	агванцам
отдало	отдало
превозносим	превозносим
вороха	вороха
готское	готское
искушать	искушать
всплесков	всплесков
увиваем	увиваем
бесперспективный	бесперспективный
королькам	королькам
прошивают	прошивают
людях	людях
даруй	даруй
зенитчиком	зенитчиком
нечист	нечист
Матерь	Матерь
приклеить	приклеить
червонец	червонец
рубимый	рубимый
уставитесь	уставитесь
проломал	проломал
чехословацкого	чехословацкого
предкрылку	предкрылку
узнают	узнают
времени	времени
проси	проси
ходите	ходите
фараонах	фараонах
потакало	потакало
принеси	принеси
ноздрями	ноздрями
устрашить	устрашить
нержавеющего	нержавеющего
восклицали	восклицали
стояло	стояло
иных	иных
хрюкавший	хрюкавший
покрой	покрой
почернели	почернели
созвали	созвали
обо	обо
безвластные	безвластные
скапливала	скапливала
выливаешь	выливаешь
коллекционировала	коллекционировала
хвали	хвали
выросли	выросли
обветшали	обветшали
зеленого	зеленого
припекаете	припекаете
вычитаниях	вычитаниях
затворили	затворили
уславливался	уславливался
Самая	Самая
ручников	ручников
рассеянных	рассеянных
умирали	умирали
приступали	приступали
торопливой	торопливой
началом	началом
филологом	филологом
искомой	искомой
соблюдали	соблюдали
истощился	истощился
причинным	причинным
пали	пали
жало	жало
червяка	червяка
Одного	Одного
страдающий	страдающий
скакали	скакали
возлегли	возлегли
поговорить	поговорить
оставляли	оставляли
славил	славил
познаем	познаем
возьмете	возьмете
изгнанием	изгнанием
прибивало	прибивало
вишнёвыми	вишнёвыми
конкретной	конкретной
владычествовать	владычествовать
твари	твари
генитальным	генитальным
манна	манна
спрятать	спрятать
похоронить	похоронить
протянут	протянут
неверен	неверен
вводите	вводите
освободить	освободить
желали	желали
какую	какую
которого	которого
отринь	отринь
сохранился	сохранился
оживляй	оживляй
повторите	повторите
полую	полую
магазинчиком	магазинчиком
овладейте	овладейте
святою	святою
новые	новые
скрытая	скрытая
сканером	сканером
сухие	сухие
ломтиком	ломтиком
раздражить	раздражить
двумя	двумя
раздирать	раздирать
ввязываетесь	ввязываетесь
упоминайте	упоминайте
долгоносику	долгоносику
отнеси	отнеси
звезде	звезде
ксиву	ксиву
собрали	собрали
уснул	уснул
конъюнктуры	конъюнктуры
помнила	помнила
сама	сама
призови	призови
крахмальные	крахмальные
волшебника	волшебника
гинекологию	гинекологию
фазы	фазы
соорудите	соорудите
тварь	тварь
сомнительные	сомнительные
забормотавший	забормотавший
заручись	заручись
изумят	изумят
полиуретановому	полиуретановому
раздробляете	раздробляете
перестать	перестать
наклонили	наклонили
заглавий	заглавий
необрезанных	необрезанных
уверен	уверен
благоговеть	благоговеть
делить	делить
произносила	произносила
звездах	звездах
другом	другом
унывали	унывали
Божием	Божием
иссякать	иссякать
пчеле	пчеле
потухшим	потухшим
приспособятся	приспособятся
понять	понять
нашем	нашем
пересказывай	пересказывай
кульминации	кульминации
известивший	известивший
рентабельному	рентабельному
язвой	язвой
светят	светят
гармонике	гармонике
некрасива	некрасива
получите	получите
поправлявший	поправлявший
стрехи	стрехи
перекаливало	перекаливало
инфракрасную	инфракрасную
расслабив	расслабив
восходили	восходили
выговорите	выговорите
повстречать	повстречать
собранный	собранный
велико	велико
комнатушки	комнатушки
раскинуть	раскинуть
утомили	утомили
уговаривали	уговаривали
разодрала	разодрала
празднуйте	празднуйте
амбициозными	амбициозными
теменью	теменью
разорить	разорить
сторожем	сторожем
смущен	смущен
худа	худа
засыпать	засыпать
Вся	Вся
захоронения	захоронения
калужские	калужские
животными	животными
противостал	противостал
оказать	оказать
сковать	сковать
постройках	постройках
замедленный	замедленный
сироте	сироте
божествах	божествах
повысят	повысят
образую	образую
нарекли	нарекли
вторых	вторых
прибыли	прибыли
покрывало	покрывало
покрывала	покрывала
телефонен	телефонен
одну	одну
маньяках	маньяках
затворите	затворите
гребням	гребням
мурлычьте	мурлычьте
созывают	созывают
гумне	гумне
выдадите	выдадите
взывав	взывав
одетые	одетые
погрязли	погрязли
загоните	загоните
желало	желало
рыдать	рыдать
хотим	хотим
зазвонила	зазвонила
негодуете	негодуете
сербским	сербским
вороные	вороные
подкрепился	подкрепился
Оно	Оно
размерами	размерами
одолели	одолели
скрепить	скрепить
распознаем	распознаем
чужому	чужому
неувязке	неувязке
нашли	нашли
матери	матери
называли	называли
окрашивала	окрашивала
выдернете	выдернете
научи	научи
ванилином	ванилином
отрезал	отрезал
старыми	старыми
покачивав	покачивав
разоблачавшийся	разоблачавшийся
отяжелели	отяжелели
молчуна	молчуна
сия	сия
сбить	сбить
развратился	развратился
поселился	поселился
невежды	невежды
перцы	перцы
бойлером	бойлером
ткнись	ткнись
вылитая	вылитая
подборе	подборе
спуском	спуском
внутрь	внутрь
просеки	просеки
благословляйте	благословляйте
воспитывала	воспитывала
избежании	избежании
рабу	рабу
предали	предали
универсаму	универсаму
бросили	бросили
попускаешь	попускаешь
тверди	тверди
переключаются	переключаются
отложился	отложился
отправлять	отправлять
смирен	смирен
медлили	медлили
Жертвы	Жертвы
огорчен	огорчен
микрокатера	микрокатера
будничный	будничный
заключен	заключен
манны	манны
берем	берем
пухла	пухла
ходи	ходи
отлучите	отлучите
покрыли	покрыли
скрыла	скрыла
расплющиваешь	расплющиваешь
приоткрывшись	приоткрывшись
перлах	перлах
атлеток	атлеток
рассекли	рассекли
даруешь	даруешь
небесные	небесные
имели	имели
проклинали	проклинали
чтоб	чтоб
нового	нового
стояли	стояли
затишье	затишье
писаки	писаки
старческого	старческого
смел	смел
похвалили	похвалили
открой	открой
самое	самое
сахаридов	сахаридов
носильщикам	носильщикам
служанке	служанке
напоен	напоен
последуйте	последуйте
приложить	приложить
тьмы	тьмы
тортами	тортами
отведи	отведи
потерянной	потерянной
выпускаюсь	выпускаюсь
забивший	забивший
аншлюса	аншлюса
монументу	монументу
современность	современность
соавторствам	соавторствам
назидая	назидая
соблюдите	соблюдите
крупинки	крупинки
превратился	превратился
знакомого	знакомого
умножь	умножь
эпидемиологических	эпидемиологических
опалами	опалами
красный	красный
расспрос	расспрос
утешали	утешали
молодых	молодых
выпросился	выпросился
выполет	выполет
вымерла	вымерла
бедными	бедными
приковала	приковала
страшилищем	страшилищем
приношением	приношением
имперфекты	имперфекты
наводчиках	наводчиках
птичку	птичку
выдать	выдать
оскудела	оскудела
мирен	мирен
Мой	Мой
покрыла	покрыла
преступлении	преступлении
как	как
сии	сии
две	две
видите	видите
юлит	юлит
сади	сади
несдержанность	несдержанность
продемонстрируешься	продемонстрируешься
удерживать	удерживать
прославляй	прославляй
встроенного	встроенного
разговорчивого	разговорчивого
нагромождают	нагромождают
сёстрами	сёстрами
одет	одет
входите	входите
живых	живых
баги	баги
парламентскую	парламентскую
варили	варили
ассоциируете	ассоциируете
демонстрации	демонстрации
сними	сними
сострадали	сострадали
земляке	земляке
имбецилах	имбецилах
временной	временной
поменяется	поменяется
отправить	отправить
приветствуй	приветствуй
крылышко	крылышко
меньше	меньше
ожерельем	ожерельем
вороху	вороху
обратите	обратите
увещевать	увещевать
слушай	слушай
ворону	ворону
главных	главных
занимательная	занимательная
полупустых	полупустых
владеть	владеть
поспособствуете	поспособствуете
выдавать	выдавать
рубцом	рубцом
назидать	назидать
входных	входных
разных	разных
твердо	твердо
вологодское	вологодское
уи	уи
медлите	медлите
марсы	марсы
пересчитайте	пересчитайте
тоталитарной	тоталитарной
вытрешь	вытрешь
новое	новое
укрепляй	укрепляй
потребам	потребам
чье	чье
прибавите	прибавите
сверкающей	сверкающей
отступив	отступив
злоумыслила	злоумыслила
мережке	мережке
наклони	наклони
неразговорчивым	неразговорчивым
окрошке	окрошке
выводя	выводя
аромунок	аромунок
австрийца	австрийца
зуммера	зуммера
растишь	растишь
выдаст	выдаст
умерщвляй	умерщвляй
пророчествуй	пророчествуй
большом	большом
поражался	поражался
пугал	пугал
празднуй	празднуй
наскучили	наскучили
устаивалось	устаивалось
стоите	стоите
семи	семи
бухло	бухло
открывали	открывали
агульской	агульской
слепой	слепой
эпитафии	эпитафии
платите	платите
Святом	Святом
твердое	твердое
роптать	роптать
рукомойником	рукомойником
возвратите	возвратите
выстоишь	выстоишь
проклятые	проклятые
терафима	терафима
всяком	всяком
заперла	заперла
Моем	Моем
живою	живою
обыграешь	обыграешь
чехословацкий	чехословацкий
простирала	простирала
ожидали	ожидали
дружины	дружины
страшного	страшного
похвалить	похвалить
возлюбленной	возлюбленной
приветствовали	приветствовали
преуспевать	преуспевать
диспуту	диспуту
поношением	поношением
взаимодействовал	взаимодействовал
захватило	захватило
клеветнической	клеветнической
посрами	посрами
главы	главы
расслабила	расслабила
дщери	дщери
преподали	преподали
мгновенную	мгновенную
псарня	псарня
озадачено	озадачено
своротила	своротила
сказывайте	сказывайте
недопивая	недопивая
бюрократизмами	бюрократизмами
чиновница	чиновница
нимфы	нимфы
ритмического	ритмического
зарыдал	зарыдал
поселили	поселили
пострадать	пострадать
напоила	напоила
маклерам	маклерам
восемь	восемь
совместны	совместны
билом	билом
плеснуть	плеснуть
объедать	объедать
зафиксируем	зафиксируем
камни	камни
телеведущим	телеведущим
случай	случай
отринув	отринув
сравните	сравните
разумеешь	разумеешь
впитана	впитана
ехидным	ехидным
овцою	овцою
главного	главного
лгали	лгали
разматываете	разматываете
кричите	кричите
приготовила	приготовила
труби	труби
доброю	доброю
верующий	верующий
увещевай	увещевай
миновали	миновали
выкопай	выкопай
омыть	омыть
бесчестили	бесчестили
самой	самой
сохрани	сохрани
воронов	воронов
познать	познать
прилагай	прилагай
ношениям	ношениям
соверши	соверши
чинили	чинили
царит	царит
откажу	откажу
самою	самою
Приветствует	Приветствует
сажали	сажали
слушать	слушать
ела	ела
кидав	кидав
издерживали	издерживали
отказывал	отказывал
раздосадованные	раздосадованные
всплывайте	всплывайте
царили	царили
лесомелиоративные	лесомелиоративные
сердечно-сосудистой	сердечно-сосудистой
повис	повис
повисла	повисла
рассеял	рассеял
твердым	твердым
выводи	выводи
Стану	Стану
звёзд	звёзд
окружите	окружите
воззовем	воззовем
кранами	кранами
прискорбное	прискорбное
другие	другие
одни	одни
опротивело	опротивело
причастие	причастие
замещениям	замещениям
землетрясении	землетрясении
критического	критического
преклонили	преклонили
первых	первых
симфонических	симфонических
прибавляй	прибавляй
чужом	чужом
всходив	всходив
небом	небом
подоспеешь	подоспеешь
долгопяту	долгопяту
милашку	милашку
заклят	заклят
плюхаюсь	плюхаюсь
обитать	обитать
сатана	сатана
братьями	братьями
немногие	немногие
милашке	милашке
темным	темным
ослабевайте	ослабевайте
пишем	пишем
убитой	убитой
награбило	награбило
запекались	запекались
знакомые	знакомые
оскорблять	оскорблять
падите	падите
удочерите	удочерите
твердых	твердых
переночевали	переночевали
какие	какие
удали	удали
всякого	всякого
дороге	дороге
пустою	пустою
хваливший	хваливший
сокрой	сокрой
змею	змею
отнял	отнял
умножу	умножу
говорили	говорили
иным	иным
желай	желай
дворового	дворового
произносить	произносить
судебной	судебной
причесавший	причесавший
расти	расти
мельтешни	мельтешни
зелени	зелени
приклеим	приклеим
испекли	испекли
тьмою	тьмою
хвалит	хвалит
собранной	собранной
отвесного	отвесного
тропосферы	тропосферы
читали	читали
поручили	поручили
заключительных	заключительных
пощадите	пощадите
автотомии	автотомии
аккомпанементам	аккомпанементам
самостоятельностью	самостоятельностью
миниатюрную	миниатюрную
осквернили	осквернили
выслушали	выслушали
воскрешаю	воскрешаю
разведках	разведках
распорядками	распорядками
явить	явить
дедское	дедское
минимум	минимум
воссиял	воссиял
опьянел	опьянел
красочной	красочной
возмутили	возмутили
слышали	слышали
легли	легли
мраморному	мраморному
вострепетал	вострепетал
частых	частых
оскорбляли	оскорбляли
благороден	благороден
привезли	привезли
претенциозную	претенциозную
приглаживало	приглаживало
произвела	произвела
уду	уду
падали	падали
деля	деля
прилагать	прилагать
рад	рад
надевать	надевать
лужичанине	лужичанине
соорудила	соорудила
горькою	горькою
откормленные	откормленные
стремнистого	стремнистого
эта	эта
внучках	внучках
мутите	мутите
чад	чад
пощадило	пощадило
вопрошать	вопрошать
леших	леших
святого	святого
компьютерные	компьютерные
выкаливать	выкаливать
другою	другою
снимите	снимите
налагают	налагают
хотела	хотела
соедини	соедини
ненавидела	ненавидела
сокройте	сокройте
духовной	духовной
образа	образа
замышляй	замышляй
познают	познают
отвердений	отвердений
сожгли	сожгли
матерях	матерях
томлению	томлению
пленные	пленные
заклятые	заклятые
квадранты	квадранты
гармоникам	гармоникам
вознегодовали	вознегодовали
мертвый	мертвый
отпускайте	отпускайте
горды	горды
ходу	ходу
исландцев	исландцев
выговаривали	выговаривали
советчиками	советчиками
суставного	суставного
данников	данников
насажу	насажу
явок	явок
научить	научить
трамвайным	трамвайным
положен	положен
спускам	спускам
петля	петля
гусеница	гусеница
слепого	слепого
честные	честные
потаённого	потаённого
вся	вся
поднял	поднял
претендовал	претендовал
изливали	изливали
духовному	духовному
посвящать	посвящать
логотипу	логотипу
лег	лег
страшить	страшить
производите	производите
твердом	твердом
коряво	коряво
прочитать	прочитать
возвратили	возвратили
пыли	пыли
горьких	горьких
финалью	финалью
собирай	собирай
остановить	остановить
покой	покой
ветвям	ветвям
иссохли	иссохли
разделили	разделили
ради	ради
нажучат	нажучат
написал	написал
налагайте	налагайте
наводчиками	наводчиками
произнесли	произнесли
отпирать	отпирать
потонули	потонули
неподдельного	неподдельного
бросила	бросила
учи	учи
Тобой	Тобой
слушали	слушали
мне	мне
приклонился	приклонился
сверит	сверит
странствуйте	странствуйте
полированна	полированна
обвязывай	обвязывай
дорогой	дорогой
живым	живым
колечкам	колечкам
подсластителям	подсластителям
уразумейте	уразумейте
говорила	говорила
каплют	каплют
кипчак	кипчак
сооружённый	сооружённый
тысяченачальникам	тысяченачальникам
вступить	вступить
возмутился	возмутился
вышки	вышки
жилища	жилища
старою	старою
откройте	откройте
хрюкали	хрюкали
томишь	томишь
спросим	спросим
сказывать	сказывать
женьшени	женьшени
восхотели	восхотели
поручи	поручи
червовой	червовой
остригаешь	остригаешь
изнеженный	изнеженный
головах	головах
переспите	переспите
прокаженные	прокаженные
роптали	роптали
постиг	постиг
кормите	кормите
конъюнктурах	конъюнктурах
предка	предка
соединился	соединился
разматываешь	разматываешь
обрели	обрели
вонзила	вонзила
отпирали	отпирали
прожил	прожил
чужим	чужим
предсмертна	предсмертна
спросив	спросив
холодной	холодной
восхотел	восхотел
пожалело	пожалело
спустили	спустили
пройду	пройду
девушки	девушки
вернет	вернет
грязями	грязями
узнала	узнала
главным	главным
управлять	управлять
невежда	невежда
огнищан	огнищан
старинном	старинном
царскою	царскою
нетронутым	нетронутым
растили	растили
уведомляющий	уведомляющий
сразила	сразила
инфракрасной	инфракрасной
разрывают	разрывают
немому	немому
чтобы	чтобы
отсекли	отсекли
условливалось	условливалось
ксерокопии	ксерокопии
окружали	окружали
утешить	утешить
двойственности	двойственности
матерь	матерь
губит	губит
отягощала	отягощала
удерживайте	удерживайте
большого	большого
вашу	вашу
сделала	сделала
сказали	сказали
волноломам	волноломам
пумам	пумам
прибыла	прибыла
выкупали	выкупали
Она	Она
выпучите	выпучите
взывали	взывали
налетело	налетело
сосуществованиях	сосуществованиях
предки	предки
жертвы	жертвы
признают	признают
принятая	принятая
решимостью	решимостью
разуметь	разуметь
начерпала	начерпала
спросило	спросило
удалить	удалить
бузиной	бузиной
разбросали	разбросали
неверного	неверного
литую	литую
отвален	отвален
превозносило	превозносило
одаряешь	одаряешь
отключаешь	отключаешь
дохну	дохну
наполни	наполни
трепетной	трепетной
открытых	открытых
заклятых	заклятых
допускать	допускать
судите	судите
неверия	неверия
имеющий	имеющий
имеет	имеет
пленили	пленили
славили	славили
агломератам	агломератам
лучникам	лучникам
областеначальники	областеначальники
вторичным	вторичным
рассеянный	рассеянный
посинения	посинения
порист	порист
изо	изо
вооружайтесь	вооружайтесь
самым	самым
круиз	круиз
гипонимам	гипонимам
жалобе	жалобе
излился	излился
использовыванный	использовыванный
лесомелиоративной	лесомелиоративной
выводивший	выводивший
составлять	составлять
смолчало	смолчало
уронить	уронить
молодом	молодом
утаивайте	утаивайте
дало	дало
хвалишь	хвалишь
укатишь	укатишь
обращённой	обращённой
одолеть	одолеть
любила	любила
мало	мало
помилуй	помилуй
спрашивали	спрашивали
тысячу	тысячу
бузину	бузину
лежали	лежали
выстроиться	выстроиться
микрокатерах	микрокатерах
сам	сам
празднестве	празднестве
соделались	соделались
скверен	скверен
прозрел	прозрел
гипонимах	гипонимах
прищурила	прищурила
родившая	родившая
вестовым	вестовым
торжествуйте	торжествуйте
скрыты	скрыты
обёртки	обёртки
поднятою	поднятою
орудии	орудии
разматывать	разматывать
открытою	открытою
прокаженным	прокаженным
взять	взять
приносить	приносить
езди	езди
представлять	представлять
пуме	пуме
светила	светила
води	води
Самого	Самого
дерзновении	дерзновении
напялишь	напялишь
блуждать	блуждать
есть	есть
качка	качка
заворчало	заворчало
аболиционистское	аболиционистское
ищи	ищи
чтили	чтили
апатрида	апатрида
взяли	взяли
арменисте	арменисте
похороните	похороните
композиционные	композиционные
продолжала	продолжала
вложились	вложились
приступили	приступили
семинары	семинары
горько	горько
условии	условии
претендующий	претендующий
данник	данник
благородному	благородному
узнай	узнай
литым	литым
опустошили	опустошили
ремонтам	ремонтам
прямым	прямым
правый	правый
малый	малый
возвещу	возвещу
красив	красив
ехидны	ехидны
гинекологий	гинекологий
Царя	Царя
осквернить	осквернить
умножился	умножился
язва	язва
принять	принять
некрасивый	некрасивый
вырос	вырос
мифологию	мифологию
тюленятами	тюленятами
пострадали	пострадали
пугать	пугать
темень	темень
рехнись	рехнись
передайся	передайся
пшека	пшека
адептах	адептах
нагою	нагою
приготовился	приготовился
солнцестояние	солнцестояние
написанное	написанное
выводим	выводим
слушала	слушала
сел	сел
предсказывали	предсказывали
презент	презент
первое	первое
избранные	избранные
которое	которое
сжимаешь	сжимаешь
топчемся	топчемся
заколешь	заколешь
разделительной	разделительной
червь	червь
красных	красных
травы	травы
дружинами	дружинами
лучниц	лучниц
тысяченачальника	тысяченачальника
пить	пить
доставляй	доставляй
прибавить	прибавить
исследовал	исследовал
эгоисте	эгоисте
сторожу	сторожу
домой	домой
пострадал	пострадал
лишен	лишен
поядал	поядал
воплем	воплем
влеплю	влеплю
оказывать	оказывать
отступили	отступили
Свои	Свои
утерпишь	утерпишь
попойкой	попойкой
жертве	жертве
чувяках	чувяках
попирали	попирали
труса	труса
звала	звала
окрашивать	окрашивать
разорят	разорят
образцами	образцами
раздолье	раздолье
отрыгивала	отрыгивала
актёрской	актёрской
возлагали	возлагали
вывело	вывело
очистили	очистили
отряхивались	отряхивались
благо	благо
ждал	ждал
возвестили	возвестили
склонился	склонился
преступлением	преступлением
искажаете	искажаете
неясным	неясным
добычу	добычу
приукрашивающий	приукрашивающий
быть	быть
любимых	любимых
начала	начала
обвязывать	обвязывать
ней	ней
позвала	позвала
дохни	дохни
скрытых	скрытых
главу	главу
сем	сем
взмокают	взмокают
поправляем	поправляем
перерезал	перерезал
великою	великою
перебрасываешь	перебрасываешь
взывавший	взывавший
неправые	неправые
рекомендуйся	рекомендуйся
читать	читать
худо	худо
лососёвую	лососёвую
взмокающий	взмокающий
отыгрывал	отыгрывал
жертвою	жертвою
река	река
хребтах	хребтах
шубу	шубу
перейди	перейди
твердая	твердая
отвалит	отвалит
носила	носила
кровопролитии	кровопролитии
узнаете	узнаете
произошло	произошло
экспертизой	экспертизой
дома	дома
толкали	толкали
покрывал	покрывал
выстроился	выстроился
лекарях	лекарях
Святых	Святых
разоришь	разоришь
совершить	совершить
возвестят	возвестят
познала	познала
богатейшим	богатейшим
сгрузивший	сгрузивший
новым	новым
согрешите	согрешите
злоумышленный	злоумышленный
следовали	следовали
обратили	обратили
приступив	приступив
утечек	утечек
смутить	смутить
вину	вину
целом	целом
наполняло	наполняло
уцелело	уцелело
обратного	обратного
Возлюбленный	Возлюбленный
старинны	старинны
отнесли	отнесли
варите	варите
поступили	поступили
немым	немым
горькую	горькую
видеозаписями	видеозаписями
булавочной	булавочной
оскверните	оскверните
свернулись	свернулись
наполнился	наполнился
металлургической	металлургической
трусы	трусы
задумываете	задумываете
бункером	бункером
пролетают	пролетают
перца	перца
обрёкши	обрёкши
выступите	выступите
хаосам	хаосам
повесившийся	повесившийся
брали	брали
размере	размере
иная	иная
тому	тому
горького	горького
вонзили	вонзили
люби	люби
жилищу	жилищу
превышает	превышает
открытым	открытым
возливали	возливали
принятую	принятую
расположен	расположен
прельстить	прельстить
программами	программами
очистить	очистить
разделила	разделила
засели	засели
оживлять	оживлять
парус	парус
язычески	язычески
превышением	превышением
временные	временные
дщерь	дщерь
дугообразная	дугообразная
растерзали	растерзали
испёкшийся	испёкшийся
немногое	немногое
попойках	попойках
двум	двум
половец	половец
читай	читай
отослать	отослать
хулили	хулили
жило	жило
ели	ели
специальностей	специальностей
завещевайте	завещевайте
обличать	обличать
разорил	разорил
внутреннем	внутреннем
аркада	аркада
языческую	языческую
странствуем	странствуем
воздать	воздать
стояла	стояла
размётывая	размётывая
Он	Он
бабёнки	бабёнки
тайною	тайною
копиркам	копиркам
владычествовали	владычествовали
поднято	поднято
выводящий	выводящий
выслать	выслать
разорила	разорила
разводить	разводить
прибиравший	прибиравший
посылала	посылала
отчайся	отчайся
непредвиденна	непредвиденна
налагала	налагала
добыче	добыче
учить	учить
назвала	назвала
разделить	разделить
напали	напали
поцелуй	поцелуй
просты	просты
преодолению	преодолению
пев	пев
подражайте	подражайте
выказать	выказать
соорудил	соорудил
отрабатывайте	отрабатывайте
современности	современности
главные	главные
отсечь	отсечь
набрали	набрали
приписывала	приписывала
написанные	написанные
заколают	заколают
сморкая	сморкая
служила	служила
далёкая	далёкая
другой	другой
испытанном	испытанном
далёким	далёким
нанять	нанять
огорчился	огорчился
генерал-майоров	генерал-майоров
объявлявшийся	объявлявшийся
завтрашнем	завтрашнем
фаворит	фаворит
подстерегать	подстерегать
парадокса	парадокса
гидравлические	гидравлические
презенты	презенты
исцеляла	исцеляла
латинизаций	латинизаций
всевозможного	всевозможного
антикварки	антикварки
царю	царю
кончили	кончили
караимское	караимское
велик	велик
могли	могли
изоляторе	изоляторе
припал	припал
останови	останови
заключи	заключи
служить	служить
испытанных	испытанных
грамотностях	грамотностях
тяжестями	тяжестями
притворился	притворился
срач	срач
оградах	оградах
клипа	клипа
вылезать	вылезать
узнаешь	узнаешь
управляй	управляй
произносили	произносили
смешанной	смешанной
рассказывали	рассказывали
аркадах	аркадах
обладать	обладать
наслышусь	наслышусь
искажай	искажай
потаённое	потаённое
вари	вари
черви	черви
взмыв	взмыв
разжал	разжал
заколали	заколали
смелея	смелея
пригласитесь	пригласитесь
медпункты	медпункты
отяжелело	отяжелело
батуты	батуты
финали	финали
разгонюсь	разгонюсь
слышим	слышим
воспели	воспели
разбит	разбит
опротивел	опротивел
сионизма	сионизма
скрывай	скрывай
нами	нами
отринутый	отринутый
поднимали	поднимали
чреватое	чреватое
зимой	зимой
искали	искали
напустивший	напустивший
плётка	плётка
заперли	заперли
посули	посули
бризу	бризу
оплодотворявший	оплодотворявший
чертях	чертях
растивший	растивший
расслабило	расслабило
варить	варить
которые	которые
тверда	тверда
из	из
колечке	колечке
калач	калач
желтков	желтков
убийц	убийц
составился	составился
превозносить	превозносить
узнает	узнает
домбры	домбры
выступили	выступили
неверных	неверных
засвечивайся	засвечивайся
судили	судили
исполним	исполним
славистики	славистики
удочерила	удочерила
карфагенян	карфагенян
обращена	обращена
Сделали	Сделали
изреки	изреки
выпала	выпала
шерстяные	шерстяные
медпунктов	медпунктов
встречных	встречных
передвигай	передвигай
отстали	отстали
завтрашнему	завтрашнему
оправдай	оправдай
крестился	крестился
научен	научен
лучин	лучин
пересказывать	пересказывать
найди	найди
избежанию	избежанию
нарекла	нарекла
почитайте	почитайте
расслабят	расслабят
крымскотатарского	крымскотатарского
уя	уя
вело	вело
завозне	завозне
скопца	скопца
восхищения	восхищения
родословным	родословным
доли	доли
обманщика	обманщика
нам	нам
манною	манною
точиле	точиле
апоптозов	апоптозов
антигельминтного	антигельминтного
имевшие	имевшие
набивайся	набивайся
унизился	унизился
захуярим	захуярим
отсечённый	отсечённый
второю	второю
совратить	совратить
пройди	пройди
абсорбируемся	абсорбируемся
четвертою	четвертою
всходите	всходите
главврачу	главврачу
хулить	хулить
скрытой	скрытой
неровностью	неровностью
растянула	растянула
храните	храните
служителе	служителе
слушающий	слушающий
солениям	солениям
Своем	Своем
некрасивое	некрасивое
Свой	Свой
романских	романских
достать	достать
скрывать	скрывать
малом	малом
воссиять	воссиять
пчёлах	пчёлах
разбудила	разбудила
интегрируетесь	интегрируетесь
преуспевайте	преуспевайте
превозносишь	превозносишь
созрели	созрели
сказывали	сказывали
Сии	Сии
управляли	управляли
заимствовании	заимствовании
двойки	двойки
уставился	уставился
засевай	засевай
рабою	рабою
делавшийся	делавшийся
латинян	латинян
оптимистического	оптимистического
научите	научите
утверди	утверди
странствующий	странствующий
приземлилась	приземлилась
детях	детях
избранного	избранного
расслабь	расслабь
злой	злой
принято	принято
доказали	доказали
усилили	усилили
таитянах	таитянах
самых	самых
бедна	бедна
домом	домом
облокотятся	облокотятся
простирает	простирает
правильным	правильным
ловкостях	ловкостях
слагайте	слагайте
кадила	кадила
ведите	ведите
имбецилом	имбецилом
приближения	приближения
парадоксе	парадоксе
возносили	возносили
мести	мести
развязала	развязала
рукомойников	рукомойников
знойному	знойному
засохло	засохло
воспрепятствовал	воспрепятствовал
злых	злых
написали	написали
сразился	сразился
возвестит	возвестит
показывать	показывать
допускали	допускали
обитая	обитая
щеглят	щеглят
собирали	собирали
эпидемиологического	эпидемиологического
одетый	одетый
вылезающий	вылезающий
жертвам	жертвам
накрывшийся	накрывшийся
претенциозных	претенциозных
покушалась	покушалась
пассивный	пассивный
литые	литые
храбрецов	храбрецов
приняла	приняла
смотри	смотри
рифмой	рифмой
дельтапланы	дельтапланы
взирали	взирали
предвыборная	предвыборная
восходите	восходите
пространственным	пространственным
возлюбленным	возлюбленным
почетного	почетного
отступите	отступите
условливайтесь	условливайтесь
воспитывайте	воспитывайте
тысячами	тысячами
белом	белом
немого	немого
сформировался	сформировался
принята	принята
ввели	ввели
пузырьковая	пузырьковая
выкупить	выкупить
звездам	звездам
нормативна	нормативна
падишахом	падишахом
парламентское	парламентское
искать	искать
контролируются	контролируются
ехидна	ехидна
педантов	педантов
отважен	отважен
возноси	возноси
устроить	устроить
свешенный	свешенный
большою	большою
напоили	напоили
встретить	встретить
возвращен	возвращен
снабжайте	снабжайте
побратимам	побратимам
глухого	глухого
благи	благи
приказывали	приказывали
исполняйте	исполняйте
правым	правым
восклицайте	восклицайте
впереди	впереди
согласного	согласного
нечаянным	нечаянным
сжимали	сжимали
подступившийся	подступившийся
потакав	потакав
поядает	поядает
нынешнему	нынешнему
идентичную	идентичную
рубили	рубили
педанту	педанту
монополиста	монополиста
композиционна	композиционна
утолю	утолю
просить	просить
каждых	каждых
вышкам	вышкам
имейте	имейте
лишили	лишили
мала	мала
умоляла	умоляла
сообществе	сообществе
вывез	вывез
надели	надели
самого	самого
звёзды	звёзды
уничижила	уничижила
воевать	воевать
добра	добра
подвиг	подвиг
малого	малого
протяни	протяни
изнемогший	изнемогший
простерли	простерли
пазникам	пазникам
призывали	призывали
дорогою	дорогою
предназначением	предназначением
огнищанам	огнищанам
краткости	краткости
четвёртую	четвёртую
плеснул	плеснул
тоталитарное	тоталитарное
неотложке	неотложке
брюхоногий	брюхоногий
двоек	двоек
Возьмет	Возьмет
хрюкая	хрюкая
отказать	отказать
говорящих	говорящих
спит	спит
гей-парада	гей-парада
сладкою	сладкою
сбили	сбили
обманщиками	обманщиками
воздухоочистители	воздухоочистители
чести	чести
распростерли	распростерли
нечистоту	нечистоту
возвестил	возвестил
отошлите	отошлите
рубил	рубил
чешет	чешет
нехороши	нехороши
садили	садили
впала	впала
погреби	погреби
выгнать	выгнать
посылали	посылали
сердобольной	сердобольной
гидростанции	гидростанции
встать	встать
прямая	прямая
расслабит	расслабит
прогревав	прогревав
враждовали	враждовали
Это	Это
слушайте	слушайте
сошли	сошли
муэдзина	муэдзина
отдали	отдали
затрепетали	затрепетали
субботним	субботним
возвысить	возвысить
жилищам	жилищам
клеветническая	клеветническая
смутился	смутился
объединяются	объединяются
ксивах	ксивах
имеют	имеют
сокрушен	сокрушен
самые	самые
родит	родит
храним	храним
добавлениях	добавлениях
срывали	срывали
предавала	предавала
кутающий	кутающий
предшествовать	предшествовать
возливать	возливать
марафону	марафону
выломать	выломать
поладил	поладил
летевший	летевший
куражам	куражам
поступите	поступите
фурункулами	фурункулами
доставляло	доставляло
животным	животным
хотите	хотите
оплакивали	оплакивали
обратился	обратился
чужой	чужой
пистолеты-пулемёты	пистолеты-пулемёты
девушках	девушках
рассказывайте	рассказывайте
утешения	утешения
силуэте	силуэте
вознесли	вознесли
проезжал	проезжал
пинать	пинать
превозмогла	превозмогла
камнем	камнем
прибивай	прибивай
призовые	призовые
минуло	минуло
вспоминали	вспоминали
крымскотатарскому	крымскотатарскому
мутить	мутить
транспортировках	транспортировках
страшилищ	страшилищ
язвою	язвою
немые	немые
Вил	Вил
потаённым	потаённым
каждым	каждым
воронам	воронам
увеличился	увеличился
сохраните	сохраните
жали	жали
воскликнул	воскликнул
вперед	вперед
хулишь	хулишь
непредвиденном	непредвиденном
полагать	полагать
плену	плену
прославлять	прославлять
шёлкопрядильни	шёлкопрядильни
пейте	пейте
аттометр	аттометр
нержавеющим	нержавеющим
ездя	ездя
шуруп	шуруп
заимствования	заимствования
сближавшийся	сближавшийся
Моисеевой	Моисеевой
сахариде	сахариде
узнали	узнали
исправлять	исправлять
литое	литое
изделием	изделием
растапливают	растапливают
миру	миру
стихотворения	стихотворения
любимый	любимый
зеваешь	зеваешь
вылечиваем	вылечиваем
умолять	умолять
мраморная	мраморная
подкрепили	подкрепили
выпал	выпал
лиц	лиц
паническим	паническим
выслушай	выслушай
благодарили	благодарили
распорядку	распорядку
антикварках	антикварках
прямыми	прямыми
напечатают	напечатают
пойте	пойте
оздоровительного	оздоровительного
посохи	посохи
Святого	Святого
своротить	своротить
жутику	жутику
признали	признали
создали	создали
продали	продали
целые	целые
жила	жила
вникающий	вникающий
смирить	смирить
мертвые	мертвые
возвестить	возвестить
переставили	переставили
сковало	сковало
прочитай	прочитай
последуй	последуй
пили	пили
встречном	встречном
совершила	совершила
умирающий	умирающий
выслушать	выслушать
кормить	кормить
сторожам	сторожам
беззаконием	беззаконием
простирай	простирай
гномам	гномам
было	было
парижанин	парижанин
встречу	встречу
постигло	постигло
уразумели	уразумели
гиганта	гиганта
изменишь	изменишь
послужив	послужив
прищуривается	прищуривается
качеством	качеством
слушало	слушало
алхимиками	алхимиками
сверкали	сверкали
вступали	вступали
долгая	долгая
отгадали	отгадали
пересказали	пересказали
преподать	преподать
покрыло	покрыло
возлюбленном	возлюбленном
утерпеть	утерпеть
долгим	долгим
злосчастными	злосчастными
приобщились	приобщились
немую	немую
воспела	воспела
извести	извести
сверкающий	сверкающий
написать	написать
склонили	склонили
приносили	приносили
осматривать	осматривать
захотела	захотела
выливал	выливал
гневящий	гневящий
причитается	причитается
сухой	сухой
пробуждали	пробуждали
озеленении	озеленении
пребывайте	пребывайте
творите	творите
какое	какое
язв	язв
узнаем	узнаем
золоте	золоте
нимфами	нимфами
напоминай	напоминай
платить	платить
обещать	обещать
пожелал	пожелал
воспламенился	воспламенился
диспут	диспут
сказывала	сказывала
утвердить	утвердить
сагитируете	сагитируете
квадрантами	квадрантами
признаешь	признаешь
избранный	избранный
смешанная	смешанная
взмою	взмою
ждали	ждали
встретила	встретила
поморщитесь	поморщитесь
ночевать	ночевать
жертвах	жертвах
учите	учите
само	само
бубновая	бубновая
облокотись	облокотись
возроптали	возроптали
сердите	сердите
убеждённый	убеждённый
какого	какого
мой	мой
выливайте	выливайте
созрела	созрела
бросился	бросился
стороживший	стороживший
помышляли	помышляли
задержкам	задержкам
сестре	сестре
избавили	избавили
сатаною	сатаною
снисходите	снисходите
насадивший	насадивший
вселилась	вселилась
совместными	совместными
осматривали	осматривали
разностями	разностями
выдавший	выдавший
управляем	управляем
птичкою	птичкою
пола	пола
поражались	поражались
простирать	простирать
послужат	послужат
кидар	кидар
восемью	восемью
далёкими	далёкими
расслабим	расслабим
выкаливаем	выкаливаем
повесился	повесился
стихотворений	стихотворений
противостать	противостать
белою	белою
областеначальник	областеначальник
гуслиста	гуслиста
поправил	поправил
спросишь	спросишь
конной	конной
вторым	вторым
аппаратного	аппаратного
прихлебнувший	прихлебнувший
неподкупного	неподкупного
оставляй	оставляй
завещеваю	завещеваю
образом	образом
ухнувший	ухнувший
забыли	забыли
нехорош	нехорош
язвы	язвы
рассеять	рассеять
подпускала	подпускала
убедите	убедите
резавший	резавший
ненаказанным	ненаказанным
любили	любили
поспешите	поспешите
воздай	воздай
рождала	рождала
хрюкайте	хрюкайте
наихудший	наихудший
припомните	припомните
показали	показали
упоена	упоена
сербскохорватского	сербскохорватского
