своротить	своротить
сокрушить	сокрушить
оставляйте	оставляйте
кому	кому
хвалился	хвалился
выходишь	выходишь
яме	яме
легкие	легкие
приносить	приносить
если	если
погребен	погребен
верующий	верующий
спрятали	спрятали
порази	порази
составить	составить
отступить	отступить
твердо	твердо
бедные	бедные
проходишь	проходишь
письмом	письмом
всем	всем
учите	учите
предавай	предавай
слушало	слушало
заключили	заключили
бедного	бедного
переносит	переносит
бесноватых	бесноватых
деревом	деревом
проклятого	проклятого
новорожденного	новорожденного
выдавали	выдавали
навык	навык
сынов	сынов
Божием	Божием
определили	определили
входить	входить
вопроси	вопроси
разгласите	разгласите
хвали	хвали
соделай	соделай
твои	твои
светила	светила
паре	паре
смешанного	смешанного
носила	носила
твою	твою
Души	Души
садить	садить
пролился	пролился
обратила	обратила
низринут	низринут
запретили	запретили
доказали	доказали
отводит	отводит
томился	томился
Мою	Мою
покрыло	покрыло
отнесли	отнесли
Велик	Велик
левша	левша
доставить	доставить
Божию	Божию
аспидов	аспидов
считает	считает
печи	печи
смущен	смущен
тени	тени
погрязли	погрязли
больных	больных
совершили	совершили
усилили	усилили
рассекали	рассекали
проходила	проходила
вопрошающий	вопрошающий
потускло	потускло
исполняй	исполняй
какая	какая
своя	своя
владычествовать	владычествовать
сердечные	сердечные
Мой	Мой
минует	минует
понесло	понесло
желать	желать
придворным	придворным
полюби	полюби
убитый	убитый
строит	строит
царски	царски
выстроить	выстроить
возвысили	возвысили
налагать	налагать
козлах	козлах
пожалуйте	пожалуйте
чести	чести
отважен	отважен
ждали	ждали
ехидна	ехидна
отступив	отступив
воспой	воспой
воссиять	воссиять
посохом	посохом
пожалуй	пожалуй
исходила	исходила
обгорел	обгорел
козлы	козлы
небольшой	небольшой
животным	животным
разграбить	разграбить
освяти	освяти
духам	духам
любимый	любимый
возлюбила	возлюбила
сатане	сатане
родословные	родословные
осквернила	осквернила
главного	главного
точило	точило
посвящали	посвящали
спали	спали
болоте	болоте
умертвить	умертвить
пролили	пролили
большую	большую
осветила	осветила
простирай	простирай
белым	белым
страдать	страдать
Сене	Сене
кругу	кругу
служанке	служанке
выстрели	выстрели
Дине	Дине
козлу	козлу
наклони	наклони
грешить	грешить
Теми	Теми
преданным	преданным
поставить	поставить
начинайте	начинайте
мертвым	мертвым
гумне	гумне
устроили	устроили
молотили	молотили
братьям	братьям
нечист	нечист
бесноватый	бесноватый
просты	просты
сердечною	сердечною
плену	плену
мертвые	мертвые
откормленный	откормленный
мыслить	мыслить
повод	повод
развалинами	развалинами
посетить	посетить
фараон	фараон
подражали	подражали
заговоришь	заговоришь
верха	верха
пейте	пейте
каждые	каждые
вынесли	вынесли
сними	сними
нечистые	нечистые
медлить	медлить
разбирайте	разбирайте
голодные	голодные
уставом	уставом
превратили	превратили
берегу	берегу
одержимых	одержимых
чада	чада
бабке	бабке
вытащи	вытащи
вороной	вороной
выговорить	выговорить
соедини	соедини
садили	садили
пила	пила
убийцы	убийцы
двором	двором
благодарить	благодарить
собранные	собранные
никакое	никакое
благослови	благослови
чужой	чужой
внука	внука
избавляйте	избавляйте
госпоже	госпоже
приступить	приступить
успокоить	успокоить
превозмогло	превозмогло
мешки	мешки
смешанной	смешанной
чад	чад
есть	есть
была	была
царях	царях
влекла	влекла
отошлите	отошлите
постанови	постанови
посвятить	посвятить
Воздай	Воздай
открыть	открыть
признайте	признайте
охраняющий	охраняющий
божество	божество
стоят	стоят
язв	язв
вложили	вложили
выходят	выходят
развалинам	развалинам
постигла	постигла
искусили	искусили
нарушить	нарушить
отпустить	отпустить
подносить	подносить
письме	письме
сложи	сложи
напоила	напоила
поручи	поручи
бесчестили	бесчестили
каплет	каплет
восполнили	восполнили
держали	держали
жало	жало
Которой	Которой
Твоем	Твоем
возвратить	возвратить
напоены	напоены
отнесла	отнесла
лица	лица
творить	творить
брак	брак
осадили	осадили
страшить	страшить
другая	другая
смирен	смирен
пророчествуйте	пророчествуйте
снимите	снимите
возносили	возносили
благодарив	благодарив
спросила	спросила
заходи	заходи
невеждам	невеждам
колене	колене
потекли	потекли
зарыдали	зарыдали
воспитывали	воспитывали
выбросить	выбросить
голов	голов
поручился	поручился
называйте	называйте
возносить	возносить
можешь	можешь
пьяных	пьяных
Израильской	Израильской
возливать	возливать
да	да
всходили	всходили
потаенные	потаенные
бабкам	бабкам
возлегли	возлегли
поручите	поручите
глазом	глазом
желчи	желчи
озером	озером
подумайте	подумайте
каждого	каждого
внимать	внимать
каждая	каждая
четвертой	четвертой
сотворили	сотворили
возлюбленный	возлюбленный
производили	производили
котором	котором
молоком	молоком
проводите	проводите
умножился	умножился
счетом	счетом
слепого	слепого
покой	покой
созрела	созрела
землетрясением	землетрясением
окончила	окончила
возвращен	возвращен
одолело	одолело
порядка	порядка
красив	красив
Можешь	Можешь
мертвых	мертвых
наполните	наполните
пропасти	пропасти
низложить	низложить
проклинайте	проклинайте
твой	твой
принадлежащую	принадлежащую
малых	малых
раздавить	раздавить
заняты	заняты
засохло	засохло
находила	находила
искупи	искупи
сказывай	сказывай
купили	купили
отходите	отходите
распознаем	распознаем
отстали	отстали
козлов	козлов
смешанное	смешанное
самую	самую
спросите	спросите
познаете	познаете
силе	силе
подносили	подносили
наполняй	наполняй
полюбила	полюбила
уцелел	уцелел
познаешь	познаешь
предавайте	предавайте
Самый	Самый
простирала	простирала
можете	можете
узнай	узнай
глухого	глухого
расти	расти
простираешь	простираешь
нему	нему
целовать	целовать
восхвалили	восхвалили
золотого	золотого
духа	духа
иссохли	иссохли
молился	молился
могли	могли
расспросите	расспросите
чудные	чудные
оба	оба
потаенных	потаенных
повторите	повторите
простите	простите
рта	рта
свари	свари
обольстили	обольстили
молока	молока
гола	гола
подними	подними
увеличился	увеличился
Благо	Благо
поднимите	поднимите
отправляли	отправляли
долгом	долгом
выступите	выступите
больные	больные
счета	счета
похули	похули
покрывал	покрывал
никакая	никакая
отнят	отнят
живые	живые
блаженных	блаженных
разить	разить
изгнали	изгнали
живых	живых
умерло	умерло
тысячам	тысячам
любите	любите
помета	помета
жилищами	жилищами
вышло	вышло
рои	рои
гвоздем	гвоздем
уразумейте	уразумейте
одет	одет
вопросите	вопросите
каждым	каждым
напоминать	напоминать
подкрепите	подкрепите
рассмотрите	рассмотрите
ищем	ищем
уразумели	уразумели
произнеси	произнеси
одетого	одетого
точила	точила
управляем	управляем
сирот	сирот
наливай	наливай
приклони	приклони
преуспевайте	преуспевайте
возбудить	возбудить
дала	дала
попросили	попросили
согрешите	согрешите
находим	находим
расслабленным	расслабленным
впал	впал
накорми	накорми
считаете	считаете
тысяч	тысяч
спрашивать	спрашивать
постигло	постигло
начерпала	начерпала
Марком	Марком
весе	весе
воспитывайте	воспитывайте
посадить	посадить
чья	чья
вступали	вступали
удалился	удалился
целую	целую
святого	святого
погуби	погуби
стоишь	стоишь
выходили	выходили
скрепить	скрепить
объясни	объясни
осенила	осенила
пола	пола
считал	считал
обличить	обличить
отягощать	отягощать
Христа	Христа
возьмем	возьмем
благословить	благословить
велят	велят
прокаженным	прокаженным
познать	познать
бери	бери
подумал	подумал
другой	другой
посрамить	посрамить
доставили	доставили
попускаете	попускаете
нехорошо	нехорошо
наступили	наступили
приняли	приняли
окружить	окружить
Мал	Мал
отдало	отдало
утаить	утаить
убегали	убегали
сели	сели
разговаривал	разговаривал
носильщиками	носильщиками
живою	живою
полы	полы
меча	меча
ворона	ворона
взять	взять
вторых	вторых
Самой	Самой
онемеешь	онемеешь
прочитать	прочитать
простертого	простертого
Буду	Буду
испортили	испортили
укрепите	укрепите
черту	черту
подражайте	подражайте
обитаем	обитаем
Иудиной	Иудиной
расслабленного	расслабленного
отвалят	отвалят
родословных	родословных
сокрытые	сокрытые
срамили	срамили
накормить	накормить
начале	начале
прикрепи	прикрепи
другие	другие
прямой	прямой
возвысить	возвысить
надевай	надевай
уповали	уповали
обгорело	обгорело
твари	твари
пророчеством	пророчеством
приносите	приносите
пропасть	пропасть
расположен	расположен
известили	известили
получали	получали
узнают	узнают
кадили	кадили
еси	еси
выходила	выходила
умерщвляй	умерщвляй
признает	признает
лиц	лиц
имеющий	имеющий
надеть	надеть
смешанная	смешанная
поешь	поешь
блаженный	блаженный
настаивал	настаивал
котлов	котлов
возвратите	возвратите
белы	белы
приняла	приняла
скалами	скалами
второе	второе
доносили	доносили
столп	столп
овнов	овнов
предупредили	предупредили
озере	озере
отличен	отличен
похоронили	похоронили
продолжали	продолжали
лукавый	лукавый
допустила	допустила
уговаривали	уговаривали
владычествовали	владычествовали
каждой	каждой
слепой	слепой
стояли	стояли
преступить	преступить
произвело	произвело
язву	язву
твердою	твердою
лукавого	лукавого
рога	рога
вкусили	вкусили
вороны	вороны
отпустила	отпустила
объявила	объявила
лесах	лесах
хочет	хочет
поворотить	поворотить
мухе	мухе
Знаем	Знаем
приветствуй	приветствуй
поникла	поникла
объяснить	объяснить
воздай	воздай
впала	впала
обратили	обратили
хочу	хочу
лгите	лгите
жабам	жабам
больного	больного
фараоне	фараоне
восстановим	восстановим
сладкие	сладкие
одру	одру
белого	белого
посвящай	посвящай
фараону	фараону
целовала	целовала
простить	простить
прислугу	прислугу
отважился	отважился
малый	малый
носить	носить
обходили	обходили
перехватите	перехватите
мужчины	мужчины
дух	дух
беременная	беременная
избранного	избранного
обнажи	обнажи
чужие	чужие
выросли	выросли
овладели	овладели
который	который
ворон	ворон
бесчестите	бесчестите
просите	просите
открой	открой
венцом	венцом
подняла	подняла
заходят	заходят
переноси	переноси
восходили	восходили
главу	главу
ввели	ввели
восстал	восстал
призванным	призванным
сама	сама
растворить	растворить
скрытых	скрытых
Воздайте	Воздайте
разделите	разделите
прилагайте	прилагайте
предложи	предложи
попросите	попросите
познала	познала
теле	теле
жило	жило
защищайте	защищайте
жаб	жаб
отвори	отвори
язвам	язвам
смутили	смутили
внуки	внуки
он	он
пернатые	пернатые
вспомни	вспомни
освободить	освободить
Дину	Дину
злословить	злословить
меха	меха
тестом	тестом
упоминать	упоминать
служи	служи
давили	давили
добычу	добычу
наполнила	наполнила
Рабы	Рабы
изменит	изменит
предложила	предложила
украсить	украсить
разговаривают	разговаривают
рассказывай	рассказывай
слове	слове
века	века
привалите	привалите
говорите	говорите
блудили	блудили
сатану	сатану
преданный	преданный
телом	телом
сухие	сухие
духовные	духовные
пьяного	пьяного
садите	садите
Слушайте	Слушайте
невежд	невежд
изгоняйте	изгоняйте
лесу	лесу
называть	называть
служанкою	служанкою
долга	долга
восстать	восстать
воспитанные	воспитанные
граду	граду
блага	блага
било	било
страшное	страшное
расположи	расположи
слезу	слезу
будете	будете
Благословите	Благословите
овце	овце
бесовской	бесовской
проток	проток
благословите	благословите
выступив	выступив
горькая	горькая
остановила	остановила
приступив	приступив
любить	любить
делали	делали
заколения	заколения
превратить	превратить
переспит	переспит
какого	какого
осудить	осудить
возноси	возноси
разные	разные
прокаженных	прокаженных
мехе	мехе
исполни	исполни
преуспевать	преуспевать
выступили	выступили
чтить	чтить
хвалить	хвалить
посетили	посетили
верх	верх
пребывать	пребывать
оказывали	оказывали
аспидом	аспидом
изменишь	изменишь
спрятала	спрятала
трубили	трубили
поносили	поносили
рули	рули
написал	написал
доходили	доходили
блудить	блудить
столпе	столпе
страшился	страшился
зло	зло
бичом	бичом
обветшало	обветшало
снегу	снегу
населенный	населенный
мирен	мирен
иное	иное
рад	рад
силу	силу
Боге	Боге
строила	строила
порти	порти
пьем	пьем
тысяча	тысяча
превозмогли	превозмогли
могло	могло
погубить	погубить
потерянной	потерянной
воздали	воздали
мстить	мстить
Жертва	Жертва
красоту	красоту
научить	научить
тысяченачальнику	тысяченачальнику
стражам	стражам
ваш	ваш
возвеличить	возвеличить
ударила	ударила
укреплять	укреплять
захватить	захватить
чудным	чудным
перейди	перейди
богатого	богатого
портить	портить
Может	Может
отсчитайте	отсчитайте
познаем	познаем
ухом	ухом
образом	образом
сестры	сестры
обирай	обирай
старого	старого
простирал	простирал
пух	пух
молчали	молчали
простертою	простертою
крестит	крестит
заплатили	заплатили
свободным	свободным
принята	принята
приобрела	приобрела
язвах	язвах
поступив	поступив
отнятого	отнятого
умножали	умножали
произносить	произносить
предсказывали	предсказывали
откройте	откройте
устроила	устроила
строить	строить
вредить	вредить
ревнуй	ревнуй
таланту	таланту
сходи	сходи
хранить	хранить
желай	желай
перемените	перемените
пьяные	пьяные
белые	белые
заменили	заменили
стоите	стоите
омывать	омывать
по	по
производите	производите
попускаешь	попускаешь
воронам	воронам
пойте	пойте
оказывайте	оказывайте
разрушен	разрушен
приходили	приходили
обложи	обложи
пиши	пиши
творили	творили
одержимая	одержимая
забытых	забытых
злом	злом
принимай	принимай
обитать	обитать
были	были
сокрушили	сокрушили
города	города
окропи	окропи
затрепетали	затрепетали
пленный	пленный
какой	какой
изменили	изменили
запрудили	запрудили
низкою	низкою
тьмою	тьмою
вызывали	вызывали
голове	голове
уведомить	уведомить
доводит	доводит
поносить	поносить
распознать	распознать
отняты	отняты
избавился	избавился
Мои	Мои
проклинать	проклинать
погрешите	погрешите
иная	иная
полированную	полированную
нечиста	нечиста
приняты	приняты
собирайте	собирайте
взывали	взывали
восстановите	восстановите
скале	скале
производить	производить
правого	правого
меньше	меньше
святом	святом
духовных	духовных
свекровь	свекровь
Можете	Можете
устраните	устраните
расспроси	расспроси
отнятых	отнятых
люди	люди
страшных	страшных
обманывай	обманывай
связанных	связанных
дало	дало
выстроили	выстроили
всякою	всякою
поникли	поникли
темным	темным
объявите	объявите
нанять	нанять
замолчи	замолчи
узнаешь	узнаешь
большою	большою
половины	половины
цветами	цветами
худо	худо
убогого	убогого
реки	реки
доходит	доходит
води	води
собирать	собирать
поддерживали	поддерживали
спорите	спорите
благ	благ
обладать	обладать
укрепили	укрепили
сохраняла	сохраняла
самое	самое
Богов	Богов
оном	оном
кричали	кричали
души	души
царю	царю
уходят	уходят
имуществом	имуществом
бедный	бедный
бил	бил
внушить	внушить
низком	низком
тьму	тьму
хулить	хулить
проводив	проводив
поступить	поступить
возьму	возьму
птичку	птичку
приносили	приносили
траву	траву
пострадать	пострадать
избранный	избранный
жертвою	жертвою
отдайте	отдайте
умоляли	умоляли
проезжая	проезжая
доставляла	доставляла
языке	языке
думайте	думайте
живым	живым
скрытая	скрытая
умертвили	умертвили
устроить	устроить
мала	мала
возвратился	возвратился
завладели	завладели
видите	видите
отмени	отмени
отправить	отправить
возлюбленном	возлюбленном
помышляйте	помышляйте
пророчествуй	пророчествуй
целое	целое
померкло	померкло
твердой	твердой
сокройте	сокройте
Раба	Раба
уведомили	уведомили
подняли	подняли
мысли	мысли
веруйте	веруйте
вопросить	вопросить
избранным	избранным
почитаете	почитаете
роду	роду
челе	челе
убила	убила
приготовили	приготовили
стражу	стражу
низринь	низринь
просить	просить
затворив	затворив
затворила	затворила
Какая	Какая
обходить	обходить
глухой	глухой
держи	держи
выступить	выступить
велик	велик
рак	рак
член	член
призванный	призванный
станом	станом
исправить	исправить
смешанных	смешанных
открытой	открытой
кадите	кадите
вина	вина
схватила	схватила
сварили	сварили
тверд	тверд
испытывайте	испытывайте
среду	среду
любимая	любимая
обрезывай	обрезывай
разреши	разреши
сладкого	сладкого
считают	считают
красоте	красоте
служили	служили
узнает	узнает
овладел	овладел
нечистота	нечистота
числом	числом
поступи	поступи
жару	жару
крылом	крылом
началом	началом
рассеянного	рассеянного
истребите	истребите
поставили	поставили
цвете	цвете
отошли	отошли
золото	золото
набрали	набрали
завладейте	завладейте
другого	другого
легкое	легкое
воскури	воскури
вывез	вывез
обгорели	обгорели
заставили	заставили
похитила	похитила
разделить	разделить
страшным	страшным
жилой	жилой
жилищам	жилищам
мертвого	мертвого
звездах	звездах
домой	домой
повисла	повисла
пример	пример
наложить	наложить
малые	малые
простертая	простертая
ослабевать	ослабевать
жил	жил
доводить	доводить
воссияло	воссияло
вопросили	вопросили
бабки	бабки
вкусите	вкусите
проводит	проводит
умер	умер
тленного	тленного
пило	пило
камнем	камнем
опьянел	опьянел
восходить	восходить
принесла	принесла
имущество	имущество
погасить	погасить
объясним	объясним
тысячами	тысячами
Бела	Бела
опустошить	опустошить
чтили	чтили
тельца	тельца
удерживай	удерживай
ходили	ходили
чудных	чудных
понесли	понесли
рыдали	рыдали
пока	пока
воссиял	воссиял
скоте	скоте
били	били
хромые	хромые
потаенном	потаенном
судите	судите
Свою	Свою
прямые	прямые
истребить	истребить
полированной	полированной
убитых	убитых
переменили	переменили
ходи	ходи
утре	утре
сходим	сходим
проводят	проводят
черви	черви
переходит	переходит
засевайте	засевайте
Возлюбленного	Возлюбленного
рогом	рогом
выводит	выводит
развалинах	развалинах
первым	первым
рабу	рабу
окружали	окружали
избили	избили
хвалите	хвалите
округа	округа
зеленых	зеленых
сади	сади
встретили	встретили
твердая	твердая
уходить	уходить
пой	пой
страсти	страсти
вопрошать	вопрошать
Святым	Святым
одинокою	одинокою
познаю	познаю
умертви	умертви
тверды	тверды
обитали	обитали
умирали	умирали
сразила	сразила
малого	малого
богу	богу
уходи	уходи
саранчу	саранчу
подарили	подарили
пронзить	пронзить
дворах	дворах
мог	мог
напоминай	напоминай
отправляйте	отправляйте
мертвый	мертвый
яму	яму
обвини	обвини
нового	нового
померкли	померкли
подложили	подложили
имущества	имущества
восстановили	восстановили
дворе	дворе
откажет	откажет
хотели	хотели
горд	горд
благовествуйте	благовествуйте
объявили	объявили
ужин	ужин
призывать	призывать
разбудили	разбудили
уступи	уступи
населенные	населенные
звезд	звезд
сухой	сухой
укрепился	укрепился
сокрой	сокрой
точиле	точиле
Апостолом	Апостолом
Хочешь	Хочешь
захватила	захватила
признают	признают
перебить	перебить
шестом	шестом
доносят	доносят
одушевленных	одушевленных
саранчи	саранчи
животного	животного
моя	моя
написала	написала
молодого	молодого
мучился	мучился
развалиною	развалиною
возвестится	возвестится
восклицали	восклицали
дворами	дворами
какую	какую
каждых	каждых
Христе	Христе
половину	половину
имели	имели
почитал	почитал
написать	написать
платить	платить
мех	мех
Будет	Будет
твердое	твердое
благом	благом
заключила	заключила
хотят	хотят
Бога	Бога
прости	прости
городом	городом
срубили	срубили
духи	духи
богатые	богатые
отвели	отвели
рассудите	рассудите
изменила	изменила
растили	растили
дома	дома
сделанным	сделанным
наполнили	наполнили
заколают	заколают
сироту	сироту
зарыдал	зарыдал
согрешили	согрешили
знакомого	знакомого
отдай	отдай
твердым	твердым
отвратили	отвратили
немым	немым
призывайте	призывайте
завладеть	завладеть
Благ	Благ
любимым	любимым
наследуешь	наследуешь
новом	новом
отлучить	отлучить
возбудите	возбудите
думали	думали
молоти	молоти
искупить	искупить
вытру	вытру
возлагай	возлагай
ввело	ввело
послужив	послужив
поем	поем
дщерь	дщерь
переходили	переходили
просили	просили
поддерживайте	поддерживайте
хромого	хромого
поручен	поручен
разрушили	разрушили
тверди	тверди
утвердился	утвердился
раздражить	раздражить
невежда	невежда
выдавай	выдавай
произносила	произносила
ожесточили	ожесточили
голодным	голодным
обратился	обратился
храните	храните
владели	владели
голодный	голодный
люби	люби
поселить	поселить
привалили	привалили
желали	желали
литого	литого
каждое	каждое
снабдили	снабдили
разрешите	разрешите
купить	купить
ворону	ворону
поговорить	поговорить
жертва	жертва
навестить	навестить
жернова	жернова
выводить	выводить
искушай	искушай
стояло	стояло
удержали	удержали
будь	будь
налетело	налетело
восхвалите	восхвалите
рождали	рождали
остановили	остановили
Моем	Моем
искала	искала
похороните	похороните
переносят	переносят
проповедуй	проповедуй
литые	литые
судился	судился
заколите	заколите
возлагали	возлагали
обе	обе
славили	славили
истукану	истукану
другом	другом
Хвалите	Хвалите
выполняла	выполняла
Возьмет	Возьмет
любимое	любимое
весах	весах
рассеянных	рассеянных
творила	творила
приклоните	приклоните
переспим	переспим
пожалело	пожалело
простирает	простирает
человеческою	человеческою
возбудили	возбудили
управляй	управляй
приветствующий	приветствующий
обратите	обратите
окончить	окончить
вин	вин
вине	вине
страхе	страхе
наложите	наложите
приходите	приходите
восклицайте	восклицайте
вытащили	вытащили
входили	входили
прославить	прославить
гордою	гордою
надевать	надевать
возвращали	возвращали
как	как
положить	положить
откажу	откажу
красоты	красоты
овцою	овцою
возьми	возьми
пели	пели
Приветствуйте	Приветствуйте
увеличили	увеличили
сказала	сказала
спустила	спустила
выросло	выросло
исполняйте	исполняйте
беременную	беременную
приветствуете	приветствуете
совершить	совершить
молодых	молодых
войска	войска
виден	виден
тельцов	тельцов
душе	душе
дозволяй	дозволяй
нечистых	нечистых
возлюбленные	возлюбленные
запретить	запретить
стеснили	стеснили
спорить	спорить
перехватили	перехватили
чудное	чудное
почитают	почитают
права	права
открывайте	открывайте
зиму	зиму
громов	громов
погрешили	погрешили
славить	славить
явили	явили
отяготить	отяготить
благо	благо
родить	родить
славословить	славословить
схватили	схватили
удалить	удалить
дерзновении	дерзновении
унывали	унывали
бросили	бросили
бросился	бросился
посылайте	посылайте
временные	временные
насадила	насадила
Иудину	Иудину
покоился	покоился
хочешь	хочешь
лукавые	лукавые
богам	богам
Свои	Свои
родили	родили
слепых	слепых
семейством	семейством
громом	громом
проезжал	проезжал
бить	бить
покрывало	покрывало
расслабленный	расслабленный
воздала	воздала
выговори	выговори
поправили	поправили
жилы	жилы
бел	бел
пояса	пояса
победить	победить
очистим	очистим
доходила	доходила
временное	временное
прям	прям
восстанови	восстанови
избавить	избавить
разбросайте	разбросайте
четвертою	четвертою
уходит	уходит
честные	честные
узнала	узнала
пар	пар
подвигли	подвигли
сказывала	сказывала
находит	находит
подбирала	подбирала
сказало	сказало
давить	давить
самою	самою
Дан	Дан
вноси	вноси
теста	теста
направить	направить
отсеки	отсеки
умножили	умножили
обгорела	обгорела
принимайте	принимайте
заключить	заключить
землетрясении	землетрясении
злаков	злаков
разбит	разбит
взяли	взяли
ели	ели
обнови	обнови
убедила	убедила
возложили	возложили
манною	манною
девяносто	девяносто
палить	палить
произвела	произвела
слушайте	слушайте
сварите	сварите
Богами	Богами
видим	видим
ослабело	ослабело
мои	мои
свободного	свободного
Велика	Велика
козлам	козлам
предложили	предложили
рассеките	рассеките
налагали	налагали
покоить	покоить
приложили	приложили
слушающий	слушающий
богах	богах
прикрепила	прикрепила
чадо	чадо
купите	купите
извести	извести
переменить	переменить
пригласили	пригласили
принять	принять
рубите	рубите
кадила	кадила
Самом	Самом
наступите	наступите
выходить	выходить
соделается	соделается
нечистоту	нечистоту
послужить	послужить
возвестите	возвестите
сам	сам
яви	яви
исцеляла	исцеляла
красного	красного
уверить	уверить
посети	посети
облаком	облаком
братьями	братьями
значить	значить
возлюбленную	возлюбленную
призрак	призрак
жертвами	жертвами
раздели	раздели
мой	мой
чужого	чужого
спросить	спросить
принудить	принудить
подбирать	подбирать
завладел	завладел
горькой	горькой
избранная	избранная
предупреди	предупреди
благословляй	благословляй
предложить	предложить
молила	молила
щадите	щадите
воле	воле
пустую	пустую
образа	образа
затворили	затворили
пустою	пустою
Будь	Будь
слеп	слеп
войском	войском
мучить	мучить
кончили	кончили
огорчали	огорчали
золоте	золоте
святою	святою
ехидны	ехидны
овладеть	овладеть
сходить	сходить
Приветствует	Приветствует
изгонять	изгонять
связанного	связанного
поразите	поразите
изливайте	изливайте
осквернили	осквернили
имеют	имеют
голою	голою
рождала	рождала
месте	месте
дщери	дщери
Которого	Которого
удерживать	удерживать
черного	черного
славила	славила
обольстила	обольстила
беременной	беременной
проходят	проходят
призванные	призванные
головах	головах
петли	петли
поношении	поношении
ставить	ставить
чинили	чинили
отходила	отходила
поту	поту
протоки	протоки
совершите	совершите
имеет	имеет
взывать	взывать
жилищ	жилищ
занято	занято
устрашить	устрашить
горды	горды
осквернить	осквернить
изнеженная	изнеженная
благе	благе
страсть	страсть
наступив	наступив
вином	вином
делить	делить
верху	верху
сбереги	сбереги
звезду	звезду
вспомните	вспомните
худа	худа
отдала	отдала
кормили	кормили
царя	царя
поразить	поразить
томить	томить
труби	труби
распознает	распознает
мешка	мешка
сладкое	сладкое
примером	примером
выводили	выводили
которых	которых
наняли	наняли
красота	красота
возлегло	возлегло
обладайте	обладайте
обветшали	обветшали
губили	губили
написанные	написанные
собирай	собирай
жилищу	жилищу
приобрели	приобрели
лицо	лицо
устроен	устроен
привалив	привалив
смирить	смирить
одетый	одетый
сотвори	сотвори
заразою	заразою
покрова	покрова
протяни	протяни
божествах	божествах
наполняло	наполняло
злою	злою
жемчугом	жемчугом
страшные	страшные
хром	хром
известила	известила
жертве	жертве
духовным	духовным
помышлять	помышлять
делили	делили
допускали	допускали
нашли	нашли
грешите	грешите
поднял	поднял
соблюди	соблюди
пили	пили
снохе	снохе
петля	петля
положите	положите
искушали	искушали
приветствуют	приветствуют
варили	варили
отступите	отступите
увеличить	увеличить
согрешив	согрешив
безумных	безумных
ходу	ходу
отделен	отделен
прославился	прославился
пощадили	пощадили
скорым	скорым
рассказывайте	рассказывайте
бесчести	бесчести
прибыла	прибыла
вскормила	вскормила
которого	которого
твори	твори
постыди	постыди
устав	устав
познали	познали
вари	вари
воскурить	воскурить
испытывали	испытывали
ваше	ваше
наклонился	наклонился
первые	первые
заразы	заразы
похитили	похитили
Нового	Нового
превозносили	превозносили
обществом	обществом
Реву	Реву
владеть	владеть
гумном	гумном
помилуй	помилуй
рассказывали	рассказывали
возложи	возложи
раздирающий	раздирающий
внукам	внукам
духов	духов
Словом	Словом
удалили	удалили
избило	избило
божества	божества
льстили	льстили
исследуйте	исследуйте
дозволяйте	дозволяйте
охраняй	охраняй
проповедуйте	проповедуйте
червь	червь
разит	разит
своем	своем
меньшая	меньшая
выслушай	выслушай
принимали	принимали
покрой	покрой
сохранить	сохранить
языческой	языческой
стражи	стражи
соделала	соделала
наследуйте	наследуйте
налетели	налетели
похоронен	похоронен
само	само
каждою	каждою
молите	молите
истреби	истреби
бесчестить	бесчестить
сирота	сирота
отведите	отведите
признать	признать
она	она
втором	втором
сделало	сделало
воспойте	воспойте
омыть	омыть
безумные	безумные
продолжало	продолжало
богами	богами
затрубите	затрубите
дал	дал
выи	выи
возвратили	возвратили
травы	травы
открывать	открывать
прославляй	прославляй
чужою	чужою
выкупи	выкупи
затворите	затворите
Самая	Самая
умоляй	умоляй
великую	великую
разорить	разорить
стоим	стоим
преступите	преступите
положен	положен
отходят	отходят
фараона	фараона
зелени	зелени
слепым	слепым
воздайте	воздайте
ином	ином
оскудела	оскудела
замолчу	замолчу
родился	родился
сознаю	сознаю
предали	предали
ставили	ставили
приветствуйте	приветствуйте
принудили	принудили
заклятое	заклятое
избивали	избивали
противоречить	противоречить
убить	убить
посылала	посылала
толки	толки
нечистою	нечистою
нагою	нагою
раскрыла	раскрыла
приложился	приложился
повторили	повторили
возливай	возливай
срубите	срубите
терпи	терпи
вечере	вечере
губить	губить
купила	купила
медлите	медлите
помнили	помнили
сходят	сходят
изгнать	изгнать
осудили	осудили
творите	творите
принят	принят
был	был
исследуй	исследуй
построить	построить
уменьши	уменьши
великою	великою
святых	святых
сказать	сказать
воздать	воздать
Который	Который
лицом	лицом
возложила	возложила
объявить	объявить
бесславить	бесславить
мечу	мечу
строишь	строишь
считайте	считайте
мстили	мстили
горькие	горькие
тленным	тленным
утвердить	утвердить
убийце	убийце
воронов	воронов
ночных	ночных
входите	входите
река	река
желающий	желающий
связанные	связанные
почитай	почитай
прочитай	прочитай
проклятою	проклятою
возросло	возросло
языку	языку
молоке	молоке
разгласили	разгласили
черный	черный
благотворите	благотворите
дайте	дайте
честным	честным
гвозди	гвозди
проводить	проводить
отвален	отвален
страж	страж
голодных	голодных
смирите	смирите
будут	будут
подносят	подносят
уходили	уходили
странствуйте	странствуйте
удерживайте	удерживайте
тьме	тьме
растила	растила
Начало	Начало
ночное	ночное
узнаем	узнаем
прилагай	прилагай
пернатых	пернатых
Он	Он
научи	научи
убийством	убийством
соверши	соверши
немой	немой
Царя	Царя
немые	немые
раздирайте	раздирайте
морскою	морскою
весом	весом
вывели	вывели
водить	водить
искало	искало
красных	красных
новорожденные	новорожденные
сказывать	сказывать
слепые	слепые
сверкающий	сверкающий
дерзновением	дерзновением
облегчи	облегчи
приводить	приводить
крестишь	крестишь
животное	животное
злак	злак
пребывайте	пребывайте
посох	посох
печь	печь
было	было
утверди	утверди
отправили	отправили
возлюбленною	возлюбленною
сел	сел
преследуй	преследуй
неправы	неправы
овнами	овнами
успокоили	успокоили
поехал	поехал
растить	растить
населенного	населенного
предавала	предавала
воздух	воздух
пьющий	пьющий
превозносите	превозносите
Возлюбленном	Возлюбленном
истуканом	истуканом
благословили	благословили
скалу	скалу
оставить	оставить
говорить	говорить
боком	боком
наследует	наследует
подняло	подняло
большом	большом
гордо	гордо
стеснен	стеснен
торжествуй	торжествуй
скверны	скверны
возмутить	возмутить
садился	садился
пища	пища
выбрасывать	выбрасывать
познают	познают
старою	старою
испытанный	испытанный
Марка	Марка
слушать	слушать
Духу	Духу
настаивали	настаивали
провозгласите	провозгласите
Своем	Своем
знакомых	знакомых
сходила	сходила
лесом	лесом
погряз	погряз
схоронить	схоронить
половине	половине
усилить	усилить
похулили	похулили
наполняйте	наполняйте
уха	уха
подвиг	подвиг
вспомнили	вспомнили
обитая	обитая
немых	немых
звала	звала
пронзила	пронзила
почитаю	почитаю
рабе	рабе
освети	освети
потускли	потускли
страхом	страхом
девяноста	девяноста
Христом	Христом
простертым	простертым
камнях	камнях
признали	признали
родившая	родившая
сложили	сложили
вспомнила	вспомнила
удержи	удержи
тысячах	тысячах
снисходить	снисходить
принесли	принесли
зеленого	зеленого
уцелело	уцелело
вывело	вывело
разбудила	разбудила
находился	находился
управлять	управлять
обратить	обратить
Христов	Христов
оценили	оценили
преуспевали	преуспевали
вредили	вредили
иных	иных
похвалить	похвалить
Бог	Бог
пред	пред
черные	черные
посылали	посылали
постановить	постановить
сделай	сделай
соблюдите	соблюдите
царскою	царскою
разложили	разложили
замеси	замеси
молодые	молодые
тьмы	тьмы
смело	смело
одушевленное	одушевленное
стану	стану
получили	получили
пара	пара
соорудили	соорудили
Христу	Христу
согласные	согласные
ослепила	ослепила
судили	судили
нехорош	нехорош
почтили	почтили
нечисты	нечисты
страшного	страшного
которой	которой
управляли	управляли
грабить	грабить
раздражен	раздражен
научите	научите
богов	богов
пишем	пишем
щади	щади
составили	составили
открытый	открытый
торжествующий	торжествующий
сторож	сторож
приноси	приноси
Будут	Будут
возливайте	возливайте
тысяче	тысяче
ударить	ударить
сверкали	сверкали
Силом	Силом
скотом	скотом
приложить	приложить
одетые	одетые
самый	самый
бела	бела
занятые	занятые
удалите	удалите
родишь	родишь
неверен	неверен
разбили	разбили
разделила	разделила
вышли	вышли
хулите	хулите
умерщвляйте	умерщвляйте
выбрасывайте	выбрасывайте
камня	камня
умертвила	умертвила
сторожа	сторожа
уверен	уверен
ослабела	ослабела
столе	столе
рассудили	рассудили
выбросили	выбросили
оных	оных
неверным	неверным
откормленные	откормленные
откормленных	откормленных
счету	счету
каком	каком
допускала	допускала
цвета	цвета
духами	духами
окончи	окончи
удерживали	удерживали
сосчитай	сосчитай
реши	реши
располагая	располагая
внимали	внимали
окружила	окружила
брани	брани
вели	вели
отложите	отложите
получила	получила
храни	храни
снисходите	снисходите
оробели	оробели
наложили	наложили
голубой	голубой
самая	самая
кричите	кричите
малы	малы
получите	получите
возвестить	возвестить
правый	правый
брака	брака
помилуйте	помилуйте
Самого	Самого
Жертвы	Жертвы
Свой	Свой
сестре	сестре
вес	вес
ослабеть	ослабеть
моем	моем
теснили	теснили
очисти	очисти
страдающий	страдающий
тверда	тверда
обольстить	обольстить
Рев	Рев
пожалел	пожалел
посадили	посадили
пронзили	пронзили
глухие	глухие
изгоняли	изгоняли
кончен	кончен
берег	берег
духом	духом
строили	строили
убийстве	убийстве
белою	белою
обгорелою	обгорелою
явить	явить
пощади	пощади
спасу	спасу
последовать	последовать
Силу	Силу
животные	животные
беременною	беременною
известите	известите
пасли	пасли
защищать	защищать
почетного	почетного
Аду	Аду
утаили	утаили
скалах	скалах
вела	вела
омывали	омывали
манны	манны
простирать	простирать
стояла	стояла
сходили	сходили
сатаною	сатаною
заколали	заколали
жила	жила
вводили	вводили
одержимый	одержимый
сокрушите	сокрушите
глухою	глухою
рада	рада
налагай	налагай
буду	буду
постигли	постигли
расслабленных	расслабленных
кругом	кругом
иным	иным
приучили	приучили
очистите	очистите
запрети	запрети
смутить	смутить
новым	новым
торжествуйте	торжествуйте
рассудить	рассудить
больным	больным
платили	платили
требуй	требуй
возлюбленного	возлюбленного
выносит	выносит
подарила	подарила
изменился	изменился
приучила	приучила
путем	путем
свободные	свободные
никакой	никакой
родных	родных
пою	пою
раздражите	раздражите
крыле	крыле
вытрут	вытрут
твердую	твердую
повторился	повторился
лукавых	лукавых
спешила	спешила
затыкали	затыкали
Святом	Святом
исполнился	исполнился
смели	смели
жилища	жилища
отходили	отходили
хотите	хотите
точил	точил
которая	которая
людях	людях
ставила	ставила
уразумел	уразумел
обманывайте	обманывайте
изменить	изменить
свободных	свободных
умножить	умножить
спрашивай	спрашивай
захватили	захватили
половиною	половиною
черным	черным
избранной	избранной
бывшую	бывшую
иного	иного
окружите	окружите
разводить	разводить
которым	которым
весами	весами
напасти	напасти
посрами	посрами
оробел	оробел
Твой	Твой
всякое	всякое
ищи	ищи
наши	наши
назидается	назидается
благословляли	благословляли
преступили	преступили
всю	всю
отнята	отнята
рассмотри	рассмотри
внушили	внушили
родным	родным
тысячу	тысячу
узнайте	узнайте
отними	отними
пересчитайте	пересчитайте
иной	иной
освятить	освятить
устрашили	устрашили
целого	целого
убитой	убитой
преследовала	преследовала
выводи	выводи
обложили	обложили
облегчить	облегчить
матерь	матерь
влекли	влекли
мертвою	мертвою
имеешь	имеешь
оставится	оставится
восходите	восходите
возросли	возросли
родившие	родившие
простираете	простираете
тень	тень
крестился	крестился
левою	левою
ходить	ходить
презирайте	презирайте
подходить	подходить
обществе	обществе
манна	манна
одни	одни
заходить	заходить
сознает	сознает
градом	градом
попускал	попускал
немалую	немалую
худ	худ
прокаженные	прокаженные
написанное	написанное
исчислили	исчислили
поднято	поднято
сухую	сухую
неправ	неправ
первом	первом
твоя	твоя
прославили	прославили
добыча	добыча
тельцу	тельцу
скверною	скверною
наступить	наступить
оставила	оставила
взывайте	взывайте
берет	берет
приняло	приняло
язве	язве
содержите	содержите
явился	явился
лукавым	лукавым
потаенного	потаенного
заплати	заплати
убитые	убитые
одолеть	одолеть
сразился	сразился
посмотрите	посмотрите
раздавали	раздавали
прилагать	прилагать
Сеном	Сеном
которую	которую
грабили	грабили
пленных	пленных
избранное	избранное
дорогой	дорогой
протоками	протоками
возвести	возвести
посмотри	посмотри
чужом	чужом
пчеле	пчеле
поставила	поставила
вступите	вступите
язвы	язвы
засохли	засохли
реке	реке
цари	цари
чину	чину
Моя	Моя
лицах	лицах
поверили	поверили
светить	светить
местом	местом
схоронили	схоронили
собирали	собирали
поручали	поручали
строим	строим
бесноватого	бесноватого
построила	построила
отходит	отходит
допустили	допустили
челах	челах
замесила	замесила
дереве	дереве
левый	левый
лицами	лицами
юноше	юноше
пройду	пройду
множеством	множеством
мыслите	мыслите
войске	войске
ртом	ртом
поступите	поступите
могу	могу
произнесли	произнесли
живом	живом
воздухе	воздухе
возлюбленной	возлюбленной
сохраните	сохраните
молчите	молчите
окружили	окружили
думать	думать
совершали	совершали
дрогнуло	дрогнуло
последуйте	последуйте
расположите	расположите
Галилейскую	Галилейскую
предавали	предавали
неверные	неверные
пчелы	пчелы
вытащить	вытащить
принесем	принесем
подкрепи	подкрепи
защити	защити
поношением	поношением
родила	родила
поднять	поднять
поникло	поникло
проклятые	проклятые
главные	главные
погубите	погубите
духу	духу
возлюби	возлюби
покройте	покройте
самого	самого
переносим	переносим
молодым	молодым
звезде	звезде
вскорми	вскорми
возвестили	возвестили
Благослови	Благослови
влекло	влекло
искусить	искусить
можем	можем
служите	служите
пить	пить
победили	победили
черта	черта
язва	язва
сходите	сходите
варите	варите
проси	проси
Возьму	Возьму
фараонов	фараонов
отяжелели	отяжелели
вечера	вечера
призраку	призраку
села	села
побить	побить
домом	домом
правых	правых
душа	душа
согрешить	согрешить
учить	учить
устранили	устранили
рака	рака
бедных	бедных
почитайте	почитайте
пригласите	пригласите
новое	новое
сделанный	сделанный
имеете	имеете
скакали	скакали
онемеют	онемеют
смешанный	смешанный
отвозят	отвозят
унывайте	унывайте
веке	веке
помните	помните
сравните	сравните
поспешили	поспешили
отринь	отринь
небе	небе
жребием	жребием
носите	носите
открытых	открытых
твердом	твердом
серебре	серебре
избить	избить
отягощай	отягощай
истукан	истукан
лишен	лишен
ними	ними
побила	побила
похвалился	похвалился
укрепляли	укрепляли
останови	останови
подходите	подходите
приводите	приводите
смотри	смотри
потом	потом
объяснили	объяснили
свитке	свитке
лишить	лишить
разных	разных
владейте	владейте
созывайте	созывайте
почти	почти
золота	золота
беременных	беременных
самые	самые
вмещала	вмещала
похоронить	похоронить
умерли	умерли
спешите	спешите
быть	быть
сердечным	сердечным
доводите	доводите
отделили	отделили
разбила	разбила
разным	разным
посвятили	посвятили
смешанною	смешанною
заколал	заколал
велишь	велишь
образе	образе
возьмешь	возьмешь
скованный	скованный
последовали	последовали
бывшая	бывшая
вносите	вносите
проклятую	проклятую
аспиды	аспиды
вырос	вырос
определить	определить
повредили	повредили
бесславием	бесславием
наполнился	наполнился
преследуйте	преследуйте
Какое	Какое
скот	скот
возврати	возврати
решите	решите
наливала	наливала
отдали	отдали
терпим	терпим
Слове	Слове
выходите	выходите
Силе	Силе
исполнила	исполнила
схватить	схватить
желала	желала
собранный	собранный
проклинали	проклинали
освободи	освободи
сказывайте	сказывайте
вводите	вводите
порядке	порядке
проводили	проводили
шестой	шестой
приступили	приступили
исцели	исцели
переходить	переходить
откормленного	откормленного
мужчинах	мужчинах
чужое	чужое
добыч	добыч
одре	одре
вдовы	вдовы
обветшала	обветшала
литых	литых
блудила	блудила
Белы	Белы
жабами	жабами
множестве	множестве
оценить	оценить
ночные	ночные
Дина	Дина
камню	камню
протоках	протоках
ним	ним
почтить	почтить
стражами	стражами
строился	строился
мал	мал
утвердили	утвердили
убедили	убедили
раскрыли	раскрыли
извратила	извратила
Апостол	Апостол
огорчен	огорчен
лежали	лежали
вступился	вступился
самой	самой
Соляной	Соляной
вступить	вступить
укрепить	укрепить
скала	скала
одолели	одолели
скрытые	скрытые
старейшинах	старейшинах
хромым	хромым
повороти	повороти
построили	построили
превозмогла	превозмогла
подпал	подпал
правою	правою
кропили	кропили
обрезывали	обрезывали
гусенице	гусенице
блаженным	блаженным
полу	полу
Было	Было
превозносить	превозносить
тысячи	тысячи
горькою	горькою
иные	иные
переходят	переходят
каков	каков
наставить	наставить
саранча	саранча
купи	купи
оскверните	оскверните
выходи	выходи
бросила	бросила
сироты	сироты
умножила	умножила
вторым	вторым
верили	верили
какою	какою
раба	раба
наполни	наполни
испортите	испортите
рубили	рубили
поглотить	поглотить
вымой	вымой
любили	любили
открытым	открытым
рабою	рабою
серебром	серебром
посвяти	посвяти
послужили	послужили
членом	членом
внуши	внуши
огорчили	огорчили
выкупите	выкупите
положила	положила
помнила	помнила
онемело	онемело
хотела	хотела
доставляй	доставляй
утомленных	утомленных
имея	имея
открытом	открытом
Ком	Ком
выкопали	выкопали
научили	научили
выслушать	выслушать
утопать	утопать
отличить	отличить
утомленного	утомленного
навыком	навыком
которые	которые
оставили	оставили
принесло	принесло
бедным	бедным
иссох	иссох
рождайте	рождайте
набрать	набрать
сосчитали	сосчитали
молодом	молодом
добыче	добыче
лишился	лишился
пролить	пролить
первое	первое
головами	головами
изнеженную	изнеженную
выполнить	выполнить
потекло	потекло
открытою	открытою
исправили	исправили
испытанного	испытанного
сделали	сделали
вызывающий	вызывающий
жары	жары
поправить	поправить
отделить	отделить
воспитанный	воспитанный
духе	духе
наушника	наушника
Слушай	Слушай
саранчою	саранчою
доставляло	доставляло
век	век
столом	столом
призванных	призванных
ком	ком
снохи	снохи
наскучили	наскучили
произносили	произносили
нашла	нашла
соединить	соединить
золотою	золотою
будешь	будешь
родит	родит
новой	новой
провозгласи	провозгласи
сторожу	сторожу
лишили	лишили
рубить	рубить
Галилейской	Галилейской
продолжай	продолжай
причинили	причинили
тьма	тьма
исчисли	исчисли
мертво	мертво
небом	небом
козлами	козлами
морем	морем
морскую	морскую
разрешить	разрешить
возвестила	возвестила
нечистым	нечистым
толкали	толкали
осмолила	осмолила
встали	встали
старые	старые
спросили	спросили
которою	которою
дороге	дороге
узнать	узнать
приветствовал	приветствовал
бога	бога
рассеянным	рассеянным
положи	положи
пожалеть	пожалеть
узнаю	узнаю
самых	самых
сделанной	сделанной
отправился	отправился
посылать	посылать
трубить	трубить
сотворите	сотворите
возлюбите	возлюбите
встретила	встретила
одною	одною
убитою	убитою
иссохло	иссохло
покрывали	покрывали
отсчитай	отсчитай
Матери	Матери
согласного	согласного
жили	жили
лице	лице
выдать	выдать
постыдить	постыдить
ничтожества	ничтожества
целых	целых
скрывать	скрывать
родят	родят
разорите	разорите
уговори	уговори
считать	считать
тварь	тварь
чужую	чужую
овладейте	овладейте
отпустили	отпустили
исходит	исходит
открытую	открытую
убеди	убеди
спорили	спорили
говори	говори
управляющий	управляющий
прямым	прямым
богатый	богатый
споры	споры
выкопай	выкопай
отводили	отводили
пьяною	пьяною
варить	варить
отпускать	отпускать
жертвы	жертвы
устранить	устранить
выслушали	выслушали
выносите	выносите
платите	платите
язык	язык
новых	новых
живая	живая
опьянейте	опьянейте
восполнить	восполнить
святой	святой
говорила	говорила
страху	страху
волах	волах
берем	берем
прибыли	прибыли
отвела	отвела
объяви	объяви
признаю	признаю
побили	побили
избавлять	избавлять
наги	наги
отлучите	отлучите
спешит	спешит
свитком	свитком
слушали	слушали
святую	святую
огорчить	огорчить
празднуйте	празднуйте
ослабевайте	ослабевайте
отпусти	отпусти
почетных	почетных
затрубили	затрубили
замер	замер
Святых	Святых
оставлять	оставлять
направился	направился
пути	пути
утихло	утихло
возбуди	возбуди
саранче	саранче
пару	пару
защитить	защитить
порядку	порядку
пас	пас
бросить	бросить
богатых	богатых
называли	называли
столпом	столпом
обвинить	обвинить
свои	свои
восклицать	восклицать
познай	познай
вводить	вводить
погубили	погубили
нарушили	нарушили
отяжелело	отяжелело
смертный	смертный
желало	желало
нашем	нашем
кадить	кадить
поднятых	поднятых
Мало	Мало
скованного	скованного
любимой	любимой
приходить	приходить
худом	худом
отсекли	отсекли
торгу	торгу
освятите	освятите
помни	помни
морю	морю
тельцами	тельцами
замечать	замечать
победит	победит
рассеянный	рассеянный
наушник	наушник
провозгласить	провозгласить
скрытое	скрытое
вину	вину
звезды	звезды
жертвах	жертвах
помет	помет
языков	языков
служила	служила
повредить	повредить
жабы	жабы
налагайте	налагайте
округ	округ
благословлять	благословлять
жди	жди
выдавайте	выдавайте
Иудин	Иудин
поговорив	поговорив
жабах	жабах
мою	мою
предсказывайте	предсказывайте
дай	дай
ревнуйте	ревнуйте
глаза	глаза
оставляли	оставляли
петь	петь
кормить	кормить
замерло	замерло
выдай	выдай
красные	красные
Велики	Велики
кропить	кропить
приготовила	приготовила
отпускайте	отпускайте
поднимали	поднимали
прямою	прямою
обновить	обновить
срубить	срубить
поспешите	поспешите
узнали	узнали
минуло	минуло
посвятите	посвятите
крестить	крестить
уразуметь	уразуметь
убогие	убогие
утих	утих
скоту	скоту
ослепить	ослепить
возлюбили	возлюбили
овну	овну
душу	душу
одетым	одетым
малое	малое
Духом	Духом
язвами	язвами
Матерь	Матерь
срамить	срамить
принадлежащие	принадлежащие
почитали	почитали
внимайте	внимайте
первого	первого
прибыл	прибыл
поя	поя
отведи	отведи
последовала	последовала
называй	называй
возложите	возложите
живого	живого
неверующие	неверующие
этого	этого
птичкою	птичкою
сердечной	сердечной
ослепили	ослепили
рыдать	рыдать
уступили	уступили
сказали	сказали
исполним	исполним
славословили	славословили
убийцу	убийцу
расположили	расположили
осадить	осадить
старых	старых
лев	лев
возлег	возлег
мозгом	мозгом
счет	счет
долги	долги
твердых	твердых
подложи	подложи
хотим	хотим
совершила	совершила
помнить	помнить
медлили	медлили
Израилевой	Израилевой
разори	разори
помышляли	помышляли
мечом	мечом
принимала	принимала
поместила	поместила
превозносился	превозносился
благословила	благословила
унизили	унизили
поворотили	поворотили
приносила	приносила
веса	веса
открытого	открытого
напоен	напоен
оно	оно
Цари	Цари
повис	повис
изливали	изливали
вывезли	вывезли
скакать	скакать
нага	нага
померк	померк
благи	благи
взяла	взяла
талант	талант
значила	значила
известить	известить
искать	искать
начала	начала
привезли	привезли
располагает	располагает
охраняйте	охраняйте
поручили	поручили
осмоли	осмоли
блаженного	блаженного
звали	звали
одинокая	одинокая
выстрелили	выстрелили
пожалели	пожалели
никакого	никакого
намерены	намерены
утвердите	утвердите
причинить	причинить
уговорить	уговорить
благовестием	благовестием
ничтожество	ничтожество
упоминайте	упоминайте
Хвали	Хвали
блуди	блуди
богатым	богатым
соляным	соляным
злодействе	злодействе
располагал	располагал
отсек	отсек
первых	первых
своротила	своротила
выкупить	выкупить
скрывала	скрывала
могут	могут
оказывай	оказывай
осади	осади
истребила	истребила
испытанных	испытанных
вороные	вороные
открытое	открытое
приложите	приложите
принятые	принятые
изливай	изливай
познает	познает
опустили	опустили
взял	взял
жилами	жилами
госпожи	госпожи
наш	наш
Твою	Твою
сухая	сухая
суди	суди
противоречили	противоречили
бог	бог
белый	белый
требуйте	требуйте
перейдем	перейдем
немого	немого
пил	пил
сруби	сруби
добра	добра
оскудели	оскудели
Твоя	Твоя
страже	страже
считаешь	считаешь
искушайте	искушайте
дополнить	дополнить
хромых	хромых
слушала	слушала
злословили	злословили
птенцов	птенцов
перебило	перебило
поглотила	поглотила
благодарили	благодарили
стоит	стоит
поселили	поселили
возливала	возливала
прикрепили	прикрепили
Будете	Будете
поддерживать	поддерживать
уходите	уходите
положили	положили
мытарь	мытарь
верхом	верхом
избранные	избранные
утопает	утопает
Новы	Новы
кормила	кормила
исполнить	исполнить
бич	бич
проходите	проходите
вложить	вложить
скрепите	скрепите
сохраняйте	сохраняйте
повреди	повреди
это	это
темных	темных
возвеличился	возвеличился
уповать	уповать
поехали	поехали
Святого	Святого
немало	немало
поступили	поступили
возгласите	возгласите
юношах	юношах
сажали	сажали
переносить	переносить
червю	червю
целом	целом
отворили	отворили
голубого	голубого
дорогою	дорогою
простертой	простертой
сокрытый	сокрытый
теснился	теснился
вечером	вечером
набрала	набрала
странствующий	странствующий
сравнить	сравнить
вступили	вступили
надел	надел
отнимите	отнимите
отложи	отложи
беременные	беременные
сажен	сажен
Сию	Сию
град	град
отвозили	отвозили
очистить	очистить
шипов	шипов
шипа	шипа
выбросите	выбросите
разложите	разложите
Тем	Тем
закрой	закрой
носили	носили
считай	считай
похвалили	похвалили
ростом	ростом
ночного	ночного
плече	плече
аспида	аспида
разводите	разводите
рассуди	рассуди
отвратите	отвратите
заключен	заключен
отяготили	отяготили
воспитывала	воспитывала
воротился	воротился
прислуги	прислуги
бесноватые	бесноватые
унывать	унывать
проходить	проходить
пройди	пройди
возрос	возрос
сами	сами
отпустим	отпустим
умирать	умирать
жилищах	жилищах
выходит	выходит
богом	богом
голодного	голодного
пророчестве	пророчестве
тайны	тайны
рабы	рабы
правым	правым
моря	моря
Душа	Душа
отложили	отложили
никакою	никакою
вынеси	вынеси
наполняла	наполняла
просила	просила
подумали	подумали
сделала	сделала
отпустите	отпустите
покрою	покрою
признаешь	признаешь
ступите	ступите
находили	находили
отходить	отходить
спроси	спроси
окропили	окропили
вызывать	вызывать
скрывай	скрывай
сделайте	сделайте
похитить	похитить
глазу	глазу
подтвердить	подтвердить
Израилеву	Израилеву
напасть	напасть
фараоном	фараоном
сокрушен	сокрушен
произноси	произноси
каплют	каплют
проклят	проклят
дополните	дополните
онемел	онемел
свободный	свободный
начерпали	начерпали
свекрови	свекрови
продолжала	продолжала
неверующая	неверующая
поднят	поднят
Приветствуй	Приветствуй
содержали	содержали
приготовить	приготовить
зимой	зимой
старейшины	старейшины
провозгласили	провозгласили
рой	рой
пищи	пищи
облаке	облаке
поглотили	поглотили
благовестить	благовестить
открыли	открыли
избавили	избавили
право	право
аспид	аспид
слез	слез
хранили	хранили
поноси	поноси
выливайте	выливайте
назидая	назидая
исходили	исходили
сухою	сухою
сынах	сынах
отменить	отменить
покров	покров
избранных	избранных
словом	словом
рулем	рулем
заклятым	заклятым
миру	миру
затыкает	затыкает
святым	святым
сопровождать	сопровождать
большая	большая
придворных	придворных
говорили	говорили
старое	старое
заключите	заключите
покрывала	покрывала
наставили	наставили
отличился	отличился
обложила	обложила
затворит	затворит
смири	смири
вложи	вложи
истребили	истребили
подтверди	подтверди
камни	камни
пленила	пленила
какие	какие
нехороша	нехороша
преданного	преданного
обрати	обрати
меньшие	меньшие
отступили	отступили
заговорит	заговорит
отдать	отдать
столах	столах
изнеженный	изнеженный
каждом	каждом
судив	судив
вело	вело
пленили	пленили
поддерживала	поддерживала
заколи	заколи
пол	пол
черных	черных
строите	строите
спите	спите
Возлюбленный	Возлюбленный
другую	другую
чудовища	чудовища
имейте	имейте
палит	палит
половина	половина
убегу	убегу
выслушайте	выслушайте
исцелить	исцелить
половинах	половинах
невежды	невежды
белом	белом
любимую	любимую
главных	главных
учился	учился
узнаете	узнаете
мало	мало
смертным	смертным
даруешь	даруешь
смертного	смертного
венца	венца
тысяченачальникам	тысяченачальникам
убитым	убитым
передвигай	передвигай
головою	головою
Адам	Адам
соорудить	соорудить
ужина	ужина
извратить	извратить
небольшую	небольшую
вымойте	вымойте
подтвердили	подтвердили
забытая	забытая
покрыли	покрыли
подкрепили	подкрепили
утру	утру
божеству	божеству
хромой	хромой
простирали	простирали
Даном	Даном
могла	могла
заклятого	заклятого
принято	принято
начало	начало
молотить	молотить
расположился	расположился
сосчитать	сосчитать
променяли	променяли
Оно	Оно
пребывали	пребывали
Богу	Богу
запрудите	запрудите
золотой	золотой
потерянною	потерянною
похорони	похорони
исцеляйте	исцеляйте
опустошили	опустошили
Как	Как
человеческой	человеческой
выдайте	выдайте
счете	счете
великой	великой
траве	траве
ожесточите	ожесточите
льстить	льстить
Духе	Духе
первою	первою
стража	стража
преследовали	преследовали
почитает	почитает
сторожам	сторожам
молодую	молодую
выливай	выливай
напоили	напоили
соблазнить	соблазнить
козлом	козлом
сберегите	сберегите
рабах	рабах
разграбили	разграбили
засевай	засевай
изнеженных	изнеженных
жала	жала
уменьшить	уменьшить
имело	имело
каждый	каждый
добро	добро
сатаны	сатаны
жребии	жребии
соединился	соединился
смертные	смертные
разорили	разорили
снабди	снабди
исполнили	исполнили
плачу	плачу
уповайте	уповайте
выполняйте	выполняйте
спешить	спешить
нечистоте	нечистоте
рыдайте	рыдайте
пленным	пленным
Знайте	Знайте
беременным	беременным
заплатить	заплатить
вы	вы
чудовище	чудовище
звезда	звезда
отцов	отцов
вороти	вороти
обирал	обирал
дали	дали
пухла	пухла
язвою	язвою
плачем	плачем
всходите	всходите
отворила	отворила
посвятила	посвятила
Тиром	Тиром
променять	променять
рождать	рождать
передвигает	передвигает
возмутили	возмутили
возгласи	возгласи
исчислить	исчислить
губи	губи
птенцах	птенцах
поспешив	поспешив
благословляйте	благословляйте
исчислите	исчислите
они	они
смел	смел
носился	носился
молодая	молодая
наполнить	наполнить
нем	нем
любимы	любимы
приклонить	приклонить
литое	литое
презирать	презирать
подпали	подпали
переходишь	переходишь
очистили	очистили
опусти	опусти
молили	молили
спит	спит
разрушить	разрушить
проходи	проходи
мечи	мечи
остановить	остановить
мозгов	мозгов
Духа	Духа
раздражили	раздражили
растворила	растворила
вопрошали	вопрошали
торга	торга
каждую	каждую
ждите	ждите
принимать	принимать
святая	святая
устройством	устройством
нехороши	нехороши
сосчитайте	сосчитайте
вмещать	вмещать
путевой	путевой
пострадали	пострадали
обнажен	обнажен
коленом	коленом
почиешь	почиешь
выкупали	выкупали
малом	малом
убитого	убитого
заходит	заходит
пленные	пленные
зле	зле
добром	добром
ходите	ходите
венце	венце
Тире	Тире
дрогнули	дрогнули
случая	случая
отвалит	отвалит
затрепетал	затрепетал
выть	выть
левши	левши
соделались	соделались
замедлить	замедлить
правые	правые
открывай	открывай
сатана	сатана
открыто	открыто
гусеницы	гусеницы
прославлять	прославлять
открыт	открыт
Дух	Дух
разбросали	разбросали
благую	благую
нагой	нагой
велико	велико
второй	второй
прогони	прогони
молодой	молодой
смущали	смущали
встал	встал
выполним	выполним
весу	весу
отцах	отцах
главным	главным
убит	убит
возносите	возносите
жив	жив
путевые	путевые
лгали	лгали
второю	второю
образует	образует
восстало	восстало
подражать	подражать
обходите	обходите
Богом	Богом
презирали	презирали
убийц	убийц
поверить	поверить
прекратился	прекратился
судить	судить
благовествуй	благовествуй
поднята	поднята
будем	будем
возьмет	возьмет
проходит	проходит
сокрыт	сокрыт
возлюбленных	возлюбленных
чтите	чтите
сохранили	сохранили
может	может
ослабели	ослабели
скорую	скорую
учили	учили
мучила	мучила
последовало	последовало
отстать	отстать
больше	больше
воплю	воплю
чью	чью
всходить	всходить
возьмут	возьмут
покрывать	покрывать
почитать	почитать
сокруши	сокруши
разбирать	разбирать
схватите	схватите
пьяным	пьяным
возлагать	возлагать
мстите	мстите
сходишь	сходишь
вдовою	вдовою
отделите	отделите
мытаря	мытаря
передвигают	передвигают
разбить	разбить
укрепи	укрепи
наклонили	наклонили
поцелую	поцелую
трубите	трубите
пухли	пухли
бесноватым	бесноватым
тайною	тайною
искали	искали
живой	живой
засохла	засохла
пожирала	пожирала
целые	целые
Приветствуют	Приветствуют
светили	светили
насади	насади
искушать	искушать
взяло	взяло
поцелуй	поцелуй
зла	зла
любимых	любимых
сходит	сходит
отринут	отринут
прекрати	прекрати
находить	находить
сокрытой	сокрытой
намерен	намерен
призывали	призывали
держите	держите
мучили	мучили
цвет	цвет
приклонили	приклонили
согласился	согласился
раскрытую	раскрытую
красный	красный
тесните	тесните
грешили	грешили
малым	малым
научился	научился
проклинай	проклинай
берете	берете
возложить	возложить
умертвите	умертвите
граде	граде
жертвам	жертвам
бросали	бросали
избивать	избивать
переходи	переходи
поступали	поступали
большой	большой
сделать	сделать
навести	навести
поместить	поместить
прочитайте	прочитайте
Начала	Начала
Хочет	Хочет
браните	браните
утром	утром
убили	убили
унизить	унизить
носильщиков	носильщиков
нечистой	нечистой
спаси	спаси
проклятых	проклятых
ступили	ступили
неверных	неверных
случай	случай
гусеница	гусеница
Сия	Сия
Сам	Сам
чужая	чужая
погреби	погреби
выдавать	выдавать
отвратить	отвратить
сложить	сложить
прославляли	прославляли
собранным	собранным
страх	страх
протянут	протянут
белых	белых
имеем	имеем
возлюбленным	возлюбленным
заставить	заставить
жемчуга	жемчуга
Израильскою	Израильскою
осени	осени
плечом	плечом
созывать	созывать
слушай	слушай
пали	пали
поводом	поводом
среды	среды
бесовскую	бесовскую
оказывать	оказывать
жали	жали
восстановить	восстановить
второго	второго
града	града
услышите	услышите
убийца	убийца
золотом	золотом
жернов	жернов
злодейством	злодейством
самым	самым
наскучил	наскучил
добре	добре
затворить	затворить
произносите	произносите
подходили	подходили
пожирать	пожирать
строят	строят
отыщи	отыщи
числе	числе
омыли	омыли
смотрите	смотрите
звездам	звездам
спустили	спустили
получить	получить
болотом	болотом
переходите	переходите
огорчился	огорчился
закрою	закрою
любила	любила
приводили	приводили
посадите	посадите
желчь	желчь
большого	большого
напоить	напоить
сопровождали	сопровождали
расслабленные	расслабленные
исходят	исходят
заключи	заключи
животных	животных
пригласи	пригласи
жертву	жертву
мешке	мешке
тайна	тайна
любим	любим
ожесточи	ожесточи
разделили	разделили
скал	скал
покровом	покровом
воплем	воплем
знакомые	знакомые
безумным	безумным
окончили	окончили
попроси	попроси
отдели	отдели
раздирать	раздирать
замолчали	замолчали
поразили	поразили
направили	направили
одолела	одолела
напоминайте	напоминайте
сказывали	сказывали
созрели	созрели
исполните	исполните
замечайте	замечайте
украсила	украсила
трава	трава
прямых	прямых
пьяный	пьяный
язычески	язычески
поясом	поясом
заплатите	заплатите
освятили	освятили
одержимого	одержимого
пересчитай	пересчитай
выходим	выходим
благодарите	благодарите
одинокую	одинокую
прогоните	прогоните
знаком	знаком
устройстве	устройстве
образ	образ
соблазнили	соблазнили
образуем	образуем
бока	бока
отворить	отворить
будет	будет
сокрытую	сокрытую
котлом	котлом
привезла	привезла
начинай	начинай
заменим	заменим
поразила	поразила
мухи	мухи
находят	находят
опустошен	опустошен
ела	ела
погасили	погасили
скрывайте	скрывайте
утомленный	утомленный
снегом	снегом
сестрою	сестрою
святые	святые
лежите	лежите
сотворила	сотворила
соляною	соляною
принеси	принеси
последуй	последуй
научен	научен
приветствовала	приветствовала
замедли	замедли
кормите	кормите
обличи	обличи
хулили	хулили
Соляную	Соляную
жертв	жертв
Кому	Кому
лицу	лицу
страха	страха
подкрепить	подкрепить
отыщите	отыщите
благотворить	благотворить
написали	написали
леса	леса
служить	служить
проходили	проходили
роста	роста
низложи	низложи
матери	матери
даруй	даруй
образу	образу
верить	верить
наг	наг
новые	новые
раздражали	раздражали
снега	снега
отнято	отнято
начать	начать
семействе	семействе
уговаривать	уговаривать
возвестим	возвестим
головы	головы
почиет	почиет
тельцам	тельцам
накормили	накормили
сохрани	сохрани
теснить	теснить
самом	самом
берега	берега
твердые	твердые
познайте	познайте
доказать	доказать
учи	учи
встретить	встретить
держу	держу
дать	дать
услышали	услышали
смешанные	смешанные
раскрытая	раскрытая
человеческую	человеческую
сладкою	сладкою
Был	Был
языком	языком
пары	пары
горькую	горькую
вкусить	вкусить
языческую	языческую
выносили	выносили
собирала	собирала
постиг	постиг
соделаю	соделаю
вносить	вносить
умирающий	умирающий
доброю	доброю
отврати	отврати
празднуй	празднуй
нашу	нашу
велите	велите
Царю	Царю
