beharret	beharret
Worten	Worten
speise	speise
Schilde	Schilde
verkehrt	verkehrt
ausrufest	ausrufest
mangelte	mangelte
Worte	Worte
Heere	Heere
klage	klage
kriegen	kriegen
verdeckst	verdeckst
weichet	weichet
Bär	Bär
wehe	wehe
Rühmst	Rühmst
preiset	preiset
Älteste	Älteste
hattet	hattet
neigest	neigest
besäest	besäest
verwahrt	verwahrt
Solcher	Solcher
Äste	Äste
erlöset	erlöset
plagen	plagen
versagt	versagt
heben	heben
Laufen	Laufen
Mäusen	Mäusen
wäre	wäre
verlobte	verlobte
fromme	fromme
bestellt	bestellt
Söhnen	Söhnen
lieben	lieben
Male	Male
fertigte	fertigte
bringest	bringest
Wache	Wache
Frösche	Frösche
Sollte	Sollte
schämst	schämst
opferte	opferte
Höfe	Höfe
schätzt	schätzt
hell	hell
strecken	strecken
wissest	wissest
sorgte	sorgte
Strafe	Strafe
ratschlagen	ratschlagen
aßet	aßet
Hure	Hure
Früchte	Früchte
betrübten	betrübten
schlagest	schlagest
beschwöre	beschwöre
vor	vor
versucht	versucht
gebären	gebären
versuchen	versuchen
weist	weist
liege	liege
rauschte	rauschte
Knabe	Knabe
Jahren	Jahren
erschrickt	erschrickt
stirbst	stirbst
fluchet	fluchet
naht	naht
speiet	speiet
Tritte	Tritte
Buben	Buben
höret	höret
beide	beide
aufstanden	aufstanden
flehst	flehst
Sorget	Sorget
Rechte	Rechte
siehst	siehst
Wachet	Wachet
Einem	Einem
untergehst	untergehst
fragen	fragen
stehest	stehest
kämpfe	kämpfe
Knechte	Knechte
Nehmt	Nehmt
Prophet	Prophet
Eilet	Eilet
stoßet	stoßet
Spannt	Spannt
beweisest	beweisest
handhabest	handhabest
Kräfte	Kräfte
arbeit	arbeit
ihren	ihren
schätzen	schätzen
pflegte	pflegte
wohnst	wohnst
reichte	reichte
reife	reife
regen	regen
schenkst	schenkst
erhöhst	erhöhst
geboten	geboten
untergeht	untergeht
entsetzt	entsetzt
bezahlst	bezahlst
brauchte	brauchte
zeigst	zeigst
urteile	urteile
Stimmen	Stimmen
rührst	rührst
denkst	denkst
eilte	eilte
werft	werft
beweisen	beweisen
verkürzest	verkürzest
Fülle	Fülle
schießt	schießt
hättest	hättest
Beinen	Beinen
Gängen	Gängen
Könige	Könige
erlösen	erlösen
Zeugen	Zeugen
grünte	grünte
bekehret	bekehret
wollten	wollten
heilet	heilet
lehnte	lehnte
angehöret	angehöret
lieget	lieget
zweifeln	zweifeln
merkte	merkte
widerstanden	widerstanden
Gesetzen	Gesetzen
erschreckt	erschreckt
Lehne	Lehne
trüb	trüb
Trübsale	Trübsale
möchte	möchte
jauchzt	jauchzt
zuschließet	zuschließet
Ihr	Ihr
jedes	jedes
gehörte	gehörte
lösest	lösest
höhnte	höhnte
ungehorsame	ungehorsame
leiten	leiten
Bahn	Bahn
Gebt	Gebt
Wüsten	Wüsten
streckte	streckte
gebieten	gebieten
Grüße	Grüße
scheinest	scheinest
verkündigest	verkündigest
Töpfe	Töpfe
verbannet	verbannet
schaute	schaute
glaube	glaube
Bäume	Bäume
säte	säte
betrübte	betrübte
Mein	Mein
erfahrt	erfahrt
Entsetzet	Entsetzet
sucht	sucht
verunreinigst	verunreinigst
Reife	Reife
Sabbate	Sabbate
zeuge	zeuge
wisse	wisse
stürze	stürze
eingehet	eingehet
lachen	lachen
Herr	Herr
fremde	fremde
verständig	verständig
lehrte	lehrte
freute	freute
zudeckte	zudeckte
nötig	nötig
Tischen	Tischen
solche	solche
wilden	wilden
gute	gute
verstehst	verstehst
dürfest	dürfest
nahest	nahest
fallen	fallen
Predigten	Predigten
Heide	Heide
wechseln	wechseln
fällte	fällte
zerbrecht	zerbrecht
Werk	Werk
Äxte	Äxte
Lüste	Lüste
Huren	Huren
Füchse	Füchse
saget	saget
schlag	schlag
Wunde	Wunde
messen	messen
glauben	glauben
verdammte	verdammte
Gebote	Gebote
bewahrest	bewahrest
bereite	bereite
dürft	dürft
Streite	Streite
morde	morde
Gästen	Gästen
unseres	unseres
Schlägen	Schlägen
wehen	wehen
Maultieren	Maultieren
links	links
Buche	Buche
Basilisk	Basilisk
verstopft	verstopft
würden	würden
führe	führe
Kühe	Kühe
ach	ach
keines	keines
enge	enge
nötige	nötige
Sollten	Sollten
kennet	kennet
scheinet	scheinet
Ach	Ach
war	war
hinausgeht	hinausgeht
bedeckt	bedeckt
Biene	Biene
anrichtet	anrichtet
Geschäfte	Geschäfte
schlaf	schlaf
hebst	hebst
rufst	rufst
versteckst	versteckst
gedenkst	gedenkst
wachen	wachen
besucht	besucht
stand	stand
baute	baute
glaubest	glaubest
wünschte	wünschte
Seit	Seit
untertreten	untertreten
ehrest	ehrest
Willst	Willst
Schafen	Schafen
beißt	beißt
wünsche	wünsche
Wollt	Wollt
Fremden	Fremden
kühlen	kühlen
Drachen	Drachen
wurden	wurden
Sabbaten	Sabbaten
dein	dein
Kost	Kost
glaubet	glaubet
morden	morden
erste	erste
werten	werten
Heeren	Heeren
konnte	konnte
Schaffe	Schaffe
lose	lose
Anklage	Anklage
Solches	Solches
Alte	Alte
grabe	grabe
vertrieben	vertrieben
irre	irre
Schreien	Schreien
anders	anders
verstört	verstört
Gebärde	Gebärde
waren	waren
Grieche	Grieche
verlähmte	verlähmte
kämpfte	kämpfte
nächste	nächste
wer	wer
Taube	Taube
Tut	Tut
Kehre	Kehre
rauben	rauben
rühmst	rühmst
Geräte	Geräte
Maßen	Maßen
zürnest	zürnest
ermahnet	ermahnet
übet	übet
wirkte	wirkte
anrichten	anrichten
umkämen	umkämen
Westen	Westen
Eile	Eile
wurdet	wurdet
bestellte	bestellte
vertrieb	vertrieb
kühle	kühle
Gefängnisse	Gefängnisse
bange	bange
verlobt	verlobt
Ei	Ei
verkriechst	verkriechst
krank	krank
Reich	Reich
währte	währte
sitzen	sitzen
streckst	streckst
bauten	bauten
hüte	hüte
unser	unser
tuest	tuest
erbaut	erbaut
zählst	zählst
verwirfst	verwirfst
gründen	gründen
glänzt	glänzt
Deinem	Deinem
stürzte	stürzte
schenket	schenket
aufstehst	aufstehst
umkommst	umkommst
tatet	tatet
Sehe	Sehe
eilet	eilet
erfüllet	erfüllet
Tiefen	Tiefen
huren	huren
trauten	trauten
brach	brach
fünfte	fünfte
lehrest	lehrest
Einen	Einen
zählte	zählte
Wogen	Wogen
prüfst	prüfst
leite	leite
zeuget	zeuget
Trübsalen	Trübsalen
jagte	jagte
ausführt	ausführt
Anschläge	Anschläge
strecke	strecke
geselle	geselle
stürzest	stürzest
Neumonde	Neumonde
schmückte	schmückte
Tauben	Tauben
Wachen	Wachen
heiligest	heiligest
treibst	treibst
angehört	angehört
Held	Held
strafst	strafst
lauft	lauft
wacht	wacht
gewinne	gewinne
Meinem	Meinem
müßten	müßten
werdet	werdet
hebe	hebe
Essen	Essen
möchten	möchten
wache	wache
verkürzt	verkürzt
Stämmen	Stämmen
Boten	Boten
Fromme	Fromme
müßte	müßte
danke	danke
arbeiten	arbeiten
Höhen	Höhen
bedeckest	bedeckest
gibt	gibt
betrügen	betrügen
holte	holte
verstörten	verstörten
Aufsätze	Aufsätze
Spitzen	Spitzen
sehest	sehest
Diese	Diese
springen	springen
raubest	raubest
Kriegsknechten	Kriegsknechten
meinst	meinst
Rufet	Rufet
Drache	Drache
Söhne	Söhne
beweise	beweise
verstecken	verstecken
Aller	Aller
wollest	wollest
fragst	fragst
drängest	drängest
ältesten	ältesten
gern	gern
backt	backt
keinen	keinen
bewahrt	bewahrt
eile	eile
meinem	meinem
laut	laut
ehrte	ehrte
Trinkgefäßen	Trinkgefäßen
Sehne	Sehne
vertilgst	vertilgst
machest	machest
Schwänze	Schwänze
Testamenten	Testamenten
bebte	bebte
stehst	stehst
weich	weich
verfolgst	verfolgst
heilte	heilte
mehrte	mehrte
Sabbatjahr	Sabbatjahr
erhöhest	erhöhest
weiden	weiden
schreiben	schreiben
fange	fange
heißt	heißt
Ängste	Ängste
Herrn	Herrn
sterbt	sterbt
Letzten	Letzten
schwebe	schwebe
zuhört	zuhört
Altären	Altären
kurz	kurz
lügst	lügst
Hast	Hast
begehre	begehre
besät	besät
hure	hure
beten	beten
Türkis	Türkis
pflügte	pflügte
gießest	gießest
weine	weine
seufzte	seufzte
haderte	haderte
Wollte	Wollte
Röcke	Röcke
laufe	laufe
Wegen	Wegen
Stricken	Stricken
breche	breche
Schild	Schild
Stärke	Stärke
Säcke	Säcke
aufhörte	aufhörte
Füllet	Füllet
Leuchten	Leuchten
übrigbleibet	übrigbleibet
lobe	lobe
Füllen	Füllen
Schwelle	Schwelle
Kreuze	Kreuze
merket	merket
verderben	verderben
nachwandelst	nachwandelst
All	All
trägst	trägst
regieren	regieren
feierten	feierten
grüßt	grüßt
säumet	säumet
auflöste	auflöste
weiten	weiten
schweigen	schweigen
jede	jede
verstehest	verstehest
erwerben	erwerben
Name	Name
erst	erst
verzieh	verzieh
murmelte	murmelte
Flöte	Flöte
Ding	Ding
bringst	bringst
erhebest	erhebest
nimmt	nimmt
Kein	Kein
umkehrte	umkehrte
Gehör	Gehör
aller	aller
sehet	sehet
schwelle	schwelle
anzeige	anzeige
lachte	lachte
deines	deines
befestigten	befestigten
Acht	Acht
Glaubst	Glaubst
Bergen	Bergen
seht	seht
Jahre	Jahre
Staub	Staub
rühmet	rühmet
Abhängen	Abhängen
seufzt	seufzt
raten	raten
bedenken	bedenken
anrührte	anrührte
Gefäßen	Gefäßen
backen	backen
jedem	jedem
erzürnet	erzürnet
Gedanke	Gedanke
gedacht	gedacht
esset	esset
Zweige	Zweige
Gefangenen	Gefangenen
betrübet	betrübet
Perle	Perle
Pauke	Pauke
haltest	haltest
Buchstabe	Buchstabe
recke	recke
verkündigst	verkündigst
werte	werte
reizest	reizest
Wände	Wände
kosten	kosten
aufstehet	aufstehet
schmücket	schmücket
Heiden	Heiden
sitzet	sitzet
nehmest	nehmest
lest	lest
offenbar	offenbar
zwölften	zwölften
säumen	säumen
schaffe	schaffe
regierest	regierest
stellet	stellet
einsammelst	einsammelst
fahret	fahret
schaffst	schaffst
unterrichtet	unterrichtet
ausführte	ausführte
Freunden	Freunden
weichen	weichen
sagte	sagte
unsre	unsre
Ströme	Ströme
schaffet	schaffet
Ordnung	Ordnung
verschont	verschont
säume	säume
Räte	Räte
werde	werde
tretest	tretest
Werden	Werden
müsset	müsset
Herden	Herden
Am	Am
bekehrten	bekehrten
entsündigte	entsündigte
Kreisen	Kreisen
Hecke	Hecke
Bäumen	Bäumen
Hunde	Hunde
pflanzest	pflanzest
hängte	hängte
empört	empört
träumen	träumen
den	den
absagen	absagen
hebräische	hebräische
Werde	Werde
grüne	grüne
fressen	fressen
erzeigt	erzeigt
gewöhnt	gewöhnt
bemühst	bemühst
dritte	dritte
durchbohrte	durchbohrte
zerstreute	zerstreute
Sekten	Sekten
fluchten	fluchten
klagte	klagte
stürzt	stürzt
Propheten	Propheten
Schneide	Schneide
Seines	Seines
Suchet	Suchet
erbte	erbte
hatte	hatte
erlösest	erlösest
trinken	trinken
eines	eines
mühe	mühe
Schlange	Schlange
säst	säst
verhalten	verhalten
Leiste	Leiste
erkennst	erkennst
webet	webet
Perlen	Perlen
verkehrte	verkehrte
laufet	laufet
Werke	Werke
Lehnen	Lehnen
hänge	hänge
abtrünnigen	abtrünnigen
sagen	sagen
erwürgt	erwürgt
Sagte	Sagte
steinigest	steinigest
berühret	berühret
Eiche	Eiche
Wehre	Wehre
vergebt	vergebt
Schuhen	Schuhen
weite	weite
verkauften	verkauften
erhebst	erhebst
Wille	Wille
wart	wart
Säcken	Säcken
reiche	reiche
Helmen	Helmen
freiwillige	freiwillige
Tanne	Tanne
ihr	ihr
Kühen	Kühen
ausführe	ausführe
eins	eins
brachen	brachen
suchet	suchet
drängst	drängst
Monate	Monate
drängten	drängten
gedenkest	gedenkest
Klauen	Klauen
Schenken	Schenken
aufhört	aufhört
schaffte	schaffte
meinte	meinte
kostet	kostet
hebet	hebet
Köpfe	Köpfe
Maultiere	Maultiere
zählet	zählet
Zweigen	Zweigen
verkriechet	verkriechet
Enden	Enden
vergesset	vergesset
stärken	stärken
spracht	spracht
leider	leider
fliege	fliege
Warten	Warten
Als	Als
ungefälschter	ungefälschter
Meinen	Meinen
fahrest	fahrest
kämpfen	kämpfen
würzen	würzen
gebrauchte	gebrauchte
verkündigten	verkündigten
Schaffet	Schaffet
niemand	niemand
ab	ab
bleibest	bleibest
beschädigte	beschädigte
bezahlest	bezahlest
gesellt	gesellt
erschreckte	erschreckte
unterrichte	unterrichte
Rufe	Rufe
wünschet	wünschet
Wirst	Wirst
zerbrichst	zerbrichst
Hälse	Hälse
Willen	Willen
wilde	wilde
los	los
spannt	spannt
Füßen	Füßen
beschuldiget	beschuldiget
Alten	Alten
zerreißt	zerreißt
anhangt	anhangt
gehörten	gehörten
Wert	Wert
fertig	fertig
Halle	Halle
Anfechtungen	Anfechtungen
jaget	jaget
Speisen	Speisen
Aas	Aas
Dinge	Dinge
besuche	besuche
setzte	setzte
schau	schau
auflöst	auflöst
reichet	reichet
Zähne	Zähne
konnten	konnten
stellst	stellst
steinigst	steinigst
aufwachst	aufwachst
Hörst	Hörst
nimmst	nimmst
entsetzen	entsetzen
suchte	suchte
nähre	nähre
Soll	Soll
Zehe	Zehe
erforschest	erforschest
bat	bat
verkehre	verkehre
diente	diente
teilen	teilen
Gevierte	Gevierte
Sagen	Sagen
frische	frische
forschte	forschte
merken	merken
Steige	Steige
hatten	hatten
koste	koste
erfüllst	erfüllst
zerrüttet	zerrüttet
Steigen	Steigen
wachset	wachset
Bube	Bube
urteilte	urteilte
erweckst	erweckst
male	male
Wehklagen	Wehklagen
Danket	Danket
möget	möget
eures	eures
Dein	Dein
aßest	aßest
pflügen	pflügen
empörte	empörte
raubte	raubte
Speere	Speere
Warte	Warte
löste	löste
hinausgehst	hinausgehst
Fittiche	Fittiche
solle	solle
Leichnamen	Leichnamen
schauest	schauest
Hunden	Hunden
setzt	setzt
füllte	füllte
fetten	fetten
wahre	wahre
schenke	schenke
Grab	Grab
messet	messet
Rühmet	Rühmet
Freunde	Freunde
aufrichten	aufrichten
fehlet	fehlet
Fäusten	Fäusten
Säuen	Säuen
jungen	jungen
Könnet	Könnet
ausrufen	ausrufen
Gefilde	Gefilde
würde	würde
demütigte	demütigte
kämpfet	kämpfet
allem	allem
Stühle	Stühle
schreiet	schreiet
umkehret	umkehret
Fellen	Fellen
erkennet	erkennet
toten	toten
gefällst	gefällst
Pferde	Pferde
Schleife	Schleife
ausgehst	ausgehst
Plagen	Plagen
rufest	rufest
Namen	Namen
Türme	Türme
Tagen	Tagen
empörten	empörten
warten	warten
fertige	fertige
erfreut	erfreut
lieb	lieb
Ecken	Ecken
streute	streute
heiligten	heiligten
ratet	ratet
Gebeten	Gebeten
Taten	Taten
Weil	Weil
erzeigen	erzeigen
hättet	hättet
Schläge	Schläge
wurdest	wurdest
Erben	Erben
wegführe	wegführe
erschrickst	erschrickst
bedenket	bedenket
wurde	wurde
anrührt	anrührt
Lesen	Lesen
verstanden	verstanden
spalten	spalten
Binde	Binde
wirft	wirft
selbst	selbst
verzehrst	verzehrst
stoßt	stoßt
Keine	Keine
ermahnt	ermahnt
abweichet	abweichet
Habe	Habe
spanne	spanne
lache	lache
versteckt	versteckt
griffen	griffen
Gefangene	Gefangene
vermögen	vermögen
hassest	hassest
machet	machet
euren	euren
möge	möge
Bitte	Bitte
Höret	Höret
liebet	liebet
durchbohrt	durchbohrt
begrabest	begrabest
dürfe	dürfe
vertrauten	vertrauten
brechen	brechen
wiederkommt	wiederkommt
gießt	gießt
Teil	Teil
Städte	Städte
losen	losen
vertrage	vertrage
tobst	tobst
Würze	Würze
wehklagen	wehklagen
bereitet	bereitet
folgen	folgen
gerne	gerne
wog	wog
zeugte	zeugte
helfest	helfest
hause	hause
wehklage	wehklage
Meines	Meines
verdammst	verdammst
hieltet	hieltet
Erstlingen	Erstlingen
machte	machte
feiern	feiern
knüpfst	knüpfst
Narr	Narr
gehöre	gehöre
mehret	mehret
verkaufe	verkaufe
verbirgt	verbirgt
spricht	spricht
gebührt	gebührt
Gebete	Gebete
Kristallen	Kristallen
Suche	Suche
verdeckten	verdeckten
versöhnst	versöhnst
Fels	Fels
wolle	wolle
Zäunen	Zäunen
flehte	flehte
zeugest	zeugest
sitzest	sitzest
siegen	siegen
verkehrten	verkehrten
Denen	Denen
hineingeht	hineingeht
koche	koche
Kohlen	Kohlen
weinte	weinte
trotzet	trotzet
nahe	nahe
Unrechten	Unrechten
Bienen	Bienen
steigen	steigen
Gewürzen	Gewürzen
schlafet	schlafet
sprecht	sprecht
bauet	bauet
leid	leid
innere	innere
ehret	ehret
verdammten	verdammten
irren	irren
Vorhäuten	Vorhäuten
aufkommt	aufkommt
macht	macht
aufkämen	aufkämen
erzürnt	erzürnt
auflegte	auflegte
denen	denen
stelle	stelle
Bären	Bären
Schmieden	Schmieden
blende	blende
Ebenen	Ebenen
vertraute	vertraute
sagst	sagst
gehet	gehet
forschet	forschet
fresse	fresse
Linken	Linken
Macht	Macht
Gebärden	Gebärden
Verwundete	Verwundete
still	still
Kreise	Kreise
fastetest	fastetest
Zerstreuten	Zerstreuten
meine	meine
streiten	streiten
würze	würze
Maße	Maße
plagte	plagte
Felle	Felle
Banden	Banden
weh	weh
redete	redete
bekannt	bekannt
wirfst	wirfst
erhört	erhört
tust	tust
erfreuest	erfreuest
Spießen	Spießen
erwürget	erwürget
schreckt	schreckt
am	am
Zeug	Zeug
bewähret	bewähret
fällt	fällt
stürzen	stürzen
demütigst	demütigst
müsse	müsse
kaufest	kaufest
begrabt	begrabt
gebiete	gebiete
abweichest	abweichest
gebet	gebet
verführt	verführt
Samen	Samen
Gibt	Gibt
Hallen	Hallen
Eingeweide	Eingeweide
reizen	reizen
scheue	scheue
Ältesten	Ältesten
speist	speist
gedachten	gedachten
Neumonden	Neumonden
gebühren	gebühren
lebet	lebet
solches	solches
gehört	gehört
speiest	speiest
wirkst	wirkst
leben	leben
Ruder	Ruder
stäupte	stäupte
weisen	weisen
überführt	überführt
beseht	beseht
frisch	frisch
stiften	stiften
Türkise	Türkise
Erste	Erste
ladest	ladest
Weichet	Weichet
rufet	rufet
begehrten	begehrten
fasset	fasset
Christen	Christen
begehrst	begehrst
behaltest	behaltest
unschuldigen	unschuldigen
schreibst	schreibst
nachwandelt	nachwandelt
Blitzen	Blitzen
seufzest	seufzest
Binden	Binden
befragte	befragte
Hälsen	Hälsen
schöpfe	schöpfe
Beine	Beine
tat	tat
Tage	Tage
preist	preist
lebest	lebest
zudeckt	zudeckt
Narren	Narren
liebte	liebte
Fett	Fett
zerstört	zerstört
Ihren	Ihren
Fremde	Fremde
Armen	Armen
Herde	Herde
fette	fette
Glaubet	Glaubet
Tieren	Tieren
Haue	Haue
laute	laute
Glauben	Glauben
helfet	helfet
heiße	heiße
gehst	gehst
kehret	kehret
unsrer	unsrer
amen	amen
grüßet	grüßet
schicke	schicke
Sprüchen	Sprüchen
tief	tief
hausen	hausen
Rufen	Rufen
verlähmt	verlähmt
Hebet	Hebet
leere	leere
führte	führte
jammerte	jammerte
Rubinen	Rubinen
Junge	Junge
Jungen	Jungen
lehre	lehre
Stimme	Stimme
mühte	mühte
Last	Last
Königen	Königen
Solch	Solch
ungeistlichen	ungeistlichen
Aussätzigen	Aussätzigen
Ochsen	Ochsen
grüßen	grüßen
Taufen	Taufen
vereinigte	vereinigte
spiele	spiele
Bäche	Bäche
angehören	angehören
Reihen	Reihen
weichst	weichst
erlasset	erlasset
solcher	solcher
Kehret	Kehret
Joche	Joche
fällen	fällen
selber	selber
Tannen	Tannen
zierte	zierte
erniedrigst	erniedrigst
brauchst	brauchst
Gründen	Gründen
all	all
Frommen	Frommen
deckst	deckst
verzieht	verzieht
Schreiet	Schreiet
Letzte	Letzte
mußt	mußt
reizt	reizt
borgst	borgst
Höhle	Höhle
verkündiget	verkündiget
eine	eine
brauste	brauste
frage	frage
klagen	klagen
schnell	schnell
Unglauben	Unglauben
unsere	unsere
Weinstöcke	Weinstöcke
mahlen	mahlen
folgte	folgte
pflanzet	pflanzet
sorge	sorge
zuhörte	zuhörte
berührt	berührt
scheute	scheute
regiert	regiert
decke	decke
Ebene	Ebene
Fahrt	Fahrt
ruhe	ruhe
beweist	beweist
blast	blast
Bunde	Bunde
Sei	Sei
begehret	begehret
bestimmt	bestimmt
räumet	räumet
Fische	Fische
rechte	rechte
malen	malen
Trübsal	Trübsal
verlasset	verlasset
außer	außer
Forschet	Forschet
aufhebt	aufhebt
kaufte	kaufte
Götze	Götze
wehte	wehte
pflegst	pflegst
Zöpfen	Zöpfen
bleibe	bleibe
Schauen	Schauen
ausbreitet	ausbreitet
solchen	solchen
Haut	Haut
steigest	steigest
legte	legte
wohnest	wohnest
hilft	hilft
jagst	jagst
bauest	bauest
erforscht	erforscht
fallest	fallest
seist	seist
blitzen	blitzen
Schalen	Schalen
Leisten	Leisten
gereicht	gereicht
stolz	stolz
verklärt	verklärt
frevles	frevles
Herz	Herz
Märkten	Märkten
Tat	Tat
Gewürze	Gewürze
glänzte	glänzte
Anschlägen	Anschlägen
ehrst	ehrst
zerstreut	zerstreut
vergießt	vergießt
plagest	plagest
dienet	dienet
Leuchte	Leuchte
außen	außen
Sterne	Sterne
treibest	treibest
zerbrechest	zerbrechest
gehorcht	gehorcht
Gefilden	Gefilden
hingeht	hingeht
ausgerecktem	ausgerecktem
offenbare	offenbare
bitten	bitten
Würzen	Würzen
Gründe	Gründe
zerreißest	zerreißest
Quelle	Quelle
geratest	geratest
herrschte	herrschte
wälzet	wälzet
wogen	wogen
heiligem	heiligem
suchen	suchen
suche	suche
bekennst	bekennst
Reizen	Reizen
danket	danket
lasset	lasset
taufen	taufen
Machet	Machet
sondern	sondern
Erden	Erden
War	War
empfange	empfange
währet	währet
küsse	küsse
betrübst	betrübst
Gläubige	Gläubige
stillest	stillest
rechten	rechten
fraget	fraget
wild	wild
erweckt	erweckt
aufstand	aufstand
Gesell	Gesell
Jünger	Jünger
sitzt	sitzt
eng	eng
verboten	verboten
achten	achten
halben	halben
deinem	deinem
wärt	wärt
bedürft	bedürft
feiert	feiert
Kohle	Kohle
Tun	Tun
Säue	Säue
Bitten	Bitten
Bleibet	Bleibet
Stufen	Stufen
stille	stille
Ochse	Ochse
teilet	teilet
Wehr	Wehr
wundere	wundere
Lüsten	Lüsten
warte	warte
spielet	spielet
versuche	versuche
Abtrünnigen	Abtrünnigen
schlafest	schlafest
schnelle	schnelle
Keilen	Keilen
Mäuse	Mäuse
fehlen	fehlen
erhörest	erhörest
trinkest	trinkest
bestellten	bestellten
zeugen	zeugen
Einheimische	Einheimische
gehorchte	gehorchte
einführen	einführen
haust	haust
Eingeweiden	Eingeweiden
Klüften	Klüften
Kommet	Kommet
handhabt	handhabt
Laie	Laie
logen	logen
Weh	Weh
anbetet	anbetet
mache	mache
Heuschrecken	Heuschrecken
elfte	elfte
Meine	Meine
schauen	schauen
überführen	überführen
glaubst	glaubst
Helme	Helme
entgegenkamst	entgegenkamst
auszieht	auszieht
Fittichen	Fittichen
Brüste	Brüste
aufrichtet	aufrichtet
umbringet	umbringet
Kosten	Kosten
Schätze	Schätze
Pfeife	Pfeife
übest	übest
entsetzet	entsetzet
maß	maß
Ratsherren	Ratsherren
bewahrst	bewahrst
Orten	Orten
wehre	wehre
verziehst	verziehst
bitte	bitte
Schar	Schar
Gerichte	Gerichte
Obrigkeiten	Obrigkeiten
Sollst	Sollst
verwirren	verwirren
hieltest	hieltest
Ärgernisse	Ärgernisse
aber	aber
wert	wert
Hebe	Hebe
opfern	opfern
fahrt	fahrt
Weiche	Weiche
erhöhet	erhöhet
bestanden	bestanden
blaset	blaset
schweiget	schweiget
zwölfte	zwölfte
lesen	lesen
verbannt	verbannt
Händen	Händen
Weiß	Weiß
Kaufleute	Kaufleute
verwahret	verwahret
mal	mal
weinet	weinet
steig	steig
erfahret	erfahret
stirbt	stirbt
Hin	Hin
erlassen	erlassen
grün	grün
Kreuz	Kreuz
Den	Den
Pfeifen	Pfeifen
verstörte	verstörte
bleibst	bleibst
schätzte	schätzte
Grenze	Grenze
gebest	gebest
sitze	sitze
erbest	erbest
wachsen	wachsen
Fliegen	Fliegen
bekennet	bekennet
schlaget	schlaget
führest	führest
ungefälschtem	ungefälschtem
Werkzeugen	Werkzeugen
weisest	weisest
trieb	trieb
habet	habet
betrübt	betrübt
umkommt	umkommt
Fallt	Fallt
Heiße	Heiße
wärmet	wärmet
standet	standet
Schau	Schau
Strömen	Strömen
Ellen	Ellen
ziehest	ziehest
hörte	hörte
Märkte	Märkte
Zeuge	Zeuge
jauchzte	jauchzte
besorgt	besorgt
Fallet	Fallet
maßen	maßen
ehe	ehe
krieget	krieget
Dank	Dank
unschuldige	unschuldige
springst	springst
baust	baust
suchest	suchest
drückte	drückte
suchten	suchten
batest	batest
unsres	unsres
schießen	schießen
sorgen	sorgen
Riese	Riese
Meere	Meere
einem	einem
Nehmet	Nehmet
zanket	zanket
binde	binde
stärkte	stärkte
Juden	Juden
Sinnen	Sinnen
Wolle	Wolle
erhöht	erhöht
entsetzten	entsetzten
beschwören	beschwören
erlöse	erlöse
Sabbatjahre	Sabbatjahre
Tyrannen	Tyrannen
Werdet	Werdet
fluchte	fluchte
laben	laben
ritt	ritt
wehren	wehren
zuschließt	zuschließt
Zeugnissen	Zeugnissen
Eine	Eine
Testamente	Testamente
ausrichtet	ausrichtet
Kräften	Kräften
lernst	lernst
fließe	fließe
Monde	Monde
Dienst	Dienst
ehren	ehren
werdest	werdest
Grabe	Grabe
nütze	nütze
schlagt	schlagt
dritten	dritten
absagt	absagt
ausziehst	ausziehst
Schlangen	Schlangen
Ha	Ha
flucht	flucht
Jünglinge	Jünglinge
regte	regte
sage	sage
wechselte	wechselte
bekehrst	bekehrst
wachte	wachte
Feiertagen	Feiertagen
erkannten	erkannten
Säge	Säge
zweifel	zweifel
aufwacht	aufwacht
lobet	lobet
liebe	liebe
Welche	Welche
Bund	Bund
stiftete	stiftete
Ringe	Ringe
Röhre	Röhre
esse	esse
beides	beides
vereinigt	vereinigt
gewinnen	gewinnen
Ratet	Ratet
Schuhe	Schuhe
grüßte	grüßte
schaffest	schaffest
fülle	fülle
Frage	Frage
bestand	bestand
Zerstreut	Zerstreut
vergießest	vergießest
Schiffen	Schiffen
traget	traget
Toren	Toren
mußte	mußte
Felsen	Felsen
solchem	solchem
Flöten	Flöten
demütige	demütige
ihre	ihre
denket	denket
verkündigt	verkündigt
erzeigest	erzeigest
Seht	Seht
befestigte	befestigte
schmelzen	schmelzen
Schwellen	Schwellen
Menschen	Menschen
jemand	jemand
zankte	zankte
zweiten	zweiten
legst	legst
Teppichen	Teppichen
Früchten	Früchten
gleiche	gleiche
Merket	Merket
könnt	könnt
Erde	Erde
Ersten	Ersten
lebte	lebte
kehre	kehre
möchtest	möchtest
entsündigten	entsündigten
Schleifen	Schleifen
fastete	fastete
Palästen	Palästen
könnest	könnest
Jünglingen	Jünglingen
Kriegsknechte	Kriegsknechte
Folge	Folge
fällst	fällst
gehören	gehören
Ringen	Ringen
Staube	Staube
liegst	liegst
zerstreust	zerstreust
liebest	liebest
lüge	lüge
Dingen	Dingen
zerstreuet	zerstreuet
Mache	Mache
hurst	hurst
verstand	verstand
ziehet	ziehet
Kristalle	Kristalle
sündiget	sündiget
Ring	Ring
Ängsten	Ängsten
reich	reich
Schlägst	Schlägst
anzeigen	anzeigen
Kaufleuten	Kaufleuten
schweigst	schweigst
schätze	schätze
halbe	halbe
kühl	kühl
austilgen	austilgen
Funke	Funke
messe	messe
aufrichtest	aufrichtest
Quellen	Quellen
Majestät	Majestät
Ratsherr	Ratsherr
vier	vier
Folget	Folget
Vorhäute	Vorhäute
weiche	weiche
Erbe	Erbe
anbetest	anbetest
predigt	predigt
demütiget	demütiget
beugte	beugte
Ränken	Ränken
speisen	speisen
kurze	kurze
erhebet	erhebet
linken	linken
wohnet	wohnet
Winden	Winden
Elle	Elle
Solche	Solche
Tische	Tische
schnitt	schnitt
zweite	zweite
Fröschen	Fröschen
entsetzte	entsetzte
einst	einst
fresset	fresset
mögt	mögt
lehret	lehret
Skorpionen	Skorpionen
werden	werden
Eichen	Eichen
weg	weg
Röcken	Röcken
Einheimischen	Einheimischen
brauche	brauche
Gibst	Gibst
Spaltungen	Spaltungen
habt	habt
kommest	kommest
Könnt	Könnt
Esset	Esset
band	band
Pfunden	Pfunden
Sinne	Sinne
Sieben	Sieben
ausgereckt	ausgereckt
Orte	Orte
Arm	Arm
Ärzte	Ärzte
Fetten	Fetten
gelang	gelang
Träume	Träume
Gedanken	Gedanken
ziert	ziert
knüpfte	knüpfte
vergleiche	vergleiche
verunreinigt	verunreinigt
nahte	nahte
verzehrt	verzehrt
abzieht	abzieht
verfolgt	verfolgt
fälle	fälle
hauen	hauen
spielen	spielen
vertilgt	vertilgt
Fahret	Fahret
weide	weide
Anfechtung	Anfechtung
Höhe	Höhe
Wänden	Wänden
besorgte	besorgte
Gehorcht	Gehorcht
schenken	schenken
Ochs	Ochs
tut	tut
Geschäften	Geschäften
freiwilligen	freiwilligen
bereits	bereits
wiederkamen	wiederkamen
Bleche	Bleche
ausgeht	ausgeht
Weinberge	Weinberge
greifet	greifet
Forsche	Forsche
begehrte	begehrte
verkaufte	verkaufte
fließen	fließen
reden	reden
Morde	Morde
Weine	Weine
Gesellen	Gesellen
Jude	Jude
elften	elften
prediget	prediget
unserer	unserer
Tust	Tust
gleich	gleich
bleibet	bleibet
verstehet	verstehet
neigte	neigte
Zeugnisse	Zeugnisse
trinket	trinket
Kommst	Kommst
Wehe	Wehe
warst	warst
Rubine	Rubine
Sehet	Sehet
erweckest	erweckest
Führet	Führet
tragt	tragt
Regenten	Regenten
Gemeinden	Gemeinden
bricht	bricht
ausfuhr	ausfuhr
fehlte	fehlte
Bleibe	Bleibe
Teile	Teile
Merke	Merke
Licht	Licht
eingehst	eingehst
schwebte	schwebte
rufe	rufe
Spanne	Spanne
Weinet	Weinet
Haben	Haben
Reiche	Reiche
Buchstaben	Buchstaben
leset	leset
irrte	irrte
ungehorsam	ungehorsam
sündigt	sündigt
Waren	Waren
erkennest	erkennest
baten	baten
Griechen	Griechen
rittest	rittest
aufmacht	aufmacht
ausbreitete	ausbreitete
Deinen	Deinen
strafet	strafet
heißest	heißest
auflegst	auflegst
Reihe	Reihe
suchst	suchst
anrichte	anrichte
Streiten	Streiten
befehle	befehle
lügen	lügen
Ehren	Ehren
räumen	räumen
Seile	Seile
verklärest	verklärest
Helden	Helden
Löwen	Löwen
Städten	Städten
kommst	kommst
Königreiche	Königreiche
aufrichte	aufrichte
Gut	Gut
einnehmest	einnehmest
langte	langte
Fragen	Fragen
trieben	trieben
keiner	keiner
nehmet	nehmet
lebst	lebst
lassest	lassest
versöhnet	versöhnet
stimmte	stimmte
Wesen	Wesen
ritten	ritten
Gläubigen	Gläubigen
banden	banden
offenbart	offenbart
Bürde	Bürde
laden	laden
Wehklage	Wehklage
Hundert	Hundert
Lasten	Lasten
zürnet	zürnet
anhangen	anhangen
taufet	taufet
Weihe	Weihe
verstecke	verstecke
verdammt	verdammt
schöpfen	schöpfen
verwahrst	verwahrst
Regent	Regent
schlaft	schlaft
reif	reif
meines	meines
erntete	erntete
Ordnungen	Ordnungen
verführen	verführen
Recht	Recht
borgte	borgte
hörest	hörest
Riesen	Riesen
verlaßt	verlaßt
Dienet	Dienet
hasse	hasse
Arme	Arme
Altäre	Altäre
gießet	gießet
deine	deine
Füchsen	Füchsen
zweifelte	zweifelte
webte	webte
Gäste	Gäste
Wehen	Wehen
träumte	träumte
Keile	Keile
Stämme	Stämme
einer	einer
aufhebest	aufhebest
weichest	weichest
Rehen	Rehen
fastetet	fastetet
Feiertage	Feiertage
kommet	kommet
Gar	Gar
Predigt	Predigt
ein	ein
Alles	Alles
täuschet	täuschet
klaget	klaget
braust	braust
Kleinode	Kleinode
schrecken	schrecken
Klaue	Klaue
müßt	müßt
steckst	steckst
Schauet	Schauet
Werkzeuge	Werkzeuge
Schale	Schale
setzest	setzest
vergleichen	vergleichen
brenne	brenne
Kleinoden	Kleinoden
Setzt	Setzt
Ehre	Ehre
schöpfte	schöpfte
anzeigt	anzeigt
bestimmte	bestimmte
preise	preise
Teilen	Teilen
Ästen	Ästen
alles	alles
wallet	wallet
Abhänge	Abhänge
zieren	zieren
Jüngern	Jüngern
traut	traut
kaufe	kaufe
Schmiede	Schmiede
mehr	mehr
griffe	griffe
sieht	sieht
hingehet	hingehet
urteilen	urteilen
Raben	Raben
Winde	Winde
anderen	anderen
gelobten	gelobten
steiget	steiget
heißet	heißet
nährte	nährte
Pfunde	Pfunde
Ställen	Ställen
Zöpfe	Zöpfe
mein	mein
reizte	reizte
Schulden	Schulden
Meinst	Meinst
heiß	heiß
vergebet	vergebet
liebst	liebst
zerschlagt	zerschlagt
erforschet	erforschet
Gemeinde	Gemeinde
dankte	dankte
Sehnen	Sehnen
wehrte	wehrte
frommen	frommen
Strafen	Strafen
vermöget	vermöget
Ställe	Ställe
predigst	predigst
Zäume	Zäume
scheu	scheu
älteste	älteste
taufe	taufe
sollte	sollte
kaufet	kaufet
backe	backe
scheiden	scheiden
Sorgen	Sorgen
verbirgst	verbirgst
nützt	nützt
Seine	Seine
ärger	ärger
verlaß	verlaß
log	log
anzeigte	anzeigte
auflegt	auflegt
beschädigten	beschädigten
ruhte	ruhte
verdeckt	verdeckt
Lehren	Lehren
strafe	strafe
drücken	drücken
stahl	stahl
hinaufgeht	hinaufgeht
Gefäße	Gefäße
Mal	Mal
decket	decket
dienest	dienest
Feste	Feste
trügen	trügen
Führe	Führe
blenden	blenden
Stäbe	Stäbe
Ärzten	Ärzten
stiegen	stiegen
vermag	vermag
konntest	konntest
Eines	Eines
wisset	wisset
Pauken	Pauken
Hirschen	Hirschen
besäet	besäet
folge	folge
lernte	lernte
aufheben	aufheben
gelobte	gelobte
erniedrigt	erniedrigt
jeder	jeder
Wüste	Wüste
Gehilfe	Gehilfe
Seil	Seil
Geboten	Geboten
Edelsteine	Edelsteine
ausgereckten	ausgereckten
ansehet	ansehet
forschen	forschen
ausführen	ausführen
Räten	Räten
verführe	verführe
lang	lang
vierten	vierten
Leiden	Leiden
Frieden	Frieden
bedürfet	bedürfet
feierte	feierte
Aase	Aase
hauest	hauest
scheide	scheide
Trage	Trage
ringe	ringe
schneiden	schneiden
Wege	Wege
Scharen	Scharen
wirket	wirket
tobte	tobte
Seiten	Seiten
Loben	Loben
versuchet	versuchet
vertraget	vertraget
zuteilte	zuteilte
Stühlen	Stühlen
batet	batet
rufen	rufen
Steiget	Steiget
Gerichten	Gerichten
kriegte	kriegte
Deutung	Deutung
er	er
hasset	hasset
leiden	leiden
hoffet	hoffet
Sieb	Sieb
lachet	lachet
raubet	raubet
besitzt	besitzt
redetet	redetet
streite	streite
grünen	grünen
trinkst	trinkst
Brote	Brote
wunderte	wunderte
Anklagen	Anklagen
haltet	haltet
ihres	ihres
unseren	unseren
hängen	hängen
Feind	Feind
erdacht	erdacht
beschuldigt	beschuldigt
vierte	vierte
Elfen	Elfen
trotzest	trotzest
merke	merke
eurem	eurem
frevler	frevler
trübe	trübe
stolze	stolze
löset	löset
Urteile	Urteile
befragt	befragt
anruft	anruft
ruhest	ruhest
hänget	hänget
vorn	vorn
Same	Same
erwerbe	erwerbe
säet	säet
mahle	mahle
aufkäme	aufkäme
Kriege	Kriege
Pfeilen	Pfeilen
sorget	sorget
Flammen	Flammen
gelobst	gelobst
konntet	konntet
Diebe	Diebe
halte	halte
nehmt	nehmt
Jochen	Jochen
erfahrest	erfahrest
arm	arm
holet	holet
blasen	blasen
eigene	eigene
stäupten	stäupten
Abtrünnige	Abtrünnige
loben	loben
gehorchest	gehorchest
stellte	stellte
Gefängnissen	Gefängnissen
ringst	ringst
haben	haben
ernten	ernten
betrüge	betrüge
Stolze	Stolze
mögest	mögest
decken	decken
Aufsätzen	Aufsätzen
Welchen	Welchen
untertretet	untertretet
rauschen	rauschen
einsammelte	einsammelte
bleiben	bleiben
graben	graben
Lobgesänge	Lobgesänge
zuteil	zuteil
Bürden	Bürden
schlafe	schlafe
pflege	pflege
brecht	brecht
hebräischen	hebräischen
beschwerst	beschwerst
Deutungen	Deutungen
salzen	salzen
harret	harret
erhörst	erhörst
Lichte	Lichte
ringet	ringet
teil	teil
Stäben	Stäben
gebot	gebot
ratschlagte	ratschlagte
soll	soll
herrschet	herrschet
Seilen	Seilen
predigte	predigte
seien	seien
Skorpione	Skorpione
Spieße	Spieße
Tiefe	Tiefe
spaltete	spaltete
Edelsteinen	Edelsteinen
Bette	Bette
Gelobt	Gelobt
gebt	gebt
verziehe	verziehe
sollt	sollt
pflanzte	pflanzte
brennen	brennen
Gehilfen	Gehilfen
Grenzen	Grenzen
Morden	Morden
nachwandelte	nachwandelte
pflüget	pflüget
handhaben	handhaben
eingeht	eingeht
ausgereckte	ausgereckte
werfet	werfet
könnet	könnet
Sucht	Sucht
trefft	trefft
erbet	erbet
Knaben	Knaben
Pflanzungen	Pflanzungen
Eins	Eins
reizet	reizet
Tiere	Tiere
aufkommen	aufkommen
Krieg	Krieg
wärme	wärme
Plage	Plage
verwirrt	verwirrt
gebäret	gebäret
vertilgest	vertilgest
gelangen	gelangen
stellen	stellen
stillte	stillte
ehre	ehre
bestimmten	bestimmten
Gebeinen	Gebeinen
weinst	weinst
sollst	sollst
bemüht	bemüht
führst	führst
Heben	Heben
faule	faule
beiden	beiden
schneide	schneide
Mensch	Mensch
Hirten	Hirten
rede	rede
beharrt	beharrt
leihst	leihst
kehrte	kehrte
Monden	Monden
griechischen	griechischen
heulet	heulet
ungeistlich	ungeistlich
beweiset	beweiset
Türmen	Türmen
wärmte	wärmte
aufnahmt	aufnahmt
schmiert	schmiert
niemanden	niemanden
Gehorchet	Gehorchet
schaffen	schaffen
schreie	schreie
lehnen	lehnen
schmierte	schmierte
erzürnst	erzürnst
Tore	Tore
schläfst	schläfst
Paläste	Paläste
könne	könne
Entsetzen	Entsetzen
armen	armen
Raube	Raube
brechet	brechet
Buchen	Buchen
Elf	Elf
kaufst	kaufst
hingehst	hingehst
kranken	kranken
schreien	schreien
Wehret	Wehret
essen	essen
lauf	lauf
salz	salz
versöhnt	versöhnt
zerstreuest	zerstreuest
seines	seines
teile	teile
ratschlagt	ratschlagt
ziere	ziere
deckte	deckte
haue	haue
schöpfest	schöpfest
Garten	Garten
verstopften	verstopften
drängte	drängte
stoße	stoße
Rabe	Rabe
Pflanzung	Pflanzung
verhalte	verhalte
stoßest	stoßest
begehrt	begehrt
Tritt	Tritt
Seinen	Seinen
Unrecht	Unrecht
habe	habe
Decken	Decken
küssen	küssen
Weg	Weg
kehren	kehren
Sprüche	Sprüche
Monaten	Monaten
bekehrt	bekehrt
verbergest	verbergest
wehret	wehret
pflanze	pflanze
steinigte	steinigte
schlage	schlage
warnst	warnst
könnten	könnten
Büsche	Büsche
ringen	ringen
stiege	stiege
trägt	trägt
Laien	Laien
umbringt	umbringt
keinem	keinem
verständige	verständige
verbot	verbot
rächte	rächte
Augen	Augen
stimmen	stimmen
Amen	Amen
gereichte	gereichte
fliegen	fliegen
Rehe	Rehe
gelobt	gelobt
trage	trage
Hecken	Hecken
Hirsche	Hirsche
meinen	meinen
verlasse	verlasse
tiefe	tiefe
erzeigte	erzeigte
weinest	weinest
erschrecket	erschrecket
fangt	fangt
verderbet	verderbet
Hände	Hände
schmelzt	schmelzt
Obrigkeit	Obrigkeit
heftete	heftete
hineingehst	hineingehst
berufe	berufe
eurer	eurer
unserem	unserem
übrigbleiben	übrigbleiben
Schuld	Schuld
Majestäten	Majestäten
krähen	krähen
Lob	Lob
lehrst	lehrst
inneren	inneren
Regiert	Regiert
schnitten	schnitten
Weinbergen	Weinbergen
Fischen	Fischen
aufnahmen	aufnahmen
ratschlaget	ratschlaget
bewährt	bewährt
ernte	ernte
Festen	Festen
Stärket	Stärket
könnte	könnte
Klage	Klage
Stolz	Stolz
Brüsten	Brüsten
gehorchst	gehorchst
höhnest	höhnest
Sternen	Sternen
Wirte	Wirte
Flamme	Flamme
gewöhnte	gewöhnte
zerrüttete	zerrüttete
Vorstädten	Vorstädten
Befehle	Befehle
gehorchten	gehorchten
Trinket	Trinket
bessere	bessere
hieben	hieben
Schiffe	Schiffe
Gebirgen	Gebirgen
stäupt	stäupt
Dieben	Dieben
bis	bis
Bächen	Bächen
scheinen	scheinen
Höfen	Höfen
Feinden	Feinden
wälzte	wälzte
herrschest	herrschest
neige	neige
beben	beben
pflanzt	pflanzt
mußten	mußten
hieb	hieb
Fällen	Fällen
Gerät	Gerät
blitzte	blitzte
mangeln	mangeln
Verheißungen	Verheißungen
Christ	Christ
beschwert	beschwert
erlöst	erlöst
geraten	geraten
Wunden	Wunden
erdachten	erdachten
Trinken	Trinken
Leid	Leid
Aussätzige	Aussätzige
Meeren	Meeren
Für	Für
begrabet	begrabet
Betten	Betten
Wäre	Wäre
Füße	Füße
Decket	Decket
halt	halt
Unserer	Unserer
gründe	gründe
lernet	lernet
schenkest	schenkest
täuschte	täuschte
wach	wach
sei	sei
streuen	streuen
heile	heile
Band	Band
Solchen	Solchen
predigten	predigten
Hat	Hat
Reif	Reif
Satzungen	Satzungen
zeigte	zeigte
gelangt	gelangt
verbergt	verbergt
ratschlagten	ratschlagten
beider	beider
greife	greife
gehest	gehest
Ärgernissen	Ärgernissen
brause	brause
Hauen	Hauen
wenden	wenden
Gänge	Gänge
reifen	reifen
fehle	fehle
helft	helft
schließt	schließt
Graben	Graben
schon	schon
Feinde	Feinde
Grase	Grase
Rechten	Rechten
schauet	schauet
gehörst	gehörst
bekennt	bekennt
wünschen	wünschen
verzehre	verzehre
wachse	wachse
zeugst	zeugst
ärgere	ärgere
schwimmst	schwimmst
möchtet	möchtet
zeiget	zeiget
Gute	Gute
Laufet	Laufet
widerstand	widerstand
bewahret	bewahret
stärke	stärke
Weißt	Weißt
Regieren	Regieren
fragte	fragte
dürfte	dürfte
schreist	schreist
teilte	teilte
Urteil	Urteil
Kriegen	Kriegen
beißet	beißet
Tausend	Tausend
Herren	Herren
gehorchet	gehorchet
rührte	rührte
zürnst	zürnst
Tyrann	Tyrann
eure	eure
weinen	weinen
übte	übte
Lobet	Lobet
Büschen	Büschen
Woge	Woge
Wer	Wer
Gras	Gras
Weinen	Weinen
zuhöret	zuhöret
bang	bang
solch	solch
Zäune	Zäune
strafte	strafte
hattest	hattest
hätte	hätte
leer	leer
hüten	hüten
verdeckte	verdeckte
Lobgesängen	Lobgesängen
speisest	speisest
jemanden	jemanden
freuet	freuet
Zähnen	Zähnen
verwirft	verwirft
bete	bete
blitzt	blitzt
Setzet	Setzet
kehrst	kehrst
Götzen	Götzen
deinen	deinen
Ein	Ein
alle	alle
aufwachte	aufwachte
leuchten	leuchten
vergibt	vergibt
eigenen	eigenen
Steine	Steine
erbauet	erbauet
aufsteht	aufsteht
leget	leget
schließen	schließen
sagest	sagest
Töpfen	Töpfen
führen	führen
Malen	Malen
Fäuste	Fäuste
führet	führet
wegführen	wegführen
Leide	Leide
wären	wären
Broten	Broten
reckte	reckte
erzeigten	erzeigten
Meinet	Meinet
Königreichen	Königreichen
Stufe	Stufe
wegen	wegen
Befehlen	Befehlen
Beten	Beten
Buch	Buch
vertrauet	vertrauet
Trinkgefäße	Trinkgefäße
jammern	jammern
erben	erben
Briefe	Briefe
schwellen	schwellen
umkehrt	umkehrt
Pferden	Pferden
vergibst	vergibst
schickte	schickte
zerschlaget	zerschlaget
fallet	fallet
Geviert	Geviert
Satzung	Satzung
besitze	besitze
bezahlt	bezahlt
Zäumen	Zäumen
fragest	fragest
nähret	nähret
Sekte	Sekte
Stricke	Stricke
Denn	Denn
unterrichten	unterrichten
Weinstöcken	Weinstöcken
Hirte	Hirte
einen	einen
tote	tote
heulte	heulte
prüfest	prüfest
Briefen	Briefen
bedeckst	bedeckst
beugst	beugst
Raten	Raten
siegte	siegte
Leichname	Leichname
ersten	ersten
verderbest	verderbest
Friede	Friede
Gebet	Gebet
fünften	fünften
Fette	Fette
schläft	schläft
legest	legest
schwimmen	schwimmen
fluche	fluche
stahlen	stahlen
erbaust	erbaust
Steinen	Steinen
spielte	spielte
folget	folget
Blitze	Blitze
bekannten	bekannten
Falle	Falle
anrufen	anrufen
Habt	Habt
seinem	seinem
hätten	hätten
Stücken	Stücken
Taufe	Taufe
machst	machst
umkäme	umkäme
kein	kein
Hunderten	Hunderten
weise	weise
behalte	behalte
Maß	Maß
Fällt	Fällt
rate	rate
tragest	tragest
Speise	Speise
Bahnen	Bahnen
hörst	hörst
baue	baue
gut	gut
Decke	Decke
Tragt	Tragt
Heißt	Heißt
vermöge	vermöge
gebäre	gebäre
Reizt	Reizt
brichst	brichst
leide	leide
trotze	trotze
Röhren	Röhren
sprechet	sprechet
wälzt	wälzt
meinet	meinet
Unsere	Unsere
gedenket	gedenket
liegen	liegen
denn	denn
preisen	preisen
zerstörst	zerstörst
füllst	füllst
Leiche	Leiche
verlieren	verlieren
allen	allen
Saget	Saget
Linke	Linke
Entsetzt	Entsetzt
gibst	gibst
Verwundeten	Verwundeten
schonte	schonte
ausrichtest	ausrichtest
Gelobet	Gelobet
stehet	stehet
Gesetze	Gesetze
Löwe	Löwe
Stücke	Stücke
hadere	hadere
binden	binden
harrte	harrte
erkanntet	erkanntet
Lobe	Lobe
Verheißung	Verheißung
Herzen	Herzen
ziehst	ziehst
strafen	strafen
steckte	steckte
kennest	kennest
Bärte	Bärte
setzet	setzet
würdest	würdest
Diesen	Diesen
Erstlinge	Erstlinge
Sägen	Sägen
empfanget	empfanget
Empörungen	Empörungen
wahr	wahr
behaltet	behaltet
sterbest	sterbest
Funken	Funken
Schilden	Schilden
Grüßet	Grüßet
fallt	fallt
lange	lange
Weile	Weile
aufmachte	aufmachte
brausen	brausen
erschreckten	erschreckten
wallte	wallte
Geliebten	Geliebten
einführt	einführt
Kleinod	Kleinod
warnte	warnte
Klüfte	Klüfte
besehet	besehet
taufte	taufte
Bete	Bete
steige	steige
Gebot	Gebot
trüge	trüge
Bande	Bande
Spaltung	Spaltung
Sorge	Sorge
zerrütteten	zerrütteten
zerstreuten	zerstreuten
Jahr	Jahr
arme	arme
spannte	spannte
lade	lade
versagen	versagen
Weihen	Weihen
Schenke	Schenke
Lehre	Lehre
anzeigest	anzeigest
erfüllt	erfüllt
verziehen	verziehen
Pfeile	Pfeile
Leset	Leset
vermagst	vermagst
grüße	grüße
zerbricht	zerbricht
Fliege	Fliege
schämet	schämet
heiligte	heiligte
bist	bist
versuchst	versuchst
Bote	Bote
müssest	müssest
sollten	sollten
fassest	fassest
Reichen	Reichen
schrecke	schrecke
Heuschrecke	Heuschrecke
rühmte	rühmte
besitzet	besitzet
stärket	stärket
erhaltet	erhaltet
ansehen	ansehen
würdet	würdet
regieret	regieret
Alle	Alle
wohnte	wohnte
bracht	bracht
Wären	Wären
entsündigen	entsündigen
habest	habest
Leichen	Leichen
Schade	Schade
Werte	Werte
eingehest	eingehest
Spitze	Spitze
nötigte	nötigte
leuchtete	leuchtete
prüfet	prüfet
trotzt	trotzt
befragten	befragten
Deine	Deine
Empörung	Empörung
füllen	füllen
vergessest	vergessest
heil	heil
leihet	leihet
sprachen	sprachen
lauten	lauten
eher	eher
Köpfen	Köpfen
ihrem	ihrem
schämte	schämte
Basilisken	Basilisken
gebietet	gebietet
Berge	Berge
nächsten	nächsten
wollt	wollt
Tier	Tier
erkannte	erkannte
Schafe	Schafe
drücke	drücke
Vorstädte	Vorstädte
gebraucht	gebraucht
pflanzen	pflanzen
lehren	lehren
fasse	fasse
Rauben	Rauben
Ihre	Ihre
Gebeine	Gebeine
Hie	Hie
verliert	verliert
Rudern	Rudern
hoffte	hoffte
hinaufgehst	hinaufgehst
redetest	redetest
bestimmst	bestimmst
Träumen	Träumen
Klagen	Klagen
Einer	Einer
haut	haut
Maultier	Maultier
ausfuhren	ausfuhren
lobte	lobte
zürnte	zürnte
faul	faul
wärst	wärst
griechisch	griechisch
wiederkamt	wiederkamt
sprichst	sprichst
gelangte	gelangte
hebräisch	hebräisch
heftetest	heftetest
verkauft	verkauft
bekehrte	bekehrte
seine	seine
vertraut	vertraut
schließe	schließe
tretet	tretet
einführte	einführte
wollte	wollte
halten	halten
taten	taten
schenkte	schenkte
Ende	Ende
Geliebte	Geliebte
regiere	regiere
einnehmet	einnehmet
verkaufst	verkaufst
Schätzen	Schätzen
wende	wende
Gebirge	Gebirge
Schneiden	Schneiden
Blechen	Blechen
treffen	treffen
besser	besser
berufen	berufen
Auge	Auge
Schaden	Schaden
Knechten	Knechten
schmückst	schmückst
anrufe	anrufe
demütig	demütig
sonderte	sonderte
seit	seit
Wir	Wir
linke	linke
Ecke	Ecke
labe	labe
befestigt	befestigt
seinen	seinen
falle	falle
Zehen	Zehen
helle	helle
abtrünnige	abtrünnige
glaubte	glaubte
junge	junge
Unglaube	Unglaube
wiederkommst	wiederkommst
taufst	taufst
triebe	triebe
essest	essest
verliere	verliere
befehlt	befehlt
befehlen	befehlen
erlaubte	erlaubte
greifen	greifen
entgegenkamen	entgegenkamen
ausrottet	ausrottet
Speeren	Speeren
sterbet	sterbet
spannen	spannen
kochte	kochte
Werken	Werken
reichen	reichen
Gehörst	Gehörst
erlaubt	erlaubt
jeden	jeden
Tausenden	Tausenden
erhalte	erhalte
fremden	fremden
gewinnet	gewinnet
Fallen	Fallen
blase	blase
gefällt	gefällt
austilgest	austilgest
beschädigt	beschädigt
griff	griff
holst	holst
rächest	rächest
träge	träge
rühmest	rühmest
verschonet	verschonet
Ränke	Ränke
hilfst	hilfst
tragen	tragen
Schwänzen	Schwänzen
kennst	kennst
fließt	fließt
abziehen	abziehen
wachet	wachet
Fürst	Fürst
keine	keine
murmeln	murmeln
krähte	krähte
löst	löst
besuchen	besuchen
bringet	bringet
dienst	dienst
Sage	Sage
gelobet	gelobet
Höhlen	Höhlen
bekannte	bekannte
Teppiche	Teppiche
ausrottest	ausrottest
besitzest	besitzest
Äxten	Äxten
