kehret	kehret
schneide	schneide
austilge	austilge
sprecht	sprecht
gehorchte	gehorchte
Leisten	Leisten
verführe	verführe
müssest	müssest
wer	wer
Regiert	Regiert
flehst	flehst
Narr	Narr
Teil	Teil
Bürden	Bürden
verstehet	verstehet
bekannten	bekannten
lauft	lauft
lauf	lauf
Vorstädten	Vorstädten
kennst	kennst
hoffte	hoffte
Älteste	Älteste
teilte	teilte
Reizen	Reizen
hebet	hebet
weichst	weichst
mache	mache
entsetzte	entsetzte
zudeckte	zudeckte
Grab	Grab
gehst	gehst
Heeren	Heeren
setzet	setzet
Gläubigen	Gläubigen
Elf	Elf
Orten	Orten
hause	hause
vergebet	vergebet
entsündigte	entsündigte
Teile	Teile
Herrn	Herrn
fasse	fasse
erlaubte	erlaubte
vermagst	vermagst
lassest	lassest
Sprüche	Sprüche
verkehre	verkehre
jauchzt	jauchzt
Schwelle	Schwelle
beißet	beißet
Seile	Seile
Zerstreuten	Zerstreuten
anbetet	anbetet
steinigte	steinigte
umbringet	umbringet
Ängsten	Ängsten
ihrem	ihrem
trägt	trägt
müßten	müßten
mögt	mögt
erzeigten	erzeigten
schenket	schenket
gehöre	gehöre
höhnest	höhnest
verklärt	verklärt
Laufen	Laufen
anhangen	anhangen
kühlen	kühlen
Röhren	Röhren
Höfen	Höfen
Esset	Esset
Kannen	Kannen
Fittichen	Fittichen
aufhört	aufhört
Letzten	Letzten
stäupten	stäupten
blasen	blasen
gewöhnte	gewöhnte
forschte	forschte
umkommst	umkommst
Pferde	Pferde
Blitzen	Blitzen
Vorhäuten	Vorhäuten
koste	koste
verwahret	verwahret
bestellt	bestellt
Gängen	Gängen
beides	beides
schwimmen	schwimmen
elfte	elfte
Ebene	Ebene
kosten	kosten
schenke	schenke
Warten	Warten
Kleinode	Kleinode
jeden	jeden
waren	waren
Könnt	Könnt
Gänge	Gänge
Eingeweide	Eingeweide
sucht	sucht
siegte	siegte
armen	armen
irren	irren
erschreckt	erschreckt
vergibst	vergibst
Trage	Trage
Füße	Füße
fehlte	fehlte
Gemeinde	Gemeinde
beweise	beweise
ab	ab
Leset	Leset
eurer	eurer
besitze	besitze
verlobte	verlobte
Willen	Willen
wilde	wilde
kennest	kennest
erschrecket	erschrecket
Taube	Taube
lehret	lehret
eingehst	eingehst
Eingeweiden	Eingeweiden
vierten	vierten
Deinen	Deinen
Stufe	Stufe
Solche	Solche
greifet	greifet
brach	brach
fremden	fremden
Königen	Königen
zerreißest	zerreißest
Beinen	Beinen
wechselte	wechselte
werfet	werfet
zeugest	zeugest
Steine	Steine
Nehmt	Nehmt
schmückst	schmückst
Zäumen	Zäumen
Willst	Willst
Ihren	Ihren
ehrte	ehrte
helft	helft
stehet	stehet
Knabe	Knabe
säumet	säumet
gebührt	gebührt
ausgeht	ausgeht
erforschet	erforschet
schämte	schämte
ruhte	ruhte
bestimmten	bestimmten
zwölften	zwölften
zerstücken	zerstücken
durften	durften
widerstand	widerstand
schießt	schießt
Betten	Betten
wundere	wundere
machet	machet
reichet	reichet
Stimme	Stimme
Ehre	Ehre
Rubine	Rubine
seist	seist
speise	speise
hieb	hieb
bewahret	bewahret
aufkommen	aufkommen
Träumen	Träumen
zieren	zieren
denket	denket
ausführen	ausführen
salz	salz
griff	griff
einführen	einführen
nötige	nötige
Kristalle	Kristalle
zankte	zankte
greife	greife
Aufsätze	Aufsätze
entgegenkamst	entgegenkamst
hinausgehst	hinausgehst
Kein	Kein
Anfechtung	Anfechtung
Bär	Bär
haust	haust
gehest	gehest
leuchten	leuchten
weinet	weinet
beschwert	beschwert
diente	diente
ausführte	ausführte
Blitze	Blitze
Danket	Danket
zerstreuten	zerstreuten
linken	linken
Scharen	Scharen
Städten	Städten
Wärt	Wärt
Leid	Leid
alle	alle
Götze	Götze
Forschet	Forschet
selber	selber
haltet	haltet
nachwandelt	nachwandelt
fahret	fahret
Feind	Feind
strafe	strafe
erlöse	erlöse
Stäbe	Stäbe
stelle	stelle
träumen	träumen
wurden	wurden
vergießest	vergießest
trüge	trüge
Würze	Würze
hassest	hassest
verkauft	verkauft
Gebirge	Gebirge
zeuge	zeuge
durchläutert	durchläutert
herrschest	herrschest
bewahrt	bewahrt
fromme	fromme
Fette	Fette
pflanze	pflanze
Stämme	Stämme
zerstückte	zerstückte
Drachen	Drachen
Sinne	Sinne
Steige	Steige
verlaß	verlaß
Stäben	Stäben
anrührt	anrührt
drängest	drängest
vertrage	vertrage
Grenze	Grenze
gehorchten	gehorchten
entsetzet	entsetzet
aufstand	aufstand
säume	säume
greifen	greifen
Dann	Dann
hörst	hörst
verdeckte	verdeckte
aufkommt	aufkommt
pflüget	pflüget
gehorchet	gehorchet
Fromme	Fromme
vergleichen	vergleichen
Abhängen	Abhängen
Amen	Amen
heben	heben
Hirt	Hirt
scheinen	scheinen
halben	halben
bitten	bitten
unsre	unsre
Eilet	Eilet
verzieh	verzieh
Vorhäute	Vorhäute
verständige	verständige
erniedrigt	erniedrigt
leuchtete	leuchtete
zeugst	zeugst
nachwandelte	nachwandelte
gebäre	gebäre
baute	baute
offenbart	offenbart
mehret	mehret
verbannt	verbannt
verkündige	verkündige
brenne	brenne
wärmte	wärmte
Riesen	Riesen
dingte	dingte
untertretet	untertretet
schmierte	schmierte
fälle	fälle
freuet	freuet
leide	leide
Hin	Hin
Gras	Gras
Ersten	Ersten
irgendein	irgendein
Heide	Heide
fastetest	fastetest
schmücket	schmücket
sagest	sagest
Sabbaten	Sabbaten
Fülle	Fülle
Kriegen	Kriegen
befragte	befragte
Köpfe	Köpfe
verkündigte	verkündigte
warnte	warnte
erst	erst
ansehen	ansehen
fragest	fragest
wehklagen	wehklagen
Speeren	Speeren
Kohlen	Kohlen
Male	Male
brauchst	brauchst
gebiete	gebiete
Gefilden	Gefilden
erhaltet	erhaltet
Maß	Maß
dankte	dankte
ehret	ehret
sterbest	sterbest
Heiden	Heiden
wir	wir
Leide	Leide
Fällt	Fällt
wegen	wegen
ersten	ersten
Hie	Hie
brauchte	brauchte
unschuldige	unschuldige
frisch	frisch
brauche	brauche
Eile	Eile
feiern	feiern
bekannte	bekannte
wachsen	wachsen
schenkest	schenkest
Wäre	Wäre
Bette	Bette
fluchten	fluchten
Gemeinden	Gemeinden
Wirst	Wirst
Glaubet	Glaubet
Tagen	Tagen
auflegte	auflegte
verstopften	verstopften
stoße	stoße
verführt	verführt
erbet	erbet
kennet	kennet
bleibet	bleibet
steiget	steiget
taufen	taufen
Leiste	Leiste
erzeigest	erzeigest
brachen	brachen
beiden	beiden
Knaben	Knaben
Flöte	Flöte
bezahlst	bezahlst
blitzt	blitzt
still	still
füllte	füllte
bleiben	bleiben
Tausenden	Tausenden
Schilde	Schilde
gewinne	gewinne
ungefälschtem	ungefälschtem
lehrst	lehrst
keinem	keinem
strafst	strafst
besitzest	besitzest
reckte	reckte
besäet	besäet
auszögen	auszögen
Keile	Keile
steinigst	steinigst
Schenke	Schenke
naht	naht
meinem	meinem
mehrte	mehrte
plagen	plagen
zierte	zierte
helfest	helfest
borgte	borgte
achten	achten
Sagte	Sagte
Söhnen	Söhnen
heiligem	heiligem
Wolle	Wolle
gebären	gebären
Befehle	Befehle
geratest	geratest
löst	löst
Satzungen	Satzungen
Raube	Raube
Neumonde	Neumonde
kurze	kurze
anhanget	anhanget
letzten	letzten
Tage	Tage
vorn	vorn
Höhlen	Höhlen
unserem	unserem
irrte	irrte
Empörung	Empörung
ausbreitete	ausbreitete
leset	leset
älteste	älteste
schlag	schlag
Schreien	Schreien
Gründe	Gründe
batest	batest
stolze	stolze
Sterne	Sterne
frage	frage
erlöset	erlöset
Köpfen	Köpfen
letzte	letzte
Narren	Narren
lest	lest
bracht	bracht
Spitze	Spitze
Fische	Fische
anrufe	anrufe
heißest	heißest
aufrichten	aufrichten
Bist	Bist
Denn	Denn
preiset	preiset
Streiten	Streiten
hasse	hasse
Zeugnisse	Zeugnisse
demütig	demütig
Gefangenen	Gefangenen
frevle	frevle
durfte	durfte
küsse	küsse
gehört	gehört
Fliegen	Fliegen
Märkten	Märkten
Maultier	Maultier
Ein	Ein
Gebeine	Gebeine
zanket	zanket
andere	andere
zerstreust	zerstreust
Büsche	Büsche
erhebet	erhebet
trotzet	trotzet
unserer	unserer
Tritt	Tritt
schweigst	schweigst
Gefäße	Gefäße
Forsche	Forsche
befragten	befragten
grüßt	grüßt
umbringt	umbringt
eine	eine
beschuldigt	beschuldigt
heiliget	heiliget
sehest	sehest
Brüsten	Brüsten
wären	wären
hinausgeht	hinausgeht
Monden	Monden
klaget	klaget
regte	regte
sprachen	sprachen
anders	anders
werde	werde
Gehör	Gehör
könnten	könnten
verbannet	verbannet
entsündigt	entsündigt
urteilen	urteilen
Geboten	Geboten
Könnet	Könnet
möchtet	möchtet
Abtrünnige	Abtrünnige
Geschäfte	Geschäfte
zeugen	zeugen
lieben	lieben
All	All
opferte	opferte
schießen	schießen
führen	führen
höret	höret
erzeigen	erzeigen
zerstreut	zerstreut
einen	einen
Worten	Worten
plagte	plagte
wehret	wehret
Halte	Halte
Riese	Riese
zählst	zählst
dingt	dingt
erhöhest	erhöhest
kehren	kehren
arbeiten	arbeiten
Ecke	Ecke
Festen	Festen
soll	soll
Fragen	Fragen
Frommen	Frommen
Gevierte	Gevierte
liebet	liebet
suchten	suchten
Pferden	Pferden
Ringe	Ringe
Löwen	Löwen
schläfst	schläfst
wert	wert
wacht	wacht
führst	führst
Regent	Regent
Waren	Waren
Frieden	Frieden
verliere	verliere
ritten	ritten
ausführe	ausführe
ihn	ihn
solche	solche
hänget	hänget
zuhöret	zuhöret
gelobet	gelobet
Wille	Wille
wohnest	wohnest
Abtrünnigen	Abtrünnigen
fetten	fetten
ansehet	ansehet
zerschlaget	zerschlaget
blitzen	blitzen
ausführt	ausführt
aufhörte	aufhörte
lebet	lebet
Schiffe	Schiffe
Zähnen	Zähnen
Vorstädte	Vorstädte
versagt	versagt
bereitet	bereitet
schöpfte	schöpfte
gefällst	gefällst
regierest	regierest
deren	deren
glauben	glauben
irre	irre
Schlägst	Schlägst
Einer	Einer
schätzte	schätzte
gelobt	gelobt
ausfuhr	ausfuhr
Ei	Ei
solchem	solchem
ehren	ehren
aufwachst	aufwachst
rüstete	rüstete
spielen	spielen
Gibt	Gibt
Sabbatjahr	Sabbatjahr
umbrächten	umbrächten
Deine	Deine
beseht	beseht
eure	eure
anfingst	anfingst
bestanden	bestanden
ungeistlichen	ungeistlichen
Bleche	Bleche
erzeigte	erzeigte
Schilden	Schilden
durchläuterte	durchläuterte
bewahrst	bewahrst
bringst	bringst
erntete	erntete
ladest	ladest
einem	einem
verwahrst	verwahrst
aufstehet	aufstehet
zeigst	zeigst
Tust	Tust
Fäuste	Fäuste
Sehnen	Sehnen
verbirgt	verbirgt
Höfe	Höfe
fliege	fliege
Werde	Werde
verstehest	verstehest
vertilgten	vertilgten
sichten	sichten
schlaft	schlaft
heil	heil
ziehet	ziehet
Mal	Mal
Wänden	Wänden
müsset	müsset
scheu	scheu
zeigte	zeigte
erlösen	erlösen
wilden	wilden
aufmacht	aufmacht
fressen	fressen
hure	hure
beschwöre	beschwöre
Stolze	Stolze
Blechen	Blechen
scheue	scheue
lachen	lachen
ob	ob
Ärzten	Ärzten
abweichet	abweichet
willst	willst
Spießen	Spießen
lebst	lebst
Füchse	Füchse
verständig	verständig
Weinstöcke	Weinstöcke
entsündigen	entsündigen
Buben	Buben
hineinbrächten	hineinbrächten
pflanzen	pflanzen
jeder	jeder
Gesellen	Gesellen
Rehen	Rehen
urteilte	urteilte
Gebete	Gebete
Bäume	Bäume
kranken	kranken
unterrichten	unterrichten
Lesen	Lesen
schaffet	schaffet
besitzt	besitzt
Tiere	Tiere
angehöret	angehöret
Broten	Broten
Pfunde	Pfunde
webet	webet
beschädigt	beschädigt
spannt	spannt
eingehet	eingehet
berührt	berührt
speiet	speiet
liebst	liebst
Würzen	Würzen
Banden	Banden
knüpfte	knüpfte
fastetet	fastetet
empfange	empfange
drängte	drängte
Warte	Warte
Kaufleute	Kaufleute
untergeht	untergeht
erniedrigst	erniedrigst
lesen	lesen
essest	essest
glänzte	glänzte
Gefängnissen	Gefängnissen
junge	junge
reden	reden
war	war
Jüngern	Jüngern
Gästen	Gästen
leiten	leiten
weiten	weiten
sahet	sahet
gute	gute
bedürfet	bedürfet
redete	redete
Leichname	Leichname
drückte	drückte
sorgte	sorgte
Auge	Auge
wünsche	wünsche
pflanzte	pflanzte
Wüste	Wüste
rauben	rauben
Schwellen	Schwellen
abweichest	abweichest
Funke	Funke
Feiertage	Feiertage
recke	recke
stürzt	stürzt
drücke	drücke
schreckt	schreckt
rotten	rotten
vielen	vielen
Weinstöcken	Weinstöcken
Kohle	Kohle
verunreinigst	verunreinigst
Knechten	Knechten
Höhe	Höhe
entgegenkamen	entgegenkamen
Decke	Decke
Weile	Weile
lehren	lehren
stillte	stillte
eher	eher
ziehst	ziehst
verstecke	verstecke
gehet	gehet
gehorchst	gehorchst
tote	tote
Meinen	Meinen
gebot	gebot
Alte	Alte
löste	löste
nahte	nahte
sollt	sollt
aufrichtet	aufrichtet
schrecke	schrecke
laut	laut
Fischen	Fischen
ratet	ratet
Ruder	Ruder
Heben	Heben
habet	habet
Weil	Weil
zudeckt	zudeckt
seufzt	seufzt
verdammt	verdammt
Stricken	Stricken
Denen	Denen
Anschlägen	Anschlägen
Kräfte	Kräfte
Maultiere	Maultiere
Soll	Soll
faule	faule
liebe	liebe
Tausend	Tausend
backen	backen
teile	teile
einer	einer
verkaufe	verkaufe
verlähmt	verlähmt
griffen	griffen
einsammelte	einsammelte
erhebst	erhebst
erhörst	erhörst
jungen	jungen
mußten	mußten
Heuschrecken	Heuschrecken
eile	eile
Weinen	Weinen
Sollte	Sollte
untertreten	untertreten
höhnte	höhnte
Stärket	Stärket
hineingeht	hineingeht
wärst	wärst
Jünglinge	Jünglinge
schreiet	schreiet
eines	eines
maß	maß
besuche	besuche
träge	träge
meinen	meinen
empörte	empörte
versöhnst	versöhnst
verhalte	verhalte
weh	weh
bestimmt	bestimmt
haderte	haderte
wiederkamt	wiederkamt
folgte	folgte
Plage	Plage
War	War
stehest	stehest
treffen	treffen
Beten	Beten
brechet	brechet
freiwillige	freiwillige
lauten	lauten
einsammelst	einsammelst
schenken	schenken
Grenzen	Grenzen
gelangen	gelangen
Säue	Säue
Monde	Monde
Jünger	Jünger
steckst	steckst
Mäuse	Mäuse
handhaben	handhaben
fließen	fließen
setzt	setzt
behalte	behalte
stillest	stillest
spiele	spiele
Tyrannen	Tyrannen
Aussätzigen	Aussätzigen
bedeckst	bedeckst
Wachen	Wachen
verwirfst	verwirfst
klagen	klagen
nehmet	nehmet
fließt	fließt
weist	weist
vermahnt	vermahnt
sagen	sagen
meinet	meinet
Trübsalen	Trübsalen
Wehen	Wehen
fehlen	fehlen
gereichte	gereichte
schenkte	schenkte
gelangt	gelangt
Diesen	Diesen
wisset	wisset
Rubinen	Rubinen
verkündigst	verkündigst
entsetzen	entsetzen
macht	macht
übte	übte
kriegen	kriegen
stärket	stärket
Majestät	Majestät
ihre	ihre
wehrte	wehrte
Füchsen	Füchsen
gewöhnt	gewöhnt
kehrst	kehrst
Edelsteine	Edelsteine
Acht	Acht
anzeigt	anzeigt
jagte	jagte
legst	legst
schaffen	schaffen
Kannst	Kannst
schlafet	schlafet
verkündigten	verkündigten
sündigten	sündigten
lobe	lobe
fülle	fülle
Speisen	Speisen
Schneide	Schneide
Rabe	Rabe
Haben	Haben
Elfen	Elfen
Letzte	Letzte
pflanzt	pflanzt
schneiden	schneiden
Fröschen	Fröschen
allen	allen
regieret	regieret
Herren	Herren
morden	morden
Staub	Staub
Äste	Äste
Seilen	Seilen
wachse	wachse
stoßet	stoßet
lachte	lachte
murmeln	murmeln
Herden	Herden
zweite	zweite
werft	werft
ausrufest	ausrufest
Tote	Tote
Fahret	Fahret
brichst	brichst
solches	solches
gleiche	gleiche
aufhebest	aufhebest
Arme	Arme
gebt	gebt
Folge	Folge
wälzet	wälzet
selbst	selbst
würdest	würdest
Röcke	Röcke
warnst	warnst
vermahnet	vermahnet
bekennt	bekennt
sündigte	sündigte
Hebet	Hebet
glänzt	glänzt
Junge	Junge
diesen	diesen
Räte	Räte
Wüsten	Wüsten
sündigt	sündigt
trieben	trieben
jede	jede
verziehst	verziehst
ausgehst	ausgehst
Ihre	Ihre
empört	empört
regiert	regiert
weinst	weinst
seht	seht
sollte	sollte
Brüste	Brüste
krank	krank
bricht	bricht
Teilen	Teilen
heilige	heilige
vertilgen	vertilgen
tat	tat
stiegen	stiegen
anderen	anderen
frische	frische
braust	braust
beschwören	beschwören
Rufen	Rufen
erkannte	erkannte
Säge	Säge
versagen	versagen
verkauften	verkauften
halbe	halbe
müßt	müßt
pflanzest	pflanzest
Schar	Schar
weinen	weinen
Tragt	Tragt
halt	halt
Teppiche	Teppiche
ausfuhren	ausfuhren
Steiget	Steiget
Zöpfen	Zöpfen
betrübst	betrübst
Unglauben	Unglauben
erschreckte	erschreckte
spielet	spielet
verderbest	verderbest
Reiche	Reiche
Fett	Fett
aßet	aßet
Stühle	Stühle
reizen	reizen
Diebe	Diebe
Heißt	Heißt
kämpfet	kämpfet
Säuen	Säuen
am	am
stehst	stehst
erhöht	erhöht
möchten	möchten
keiner	keiner
befehlt	befehlt
fertig	fertig
erfahrt	erfahrt
ehre	ehre
Pflanzungen	Pflanzungen
lebest	lebest
Verheißung	Verheißung
Seil	Seil
weinest	weinest
gedenkst	gedenkst
Schleife	Schleife
reizt	reizt
verderben	verderben
müsse	müsse
übrigbleibe	übrigbleibe
zuschließet	zuschließet
redetest	redetest
stimmen	stimmen
Herr	Herr
Früchten	Früchten
hauest	hauest
wollest	wollest
lade	lade
verstanden	verstanden
Wache	Wache
ziere	ziere
erhört	erhört
wiederkommt	wiederkommt
Gesetzen	Gesetzen
erhalte	erhalte
hatten	hatten
demütige	demütige
versteckt	versteckt
scheinest	scheinest
besser	besser
beugst	beugst
beten	beten
aufsteht	aufsteht
erfreut	erfreut
Reichen	Reichen
reifen	reifen
Schafe	Schafe
wunderte	wunderte
bekehret	bekehret
Schild	Schild
wiederkommst	wiederkommst
nötig	nötig
ferne	ferne
Klüften	Klüften
eurem	eurem
Schlägen	Schlägen
Taufe	Taufe
Erstlingen	Erstlingen
trage	trage
ausrichtet	ausrichtet
schwelle	schwelle
krähte	krähte
Schläge	Schläge
vermöget	vermöget
arbeit	arbeit
heftete	heftete
wälzte	wälzte
den	den
Laien	Laien
verkürzest	verkürzest
vergibt	vergibt
heulte	heulte
Ha	Ha
gebieten	gebieten
sitze	sitze
offenbare	offenbare
bestand	bestand
deine	deine
fehle	fehle
Ratsherren	Ratsherren
Märkte	Märkte
bekennst	bekennst
stäupen	stäupen
Arm	Arm
essen	essen
zerstreuet	zerstreuet
Habt	Habt
Propheten	Propheten
Pauke	Pauke
Deinem	Deinem
verstörten	verstörten
trieb	trieb
begehrte	begehrte
predigte	predigte
Bete	Bete
Zeug	Zeug
Raten	Raten
grabe	grabe
brecht	brecht
Hallen	Hallen
fraget	fraget
Töpfe	Töpfe
übrigbleibt	übrigbleibt
außen	außen
Lobet	Lobet
auszogen	auszogen
nährte	nährte
erlösest	erlösest
decke	decke
bat	bat
gelobten	gelobten
verkürzt	verkürzt
wärme	wärme
wehen	wehen
Paläste	Paläste
könnest	könnest
taufst	taufst
Geschäften	Geschäften
schließt	schließt
betrüge	betrüge
außer	außer
zerstörst	zerstörst
glühende	glühende
Erde	Erde
wünschet	wünschet
Geräte	Geräte
Euren	Euren
Held	Held
wehre	wehre
Aussätzige	Aussätzige
verdammten	verdammten
auflegt	auflegt
leite	leite
pflanzet	pflanzet
Ring	Ring
Freunden	Freunden
preist	preist
Skorpionen	Skorpionen
Briefe	Briefe
lache	lache
Bund	Bund
stärkte	stärkte
Garten	Garten
beschädigten	beschädigten
hilfst	hilfst
Aller	Aller
kommst	kommst
mehr	mehr
ein	ein
verboten	verboten
rächest	rächest
leider	leider
Rufet	Rufet
Leiden	Leiden
umkehrt	umkehrt
Kost	Kost
jagst	jagst
strafet	strafet
schicke	schicke
Tore	Tore
Toten	Toten
gehörten	gehörten
Schmiede	Schmiede
malen	malen
schauet	schauet
ach	ach
folge	folge
Tanne	Tanne
unehret	unehret
Tritte	Tritte
Berge	Berge
blase	blase
frevler	frevler
baue	baue
gewinnet	gewinnet
Stricke	Stricke
Empörungen	Empörungen
Diese	Diese
säumen	säumen
Wehe	Wehe
fragen	fragen
Schaffet	Schaffet
schlagest	schlagest
Wogen	Wogen
glaubet	glaubet
heiligt	heiligt
springen	springen
rührst	rührst
trotzest	trotzest
füllen	füllen
Macht	Macht
sonderte	sonderte
Altären	Altären
Jahr	Jahr
schenkst	schenkst
Steinen	Steinen
überführt	überführt
weg	weg
täuschet	täuschet
verklärest	verklärest
werten	werten
pflegte	pflegte
Urteile	Urteile
frommen	frommen
konnten	konnten
Tun	Tun
Fellen	Fellen
Spannt	Spannt
Ärgernisse	Ärgernisse
stürzen	stürzen
aufwacht	aufwacht
werden	werden
spalten	spalten
Bärte	Bärte
Felsen	Felsen
wachset	wachset
empfanget	empfanget
lobte	lobte
stiftete	stiftete
haue	haue
Entsetzet	Entsetzet
Essen	Essen
bedenken	bedenken
befehlen	befehlen
erlöst	erlöst
Kosten	Kosten
schätzt	schätzt
gerne	gerne
Eure	Eure
füllst	füllst
streute	streute
Schale	Schale
Bunde	Bunde
trüb	trüb
laden	laden
Ringen	Ringen
bemüht	bemüht
teilet	teilet
Sorge	Sorge
Juden	Juden
Gebeten	Gebeten
Boten	Boten
teil	teil
urteile	urteile
Grüßet	Grüßet
verkündigest	verkündigest
erfahret	erfahret
grün	grün
Leichen	Leichen
allem	allem
Hecken	Hecken
Tiefen	Tiefen
besehet	besehet
verfolgst	verfolgst
Meere	Meere
kämpfen	kämpfen
huren	huren
machst	machst
Seht	Seht
enge	enge
Gäste	Gäste
lehnte	lehnte
Hände	Hände
brause	brause
wünschte	wünschte
verkehrte	verkehrte
Einheimische	Einheimische
verlaßt	verlaßt
tiefe	tiefe
reizte	reizte
Unsere	Unsere
Buchen	Buchen
ihren	ihren
rufe	rufe
anruft	anruft
Weichet	Weichet
Götzen	Götzen
bewährt	bewährt
mahlen	mahlen
halte	halte
grüße	grüße
liegen	liegen
eilet	eilet
schlagt	schlagt
Christ	Christ
rechten	rechten
hilft	hilft
Gedanken	Gedanken
Kühe	Kühe
beide	beide
Enden	Enden
demütiget	demütiget
gehörte	gehörte
Herde	Herde
log	log
Predigten	Predigten
erfahrest	erfahrest
verunreinigt	verunreinigt
Hälsen	Hälsen
ernten	ernten
absagen	absagen
Streite	Streite
fallt	fallt
Fallet	Fallet
Dienst	Dienst
Gebärde	Gebärde
Rufe	Rufe
verbirgst	verbirgst
einerntest	einerntest
messe	messe
aufhobt	aufhobt
ermahnt	ermahnt
verlobt	verlobt
Folget	Folget
Keine	Keine
sitzest	sitzest
welche	welche
habest	habest
tut	tut
Meinet	Meinet
keinen	keinen
feierte	feierte
erdachten	erdachten
vor	vor
Befehlen	Befehlen
streckte	streckte
gebrauchte	gebrauchte
Erste	Erste
steigest	steigest
Ordnungen	Ordnungen
Kleinoden	Kleinoden
Ärzte	Ärzte
vier	vier
scheute	scheute
Felle	Felle
stürzte	stürzte
Schmieden	Schmieden
raubet	raubet
zerrüttete	zerrüttete
strecke	strecke
Klagen	Klagen
stellen	stellen
haltest	haltest
springst	springst
dürft	dürft
schon	schon
Suche	Suche
jemanden	jemanden
unsres	unsres
übrigbleiben	übrigbleiben
Laie	Laie
Funken	Funken
taufe	taufe
Seinen	Seinen
Löwe	Löwe
harrte	harrte
setzte	setzte
hineinbrächte	hineinbrächte
Rühmst	Rühmst
opfern	opfern
vergebt	vergebt
Schuhen	Schuhen
Schiffen	Schiffen
viele	viele
trübe	trübe
mühe	mühe
Bitte	Bitte
liebest	liebest
wirket	wirket
Zeugen	Zeugen
verkaufst	verkaufst
Händen	Händen
umbrächte	umbrächte
Zweigen	Zweigen
handhabest	handhabest
esse	esse
meinst	meinst
verzehre	verzehre
Rudern	Rudern
würde	würde
Grabe	Grabe
raubest	raubest
jammern	jammern
Zöpfe	Zöpfe
Bächen	Bächen
reif	reif
Gehilfe	Gehilfe
hieben	hieben
Schlangen	Schlangen
bereits	bereits
lügen	lügen
niemand	niemand
Buchstabe	Buchstabe
wog	wog
treibst	treibst
rechte	rechte
schnell	schnell
Am	Am
Dieben	Dieben
Spieße	Spieße
Hecke	Hecke
ziehest	ziehest
Gefäßen	Gefäßen
hörest	hörest
Frösche	Frösche
abtrünnigen	abtrünnigen
Predigt	Predigt
übrigbleibet	übrigbleibet
weiche	weiche
Winde	Winde
Gerät	Gerät
Taufen	Taufen
Haue	Haue
einführt	einführt
aufwachte	aufwachte
Spitzen	Spitzen
Stücken	Stücken
holte	holte
erbte	erbte
heiligten	heiligten
ausrottest	ausrottest
absagt	absagt
auflöste	auflöste
predigt	predigt
Namen	Namen
lebte	lebte
Feste	Feste
offenbar	offenbar
trägst	trägst
Werdet	Werdet
strecken	strecken
verziehen	verziehen
Briefen	Briefen
wache	wache
wenden	wenden
heftetest	heftetest
leiden	leiden
versuchet	versuchet
Zäunen	Zäunen
Krieg	Krieg
schreist	schreist
bezahlt	bezahlt
hingehet	hingehet
siegen	siegen
scheide	scheide
rufst	rufst
blitzte	blitzte
fällt	fällt
Ecken	Ecken
Gehilfen	Gehilfen
Wären	Wären
sündigst	sündigst
maßen	maßen
löset	löset
ausrottet	ausrottet
Anfechtungen	Anfechtungen
wach	wach
aufnahmt	aufnahmt
befragt	befragt
weisen	weisen
umkäme	umkäme
nächsten	nächsten
arm	arm
ernte	ernte
betrübet	betrübet
heile	heile
spannte	spannte
besät	besät
suchte	suchte
eilte	eilte
gebet	gebet
beider	beider
versteckst	versteckst
hattet	hattet
vermahnen	vermahnen
Rechte	Rechte
brausen	brausen
holst	holst
hebräische	hebräische
Hirschen	Hirschen
niemanden	niemanden
danket	danket
verstand	verstand
nächste	nächste
binden	binden
behaltest	behaltest
Pfeife	Pfeife
nähre	nähre
steig	steig
Dein	Dein
deinen	deinen
erschrickt	erschrickt
Rechten	Rechten
Bäche	Bäche
stoßt	stoßt
Menschen	Menschen
fällen	fällen
verkriechet	verkriechet
wollt	wollt
schlafest	schlafest
vermahnten	vermahnten
erkennest	erkennest
Geviert	Geviert
verzweifelten	verzweifelten
Binde	Binde
gelobst	gelobst
kehrte	kehrte
Säcke	Säcke
nähret	nähret
legest	legest
habe	habe
wohnst	wohnst
begrabt	begrabt
bereite	bereite
Machet	Machet
dich	dich
vermahnte	vermahnte
kaufe	kaufe
helle	helle
Sprüchen	Sprüchen
murmelte	murmelte
eigene	eigene
jene	jene
unseres	unseres
umkämen	umkämen
zweifeln	zweifeln
Führet	Führet
Kräften	Kräften
hineingehst	hineingehst
anzöge	anzöge
Zähne	Zähne
erlassen	erlassen
Lüsten	Lüsten
Ach	Ach
Klüfte	Klüfte
werte	werte
gut	gut
befestigte	befestigte
prüfst	prüfst
Pflanzung	Pflanzung
weisest	weisest
zuteilte	zuteilte
gedenket	gedenket
vergessest	vergessest
gibst	gibst
Abhänge	Abhänge
beschwerst	beschwerst
zerstückt	zerstückt
Stärke	Stärke
gefällt	gefällt
merket	merket
Töpfen	Töpfen
Schuld	Schuld
stellst	stellst
Elle	Elle
vertrieb	vertrieb
Fetten	Fetten
möget	möget
nimmst	nimmst
räumet	räumet
Weiche	Weiche
Edelsteinen	Edelsteinen
Ehren	Ehren
solchen	solchen
Recht	Recht
stärken	stärken
Leuchten	Leuchten
rüstetet	rüstetet
begehre	begehre
Erben	Erben
erschrickst	erschrickst
Anschläge	Anschläge
begehrst	begehrst
kühl	kühl
Wunden	Wunden
wollten	wollten
Als	Als
bebte	bebte
anzeigte	anzeigte
konntet	konntet
aufhebt	aufhebt
Mache	Mache
gehörst	gehörst
Sägen	Sägen
wärt	wärt
hängen	hängen
ehrest	ehrest
aufkämen	aufkämen
Geliebten	Geliebten
könne	könne
Gefangene	Gefangene
geraten	geraten
Wissen	Wissen
linke	linke
Sabbate	Sabbate
aufnahmen	aufnahmen
Huren	Huren
rühmest	rühmest
wohnet	wohnet
erhebest	erhebest
gießt	gießt
Gebirgen	Gebirgen
Alles	Alles
ausgereckten	ausgereckten
Band	Band
auszogst	auszogst
seine	seine
sitzt	sitzt
Schleifen	Schleifen
Speere	Speere
erbest	erbest
Tiefe	Tiefe
gießest	gießest
Lichte	Lichte
losen	losen
betrügen	betrügen
anrichte	anrichte
täuschte	täuschte
Testamente	Testamente
handhabt	handhabt
fresset	fresset
bekehrten	bekehrten
Hauen	Hauen
hieltest	hieltest
welchen	welchen
Zeuge	Zeuge
langte	langte
beben	beben
Bürde	Bürde
Gebote	Gebote
verdeckt	verdeckt
Ordnung	Ordnung
Bahnen	Bahnen
meine	meine
sagst	sagst
Morden	Morden
Tauben	Tauben
anfinge	anfinge
merkte	merkte
Solchen	Solchen
Kaufleuten	Kaufleuten
erfüllst	erfüllst
Weiß	Weiß
stellet	stellet
keines	keines
lernet	lernet
Wachet	Wachet
Verheißungen	Verheißungen
schließen	schließen
verkaufte	verkaufte
Ästen	Ästen
fette	fette
Wollt	Wollt
erwerben	erwerben
Verwundeten	Verwundeten
gereicht	gereicht
ritt	ritt
lehnen	lehnen
entsetzten	entsetzten
Weihen	Weihen
vertilgest	vertilgest
Kehre	Kehre
stellte	stellte
streite	streite
denen	denen
rächte	rächte
Helden	Helden
Schenken	Schenken
hebst	hebst
prüfest	prüfest
manche	manche
hänge	hänge
unehrt	unehrt
Gründen	Gründen
erschreckten	erschreckten
Skorpione	Skorpione
Fremden	Fremden
Gehörst	Gehörst
besäen	besäen
abtrünnige	abtrünnige
ander	ander
Gerichten	Gerichten
schlaf	schlaf
schaute	schaute
Habe	Habe
eins	eins
Herz	Herz
dienest	dienest
zweifel	zweifel
traut	traut
wirkte	wirkte
vereinigte	vereinigte
hausen	hausen
Schreiet	Schreiet
vertraget	vertraget
hebräischen	hebräischen
heilet	heilet
rühmst	rühmst
dritte	dritte
Ströme	Ströme
einst	einst
rate	rate
Sekte	Sekte
Testamenten	Testamenten
berufe	berufe
ungeistlich	ungeistlich
Fels	Fels
wollte	wollte
backe	backe
müßte	müßte
Nehmet	Nehmet
anrichtet	anrichtet
lernte	lernte
Lehne	Lehne
Woge	Woge
regieren	regieren
haut	haut
verbergt	verbergt
hinaufgehst	hinaufgehst
Hirte	Hirte
Gesell	Gesell
Setzt	Setzt
verstörte	verstörte
gründe	gründe
kriegte	kriegte
unsrer	unsrer
Welchen	Welchen
bekehrt	bekehrt
heiligte	heiligte
vertraute	vertraute
nachwandelst	nachwandelst
pflegst	pflegst
tust	tust
Tier	Tier
mühte	mühte
Ställen	Ställen
Früchte	Früchte
gelobte	gelobte
weinte	weinte
pflügte	pflügte
ausgerecktem	ausgerecktem
währet	währet
Dienet	Dienet
schauen	schauen
erlasset	erlasset
treibest	treibest
führe	führe
Tyrann	Tyrann
Sehet	Sehet
entsündigten	entsündigten
fragst	fragst
neige	neige
austilgen	austilgen
zählte	zählte
wurde	wurde
weichen	weichen
Werkzeuge	Werkzeuge
hörte	hörte
Röcken	Röcken
träumte	träumte
Worte	Worte
suche	suche
wärmet	wärmet
leere	leere
Gehorchet	Gehorchet
wälzt	wälzt
Werk	Werk
lieget	lieget
Halle	Halle
reife	reife
helfet	helfet
kehre	kehre
Einem	Einem
Schwänzen	Schwänzen
kurz	kurz
sollten	sollten
wild	wild
rede	rede
würdet	würdet
Söhne	Söhne
Zehe	Zehe
Fahrt	Fahrt
schaffst	schaffst
liege	liege
Hat	Hat
Bande	Bande
ringet	ringet
angehört	angehört
konntest	konntest
könnet	könnet
schlaget	schlaget
nütze	nütze
Pfeifen	Pfeifen
schnitt	schnitt
krähen	krähen
habt	habt
schwellen	schwellen
Grieche	Grieche
Pfeile	Pfeile
rühmet	rühmet
verzieht	verzieht
Bote	Bote
dürfest	dürfest
Dank	Dank
unterrichte	unterrichte
ihr	ihr
schlafe	schlafe
Weh	Weh
zerschlagt	zerschlagt
reichen	reichen
verlasse	verlasse
decken	decken
Feinde	Feinde
unser	unser
Büschen	Büschen
Pfeilen	Pfeilen
Kreuze	Kreuze
Rauben	Rauben
gedenkest	gedenkest
alles	alles
Monate	Monate
nahest	nahest
beschuldiget	beschuldiget
jedem	jedem
amen	amen
Für	Für
Bleibe	Bleibe
gewinnen	gewinnen
Decken	Decken
siehst	siehst
Zäune	Zäune
bang	bang
Ältesten	Ältesten
kommet	kommet
Schalen	Schalen
borgst	borgst
Satzung	Satzung
Kriegsknechten	Kriegsknechten
fassest	fassest
meinte	meinte
wehren	wehren
ringe	ringe
zuhörte	zuhörte
trefft	trefft
fällte	fällte
reiche	reiche
verkündigt	verkündigt
Gar	Gar
lehrte	lehrte
banden	banden
befestigt	befestigt
stirbt	stirbt
Türkise	Türkise
strafte	strafte
labe	labe
säte	säte
glaubst	glaubst
willen	willen
ratschlagte	ratschlagte
hattest	hattest
schätze	schätze
preisen	preisen
Name	Name
lang	lang
ausrufen	ausrufen
tragen	tragen
plagest	plagest
suchest	suchest
hätte	hätte
Lobgesängen	Lobgesängen
rührte	rührte
ermahnet	ermahnet
Ding	Ding
Bahn	Bahn
umkehret	umkehret
ringen	ringen
wegführen	wegführen
dichten	dichten
verzweifelt	verzweifelt
Hörst	Hörst
bemühst	bemühst
links	links
spaltete	spaltete
herrschet	herrschet
stand	stand
fluchte	fluchte
Toren	Toren
seufzte	seufzte
bestellten	bestellten
Amt	Amt
verstopft	verstopft
mögest	mögest
verzehrst	verzehrst
Lehnen	Lehnen
Trinkgefäße	Trinkgefäße
verführen	verführen
Feinden	Feinden
sagte	sagte
mußte	mußte
möchte	möchte
Werke	Werke
heilte	heilte
bist	bist
bedürft	bedürft
bauest	bauest
ruhest	ruhest
Entsetzen	Entsetzen
schrecken	schrecken
verlieren	verlieren
aßest	aßest
Jochen	Jochen
erzeigt	erzeigt
fluchet	fluchet
spanne	spanne
Kreisen	Kreisen
speisen	speisen
schauest	schauest
sei	sei
ratschlagten	ratschlagten
Meeren	Meeren
neigte	neigte
merke	merke
Heuschrecke	Heuschrecke
klage	klage
schätzen	schätzen
irgendeine	irgendeine
machte	machte
erwerbe	erwerbe
Gefängnisse	Gefängnisse
lange	lange
begehrten	begehrten
stäupt	stäupt
beweist	beweist
grünen	grünen
aller	aller
tretest	tretest
rauschen	rauschen
Deutung	Deutung
geboten	geboten
weise	weise
Ochsen	Ochsen
würze	würze
kostet	kostet
gern	gern
fahrest	fahrest
auszöge	auszöge
Regieren	Regieren
halten	halten
Räten	Räten
gehorchest	gehorchest
Buchstaben	Buchstaben
fehlet	fehlet
logen	logen
Klage	Klage
überführen	überführen
zürnst	zürnst
verlähmte	verlähmte
streiten	streiten
umkehrte	umkehrte
ausbreitet	ausbreitet
Reihen	Reihen
Träume	Träume
Wisset	Wisset
fange	fange
weich	weich
Trübsale	Trübsale
trauten	trauten
ausrichtest	ausrichtest
Wollte	Wollte
wirfst	wirfst
verdammst	verdammst
Bienen	Bienen
Flamme	Flamme
rote	rote
lieb	lieb
lehre	lehre
Sorgen	Sorgen
Sollst	Sollst
schickte	schickte
stoßest	stoßest
Strömen	Strömen
stirbst	stirbst
versuchen	versuchen
Lehren	Lehren
hüte	hüte
meines	meines
Stimmen	Stimmen
Unglaube	Unglaube
zuteil	zuteil
ratschlaget	ratschlaget
anrührte	anrührte
angehören	angehören
graben	graben
vermögen	vermögen
Same	Same
angehöre	angehöre
Wege	Wege
Aase	Aase
glaubest	glaubest
folgen	folgen
Seit	Seit
ziert	ziert
predigten	predigten
diese	diese
Zweige	Zweige
sitzet	sitzet
verschont	verschont
entsetzt	entsetzt
trinken	trinken
Zerstreut	Zerstreut
warten	warten
Perle	Perle
webte	webte
schreien	schreien
konnte	konnte
demütigte	demütigte
griechisch	griechisch
möge	möge
breche	breche
möchtest	möchtest
Tieren	Tieren
betrübte	betrübte
kein	kein
zerbrechest	zerbrechest
Schneiden	Schneiden
jedes	jedes
Erbe	Erbe
hell	hell
schonte	schonte
zuschließt	zuschließt
dürfe	dürfe
Schuhe	Schuhe
Keiner	Keiner
zerbricht	zerbricht
mal	mal
laute	laute
ausgereckt	ausgereckt
grünte	grünte
vertilge	vertilge
Hebe	Hebe
Sehne	Sehne
schmelzt	schmelzt
holet	holet
Wirte	Wirte
erzürnt	erzürnt
würzen	würzen
Jünglingen	Jünglingen
Erden	Erden
Zäume	Zäume
deinem	deinem
mahle	mahle
tretet	tretet
ausgereckte	ausgereckte
deckte	deckte
Werden	Werden
hieltet	hieltet
Trinken	Trinken
ausziehst	ausziehst
versöhnet	versöhnet
fangt	fangt
Solch	Solch
zerrütteten	zerrütteten
Kleinod	Kleinod
prüfet	prüfet
Gebet	Gebet
Hirten	Hirten
gehören	gehören
Westen	Westen
feierten	feierten
keine	keine
Mensch	Mensch
sterbt	sterbt
Strafe	Strafe
schau	schau
salzen	salzen
schließe	schließe
verderbet	verderbet
fallest	fallest
baten	baten
Bube	Bube
beweisest	beweisest
warte	warte
leben	leben
wachet	wachet
Sollten	Sollten
könnte	könnte
Leichnamen	Leichnamen
weiden	weiden
vertrauet	vertrauet
glaube	glaube
Fallen	Fallen
verkehrt	verkehrt
lasset	lasset
Linken	Linken
drücken	drücken
weichest	weichest
erbaust	erbaust
betrübten	betrübten
Gesetze	Gesetze
suchet	suchet
nimmt	nimmt
Buch	Buch
bringet	bringet
heulet	heulet
machest	machest
anrichten	anrichten
Linke	Linke
gründen	gründen
Ränke	Ränke
Meine	Meine
sprechet	sprechet
betrübt	betrübt
dürfte	dürfte
Türmen	Türmen
verstört	verstört
Neumonden	Neumonden
leer	leer
Hälse	Hälse
erforschest	erforschest
lachet	lachet
schämst	schämst
gibt	gibt
Hunderten	Hunderten
Höhle	Höhle
fünften	fünften
Prophet	Prophet
anrufen	anrufen
Unserer	Unserer
berufen	berufen
saget	saget
erweckt	erweckt
erdacht	erdacht
zeiget	zeiget
frevles	frevles
aber	aber
laufe	laufe
bestimmte	bestimmte
Wehre	Wehre
zerrüttet	zerrüttet
Gefilde	Gefilde
Ställe	Ställe
führet	führet
Bleibet	Bleibet
neigest	neigest
schwimmst	schwimmst
aufkäme	aufkäme
zerbrecht	zerbrecht
blaset	blaset
taten	taten
Fällen	Fällen
leihet	leihet
schwebte	schwebte
Last	Last
all	all
Äxte	Äxte
bekennet	bekennet
Werkzeugen	Werkzeugen
verbot	verbot
werdet	werdet
setzest	setzest
sterbet	sterbet
verbergest	verbergest
ratschlagen	ratschlagen
erweckest	erweckest
Tut	Tut
lösest	lösest
bessere	bessere
Raben	Raben
bleibst	bleibst
deines	deines
Grase	Grase
zählet	zählet
sorget	sorget
steckte	steckte
Hunden	Hunden
austilgest	austilgest
demütigst	demütigst
lobet	lobet
Biene	Biene
zweiten	zweiten
abzieht	abzieht
ungefälschter	ungefälschter
Erstlinge	Erstlinge
Schauet	Schauet
Unrecht	Unrecht
mangeln	mangeln
Entsetzt	Entsetzt
taufet	taufet
Gehorcht	Gehorcht
forschet	forschet
Ihr	Ihr
umkommt	umkommt
Sehe	Sehe
schweiget	schweiget
Weihe	Weihe
kaufte	kaufte
blenden	blenden
Mäusen	Mäusen
schwebe	schwebe
koche	koche
behaltet	behaltet
nehmt	nehmt
gelangte	gelangte
Einen	Einen
Freunde	Freunde
blende	blende
Sternen	Sternen
wahre	wahre
Spaltungen	Spaltungen
Beine	Beine
Sekten	Sekten
euren	euren
trinkest	trinkest
führest	führest
Maßen	Maßen
Laufet	Laufet
Decket	Decket
Schaden	Schaden
bedeckt	bedeckt
wünschen	wünschen
seufzest	seufzest
vereinigt	vereinigt
achte	achte
schöpfe	schöpfe
Rehe	Rehe
bleibest	bleibest
stahl	stahl
schreie	schreie
zürnest	zürnest
hingehst	hingehst
Jahre	Jahre
Hunde	Hunde
Höhen	Höhen
empörten	empörten
Dinge	Dinge
begrabet	begrabet
decket	decket
ungehorsam	ungehorsam
wogen	wogen
Gerichte	Gerichte
schmelzen	schmelzen
lüge	lüge
Deutungen	Deutungen
Dich	Dich
bewahrest	bewahrest
verdammte	verdammte
loben	loben
bewähret	bewähret
Buche	Buche
prediget	prediget
heißt	heißt
Reihe	Reihe
ungehorsame	ungehorsame
ehe	ehe
jaget	jaget
trinket	trinket
Glauben	Glauben
liegst	liegst
heiligest	heiligest
lernst	lernst
versuche	versuche
erkennet	erkennet
Merke	Merke
schaffest	schaffest
krieget	krieget
verstecken	verstecken
erkannten	erkannten
Sabbatjahre	Sabbatjahre
fasset	fasset
hadere	hadere
unsere	unsere
toten	toten
redetet	redetet
nötigte	nötigte
sündiget	sündiget
dingten	dingten
Einheimischen	Einheimischen
seit	seit
anzeige	anzeige
saht	saht
Basilisken	Basilisken
wurdet	wurdet
liebte	liebte
harret	harret
Perlen	Perlen
verliert	verliert
verfolgt	verfolgt
manchen	manchen
Tischen	Tischen
freute	freute
Gelobt	Gelobt
schöpfest	schöpfest
Stücke	Stücke
Sei	Sei
Leiche	Leiche
räumen	räumen
Jahren	Jahren
wahr	wahr
versöhnt	versöhnt
stimmte	stimmte
schaffe	schaffe
Weißt	Weißt
nachwandeln	nachwandeln
folget	folget
Ratet	Ratet
Augen	Augen
einnehmet	einnehmet
ihres	ihres
Urteil	Urteil
pflege	pflege
zwölfte	zwölfte
kaufet	kaufet
grüßet	grüßet
Sinnen	Sinnen
los	los
vergleiche	vergleiche
erzürnet	erzürnet
würden	würden
steinigest	steinigest
Lobgesänge	Lobgesänge
Schlange	Schlange
Keilen	Keilen
messen	messen
währte	währte
Schätzen	Schätzen
fluche	fluche
faul	faul
untergehst	untergehst
durchbohrt	durchbohrt
preise	preise
zerreißt	zerreißt
anbetest	anbetest
Anklagen	Anklagen
aufmachte	aufmachte
besorgte	besorgte
verdeckst	verdeckst
Gute	Gute
flehte	flehte
bauet	bauet
lehrest	lehrest
Gebeinen	Gebeinen
trotzt	trotzt
erste	erste
hüten	hüten
verwirft	verwirft
bestimmst	bestimmst
ärger	ärger
beweisen	beweisen
Sucht	Sucht
geselle	geselle
verwahrt	verwahrt
schreibst	schreibst
Eines	Eines
griffe	griffe
anzeigen	anzeigen
glaubte	glaubte
tief	tief
befestigten	befestigten
fresse	fresse
Fittiche	Fittiche
Bäumen	Bäumen
aufstanden	aufstanden
Bitten	Bitten
Wehr	Wehr
band	band
Stolz	Stolz
zürnet	zürnet
einführte	einführte
auflegst	auflegst
bis	bis
Ränken	Ränken
übest	übest
wallet	wallet
Meinem	Meinem
seinem	seinem
beschädigte	beschädigte
binde	binde
warst	warst
Samen	Samen
wirst	wirst
Röhre	Röhre
Strafen	Strafen
zeugte	zeugte
gehorcht	gehorcht
Weinbergen	Weinbergen
schreiben	schreiben
Palästen	Palästen
Bären	Bären
hängte	hängte
kaufest	kaufest
tobte	tobte
Wehklagen	Wehklagen
Seiten	Seiten
sollst	sollst
rühmte	rühmte
Hast	Hast
vertraut	vertraut
Kehret	Kehret
Altäre	Altäre
Eine	Eine
Quellen	Quellen
raten	raten
zweifelte	zweifelte
trügen	trügen
beharret	beharret
Klaue	Klaue
Feiertagen	Feiertagen
Tannen	Tannen
haben	haben
Gut	Gut
aufrichtest	aufrichtest
lügst	lügst
Glaubst	Glaubst
Kommet	Kommet
klagte	klagte
scheinet	scheinet
hebe	hebe
gebest	gebest
wiederkamen	wiederkamen
Gebot	Gebot
schläft	schläft
erkanntet	erkanntet
Städte	Städte
Weine	Weine
Merket	Merket
glühenden	glühenden
Weinet	Weinet
jenen	jenen
auszieht	auszieht
regiere	regiere
Setzet	Setzet
grüßte	grüßte
verkündiget	verkündiget
Spaltung	Spaltung
wechseln	wechseln
Friede	Friede
Unrechten	Unrechten
Mein	Mein
erweckst	erweckst
traget	traget
Maße	Maße
werdest	werdest
wisse	wisse
jauchzte	jauchzte
aufstehst	aufstehst
jemand	jemand
hasset	hasset
standet	standet
könnt	könnt
unschuldigen	unschuldigen
Wir	Wir
fallet	fallet
Wert	Wert
Königreiche	Königreiche
Monaten	Monaten
Majestäten	Majestäten
Aufsätzen	Aufsätzen
Helmen	Helmen
Gebt	Gebt
Gelobet	Gelobet
Trinket	Trinket
wachte	wachte
Ende	Ende
heiße	heiße
Füllet	Füllet
anzögen	anzögen
gelang	gelang
Quelle	Quelle
mußt	mußt
sorge	sorge
tatet	tatet
küssen	küssen
Säcken	Säcken
einnehmest	einnehmest
besäest	besäest
tuest	tuest
stäupte	stäupte
messet	messet
Dichten	Dichten
taufte	taufte
Könige	Könige
wäre	wäre
Ellen	Ellen
Bergen	Bergen
Kühen	Kühen
erbauet	erbauet
Schwänze	Schwänze
verschonet	verschonet
Kristallen	Kristallen
gedacht	gedacht
gebühren	gebühren
Lobe	Lobe
rufen	rufen
Halt	Halt
strafen	strafen
Staube	Staube
Haut	Haut
gedachten	gedachten
steige	steige
wohnte	wohnte
versuchst	versuchst
Stämmen	Stämmen
regen	regen
wolle	wolle
ihnen	ihnen
Ochs	Ochs
vermahne	vermahne
reichte	reichte
Speise	Speise
Joche	Joche
Maultieren	Maultieren
säet	säet
vertilgte	vertilgte
fremde	fremde
Wer	Wer
elften	elften
verwirrt	verwirrt
sprichst	sprichst
erkennst	erkennst
erfüllt	erfüllt
fließe	fließe
vergießt	vergießt
Wunde	Wunde
Fliege	Fliege
Füßen	Füßen
bete	bete
Saget	Saget
Solcher	Solcher
besorgt	besorgt
Orte	Orte
Reich	Reich
Meinst	Meinst
vertilgst	vertilgst
Licht	Licht
Klauen	Klauen
Ratsherr	Ratsherr
arme	arme
leid	leid
Ebenen	Ebenen
besucht	besucht
Seine	Seine
vermag	vermag
Pfunden	Pfunden
hättest	hättest
weide	weide
wirkst	wirkst
erlaubt	erlaubt
Lasten	Lasten
Anklage	Anklage
hätten	hätten
erhöhst	erhöhst
gesellt	gesellt
ausgereckter	ausgereckter
hebräisch	hebräisch
Ochse	Ochse
backt	backt
Gewürze	Gewürze
hurst	hurst
trotze	trotze
kochte	kochte
sorgen	sorgen
Flöten	Flöten
herrschte	herrschte
Kriegsknechte	Kriegsknechte
stille	stille
denkst	denkst
wurdest	wurdest
schlage	schlage
Alle	Alle
berühret	berühret
fliegen	fliegen
heiß	heiß
gebraucht	gebraucht
Reife	Reife
fallen	fallen
kühle	kühle
Wesen	Wesen
er	er
bekehrst	bekehrst
erben	erben
nahe	nahe
ruhe	ruhe
nehmest	nehmest
brechen	brechen
Weinberge	Weinberge
wehklage	wehklage
falle	falle
verkriechst	verkriechst
leget	leget
lose	lose
hoffet	hoffet
Werken	Werken
gebietet	gebietet
brennen	brennen
vertrieben	vertrieben
Fürst	Fürst
Hundert	Hundert
schnitten	schnitten
wegführe	wegführe
vergesset	vergesset
hauen	hauen
stürzest	stürzest
Hure	Hure
Schulden	Schulden
durchbohrte	durchbohrte
suchen	suchen
begrabest	begrabest
grüne	grüne
knüpfst	knüpfst
der	der
Königreichen	Königreichen
predigst	predigst
Den	Den
Plagen	Plagen
schweigen	schweigen
Graben	Graben
Sieb	Sieb
heißet	heißet
rauschte	rauschte
eingehest	eingehest
säst	säst
Schaffe	Schaffe
weichet	weichet
verstehst	verstehst
wende	wende
fertigte	fertigte
Dans	Dans
Schau	Schau
hättet	hättet
Fremde	Fremde
Fäusten	Fäusten
erbaut	erbaut
besuchen	besuchen
schmückte	schmückte
leihst	leihst
Basilisk	Basilisk
Lüste	Lüste
zerstreuest	zerstreuest
aufhoben	aufhoben
fastete	fastete
bezahlest	bezahlest
sage	sage
Griechen	Griechen
hatte	hatte
rufest	rufest
reich	reich
mangelte	mangelte
jammerte	jammerte
trinkst	trinkst
Stufen	Stufen
Führe	Führe
Spanne	Spanne
schmiert	schmiert
gießet	gießet
Schafen	Schafen
schaffte	schaffte
erhörest	erhörest
vertrauten	vertrauten
speist	speist
teilen	teilen
Stühlen	Stühlen
speiest	speiest
spracht	spracht
aufheben	aufheben
anhangt	anhangt
wissest	wissest
beißt	beißt
ratschlagt	ratschlagt
Heere	Heere
verhalten	verhalten
vierte	vierte
versucht	versucht
Schauen	Schauen
sich	sich
sieht	sieht
verdeckten	verdeckten
griechischen	griechischen
steigen	steigen
Sorget	Sorget
reizet	reizet
scheiden	scheiden
hingeht	hingeht
batet	batet
erfreuest	erfreuest
blast	blast
anzeigest	anzeigest
Ängste	Ängste
ehrst	ehrst
deckst	deckst
Höret	Höret
dienst	dienst
besitzet	besitzet
legte	legte
Wände	Wände
bauten	bauten
gebäret	gebäret
Obrigkeit	Obrigkeit
vertilgt	vertilgt
triebe	triebe
Gläubige	Gläubige
Füllen	Füllen
Herzen	Herzen
rittest	rittest
Eichen	Eichen
sondern	sondern
inneren	inneren
Taten	Taten
stürze	stürze
kämpfte	kämpfte
schnelle	schnelle
brauste	brauste
eng	eng
Gedanke	Gedanke
spielte	spielte
bestellte	bestellte
stolz	stolz
verwirren	verwirren
weite	weite
forschen	forschen
Zehen	Zehen
wachen	wachen
Tat	Tat
raubte	raubte
solcher	solcher
Reizt	Reizt
danke	danke
baust	baust
speisest	speisest
abziehen	abziehen
seinen	seinen
Schätze	Schätze
tragest	tragest
Steigen	Steigen
ältesten	ältesten
dritten	dritten
ärgere	ärgere
Ärgernissen	Ärgernissen
Morde	Morde
morde	morde
Wehklage	Wehklage
verzehrt	verzehrt
bange	bange
pflügen	pflügen
verkehrten	verkehrten
kommest	kommest
Knechte	Knechte
Äxten	Äxten
schöpfen	schöpfen
denn	denn
einernten	einernten
Kommst	Kommst
widerstanden	widerstanden
merken	merken
zerstört	zerstört
zeuget	zeuget
fällst	fällst
Gibst	Gibst
dein	dein
male	male
Trinkgefäßen	Trinkgefäßen
streckst	streckst
fragte	fragte
mein	mein
solch	solch
zuhört	zuhört
spannen	spannen
unseren	unseren
Jungen	Jungen
wehe	wehe
Frage	Frage
erwürget	erwürget
Kreise	Kreise
stahlen	stahlen
erzürnst	erzürnst
fertige	fertige
Weg	Weg
Drache	Drache
Bis	Bis
Heiße	Heiße
erzeige	erzeige
Suchet	Suchet
Malen	Malen
innere	innere
streuen	streuen
zerstreute	zerstreute
suchst	suchst
auflöst	auflöst
ringst	ringst
eures	eures
kaufst	kaufst
drängten	drängten
tragt	tragt
Gebärden	Gebärden
wirft	wirft
Sieben	Sieben
unterrichtet	unterrichtet
seines	seines
Christen	Christen
Alten	Alten
Fallt	Fallt
Grüße	Grüße
tobst	tobst
fünfte	fünfte
rufet	rufet
begehret	begehret
grüßen	grüßen
Pauken	Pauken
Geliebte	Geliebte
Teppichen	Teppichen
vermöge	vermöge
Eiche	Eiche
erhöhet	erhöhet
spricht	spricht
Winden	Winden
weine	weine
bleibe	bleibe
Reif	Reif
Jude	Jude
fern	fern
bedenket	bedenket
solle	solle
Tische	Tische
seien	seien
Falle	Falle
Gewürzen	Gewürzen
erfüllet	erfüllet
Helme	Helme
begehrt	begehrt
nützt	nützt
erwürgt	erwürgt
eigenen	eigenen
Werte	Werte
hinaufgeht	hinaufgeht
laufet	laufet
bitte	bitte
bekannt	bekannt
flucht	flucht
laben	laben
stiege	stiege
bedeckest	bedeckest
befehle	befehle
Eins	Eins
übet	übet
sehet	sehet
reizest	reizest
Leuchte	Leuchte
Dingen	Dingen
Obrigkeiten	Obrigkeiten
Trübsal	Trübsal
zürnte	zürnte
beugte	beugte
bringest	bringest
Sagen	Sagen
Türkis	Türkis
kämpfe	kämpfe
drängst	drängst
freiwilligen	freiwilligen
erforscht	erforscht
Hirsche	Hirsche
wehte	wehte
Kreuz	Kreuz
esset	esset
feiert	feiert
wallte	wallte
zerbrichst	zerbrichst
fahrt	fahrt
wart	wart
Regenten	Regenten
gleich	gleich
Aas	Aas
aufrichte	aufrichte
bekehrte	bekehrte
Sage	Sage
Brote	Brote
Kriege	Kriege
Armen	Armen
beweiset	beweiset
Loben	Loben
Schade	Schade
Rühmet	Rühmet
Seines	Seines
Meines	Meines
Lehre	Lehre
Binden	Binden
Wehret	Wehret
Wegen	Wegen
Verwundete	Verwundete
Flammen	Flammen
beharrt	beharrt
Zeugnissen	Zeugnissen
Welche	Welche
Lob	Lob
schämet	schämet
eingeht	eingeht
verziehe	verziehe
verlasset	verlasset
sitzen	sitzen
stärke	stärke
führte	führte
stiften	stiften
dienet	dienet
Türme	Türme
Solches	Solches
oben	oben
