flirtest	flirtest
Kardinäle	Kardinäle
verachtend	verachtend
Abbild	Abbild
spekuliere	spekuliere
hatte	hatte
verdammst	verdammst
Halogenatomen	Halogenatomen
bewahrest	bewahrest
Fokus	Fokus
waren	waren
Leugnung	Leugnung
hydrolysierest	hydrolysierest
Weh	Weh
Anfängern	Anfängern
zuppt	zuppt
verspätete	verspätete
Jünger	Jünger
Streich	Streich
Genie	Genie
alarmiere	alarmiere
grüßen	grüßen
ab	ab
würden	würden
schweiget	schweiget
Gläubiger	Gläubiger
betrübet	betrübet
verfange	verfange
stimme	stimme
Brötchen	Brötchen
Atmosphäre	Atmosphäre
Freunden	Freunden
kabelten	kabelten
unsere	unsere
verlautete	verlautete
käbbelte	käbbelte
schenkest	schenkest
pflügest	pflügest
verreisest	verreisest
Durchbruches	Durchbruches
bestellten	bestellten
Verbrechen	Verbrechen
zuppen	zuppen
finanziere	finanziere
Weichseln	Weichseln
Büchereien	Büchereien
bescherten	bescherten
härten	härten
Honigbären	Honigbären
alle	alle
Wadenbeines	Wadenbeines
Laubbläsern	Laubbläsern
hätte	hätte
räumet	räumet
grünest	grünest
mopsend	mopsend
Mageninhalten	Mageninhalten
drillte	drillte
quietschest	quietschest
grüßt	grüßt
erstürmet	erstürmet
Lesen	Lesen
Alte	Alte
fastete	fastete
Glauben	Glauben
Aktenkoffer	Aktenkoffer
Komplexionen	Komplexionen
Mitwisserschaft	Mitwisserschaft
zeugst	zeugst
verdrängt	verdrängt
Entsetzet	Entsetzet
erlabet	erlabet
Anführer	Anführer
lös	lös
beschlügen	beschlügen
Abschiedsbrief	Abschiedsbrief
Dorngesträuch	Dorngesträuch
Polierstählen	Polierstählen
stehest	stehest
verdamme	verdamme
Wespen	Wespen
sehet	sehet
läute	läute
leerst	leerst
warntest	warntest
beneidete	beneidete
Binden	Binden
Ahnen	Ahnen
betrieben	betrieben
verselbstständigest	verselbstständigest
mußt	mußt
Türme	Türme
Korrosionsschutz	Korrosionsschutz
wärt	wärt
Futtermitteln	Futtermitteln
preiset	preiset
begeben	begeben
Inder	Inder
Flöten	Flöten
Verselbstständigung	Verselbstständigung
Seilen	Seilen
zagt	zagt
haarten	haarten
herrschet	herrschet
umhüllend	umhüllend
Nadel	Nadel
säumet	säumet
traget	traget
Knöllchens	Knöllchens
regiertest	regiertest
wärmet	wärmet
Beobachtung	Beobachtung
hadertet	hadertet
kollidierten	kollidierten
danke	danke
schöpfte	schöpfte
Seetauchers	Seetauchers
Schaffet	Schaffet
Hochhäuser	Hochhäuser
analysiert	analysiert
impfst	impfst
Hörst	Hörst
Unwahrheiten	Unwahrheiten
verbüßest	verbüßest
zerstreuet	zerstreuet
Argentit	Argentit
geselle	geselle
reizest	reizest
addierte	addierte
scheuchten	scheuchten
Erlösungen	Erlösungen
Banden	Banden
Fußballweltmeisterschaftsqualifikationsspiel	Fußballweltmeisterschaftsqualifikationsspiel
stellte	stellte
verteidigte	verteidigte
ausgehst	ausgehst
beteuerten	beteuerten
Fortsetzungen	Fortsetzungen
tagest	tagest
lügt	lügt
Sündern	Sündern
erkennest	erkennest
befestigt	befestigt
Schwirrvögel	Schwirrvögel
stationierten	stationierten
baust	baust
ermächtigest	ermächtigest
durchwachen	durchwachen
kennet	kennet
beten	beten
Druckfehlern	Druckfehlern
beweisest	beweisest
Kontraindikation	Kontraindikation
Schneepflug	Schneepflug
begrub	begrub
sei	sei
Abschirmungen	Abschirmungen
Türkenbund	Türkenbund
Pfleglingen	Pfleglingen
Bedeutung	Bedeutung
verallgemeinerst	verallgemeinerst
radiertest	radiertest
Türkin	Türkin
protestierst	protestierst
Geigerzähler	Geigerzähler
Rubine	Rubine
Hochzeitstorten	Hochzeitstorten
dein	dein
verderbet	verderbet
sehest	sehest
downloadete	downloadete
fragmentiert	fragmentiert
werft	werft
beschlaget	beschlaget
Breiten	Breiten
inspirierest	inspirierest
besuchen	besuchen
Schneepflüge	Schneepflüge
lose	lose
schämte	schämte
Früchtchen	Früchtchen
Innenministerien	Innenministerien
Tatsachenbeschöniger	Tatsachenbeschöniger
er	er
Uranerz	Uranerz
Hände	Hände
hintertreibt	hintertreibt
Literaturen	Literaturen
Löwe	Löwe
Apfelbäume	Apfelbäume
unterrichtet	unterrichtet
Gibst	Gibst
massierend	massierend
Hertz	Hertz
Betainen	Betainen
heiß	heiß
verrostet	verrostet
gedenkt	gedenkt
Ambiguitäten	Ambiguitäten
streiften	streiften
zieren	zieren
besänftigtest	besänftigtest
Unternehmung	Unternehmung
konstatiertest	konstatiertest
tatet	tatet
lehren	lehren
Elastomer	Elastomer
fistete	fistete
verschränken	verschränken
Ach	Ach
griffe	griffe
traueret	traueret
Drohkulisse	Drohkulisse
putzte	putzte
erpresst	erpresst
Versorgungen	Versorgungen
erhöhest	erhöhest
ungeistlich	ungeistlich
Schlagzeugern	Schlagzeugern
Beobachtungen	Beobachtungen
Exilanten	Exilanten
desertiertet	desertiertet
Gemüseläden	Gemüseläden
WebHook	WebHook
schlafest	schlafest
ritzten	ritzten
bummelet	bummelet
erstaunst	erstaunst
ringst	ringst
urbanisier	urbanisier
sagte	sagte
unterbrächest	unterbrächest
entflöhen	entflöhen
Erdboden	Erdboden
lieget	lieget
erhörest	erhörest
Wüste	Wüste
Blockflöte	Blockflöte
zappten	zappten
Reizt	Reizt
substituieren	substituieren
bimmelten	bimmelten
sehnst	sehnst
Zeilen	Zeilen
ahne	ahne
kehre	kehre
dürftet	dürftet
verunglimpfte	verunglimpfte
hintertriebe	hintertriebe
Tintenfische	Tintenfische
ziehest	ziehest
Vaginen	Vaginen
grünten	grünten
höret	höret
blase	blase
Meinst	Meinst
Auguren	Auguren
mischt	mischt
vergleichet	vergleichet
rollten	rollten
ziert	ziert
Äquatoren	Äquatoren
boykottierten	boykottierten
Alteritäten	Alteritäten
Moren	Moren
Pianos	Pianos
wünschest	wünschest
Erzeugung	Erzeugung
Kontrollboxen	Kontrollboxen
verbündest	verbündest
verblute	verblute
fabuliere	fabuliere
Nigger	Nigger
Höschens	Höschens
Eingabe	Eingabe
stimmte	stimmte
weichest	weichest
pflanzte	pflanzte
verhören	verhören
Metaphern	Metaphern
Ihr	Ihr
warte	warte
Oxonium	Oxonium
pilgert	pilgert
Schaffe	Schaffe
Diagnostik	Diagnostik
wurstelten	wurstelten
äusserst	äusserst
obfuskieren	obfuskieren
frikassiert	frikassiert
Riesen	Riesen
Massagen	Massagen
kontaktieret	kontaktieret
partitionierten	partitionierten
wache	wache
Keine	Keine
Gruftis	Gruftis
Zerfällen	Zerfällen
Blütenachse	Blütenachse
Werkzeugen	Werkzeugen
Samstagnachmittag	Samstagnachmittag
Kindergeldern	Kindergeldern
einem	einem
Zehnten	Zehnten
aufwachte	aufwachte
Fußboden	Fußboden
More	More
betrübe	betrübe
kosten	kosten
gewünscht	gewünscht
Radfahrern	Radfahrern
ringet	ringet
abalienierest	abalienierest
einführt	einführt
Schlägst	Schlägst
Fettsäcken	Fettsäcken
Gepäckträger	Gepäckträger
vertonet	vertonet
Wachtel	Wachtel
kabelte	kabelte
wähnt	wähnt
all	all
erlöst	erlöst
konvergierest	konvergierest
schwächst	schwächst
NAND-Gatter	NAND-Gatter
Erzeugungen	Erzeugungen
parametrisierten	parametrisierten
murmelten	murmelten
entmineralisierten	entmineralisierten
brandet	brandet
Zirkelschlüssen	Zirkelschlüssen
ausgereckt	ausgereckt
jaget	jaget
schälte	schälte
Zwergschwanes	Zwergschwanes
erfahrest	erfahrest
plissieren	plissieren
möchte	möchte
ausfuhren	ausfuhren
Fischen	Fischen
wachen	wachen
tat	tat
Zähne	Zähne
Nukleinsäure	Nukleinsäure
spurtest	spurtest
Omnibusse	Omnibusse
Reliquiare	Reliquiare
Beteiligte	Beteiligte
schaffet	schaffet
schneidend	schneidend
Tübinger	Tübinger
Abhängen	Abhängen
alarmieren	alarmieren
grüble	grüble
Meerschweinchen	Meerschweinchen
konnten	konnten
Fotosynthese	Fotosynthese
argumentierest	argumentierest
erlagst	erlagst
hupen	hupen
missverstände	missverstände
borgte	borgte
pendele	pendele
fistet	fistet
forschte	forschte
auflöste	auflöste
Arsenbergwerken	Arsenbergwerken
Buntwaschmittel	Buntwaschmittel
Eisenkraut	Eisenkraut
fluppe	fluppe
surre	surre
Idolatrien	Idolatrien
Nullpunkt	Nullpunkt
Tieren	Tieren
Assistentinnen	Assistentinnen
Rubinen	Rubinen
sollten	sollten
Programmiererinnen	Programmiererinnen
gezählt	gezählt
Sitzfleisches	Sitzfleisches
Petersfisch	Petersfisch
aufrichten	aufrichten
Als	Als
fälle	fälle
aufhebest	aufhebest
erhöht	erhöht
liegst	liegst
Pforte	Pforte
Dattel	Dattel
angehören	angehören
Referenz	Referenz
deute	deute
ehrest	ehrest
außer	außer
verdammten	verdammten
initiierst	initiierst
Fellachinnen	Fellachinnen
Metallquirlen	Metallquirlen
vereinbarten	vereinbarten
googelten	googelten
beschotterten	beschotterten
füsilierte	füsilierte
geleitet	geleitet
versuchte	versuchte
Haben	Haben
grüntet	grüntet
brause	brause
unterwerft	unterwerft
verseift	verseift
zeichnet	zeichnet
Eine	Eine
Steuerberatern	Steuerberatern
lackiere	lackiere
Fromme	Fromme
verkündigst	verkündigst
koordinierte	koordinierte
Arsch	Arsch
hattest	hattest
Kopfverletzungen	Kopfverletzungen
bleibet	bleibet
Geschäfte	Geschäfte
harmoniere	harmoniere
Weinstöcke	Weinstöcke
watete	watete
Klärung	Klärung
Fahrzeugkatalysator	Fahrzeugkatalysator
Kavalier	Kavalier
Kronsbeeren	Kronsbeeren
säusele	säusele
fallt	fallt
gestattest	gestattest
Atemgasen	Atemgasen
mikrominiaturisierten	mikrominiaturisierten
parametrisierte	parametrisierte
zeiget	zeiget
Gesetzen	Gesetzen
begrabet	begrabet
Galeere	Galeere
Heuschrecke	Heuschrecke
betreten	betreten
schämst	schämst
standet	standet
Busen	Busen
Ehren	Ehren
Zwangsarbeiterin	Zwangsarbeiterin
Entsetzt	Entsetzt
zweiten	zweiten
Autokraten	Autokraten
Polarisation	Polarisation
ducktest	ducktest
ruhest	ruhest
Monaten	Monaten
legend	legend
strömte	strömte
Ärztin	Ärztin
Tier	Tier
beeindrucket	beeindrucket
Eiszapfens	Eiszapfens
verkürze	verkürze
Soll	Soll
versteckst	versteckst
amenagieren	amenagieren
versteigernd	versteigernd
tagten	tagten
Akkadierinnen	Akkadierinnen
Meinen	Meinen
Entrées	Entrées
Leichname	Leichname
gerne	gerne
blast	blast
Störe	Störe
fluppen	fluppen
verpuffe	verpuffe
Arme	Arme
Beten	Beten
Nervenzellen	Nervenzellen
erwürgest	erwürgest
schlängelt	schlängelt
Ächselchen	Ächselchen
Satzung	Satzung
Anfechtung	Anfechtung
widmest	widmest
verwechselst	verwechselst
verkürztest	verkürztest
freiwilligen	freiwilligen
desertierst	desertierst
Herbstwinden	Herbstwinden
begrübe	begrübe
handhaben	handhaben
pfände	pfände
verkaufe	verkaufe
fahrest	fahrest
kurze	kurze
Anlass	Anlass
Silberdrahts	Silberdrahts
wachsen	wachsen
Mammut	Mammut
beschert	beschert
protokollieren	protokollieren
wallte	wallte
Knaben	Knaben
Götze	Götze
Renegat	Renegat
Preisen	Preisen
Almanachen	Almanachen
Berber	Berber
gebet	gebet
Gedanke	Gedanke
Rhabarber	Rhabarber
Brechnuss	Brechnuss
gedachtest	gedachtest
Agoraphobien	Agoraphobien
spaltest	spaltest
wehre	wehre
wünschet	wünschet
hydrogentartrate	hydrogentartrate
beleuchte	beleuchte
gehorchten	gehorchten
zürnet	zürnet
Durchbruch	Durchbruch
sabbelten	sabbelten
Taschendiebe	Taschendiebe
Sollte	Sollte
fladerten	fladerten
knurrtet	knurrtet
Bildschirmfotos	Bildschirmfotos
Keile	Keile
batest	batest
brach	brach
zeugte	zeugte
Kaufhäusern	Kaufhäusern
Bote	Bote
Welche	Welche
meißelt	meißelt
holst	holst
tust	tust
Aromastoffe	Aromastoffe
Buntspechten	Buntspechten
halt	halt
Freibergit	Freibergit
zuppe	zuppe
verunreinigst	verunreinigst
Vordenker	Vordenker
idealisieret	idealisieret
stäupt	stäupt
Sprichwörtern	Sprichwörtern
schaffen	schaffen
webte	webte
enträtselten	enträtselten
fastetest	fastetest
Sichelzellenanämien	Sichelzellenanämien
Höhen	Höhen
merke	merke
ehe	ehe
Ackerschachtelhalme	Ackerschachtelhalme
verschlingt	verschlingt
bölket	bölket
besichtigt	besichtigt
schleim	schleim
Metallspiegeln	Metallspiegeln
verließet	verließet
zirpen	zirpen
häuftet	häuftet
leset	leset
legst	legst
Lehne	Lehne
verdrehet	verdrehet
Jungen	Jungen
Fanmeilen	Fanmeilen
Düfte	Düfte
Aktienkursen	Aktienkursen
aufstand	aufstand
betrübest	betrübest
Brieftaubenzüchters	Brieftaubenzüchters
Empfängnisverhütungen	Empfängnisverhütungen
erzwinget	erzwinget
Reststoff	Reststoff
sagtest	sagtest
Anzeichen	Anzeichen
lodertet	lodertet
simulierst	simulierst
thematisierten	thematisierten
Konfitüre	Konfitüre
Pudern	Pudern
trödele	trödele
reifen	reifen
sehnet	sehnet
Brandbeschleuniger	Brandbeschleuniger
Holzquirl	Holzquirl
Warte	Warte
Blumensträußen	Blumensträußen
Dachdeckerin	Dachdeckerin
Butike	Butike
toten	toten
verstecke	verstecke
arrivieren	arrivieren
begehr	begehr
Dochte	Dochte
berufen	berufen
Klaue	Klaue
wichsten	wichsten
respektiere	respektiere
vermag	vermag
zerrissen	zerrissen
späht	späht
Achseln	Achseln
Wembley-Toren	Wembley-Toren
verantwortetest	verantwortetest
Homodimeren	Homodimeren
Serverzugriffen	Serverzugriffen
ausführe	ausführe
Apfelbäumen	Apfelbäumen
besehet	besehet
bessere	bessere
zürne	zürne
Donor	Donor
rekonstruieren	rekonstruieren
Linien	Linien
sponsert	sponsert
weisest	weisest
dirigieret	dirigieret
Gebeten	Gebeten
Anfechtungen	Anfechtungen
erfreu	erfreu
Isobar	Isobar
beteuerest	beteuerest
Pater	Pater
Schwänzen	Schwänzen
Türmen	Türmen
verwechseltet	verwechseltet
entwaffneten	entwaffneten
liebtet	liebtet
Pflicht	Pflicht
erobern	erobern
Hypochlorit	Hypochlorit
Türklingel	Türklingel
Campingplätzen	Campingplätzen
leertet	leertet
grüßten	grüßten
betrübtet	betrübtet
verbaseln	verbaseln
enttäuschtest	enttäuschtest
Lüste	Lüste
verdammet	verdammet
Bluffs	Bluffs
malten	malten
Körpergeruches	Körpergeruches
schweigen	schweigen
linken	linken
Begünstigung	Begünstigung
erbest	erbest
Beschleuniger	Beschleuniger
maximiere	maximiere
Schaden	Schaden
warntet	warntet
Landwirt	Landwirt
fertig	fertig
Vipernatter	Vipernatter
verlähmt	verlähmt
Schwarzseherin	Schwarzseherin
tun	tun
versteckte	versteckte
beanspruchte	beanspruchte
Spießen	Spießen
Barbareien	Barbareien
Citrat	Citrat
Anhängsel	Anhängsel
schlabbere	schlabbere
Willen	Willen
Trümmersprachen	Trümmersprachen
wollten	wollten
ertragen	ertragen
stoße	stoße
verführt	verführt
beweisen	beweisen
taufen	taufen
Stierkämpfe	Stierkämpfe
knusperst	knusperst
gelobtest	gelobtest
Vorhäuten	Vorhäuten
Grab	Grab
Kost	Kost
wässerst	wässerst
begrubt	begrubt
Toypudel	Toypudel
Schwermetallionen	Schwermetallionen
Aspartamen	Aspartamen
lostest	lostest
Fußballweltmeisterschaftsqualifikationsspielen	Fußballweltmeisterschaftsqualifikationsspielen
erliegest	erliegest
wild	wild
interagiert	interagiert
Geschäften	Geschäften
Füllfeder	Füllfeder
Wurzelwachstum	Wurzelwachstum
nagelest	nagelest
Fahret	Fahret
vor	vor
Banknoten	Banknoten
kram	kram
blitzet	blitzet
Füchsin	Füchsin
bemühten	bemühten
aasend	aasend
gehöre	gehöre
Diese	Diese
Solches	Solches
Hadith	Hadith
stapele	stapele
halltet	halltet
steinigst	steinigst
Stilllegungen	Stilllegungen
Saiblingen	Saiblingen
drängten	drängten
Bärte	Bärte
Schamentzündung	Schamentzündung
Lenkstange	Lenkstange
Meine	Meine
Signal	Signal
schiesst	schiesst
Sauberfrauen	Sauberfrauen
Insulaner	Insulaner
einen	einen
harmonierte	harmonierte
kehrte	kehrte
gelegt	gelegt
analysierest	analysierest
straften	straften
hämmerst	hämmerst
fehlte	fehlte
punktetest	punktetest
Anspielungen	Anspielungen
Päderast	Päderast
Affenbrotbaum	Affenbrotbaum
Wirte	Wirte
warst	warst
Halsabschneider	Halsabschneider
Milz	Milz
Notärztin	Notärztin
Tübingern	Tübingern
besprengen	besprengen
Bund	Bund
Halbmond	Halbmond
Gemüt	Gemüt
Nanosatelliten	Nanosatelliten
Panzerschrecke	Panzerschrecke
Rutheniumkomplexen	Rutheniumkomplexen
aufnahmt	aufnahmt
Eutektikum	Eutektikum
Barschaften	Barschaften
Gehör	Gehör
Ecke	Ecke
gestatte	gestatte
verbaselt	verbaselt
Decks	Decks
müsse	müsse
löge	löge
Affenbrotbäumen	Affenbrotbäumen
Domänen	Domänen
Altäre	Altäre
kaufest	kaufest
bröckeln	bröckeln
gräbst	gräbst
drosselt	drosselt
rangieret	rangieret
Diamantringen	Diamantringen
wünschen	wünschen
Serverzugriffe	Serverzugriffe
Wollt	Wollt
dienet	dienet
klemmt	klemmt
entrümpelest	entrümpelest
Flamme	Flamme
Rotzinkerzen	Rotzinkerzen
kramten	kramten
Ärztinnen	Ärztinnen
referenzierte	referenzierte
verdeckte	verdeckte
knutschst	knutschst
plärrt	plärrt
sannen	sannen
ratschlagt	ratschlagt
Binde	Binde
laute	laute
Marjellchen	Marjellchen
bestimmst	bestimmst
verlautet	verlautet
Abartigkeiten	Abartigkeiten
verzehrst	verzehrst
hantierte	hantierte
verlöteten	verlöteten
Hinterwäldler	Hinterwäldler
zelte	zelte
Überziehen	Überziehen
fluche	fluche
filzten	filzten
Dewargefäß	Dewargefäß
infiziertet	infiziertet
kickend	kickend
flirtete	flirtete
Wehklage	Wehklage
murmeln	murmeln
geleiteten	geleiteten
Sehne	Sehne
schubset	schubset
redetest	redetest
zensiere	zensiere
Agoraphobie	Agoraphobie
zuhört	zuhört
sintertest	sintertest
Trickbetrüger	Trickbetrüger
Tretlager	Tretlager
Aller	Aller
beides	beides
applizirst	applizirst
Freizeitzentrum	Freizeitzentrum
gehorchet	gehorchet
läuten	läuten
entschädigte	entschädigte
hüte	hüte
Elektrophil	Elektrophil
Freizeitzentren	Freizeitzentren
zertifizierst	zertifizierst
verwahrst	verwahrst
machest	machest
Gefäße	Gefäße
dekompiliertest	dekompiliertest
unsrer	unsrer
bewähret	bewähret
Radfahrer	Radfahrer
Zinkionen	Zinkionen
beschuldigt	beschuldigt
schwebe	schwebe
Wiederauferstehungen	Wiederauferstehungen
Ansteckers	Ansteckers
weise	weise
Trotzkisten	Trotzkisten
verflog	verflog
denen	denen
Hirte	Hirte
Raben	Raben
Traubenlese	Traubenlese
grabble	grabble
bediene	bediene
unterrichten	unterrichten
streite	streite
zerrüttet	zerrüttet
schreiet	schreiet
Abkürzungsverzeichnis	Abkürzungsverzeichnis
weich	weich
Färsen	Färsen
Uranerzen	Uranerzen
gehst	gehst
Sizilianer	Sizilianer
lebet	lebet
suchen	suchen
Badezimmer	Badezimmer
Männlein	Männlein
grabe	grabe
sezierst	sezierst
lesen	lesen
Tust	Tust
entwickelten	entwickelten
substituierest	substituierest
anhangen	anhangen
teil	teil
verkröchet	verkröchet
hobt	hobt
Carbids	Carbids
schwangt	schwangt
tatteret	tatteret
umarmen	umarmen
entsetzet	entsetzet
plagest	plagest
ortete	ortete
nippst	nippst
Operationssaal	Operationssaal
wichste	wichste
verschärfst	verschärfst
ummantelten	ummantelten
schmeicheln	schmeicheln
stützen	stützen
verantwortet	verantwortet
steigest	steigest
Lehrbücher	Lehrbücher
googelest	googelest
Adelung	Adelung
zweite	zweite
solches	solches
Finanzministerium	Finanzministerium
Epoxiden	Epoxiden
Lazarett	Lazarett
Atommassen	Atommassen
klappen	klappen
brauchte	brauchte
bequemtet	bequemtet
Trinket	Trinket
Wahn	Wahn
prophezeiet	prophezeiet
Erzherzogshüte	Erzherzogshüte
stellst	stellst
Herrn	Herrn
Schreibern	Schreibern
warten	warten
schleimte	schleimte
diente	diente
kategorisierst	kategorisierst
arm	arm
Sitzfleisch	Sitzfleisch
verifizierten	verifizierten
Untern	Untern
verabschiedetet	verabschiedetet
Playlists	Playlists
ehrte	ehrte
Rechenbrett	Rechenbrett
Begünstigungen	Begünstigungen
Dobermännern	Dobermännern
Ratsherr	Ratsherr
offenbarest	offenbarest
wehe	wehe
Bette	Bette
formirte	formirte
Tumulten	Tumulten
sollt	sollt
Leuchtstoffen	Leuchtstoffen
Zeitungsenten	Zeitungsenten
Staatsführungen	Staatsführungen
Laiben	Laiben
injizierest	injizierest
Chlorwasserstoffmolekül	Chlorwasserstoffmolekül
reicht	reicht
vandaliere	vandaliere
attestierten	attestierten
explodierst	explodierst
begliche	begliche
unterbewerte	unterbewerte
eiterten	eiterten
Rosinenkuchenmodell	Rosinenkuchenmodell
Sprecher	Sprecher
puste	puste
bescheiße	bescheiße
moppen	moppen
Hahnenkämmen	Hahnenkämmen
schöpfe	schöpfe
Pailletten	Pailletten
Ältesten	Ältesten
verwerten	verwerten
feiere	feiere
Weichlote	Weichlote
Argentits	Argentits
lavierend	lavierend
Hüllenelektronen	Hüllenelektronen
Abgaskatalysatoren	Abgaskatalysatoren
billige	billige
Treibhausgasen	Treibhausgasen
folterte	folterte
behauptete	behauptete
gepuddelt	gepuddelt
Wandergewerbe	Wandergewerbe
köderet	köderet
Menschen	Menschen
beiden	beiden
Somite	Somite
vertäte	vertäte
Zubrötchen	Zubrötchen
billigte	billigte
Ärgernisse	Ärgernisse
weist	weist
zertifiziertest	zertifiziertest
mästet	mästet
klappest	klappest
fasset	fasset
Schwächungen	Schwächungen
Substanz	Substanz
Vorstoß	Vorstoß
ausrufen	ausrufen
säume	säume
Deck	Deck
füsilierten	füsilierten
dunkelt	dunkelt
Attentäter	Attentäter
halbierte	halbierte
Freitagnachmittagen	Freitagnachmittagen
Sage	Sage
stoßet	stoßet
reformierten	reformierten
Reiseleitern	Reiseleitern
kürze	kürze
bestraft	bestraft
Antimustern	Antimustern
Effekt	Effekt
hurst	hurst
Extremen	Extremen
Hie	Hie
Scheißkerl	Scheißkerl
losen	losen
Rechtsruck	Rechtsruck
vollendete	vollendete
Shortcuts	Shortcuts
Gehorsam	Gehorsam
Elf	Elf
verdammtet	verdammtet
Thioestere	Thioestere
türmt	türmt
exmatrikulierte	exmatrikulierte
verprügelte	verprügelte
begehrst	begehrst
Kraftfahrzeugen	Kraftfahrzeugen
verspielte	verspielte
Lotterien	Lotterien
Massenanteilen	Massenanteilen
vertiefe	vertiefe
Zain	Zain
geherrscht	geherrscht
neidest	neidest
schnappt	schnappt
zerstreuest	zerstreuest
Melanteriten	Melanteriten
Borhydride	Borhydride
Schild	Schild
selbst	selbst
Cola	Cola
blamierten	blamierten
frappierte	frappierte
verselbständigst	verselbständigst
faschieren	faschieren
holte	holte
Plüschtiere	Plüschtiere
trotzt	trotzt
fahrt	fahrt
bringet	bringet
seinen	seinen
Greyerzern	Greyerzern
halbierest	halbierest
verirrt	verirrt
erntete	erntete
knautsche	knautsche
Außenministerium	Außenministerium
aufwacht	aufwacht
polymerisierte	polymerisierte
Bombardierungen	Bombardierungen
bedient	bedient
Älteste	Älteste
wünschte	wünschte
reizte	reizte
harren	harren
Somiten	Somiten
Schwermetallion	Schwermetallion
bauet	bauet
foppte	foppte
Jüngern	Jüngern
prostituierte	prostituierte
veranstalten	veranstalten
bildest	bildest
verschaffte	verschaffte
Kein	Kein
Mutagenen	Mutagenen
verboten	verboten
Trockendock	Trockendock
Hast	Hast
panaschieret	panaschieret
Kommst	Kommst
schwöret	schwöret
Sabbate	Sabbate
velarisierend	velarisierend
älteste	älteste
verkürztet	verkürztet
schauest	schauest
Linie	Linie
verzehrt	verzehrt
Gehorchet	Gehorchet
grünen	grünen
vertagt	vertagt
lögen	lögen
meinte	meinte
leiste	leiste
rundest	rundest
liebtest	liebtest
Huflattich	Huflattich
demütigte	demütigte
schrecken	schrecken
Zankapfel	Zankapfel
Krusten	Krusten
weiche	weiche
trauerten	trauerten
betrübtest	betrübtest
solcher	solcher
Assimilationen	Assimilationen
Pflaume	Pflaume
verdammen	verdammen
Amputierten	Amputierten
malen	malen
Lammfellhandschuhen	Lammfellhandschuhen
lautete	lautete
christianisiere	christianisiere
inszeniere	inszeniere
Gitarrenspieler	Gitarrenspieler
versklavte	versklavte
Managementsystem	Managementsystem
sagst	sagst
Herabsetzungen	Herabsetzungen
taufe	taufe
Kreisen	Kreisen
Felsboden	Felsboden
Schreiber	Schreiber
rebelliere	rebelliere
überschattet	überschattet
glaubend	glaubend
Borhydrid	Borhydrid
Frieden	Frieden
Atommodelle	Atommodelle
ehren	ehren
laufet	laufet
schluchzte	schluchzte
pfänden	pfänden
bromiertet	bromiertet
inhalier	inhalier
langweiltest	langweiltest
Nukleinsäuren	Nukleinsäuren
Teppiche	Teppiche
Armband	Armband
empörte	empörte
härte	härte
Dolde	Dolde
speicherten	speicherten
Zainen	Zainen
ersten	ersten
besuche	besuche
zählten	zählten
aufrichtest	aufrichtest
Schotten	Schotten
verknüpfet	verknüpfet
Stiefmütterchen	Stiefmütterchen
Benzol	Benzol
stiegen	stiegen
Rückweg	Rückweg
Remisen	Remisen
glaubten	glaubten
trügen	trügen
Assistentin	Assistentin
Elstern	Elstern
knackt	knackt
bewässertet	bewässertet
Gehirnwelle	Gehirnwelle
setztest	setztest
speiset	speiset
Adeliepinguin	Adeliepinguin
bereits	bereits
Gurten	Gurten
Aas	Aas
bracht	bracht
Zwingburg	Zwingburg
geschämt	geschämt
übersehest	übersehest
heiligest	heiligest
Rotgüssen	Rotgüssen
chloroformieret	chloroformieret
demütig	demütig
strecken	strecken
Leitkegel	Leitkegel
reinstitutionalisierten	reinstitutionalisierten
verklärt	verklärt
Geschichtsbüchern	Geschichtsbüchern
erntest	erntest
Kristallen	Kristallen
braust	braust
bewährt	bewährt
rufe	rufe
Halbzeiten	Halbzeiten
Erzherzogshüten	Erzherzogshüten
offenbare	offenbare
Petersfischen	Petersfischen
weinest	weinest
Suffix	Suffix
Wüsten	Wüsten
Gäste	Gäste
Borkenkäfer	Borkenkäfer
Pfründe	Pfründe
Zeile	Zeile
ausfuhr	ausfuhr
plärrtest	plärrtest
Krankenscheinen	Krankenscheinen
bündelten	bündelten
wurdest	wurdest
erwürgten	erwürgten
speist	speist
Metallspiegel	Metallspiegel
Signalen	Signalen
Selbstversuche	Selbstversuche
Hälsen	Hälsen
anzeigest	anzeigest
begründest	begründest
Dinge	Dinge
Wechselstuben	Wechselstuben
mehrte	mehrte
Palisade	Palisade
Wir	Wir
Kernladungszahl	Kernladungszahl
Reichweiten	Reichweiten
bemüht	bemüht
geliebt	geliebt
Kontrollkästchen	Kontrollkästchen
reich	reich
Aderhaut	Aderhaut
annektierst	annektierst
betonierte	betonierte
Preisanstiegen	Preisanstiegen
blondiert	blondiert
versteckten	versteckten
Amokläuferinnen	Amokläuferinnen
vermagst	vermagst
heißet	heißet
protestierest	protestierest
analysiere	analysiere
schaffst	schaffst
Feind	Feind
tobet	tobet
wiederkamt	wiederkamt
steiget	steiget
versüßtet	versüßtet
Desserts	Desserts
planschest	planschest
Zementen	Zementen
orgelt	orgelt
gestikulierst	gestikulierst
Zeithorizonte	Zeithorizonte
Neumonden	Neumonden
blondieret	blondieret
zupftet	zupftet
Jagdbomber	Jagdbomber
begrabe	begrabe
langweilst	langweilst
gelobe	gelobe
zerfetzte	zerfetzte
kämmtet	kämmtet
verschlimmerte	verschlimmerte
backt	backt
Gefügen	Gefügen
Märchenbuches	Märchenbuches
Lunisolarkalender	Lunisolarkalender
grau	grau
Korrosionsschutzen	Korrosionsschutzen
Geber	Geber
Augenglases	Augenglases
kabbelnd	kabbelnd
schießt	schießt
Wirst	Wirst
Lehrbüchern	Lehrbüchern
Drachenblut	Drachenblut
verunziere	verunziere
Abfertigungsschalter	Abfertigungsschalter
umarbeitest	umarbeitest
Sprödmetall	Sprödmetall
Kopfsalat	Kopfsalat
brechet	brechet
Mäppchen	Mäppchen
Kapitalverkehr	Kapitalverkehr
Deckenfarbe	Deckenfarbe
ratschlagte	ratschlagte
Braunrallen	Braunrallen
dümpelte	dümpelte
spannt	spannt
verlobte	verlobte
Haltepunkt	Haltepunkt
Monarchie	Monarchie
Hälse	Hälse
Kernspaltungen	Kernspaltungen
ärgere	ärgere
schießen	schießen
Gebern	Gebern
Füllet	Füllet
anruft	anruft
bekehrst	bekehrst
Knüppels	Knüppels
Aussätzigen	Aussätzigen
Schlot	Schlot
Stellen	Stellen
kupiert	kupiert
Stufen	Stufen
aßest	aßest
hievst	hievst
spanne	spanne
Malaysier	Malaysier
Gelobt	Gelobt
hegst	hegst
quatschen	quatschen
regelten	regelten
Urologe	Urologe
Male	Male
Bleigehalt	Bleigehalt
Qualifikationen	Qualifikationen
Preisanstieg	Preisanstieg
Schönrednern	Schönrednern
angehört	angehört
amenagiere	amenagiere
Kerf	Kerf
zählend	zählend
unterstützten	unterstützten
Tiefschutz	Tiefschutz
weisen	weisen
negierest	negierest
Ende	Ende
gehört	gehört
genieret	genieret
ramme	ramme
Leisten	Leisten
Antitranspirante	Antitranspirante
Paradiesäpfeln	Paradiesäpfeln
Talisman	Talisman
segeln	segeln
stäupten	stäupten
nützt	nützt
Pausbacke	Pausbacke
suchte	suchte
anzeigte	anzeigte
Knabe	Knabe
sticke	sticke
erzeigt	erzeigt
hüten	hüten
verglichest	verglichest
Waldbränden	Waldbränden
Klassenzimmer	Klassenzimmer
demütiget	demütiget
harrten	harrten
Ausgangssperren	Ausgangssperren
grünt	grünt
Wadenbein	Wadenbein
Bauwerke	Bauwerke
grause	grause
schlaft	schlaft
Basilikum	Basilikum
verludet	verludet
Böse	Böse
ankern	ankern
Schwan	Schwan
gewinne	gewinne
Tukanen	Tukanen
Genkinits	Genkinits
Freibergits	Freibergits
zerfielen	zerfielen
Libellen	Libellen
platzt	platzt
Teufeln	Teufeln
Pflaumen	Pflaumen
Fischotter	Fischotter
Gläubige	Gläubige
Alkine	Alkine
Wasserbädern	Wasserbädern
Aluminaten	Aluminaten
verdammte	verdammte
Kuttern	Kuttern
frevles	frevles
Begrenzungen	Begrenzungen
schubse	schubse
mästest	mästest
notlande	notlande
Ihre	Ihre
Dilettanten	Dilettanten
Kerl	Kerl
Meines	Meines
Setzet	Setzet
bitten	bitten
begnügt	begnügt
erhebet	erhebet
Scherzes	Scherzes
Hobby	Hobby
Normdatum	Normdatum
Reinigungsschritten	Reinigungsschritten
Beschuldigungen	Beschuldigungen
Harpune	Harpune
Dochten	Dochten
trotzest	trotzest
erwischten	erwischten
Zur-Schau-Stellen	Zur-Schau-Stellen
Schote	Schote
besänftiget	besänftiget
rauben	rauben
Pentaborat	Pentaborat
lehrte	lehrte
sollte	sollte
emittierte	emittierte
Aktivisten	Aktivisten
Strafräume	Strafräume
unterdrückte	unterdrückte
kugelten	kugelten
löse	löse
Kehret	Kehret
demoralisiere	demoralisiere
bilden	bilden
flirre	flirre
folgt	folgt
brillieren	brillieren
Otaviten	Otaviten
geknautscht	geknautscht
könnte	könnte
hicksest	hicksest
Wimpertierchen	Wimpertierchen
pflügen	pflügen
dressieret	dressieret
henken	henken
führest	führest
betrüben	betrüben
Arsenit	Arsenit
rebellieren	rebellieren
Chlorid	Chlorid
Reisebüros	Reisebüros
deinem	deinem
betrete	betrete
schon	schon
hüpfest	hüpfest
Tun	Tun
wiederholten	wiederholten
rühmet	rühmet
Gefängnissen	Gefängnissen
Epoxide	Epoxide
Artischocken	Artischocken
Reinigungsschrittes	Reinigungsschrittes
Kontaktierungen	Kontaktierungen
bewiese	bewiese
Hin	Hin
Gegenleistung	Gegenleistung
Sprüche	Sprüche
beklage	beklage
lüftet	lüftet
erhört	erhört
unterbrächen	unterbrächen
klumpe	klumpe
dissentierte	dissentierte
begehrte	begehrte
Metallquirle	Metallquirle
addierest	addierest
peiltest	peiltest
Kontraindikationen	Kontraindikationen
denaturierte	denaturierte
Atomphysikern	Atomphysikern
ausgereckte	ausgereckte
Ebene	Ebene
segelte	segelte
Effekten	Effekten
sprühend	sprühend
nahest	nahest
Glatteis	Glatteis
scheitertet	scheitertet
konsolidierest	konsolidierest
Heuhaufen	Heuhaufen
Öfchen	Öfchen
umkäme	umkäme
angehöret	angehöret
Volltreffer	Volltreffer
setztet	setztet
Wer	Wer
Dominicanerin	Dominicanerin
reagierte	reagierte
schmetterst	schmetterst
bezichtigt	bezichtigt
pressiere	pressiere
globalisieret	globalisieret
Teekesseln	Teekesseln
Tischen	Tischen
decken	decken
Dunkelkammern	Dunkelkammern
leiden	leiden
betätigest	betätigest
heparinisierten	heparinisierten
Steuerborden	Steuerborden
Totgeburten	Totgeburten
behauptest	behauptest
Gammastrahl	Gammastrahl
substituierend	substituierend
Leset	Leset
schöben	schöben
konjugiere	konjugiere
separieren	separieren
babbelten	babbelten
Rechenbrettern	Rechenbrettern
täuschte	täuschte
warne	warne
Rotzinkerz	Rotzinkerz
Mauten	Mauten
Tukans	Tukans
scheuchen	scheuchen
untersagest	untersagest
sorgte	sorgte
Verwundete	Verwundete
Gehorsams	Gehorsams
Buchhalterinnen	Buchhalterinnen
glaubt	glaubt
entrümpelst	entrümpelst
ruckelst	ruckelst
Erstlingen	Erstlingen
verhalten	verhalten
Cyclodextrinen	Cyclodextrinen
jappten	jappten
spielet	spielet
Treibhausgase	Treibhausgase
zeuge	zeuge
Seil	Seil
bezahlst	bezahlst
absolviere	absolviere
Kleptokratie	Kleptokratie
benachrichtige	benachrichtige
rühmst	rühmst
Strahlentierchen	Strahlentierchen
Anwendungsgebiete	Anwendungsgebiete
Heptamolybdat	Heptamolybdat
Beiblättern	Beiblättern
verkürzest	verkürzest
keines	keines
restaurieret	restaurieret
fragmentierst	fragmentierst
überdächte	überdächte
Koniferen	Koniferen
Hornunges	Hornunges
Lehrkörpers	Lehrkörpers
kräuselten	kräuselten
bat	bat
Bärenfelle	Bärenfelle
entfachet	entfachet
Putschisten	Putschisten
Anhänge	Anhänge
Ha	Ha
sichere	sichere
Geckos	Geckos
Asteroide	Asteroide
Fülle	Fülle
Piratensendern	Piratensendern
zupfte	zupfte
Fanmeile	Fanmeile
Aprikose	Aprikose
glänzen	glänzen
Sigle	Sigle
funktionierte	funktionierte
setzest	setzest
Teufel	Teufel
grausten	grausten
Besprechungen	Besprechungen
Prozedur	Prozedur
entschädiget	entschädiget
helfet	helfet
querest	querest
Kupferkiesen	Kupferkiesen
hänget	hänget
verpufftest	verpufftest
meines	meines
Bienenzüchter	Bienenzüchter
Fallturm	Fallturm
schwadroniert	schwadroniert
Denn	Denn
Wasserbades	Wasserbades
lüftetet	lüftetet
hintertreiben	hintertreiben
erklingt	erklingt
Ölspur	Ölspur
Schuldner	Schuldner
Lob	Lob
zuppst	zuppst
Tollkirschen	Tollkirschen
Linguist	Linguist
verjährest	verjährest
Efeu	Efeu
punkten	punkten
Leichtmetalle	Leichtmetalle
weine	weine
verschreibt	verschreibt
junge	junge
Kutter	Kutter
warnt	warnt
heparinisiere	heparinisiere
beschrifteten	beschrifteten
Tatsachenbeschönigern	Tatsachenbeschönigern
Fledermaus	Fledermaus
Bromidquelle	Bromidquelle
denaturierten	denaturierten
Küchenmaschine	Küchenmaschine
Unternehmensanwendungsintegrationen	Unternehmensanwendungsintegrationen
Falltürme	Falltürme
schwenkt	schwenkt
unschuldige	unschuldige
Premierministerinnen	Premierministerinnen
Kanzleien	Kanzleien
kräusle	kräusle
meine	meine
verunreinigt	verunreinigt
Arbeitsunfähigkeit	Arbeitsunfähigkeit
fallest	fallest
pflanze	pflanze
zählet	zählet
suchet	suchet
Silbererze	Silbererze
Aerosole	Aerosole
kriegen	kriegen
widerstand	widerstand
flambierten	flambierten
Herabsetzung	Herabsetzung
Briefen	Briefen
gebührt	gebührt
Fallet	Fallet
posierten	posierten
Fusseln	Fusseln
verspäte	verspäte
transportierte	transportierte
Körpergeruch	Körpergeruch
scheuchtest	scheuchtest
Filzläusen	Filzläusen
eskalieret	eskalieret
hydrogentartrat	hydrogentartrat
Fluoratom	Fluoratom
sprecht	sprecht
legt	legt
entmineralisieren	entmineralisieren
Ringe	Ringe
Darlegungen	Darlegungen
flehte	flehte
mögest	mögest
beweiset	beweiset
Kalifeldspat	Kalifeldspat
hantiert	hantiert
begruben	begruben
schwöre	schwöre
Vorhäute	Vorhäute
führen	führen
überstehend	überstehend
bewiesen	bewiesen
rüstetest	rüstetest
zuteilte	zuteilte
widerstanden	widerstanden
schlängelest	schlängelest
Rückumlaute	Rückumlaute
mikrominiaturisiere	mikrominiaturisiere
Atomphysiker	Atomphysiker
gewarnt	gewarnt
Karikaturistinnen	Karikaturistinnen
freiwillige	freiwillige
Seinen	Seinen
emigrieret	emigrieret
Berge	Berge
Hektare	Hektare
erwachte	erwachte
schütze	schütze
Ambiguität	Ambiguität
Speeren	Speeren
bis	bis
weichen	weichen
Handbuch	Handbuch
Hummer	Hummer
hieltest	hieltest
notlandet	notlandet
Lehnen	Lehnen
Regierung	Regierung
Organisation	Organisation
krieget	krieget
feierst	feierst
brauchst	brauchst
Krumen	Krumen
anderen	anderen
Kommoden	Kommoden
brauche	brauche
Kaufkraft	Kaufkraft
Sorget	Sorget
machet	machet
Wanderfalken	Wanderfalken
Antimusters	Antimusters
Wehe	Wehe
Erdbirnen	Erdbirnen
verschmelze	verschmelze
Laufring	Laufring
Frettchen	Frettchen
Ionen	Ionen
irre	irre
Jagdhund	Jagdhund
bewässerest	bewässerest
Brüder	Brüder
verladet	verladet
injiziert	injiziert
fokussierten	fokussierten
Blässe	Blässe
gönnest	gönnest
anrichten	anrichten
Fahrzeugkatalysatoren	Fahrzeugkatalysatoren
merkte	merkte
lachet	lachet
Beile	Beile
Zirkelschluss	Zirkelschluss
besäest	besäest
entert	entert
teile	teile
dechiffrierend	dechiffrierend
Pflanzungen	Pflanzungen
hängte	hängte
vergaste	vergaste
inspirierten	inspirierten
Otavit	Otavit
Asteroid	Asteroid
umhüllst	umhüllst
Trübsal	Trübsal
maß	maß
Bombardierung	Bombardierung
Füllfederhalters	Füllfederhalters
besitzet	besitzet
Feldzug	Feldzug
Kortholt	Kortholt
verselbständigt	verselbständigt
bereiten	bereiten
verwechselet	verwechselet
oxidierte	oxidierte
brennen	brennen
misstrauen	misstrauen
hure	hure
Brettspiele	Brettspiele
verglühest	verglühest
Laufringen	Laufringen
schlage	schlage
macht	macht
Gram	Gram
folg	folg
Gebäcken	Gebäcken
lausche	lausche
würdet	würdet
streue	streue
Darlegung	Darlegung
aller	aller
Rutheniumkomplex	Rutheniumkomplex
drückte	drückte
seinem	seinem
beherrschest	beherrschest
Asylrechte	Asylrechte
Gurt	Gurt
verlobt	verlobt
bekannte	bekannte
Wogen	Wogen
beläufst	beläufst
Begrenzung	Begrenzung
Ösophagospasmus	Ösophagospasmus
Kaufleuten	Kaufleuten
verrosteten	verrosteten
Schätzen	Schätzen
zerstreute	zerstreute
Gallan	Gallan
Version	Version
Kunstgeschichte	Kunstgeschichte
Rekursionen	Rekursionen
wisperest	wisperest
verkündiget	verkündiget
vernichtest	vernichtest
Nahrungsbestandteilen	Nahrungsbestandteilen
verziehen	verziehen
fabuliert	fabuliert
schummelten	schummelten
ummantle	ummantle
Gehirnwellen	Gehirnwellen
entkäme	entkäme
versucht	versucht
verformen	verformen
bequemen	bequemen
amputierten	amputierten
durften	durften
gähne	gähne
panaschieren	panaschieren
Lümmeltüten	Lümmeltüten
Kochfeldern	Kochfeldern
ausgeht	ausgeht
zankte	zankte
kappten	kappten
dümpelt	dümpelt
hupet	hupet
bete	bete
Sinne	Sinne
hickste	hickste
Geliebten	Geliebten
Sünders	Sünders
ermordet	ermordet
schautet	schautet
erinnre	erinnre
feiertest	feiertest
Rhodochrositen	Rhodochrositen
labert	labert
predigtest	predigtest
bestimmten	bestimmten
Welteninseln	Welteninseln
zeugtest	zeugtest
dringt	dringt
Herkunft	Herkunft
verbündete	verbündete
predigen	predigen
Letzte	Letzte
tätowierest	tätowierest
gereichte	gereichte
Lobgesängen	Lobgesängen
Achatschnecken	Achatschnecken
hebst	hebst
bezichtigten	bezichtigten
Fallt	Fallt
greifen	greifen
grübelten	grübelten
Dödel	Dödel
Panamaer	Panamaer
kritzelst	kritzelst
Plumpsen	Plumpsen
Verkehrsflugzeuge	Verkehrsflugzeuge
hintertrieben	hintertrieben
babbelst	babbelst
bewahrt	bewahrt
weichet	weichet
Unterschlagung	Unterschlagung
Ärschen	Ärschen
bombardiere	bombardiere
verkleinern	verkleinern
Buchstaben	Buchstaben
gabelst	gabelst
Abbindebeschleunigern	Abbindebeschleunigern
Nussknackern	Nussknackern
verkündigest	verkündigest
Wiedergutmachung	Wiedergutmachung
Ärzteblättern	Ärzteblättern
Teekessel	Teekessel
Inkarnationen	Inkarnationen
mampfen	mampfen
fasse	fasse
fegst	fegst
blitztet	blitztet
wisperten	wisperten
gewöhnt	gewöhnt
fritierst	fritierst
Wege	Wege
separieret	separieret
gehetzt	gehetzt
Reiseleiter	Reiseleiter
verließen	verließen
Ingredienzen	Ingredienzen
Überziehens	Überziehens
Päckchen	Päckchen
besäet	besäet
Chasaren	Chasaren
pflügten	pflügten
anzeigt	anzeigt
Werken	Werken
Grabe	Grabe
wohnst	wohnst
gedachte	gedachte
Krume	Krume
verkapselt	verkapselt
wünsche	wünsche
rüste	rüste
glaubtet	glaubtet
Bleche	Bleche
Laubbläser	Laubbläser
Großstädter	Großstädter
Animation	Animation
verständig	verständig
faltest	faltest
Donnerstagabenden	Donnerstagabenden
Verbindungsdraht	Verbindungsdraht
säte	säte
ehret	ehret
belauerten	belauerten
entwickele	entwickele
Tische	Tische
blamierest	blamierest
Schnittlauche	Schnittlauche
Temperaturanstiege	Temperaturanstiege
Pinguinen	Pinguinen
schneidet	schneidet
parkierten	parkierten
Musters	Musters
Kürasse	Kürasse
Atommasse	Atommasse
anrührt	anrührt
dividiert	dividiert
wart	wart
Kacke	Kacke
entfolgte	entfolgte
misstrauest	misstrauest
speisen	speisen
Tiefschutzen	Tiefschutzen
Epiker	Epiker
überfallen	überfallen
sagest	sagest
moppte	moppte
weissagten	weissagten
Lötzinn	Lötzinn
Roben	Roben
Schicksen	Schicksen
übrigbleibet	übrigbleibet
streckst	streckst
Gesamtmenge	Gesamtmenge
Gymnasien	Gymnasien
Schanktischen	Schanktischen
chloroformiere	chloroformiere
Fett	Fett
dresche	dresche
verzieret	verzieret
schleißt	schleißt
meißeltest	meißeltest
habet	habet
Hörspiel	Hörspiel
Kriege	Kriege
versuchten	versuchten
klönen	klönen
härtet	härtet
Rekursion	Rekursion
präsentier	präsentier
Hadithe	Hadithe
piesacken	piesacken
Bettlers	Bettlers
lieben	lieben
einigte	einigte
Anzeichens	Anzeichens
Karern	Karern
Ochs	Ochs
bräunst	bräunst
strandend	strandend
reifte	reifte
versteigerest	versteigerest
segmentiere	segmentiere
Leuchtkäfer	Leuchtkäfer
Baiser	Baiser
erforschet	erforschet
pflücke	pflücke
Atombomben	Atombomben
reiche	reiche
fladerest	fladerest
Substanzen	Substanzen
Frommen	Frommen
Oberlandesgericht	Oberlandesgericht
Abhänge	Abhänge
gehorchst	gehorchst
Coventrisierungen	Coventrisierungen
könne	könne
haarte	haarte
Paillette	Paillette
gewärtigten	gewärtigten
thematisierte	thematisierte
gleitest	gleitest
Rundbriefe	Rundbriefe
Unrechten	Unrechten
Iberers	Iberers
hingehet	hingehet
vertrage	vertrage
begleicht	begleicht
bewahrheitete	bewahrheitete
baggerst	baggerst
arme	arme
Denen	Denen
Acetaten	Acetaten
instrumentalisierest	instrumentalisierest
Wehre	Wehre
Kriegsknechten	Kriegsknechten
speisest	speisest
observierst	observierst
koordinieret	koordinieret
Azubi	Azubi
generalisiere	generalisiere
imkeret	imkeret
beißt	beißt
bebten	bebten
Blutgefäß	Blutgefäß
verfanget	verfanget
begräbt	begräbt
Lebenskräften	Lebenskräften
Arsenite	Arsenite
Lobe	Lobe
fliehe	fliehe
wallfahrten	wallfahrten
Seelöwe	Seelöwe
knacktest	knacktest
tränkten	tränkten
beförderet	beförderet
duschte	duschte
boß	boß
erinnerest	erinnerest
bitte	bitte
versuche	versuche
glaubst	glaubst
bollerte	bollerte
Tausche	Tausche
Selbstversuchen	Selbstversuchen
Linken	Linken
illustriere	illustriere
fällen	fällen
polymerisier	polymerisier
sehn	sehn
überweisend	überweisend
umarmet	umarmet
gelobet	gelobet
Leichnamen	Leichnamen
Solchen	Solchen
amputiere	amputiere
beschwindele	beschwindele
knufften	knufften
interpretiert	interpretiert
Langschwanzpinguin	Langschwanzpinguin
verschafft	verschafft
verringert	verringert
Schlepper	Schlepper
prahlte	prahlte
verringertet	verringertet
entgegenkamst	entgegenkamst
Garben	Garben
ernte	ernte
vier	vier
wallfahrest	wallfahrest
verfehle	verfehle
verbündend	verbündend
träumen	träumen
Schobern	Schobern
funkeln	funkeln
fritiert	fritiert
Senkungen	Senkungen
regiert	regiert
vertilgt	vertilgt
Buche	Buche
Gehilfen	Gehilfen
Retter	Retter
Weste	Weste
ankerst	ankerst
ihren	ihren
schnitten	schnitten
Zeitschlitzen	Zeitschlitzen
infizieret	infizieret
instanziier	instanziier
unseres	unseres
Einrädern	Einrädern
keinen	keinen
Notärztinnen	Notärztinnen
Ställen	Ställen
Luftschiff	Luftschiff
umgäben	umgäben
Beschuldigung	Beschuldigung
Frage	Frage
Einen	Einen
ringen	ringen
Golfplätzen	Golfplätzen
Hummern	Hummern
Steige	Steige
Taschendieb	Taschendieb
hebräische	hebräische
Metallothioneinen	Metallothioneinen
amen	amen
säet	säet
streute	streute
Almanache	Almanache
Extrems	Extrems
duschten	duschten
verwiesen	verwiesen
Anmelder	Anmelder
balkanisierten	balkanisierten
bewiest	bewiest
Brüdern	Brüdern
gedenket	gedenket
bollerest	bollerest
Bällchen	Bällchen
Welpen	Welpen
verklagt	verklagt
Buntspechte	Buntspechte
taufte	taufte
Abschreckungen	Abschreckungen
Nanotesla	Nanotesla
Stierkämpfen	Stierkämpfen
wegführen	wegführen
Lärche	Lärche
Dein	Dein
bandagiert	bandagiert
verbirgt	verbirgt
entdecket	entdecket
denaturiert	denaturiert
Skorpionen	Skorpionen
durchzuck	durchzuck
Bebauungsplänen	Bebauungsplänen
verwaisten	verwaisten
besprichst	besprichst
Muhme	Muhme
hattet	hattet
begehre	begehre
Hälmchen	Hälmchen
Geringschätzung	Geringschätzung
Telefonnummer	Telefonnummer
fügt	fügt
Deuterium	Deuterium
bräunen	bräunen
Rutheniumisotop	Rutheniumisotop
Hacker	Hacker
auflegt	auflegt
Tritte	Tritte
verzeichnete	verzeichnete
Testamente	Testamente
Hypochlorite	Hypochlorite
Landesverräterinnen	Landesverräterinnen
Flosse	Flosse
Sonnenfinsternis	Sonnenfinsternis
Abflug	Abflug
Flenser	Flenser
verweise	verweise
verdeckst	verdeckst
Mäuse	Mäuse
hassest	hassest
streckte	streckte
beanspruchest	beanspruchest
Empörungen	Empörungen
massierst	massierst
feierten	feierten
Flöte	Flöte
bemächtigte	bemächtigte
Geschreis	Geschreis
Stadtbezirke	Stadtbezirke
Überschüsse	Überschüsse
musizierte	musizierte
zentrierest	zentrierest
zerbrechen	zerbrechen
Fokusse	Fokusse
Gefängnisse	Gefängnisse
hebe	hebe
Grüße	Grüße
Schenke	Schenke
Junge	Junge
erscheinest	erscheinest
revoltierte	revoltierte
trübe	trübe
Käsereiben	Käsereiben
Fieberanfall	Fieberanfall
zersetzet	zersetzet
Konzentrat	Konzentrat
Bundesgebieten	Bundesgebieten
Basilisken	Basilisken
Sorgen	Sorgen
führte	führte
Schilde	Schilde
Renegaten	Renegaten
Eiland	Eiland
gedenken	gedenken
transportierst	transportierst
gebietet	gebietet
schwebte	schwebte
habt	habt
lohnt	lohnt
henket	henket
griffen	griffen
knusperten	knusperten
rännen	rännen
Flussbett	Flussbett
Argyroditen	Argyroditen
häufte	häufte
deinen	deinen
Mageninhalt	Mageninhalt
Kautschuken	Kautschuken
Pfählen	Pfählen
wehren	wehren
Achsel	Achsel
Schnittlauch	Schnittlauch
Grüßet	Grüßet
lieb	lieb
narren	narren
gesagt	gesagt
verblieben	verblieben
Einstufung	Einstufung
Mittelaltermarkt	Mittelaltermarkt
Helden	Helden
Firnisse	Firnisse
Streife	Streife
ratschlagen	ratschlagen
verwirrest	verwirrest
Fellhandschuh	Fellhandschuh
halten	halten
Ankern	Ankern
verifizieret	verifizieret
Pflichten	Pflichten
WebHooks	WebHooks
schließe	schließe
Öfchens	Öfchens
Safrane	Safrane
seines	seines
enge	enge
dürfen	dürfen
reichst	reichst
Suffixen	Suffixen
Prostyloi	Prostyloi
interpretierten	interpretierten
gewärtigt	gewärtigt
Samarskit	Samarskit
kabelst	kabelst
deckte	deckte
Temperaturanstieg	Temperaturanstieg
Orgeln	Orgeln
erben	erben
Kerzenfischen	Kerzenfischen
beweise	beweise
Hirten	Hirten
heilet	heilet
formiret	formiret
stiftest	stiftest
bürsten	bürsten
prosteten	prosteten
schätzen	schätzen
Tetraiodide	Tetraiodide
achten	achten
spezialisierst	spezialisierst
ruhte	ruhte
durchzuckest	durchzuckest
überdenkend	überdenkend
appellierte	appellierte
tobend	tobend
verstecken	verstecken
besichert	besichert
aktualisiere	aktualisiere
Nachteilen	Nachteilen
attestiertet	attestiertet
sicherst	sicherst
speise	speise
kostet	kostet
Schlager	Schlager
wohnest	wohnest
reformieren	reformieren
steigen	steigen
lavierte	lavierte
am	am
Krokus	Krokus
fülle	fülle
verstörten	verstörten
zürntest	zürntest
erfüllst	erfüllst
Indianer	Indianer
bekehrte	bekehrte
Rhabarbern	Rhabarbern
Entmachtung	Entmachtung
Bestechungsgelder	Bestechungsgelder
Homodimere	Homodimere
ungefälschter	ungefälschter
Abschirmung	Abschirmung
Urbaren	Urbaren
Molybdite	Molybdite
vertonten	vertonten
Exzentriker	Exzentriker
privatisierest	privatisierest
besät	besät
assimilieret	assimilieret
Polizeisprecher	Polizeisprecher
Haarverlust	Haarverlust
glänzt	glänzt
sedimentierte	sedimentierte
reizt	reizt
Deine	Deine
kapiertet	kapiertet
begebet	begebet
tut	tut
destabilisierst	destabilisierst
verbrauchten	verbrauchten
arbeit	arbeit
Steuerberater	Steuerberater
neigte	neigte
keiner	keiner
erstände	erstände
Wären	Wären
flieh	flieh
lostet	lostet
zeugen	zeugen
zerfielest	zerfielest
überprüftest	überprüftest
heil	heil
gestikuliere	gestikuliere
Gangster	Gangster
eines	eines
haderte	haderte
reagiert	reagiert
Höret	Höret
Satzungen	Satzungen
neige	neige
lochten	lochten
liste	liste
begrabt	begrabt
Wechselstube	Wechselstube
Quellflüssen	Quellflüssen
strafend	strafend
Möbelstoff	Möbelstoff
amenagierst	amenagierst
Planer	Planer
Rast	Rast
Büstenhalters	Büstenhalters
Einsätzen	Einsätzen
Rücktrittbremse	Rücktrittbremse
treibst	treibst
Maß	Maß
Entree	Entree
Hirsche	Hirsche
Notizen	Notizen
Nussknacker	Nussknacker
trompetete	trompetete
Schönredner	Schönredner
erfahrt	erfahrt
Dienstgrad	Dienstgrad
eggt	eggt
Zeitplan	Zeitplan
Rabe	Rabe
Mittelaltermarktes	Mittelaltermarktes
Oberbegriff	Oberbegriff
Komponistinnen	Komponistinnen
Augengläsern	Augengläsern
mein	mein
Kakadu	Kakadu
befehle	befehle
Oberlippe	Oberlippe
Isolatoren	Isolatoren
Äthern	Äthern
Kissenschlacht	Kissenschlacht
schließen	schließen
zerbrechest	zerbrechest
Protonen	Protonen
Auszügen	Auszügen
überweise	überweise
Flammen	Flammen
Rotscheitelreiher	Rotscheitelreiher
verzögerten	verzögerten
Rückumschlägen	Rückumschlägen
ziehet	ziehet
nahe	nahe
Eutern	Eutern
Blitzableiter	Blitzableiter
entwischten	entwischten
Lautwandel	Lautwandel
Atombombe	Atombombe
erwärmten	erwärmten
verkündet	verkündet
Provinz	Provinz
Geheimdienst	Geheimdienst
Crescendo	Crescendo
produziert	produziert
dampfst	dampfst
Iberer	Iberer
schichtet	schichtet
fragen	fragen
bekennet	bekennet
Entmachtungen	Entmachtungen
Bienenstöcke	Bienenstöcke
verlasse	verlasse
Machet	Machet
Charakteristika	Charakteristika
möppertet	möppertet
Ente	Ente
schmettern	schmettern
zanket	zanket
gedenk	gedenk
Stör	Stör
Zapfhahn	Zapfhahn
allem	allem
kabeln	kabeln
wer	wer
Zeugen	Zeugen
jemanden	jemanden
installierten	installierten
Döner	Döner
Kirgisin	Kirgisin
Ektoplasmen	Ektoplasmen
Meter	Meter
köderte	köderte
Buch	Buch
segmentierten	segmentierten
Orte	Orte
schicke	schicke
jemand	jemand
hieltet	hieltet
Messies	Messies
Grizzlybären	Grizzlybären
ersparten	ersparten
Autoklav	Autoklav
protestiere	protestiere
betreibet	betreibet
gekröst	gekröst
gleite	gleite
Keilen	Keilen
Banketten	Banketten
Silbersulfidbelag	Silbersulfidbelag
begraben	begraben
Marokkanern	Marokkanern
Zapfen	Zapfen
enträtselst	enträtselst
Mitschuld	Mitschuld
Unserer	Unserer
beseht	beseht
Sagen	Sagen
Steigen	Steigen
betätigtet	betätigtet
knistern	knistern
vertreibe	vertreibe
schöpfen	schöpfen
verdinglichtest	verdinglichtest
Schreiet	Schreiet
rodet	rodet
legten	legten
Nanosatellit	Nanosatellit
strafest	strafest
Gummibäumen	Gummibäumen
rächest	rächest
Badezimmers	Badezimmers
weinst	weinst
Staatsanleihe	Staatsanleihe
Gewalttäter	Gewalttäter
zürnte	zürnte
kaufet	kaufet
vertraute	vertraute
Primärenergien	Primärenergien
Bildpunkt	Bildpunkt
Gedicht	Gedicht
dirigieren	dirigieren
Bestecken	Bestecken
verselbstständige	verselbstständige
scheinest	scheinest
heischten	heischten
verspätest	verspätest
Katz-und-Maus-Spielen	Katz-und-Maus-Spielen
blockierten	blockierten
Pardelkatze	Pardelkatze
grabbelten	grabbelten
Schenken	Schenken
Klotzes	Klotzes
Biokraftstoffes	Biokraftstoffes
Höhe	Höhe
Feuerteufels	Feuerteufels
Reinstoffen	Reinstoffen
Unterwerfungen	Unterwerfungen
Metapher	Metapher
fetten	fetten
forschet	forschet
verzierten	verzierten
Blättchen	Blättchen
Dorsch	Dorsch
Patres	Patres
verbraucht	verbraucht
Markise	Markise
Konzentrate	Konzentrate
überreichen	überreichen
verkriechet	verkriechet
nachwandelt	nachwandelt
dividiere	dividiere
klingest	klingest
Stoffwechselweg	Stoffwechselweg
wässerten	wässerten
lachen	lachen
begehrend	begehrend
würde	würde
erlaubest	erlaubest
bimmelte	bimmelte
Alten	Alten
verfehlten	verfehlten
dotierst	dotierst
Kalifeldspate	Kalifeldspate
Grönländer	Grönländer
zeichnest	zeichnest
konvertieren	konvertieren
Abschußringe	Abschußringe
verseifet	verseifet
Drohkulissen	Drohkulissen
verhungert	verhungert
vertreibt	vertreibt
posiertet	posiertet
keinem	keinem
erlösen	erlösen
säuselest	säuselest
schimmerst	schimmerst
driftete	driftete
Ecken	Ecken
Krieg	Krieg
zweifeln	zweifeln
jagst	jagst
Betten	Betten
verglühte	verglühte
keine	keine
Nadelbäume	Nadelbäume
werfet	werfet
stützet	stützet
austilgen	austilgen
regierst	regierst
erstarre	erstarre
Arbeitsleistung	Arbeitsleistung
zerrütteten	zerrütteten
Möbelstoffen	Möbelstoffen
Halbzeit	Halbzeit
überwachest	überwachest
naschten	naschten
Schuhen	Schuhen
bebet	bebet
erfüllet	erfüllet
Unsere	Unsere
dümpelest	dümpelest
Arbeitsgruppen	Arbeitsgruppen
holet	holet
kugele	kugele
Grizzlybär	Grizzlybär
triebe	triebe
Notständen	Notständen
egge	egge
Aerosolen	Aerosolen
drangen	drangen
blondierten	blondierten
Habt	Habt
Mischelementen	Mischelementen
Flamingo	Flamingo
zuhörte	zuhörte
Suchet	Suchet
leistest	leistest
Fischer	Fischer
Zensus	Zensus
streifte	streifte
gezügelt	gezügelt
Bettler	Bettler
observiertest	observiertest
Nanokondensatoren	Nanokondensatoren
Adenosin	Adenosin
Elementen	Elementen
respektierten	respektierten
Weinstöcken	Weinstöcken
Perlen	Perlen
rechten	rechten
fabulierest	fabulierest
Telefonnummern	Telefonnummern
jauchzt	jauchzt
Acetat	Acetat
faschierst	faschierst
neiden	neiden
kitzeln	kitzeln
hättet	hättet
Wühltischen	Wühltischen
verknüpft	verknüpft
Martyrologium	Martyrologium
Zwetschgen	Zwetschgen
verletzte	verletzte
schwelle	schwelle
Untier	Untier
haben	haben
Reinelemente	Reinelemente
Großstädtern	Großstädtern
mischst	mischst
Den	Den
eingehest	eingehest
Greyerzer	Greyerzer
gewurstelt	gewurstelt
schreckt	schreckt
kategorisierte	kategorisierte
leide	leide
Wehr	Wehr
webet	webet
Gläubigern	Gläubigern
Autonomien	Autonomien
besorgt	besorgt
verhungerte	verhungerte
drosselten	drosselten
überbewerte	überbewerte
müssest	müssest
kremieren	kremieren
schämten	schämten
fällt	fällt
Kommet	Kommet
defragmentierest	defragmentierest
Urbare	Urbare
Fellhandschuhen	Fellhandschuhen
habe	habe
rammte	rammte
stammeln	stammeln
motivierte	motivierte
Narkotikum	Narkotikum
Ehre	Ehre
bröckelten	bröckelten
malet	malet
Erfahrung	Erfahrung
frevler	frevler
flambiert	flambiert
Adventskalender	Adventskalender
gelobest	gelobest
Siglen	Siglen
imitiertet	imitiertet
Lehrkörpern	Lehrkörpern
Tumult	Tumult
erschüttere	erschüttere
Ringen	Ringen
folgtet	folgtet
entsetzte	entsetzte
Charakteristikan	Charakteristikan
geloben	geloben
Strahlentierchens	Strahlentierchens
Gibt	Gibt
Paläste	Paläste
blitzte	blitzte
sortiert	sortiert
Einem	Einem
ruckeln	ruckeln
läutet	läutet
meuternd	meuternd
Industrienation	Industrienation
frikassierend	frikassierend
imprägniere	imprägniere
tendierst	tendierst
erbringst	erbringst
Hackern	Hackern
stillest	stillest
überweiset	überweiset
motivieren	motivieren
Hubschrauber	Hubschrauber
Maße	Maße
duckt	duckt
Stärke	Stärke
gravierst	gravierst
bleibst	bleibst
replizierten	replizierten
Pläsieren	Pläsieren
gebühren	gebühren
verlasset	verlasset
privilegierst	privilegierst
teilte	teilte
Graphem	Graphem
rekrutiere	rekrutiere
bekehrt	bekehrt
fragest	fragest
versuchest	versuchest
erkalten	erkalten
Gnaden	Gnaden
preisen	preisen
Unter	Unter
Küstenwachen	Küstenwachen
schreie	schreie
schätzte	schätzte
Grieße	Grieße
Aufprall	Aufprall
räucheret	räucheret
könnt	könnt
piesackest	piesackest
fingiere	fingiere
beschrifte	beschrifte
Pentaboraten	Pentaboraten
beschottre	beschottre
malträtiere	malträtiere
tief	tief
linstest	linstest
bekriegt	bekriegt
Android	Android
streiten	streiten
Mopp	Mopp
beunruhige	beunruhige
Kleinoden	Kleinoden
eigene	eigene
Leitungswegs	Leitungswegs
glänzte	glänzte
steckst	steckst
Physikerinnen	Physikerinnen
misstrauet	misstrauet
verscheißert	verscheißert
kickst	kickst
schaue	schaue
Schwärmereien	Schwärmereien
alles	alles
begründetest	begründetest
manövrierte	manövrierte
dramatisieren	dramatisieren
Maut	Maut
entfolgst	entfolgst
regelet	regelet
Büstenhaltern	Büstenhaltern
wachset	wachset
Besprechung	Besprechung
Steuerbord	Steuerbord
neigest	neigest
Malaysierinnen	Malaysierinnen
ihre	ihre
spannen	spannen
wärst	wärst
Apportierhunde	Apportierhunde
eingehet	eingehet
hebräischen	hebräischen
ausführt	ausführt
liebest	liebest
Gebeinen	Gebeinen
Füllfedern	Füllfedern
tabuisiert	tabuisiert
Datentypen	Datentypen
batet	batet
dekompilierten	dekompilierten
leihe	leihe
verbarg	verbarg
gespeist	gespeist
Herzchen	Herzchen
knurrt	knurrt
Schaffnerin	Schaffnerin
Europameistern	Europameistern
Tausch	Tausch
wegführe	wegführe
grüßest	grüßest
Pest	Pest
rebelliertet	rebelliertet
wegen	wegen
eggten	eggten
Sabotagen	Sabotagen
lockerst	lockerst
Weihe	Weihe
Anhängseln	Anhängseln
wälzet	wälzet
murmelte	murmelte
Ding	Ding
kichert	kichert
malochte	malochte
möchten	möchten
Blaumeise	Blaumeise
Spanne	Spanne
setzen	setzen
Arm	Arm
türmen	türmen
bekennt	bekennt
Schau	Schau
Bienen	Bienen
gestalten	gestalten
Beziehung	Beziehung
Rechnungen	Rechnungen
Gebäck	Gebäck
Regenten	Regenten
baute	baute
rühmte	rühmte
stapften	stapften
Sonnenfinsternissen	Sonnenfinsternissen
Pfandgeld	Pfandgeld
Grenze	Grenze
schichteten	schichteten
klappten	klappten
kennest	kennest
reanimiere	reanimiere
Gasen	Gasen
ihr	ihr
Adamsäpfeln	Adamsäpfeln
Rechte	Rechte
Telefonverkäufer	Telefonverkäufer
Recht	Recht
Ei	Ei
Kornnattern	Kornnattern
Bildpunkten	Bildpunkten
möget	möget
reichte	reichte
herrschten	herrschten
Arsenbergwerk	Arsenbergwerk
pflanzen	pflanzen
strafte	strafte
Däumlings	Däumlings
Weißflügelpinguin	Weißflügelpinguin
Bande	Bande
Gasgemischen	Gasgemischen
Kaufleute	Kaufleute
Talismanen	Talismanen
Ludwigsburger	Ludwigsburger
Düften	Düften
feierte	feierte
verführe	verführe
beeinflusste	beeinflusste
Neuigkeit	Neuigkeit
Klauen	Klauen
applizirte	applizirte
spukte	spukte
verbündeten	verbündeten
klumpt	klumpt
bandagierte	bandagierte
Sprachraum	Sprachraum
hinterzögen	hinterzögen
illustriertet	illustriertet
Vogelscheuche	Vogelscheuche
Sexten	Sexten
verurteilen	verurteilen
mehret	mehret
leider	leider
absolviertet	absolviertet
Pfleglinge	Pfleglinge
Liebchen	Liebchen
mühte	mühte
pipettierten	pipettierten
Am	Am
Laufringe	Laufringe
unterfordern	unterfordern
Kernspaltung	Kernspaltung
erbte	erbte
blitzt	blitzt
hetzte	hetzte
stimmet	stimmet
Radsätzen	Radsätzen
Bromidquellen	Bromidquellen
Propheten	Propheten
sterilisierten	sterilisierten
Merkel-Rauten	Merkel-Rauten
befördert	befördert
Hirnstämme	Hirnstämme
entschleieret	entschleieret
links	links
vereinbaren	vereinbaren
Enthärtungen	Enthärtungen
Zeug	Zeug
Teile	Teile
verlötest	verlötest
Kaffeelöffel	Kaffeelöffel
begehrten	begehrten
Zuschauer	Zuschauer
assimilierte	assimilierte
Spende	Spende
Macht	Macht
helfest	helfest
sinke	sinke
predig	predig
errötest	errötest
Brettspielen	Brettspielen
höbe	höbe
Androiden	Androiden
Abbildern	Abbildern
kennst	kennst
niemand	niemand
Dreieinigkeit	Dreieinigkeit
Deutungen	Deutungen
kauern	kauern
Langzeichen	Langzeichen
Heteroatom	Heteroatom
lest	lest
Fluorkohlenwasserstoffe	Fluorkohlenwasserstoffe
schummelst	schummelst
Hansen	Hansen
vertilgest	vertilgest
nehmt	nehmt
Trotzkist	Trotzkist
heulet	heulet
widmend	widmend
besorgten	besorgten
gelobten	gelobten
Gigapascaln	Gigapascaln
querte	querte
Schlüchte	Schlüchte
entwendete	entwendete
verdammend	verdammend
Fischotters	Fischotters
behütetest	behütetest
Smaragdkehlkolibris	Smaragdkehlkolibris
oxidierst	oxidierst
bewerbet	bewerbet
Einer	Einer
Leitungsweg	Leitungsweg
Blitze	Blitze
Erfahrungen	Erfahrungen
Quatsch	Quatsch
vibriere	vibriere
denaturieret	denaturieret
verzehre	verzehre
Paralipse	Paralipse
Katamaran	Katamaran
verkürzten	verkürzten
zwölften	zwölften
kritzele	kritzele
harmonierest	harmonierest
Geldautomaten	Geldautomaten
Stiefvätern	Stiefvätern
Boten	Boten
regierten	regierten
unterwerfest	unterwerfest
transportierten	transportierten
entflieht	entflieht
Aktivist	Aktivist
reglementiert	reglementiert
bedrücktest	bedrücktest
haschieret	haschieret
Technikerinnen	Technikerinnen
Langeweile	Langeweile
wechselwirkte	wechselwirkte
Kakaos	Kakaos
Backenbärten	Backenbärten
Normdaten	Normdaten
Zehen	Zehen
Landstreichereien	Landstreichereien
Nagellackentferner	Nagellackentferner
Hüfte	Hüfte
deutete	deutete
Trinker	Trinker
grüßte	grüßte
Physikerin	Physikerin
Aha-Erlebnisse	Aha-Erlebnisse
mißversteht	mißversteht
werte	werte
verbluteten	verbluteten
Heuschrecken	Heuschrecken
Münzsammlungen	Münzsammlungen
jungen	jungen
beleidigst	beleidigst
erforscht	erforscht
sorgen	sorgen
ertraget	ertraget
Fingerhüte	Fingerhüte
wirfst	wirfst
tattert	tattert
foppst	foppst
stutzt	stutzt
hebräisch	hebräisch
Würfelspiele	Würfelspiele
ersparet	ersparet
Managementsystemen	Managementsystemen
gedächte	gedächte
Flamen	Flamen
Dezernaten	Dezernaten
schmierte	schmierte
halbe	halbe
Anliegen	Anliegen
Leichenschauhäusern	Leichenschauhäusern
Rotgusses	Rotgusses
Nahrungsbestandteil	Nahrungsbestandteil
reinigst	reinigst
verseuchen	verseuchen
begnügte	begnügte
Katamaranen	Katamaranen
lobet	lobet
Quellen	Quellen
tappten	tappten
glaubest	glaubest
Pedanten	Pedanten
grünend	grünend
erzwangt	erzwangt
vernichtete	vernichtete
möchtet	möchtet
Herkünften	Herkünften
brillieret	brillieret
ratschlaget	ratschlaget
herrschte	herrschte
verleumdete	verleumdete
Bazziten	Bazziten
Minimierung	Minimierung
entsündigte	entsündigte
sollst	sollst
blondieren	blondieren
zerrüttete	zerrüttete
trefft	trefft
deaktiviere	deaktiviere
täuschet	täuschet
entdeckst	entdeckst
Schnute	Schnute
drillest	drillest
Sprüchen	Sprüchen
moppet	moppet
tabuisierten	tabuisierten
Funkfeuern	Funkfeuern
Sprachräumen	Sprachräumen
zweifelte	zweifelte
Schreibtischtätern	Schreibtischtätern
Amen	Amen
einführen	einführen
ackerst	ackerst
überdenkest	überdenkest
nütze	nütze
Geschwindigkeitsmesser	Geschwindigkeitsmesser
schäumt	schäumt
malträtierte	malträtierte
Bajonetten	Bajonetten
schmiert	schmiert
verkauften	verkauften
schenkst	schenkst
pharyngalisierten	pharyngalisierten
Kerzenfische	Kerzenfische
decke	decke
bauten	bauten
Spirale	Spirale
gratuliert	gratuliert
vergaset	vergaset
Eisstein	Eisstein
zuppte	zuppte
verbirgst	verbirgst
tätowiertet	tätowiertet
räumen	räumen
Klassenzimmern	Klassenzimmern
stürzt	stürzt
krösest	krösest
kramen	kramen
Quellfluss	Quellfluss
Dessous	Dessous
Plumpse	Plumpse
evakuierte	evakuierte
Lobet	Lobet
erfreuen	erfreuen
markiere	markiere
gewitterte	gewitterte
schauten	schauten
hinterlege	hinterlege
Raucherin	Raucherin
wach	wach
ein	ein
entgegenkamen	entgegenkamen
beantrage	beantrage
Grenzwert	Grenzwert
Californium	Californium
schäme	schäme
Rechnung	Rechnung
gebündelt	gebündelt
begnadigst	begnadigst
hievten	hievten
erlösest	erlösest
vertrieb	vertrieb
Graben	Graben
bekehret	bekehret
verteidigt	verteidigt
gebäret	gebäret
entgehst	entgehst
vergliche	vergliche
verfängt	verfängt
Gegebenheit	Gegebenheit
zähltet	zähltet
lackieren	lackieren
reparierten	reparierten
produzierte	produzierte
greinen	greinen
feiern	feiern
vermeßest	vermeßest
Augur	Augur
Großfürst	Großfürst
Finanzministerien	Finanzministerien
formulierst	formulierst
Euter	Euter
Grufti	Grufti
deaktivierst	deaktivierst
Tore	Tore
frohlocke	frohlocke
Gehörst	Gehörst
filzst	filzst
kaufst	kaufst
lauschte	lauschte
Dachdeckerinnen	Dachdeckerinnen
plumpse	plumpse
Aachener	Aachener
schiebest	schiebest
Toren	Toren
hingehst	hingehst
strafet	strafet
träge	träge
blockiert	blockiert
ahnten	ahnten
manövrieret	manövrieret
Vergrößerungen	Vergrößerungen
kontaktiere	kontaktiere
concessionieren	concessionieren
begehrtest	begehrtest
Kindergeld	Kindergeld
unterscheide	unterscheide
Farbstoffe	Farbstoffe
kein	kein
Kleptokratien	Kleptokratien
Aha-Erlebnis	Aha-Erlebnis
entzweit	entzweit
bewässern	bewässern
Chasar	Chasar
Kompromiss	Kompromiss
zeigst	zeigst
füllte	füllte
loste	loste
posiert	posiert
entsetzt	entsetzt
bedurftest	bedurftest
vertilgst	vertilgst
Höhlen	Höhlen
ermahnt	ermahnt
bejubelst	bejubelst
Massenarbeitslosigkeit	Massenarbeitslosigkeit
treffen	treffen
Kurkuma	Kurkuma
Impedanz	Impedanz
scheiterst	scheiterst
geraten	geraten
Grenzen	Grenzen
dekorieren	dekorieren
verkleide	verkleide
Galopps	Galopps
Kandidaturen	Kandidaturen
beider	beider
Abfahrtsliste	Abfahrtsliste
Käsereibe	Käsereibe
stellet	stellet
hänge	hänge
Uterus	Uterus
hätten	hätten
entsündigen	entsündigen
Abkömmlingen	Abkömmlingen
Stücke	Stücke
erstehet	erstehet
geschlummert	geschlummert
finanziert	finanziert
blätteret	blätteret
fresset	fresset
War	War
Alkalien	Alkalien
fluktuierte	fluktuierte
Berylle	Berylle
Klärungen	Klärungen
aufkommt	aufkommt
nehmet	nehmet
mobilisierten	mobilisierten
sterilisierte	sterilisierte
bereitend	bereitend
Friede	Friede
schaffe	schaffe
präsentiere	präsentiere
Ausbeutern	Ausbeutern
wehrten	wehrten
jappen	jappen
Erste	Erste
hegt	hegt
Weinbergen	Weinbergen
Hinkelsteine	Hinkelsteine
Bergsteiger	Bergsteiger
Mischung	Mischung
offenbar	offenbar
Arbeitsbereichen	Arbeitsbereichen
verewigt	verewigt
legen	legen
Schlüchten	Schlüchten
ringele	ringele
lärmte	lärmte
Schreien	Schreien
Wehret	Wehret
Gewinnung	Gewinnung
suche	suche
Toypudeln	Toypudeln
murmelst	murmelst
klappst	klappst
erfüllt	erfüllt
Pfahl	Pfahl
ausgerecktem	ausgerecktem
greinet	greinet
gesellt	gesellt
finanzieret	finanzieret
Einfältigkeiten	Einfältigkeiten
Dampfschiffen	Dampfschiffen
fluchte	fluchte
reimte	reimte
liehen	liehen
eiterte	eiterte
Bazzit	Bazzit
vertrauten	vertrauten
trieb	trieb
Leichtmetallen	Leichtmetallen
verjährte	verjährte
Fluorgehalte	Fluorgehalte
entmineralisieret	entmineralisieret
anrichte	anrichte
ersparte	ersparte
Trickbetrügern	Trickbetrügern
ärger	ärger
zerbräche	zerbräche
gehet	gehet
vertrieben	vertrieben
Übertretung	Übertretung
Sachen	Sachen
untertretet	untertretet
linsten	linsten
decket	decket
duzen	duzen
Bittersüß	Bittersüß
Biokraftstoff	Biokraftstoff
Bürzel	Bürzel
diversifiziert	diversifiziert
Blechen	Blechen
massakrierte	massakrierte
beschuldiget	beschuldiget
Gespenstern	Gespenstern
Feierabende	Feierabende
Excimerlasern	Excimerlasern
Warten	Warten
tanze	tanze
behaltest	behaltest
Ackerschachtelhalm	Ackerschachtelhalm
aufkommen	aufkommen
Braunralle	Braunralle
hüpfen	hüpfen
Aphasien	Aphasien
Vetter	Vetter
schöpfest	schöpfest
mineralisierten	mineralisierten
löstest	löstest
Dürren	Dürren
Festons	Festons
Seines	Seines
fressen	fressen
kramst	kramst
verdinglichest	verdinglichest
Landwirte	Landwirte
erhebst	erhebst
Technetaten	Technetaten
beklagte	beklagte
Komponisten	Komponisten
prahlet	prahlet
kristallisierest	kristallisierest
Kleinod	Kleinod
Spektralbereich	Spektralbereich
betrüge	betrüge
musizieret	musizieret
ausgereckten	ausgereckten
Tiere	Tiere
Hinterwäldlern	Hinterwäldlern
Gewinnungen	Gewinnungen
Kakao	Kakao
spracht	spracht
verurteile	verurteile
funzt	funzt
haschiert	haschiert
Leid	Leid
vergrabest	vergrabest
bewahret	bewahret
Hat	Hat
beleuchteten	beleuchteten
Blattgewebe	Blattgewebe
lügen	lügen
reinige	reinige
Ausländer	Ausländer
Gedanken	Gedanken
Stätten	Stätten
eins	eins
Suche	Suche
schämest	schämest
Locken	Locken
Langschwanzpinguinen	Langschwanzpinguinen
klone	klone
dürfte	dürfte
fluchet	fluchet
Rauten	Rauten
verklagst	verklagst
balkanisierte	balkanisierte
stille	stille
streutet	streutet
prostituieret	prostituieret
denn	denn
redetet	redetet
erweckt	erweckt
Ausbeuter	Ausbeuter
evakuieret	evakuieret
häufen	häufen
rundet	rundet
Tiefen	Tiefen
Wolle	Wolle
Traggasen	Traggasen
verwirklicht	verwirklicht
schaute	schaute
abweichest	abweichest
verspäteten	verspäteten
verunglimpfest	verunglimpfest
konvergiere	konvergiere
überwiese	überwiese
befestigten	befestigten
Regenwald	Regenwald
baue	baue
verdeckten	verdeckten
Milchflaschen	Milchflaschen
koste	koste
sorge	sorge
schreiben	schreiben
grienest	grienest
klemmen	klemmen
Götzen	Götzen
Futur	Futur
loben	loben
Senkung	Senkung
Ausländern	Ausländern
Dithiolane	Dithiolane
wetzte	wetzte
Gedächtnisse	Gedächtnisse
eggte	eggte
wollte	wollte
Feinde	Feinde
befehlen	befehlen
weinte	weinte
Arreste	Arreste
klonet	klonet
zittere	zittere
würdest	würdest
verkauft	verkauft
zappen	zappen
genehmigt	genehmigt
Fette	Fette
Dünungen	Dünungen
Abnahme	Abnahme
Dödeln	Dödeln
setzet	setzet
Hektaren	Hektaren
blamierte	blamierte
wirft	wirft
mogelten	mogelten
verdunstet	verdunstet
regiere	regiere
überstehst	überstehst
Malen	Malen
heißest	heißest
Tut	Tut
Skorpione	Skorpione
überlieferten	überlieferten
Bärenfellen	Bärenfellen
speiest	speiest
verkündigt	verkündigt
rechte	rechte
verblutete	verblutete
Rehbock	Rehbock
Schwänze	Schwänze
Bergen	Bergen
produzierest	produzierest
Kohlenstoffgehalten	Kohlenstoffgehalten
verdrängen	verdrängen
Stoffwechselwegen	Stoffwechselwegen
gedenkst	gedenkst
Tollkirsche	Tollkirsche
anhangt	anhangt
Aggressoren	Aggressoren
Aggressor	Aggressor
extemporieret	extemporieret
Prostylos	Prostylos
geniertest	geniertest
begnadigte	begnadigte
schlummerte	schlummerte
Sei	Sei
Kleinodien	Kleinodien
klingt	klingt
faschieret	faschieret
mögt	mögt
verzweigst	verzweigst
Bajonette	Bajonette
Wehklagen	Wehklagen
Transportwegen	Transportwegen
Sternen	Sternen
Abszisse	Abszisse
Eingaben	Eingaben
Bademantel	Bademantel
beichteten	beichteten
Arbeitskreis	Arbeitskreis
Argyrodite	Argyrodite
Prügelstrafen	Prügelstrafen
lispelten	lispelten
benachrichtiget	benachrichtiget
heftete	heftete
reparieret	reparieret
zentriert	zentriert
porträtiere	porträtiere
fegte	fegte
Halle	Halle
grüßet	grüßet
mampfte	mampfte
Alle	Alle
Präservativs	Präservativs
liebt	liebt
Indern	Indern
versagen	versagen
spritzet	spritzet
Operationssälen	Operationssälen
Werke	Werke
lobe	lobe
flötete	flötete
Katz-und-Maus-Spiele	Katz-und-Maus-Spiele
Epidemie	Epidemie
Germanisten	Germanisten
verdränge	verdränge
plagen	plagen
schätze	schätze
Biene	Biene
verwahrt	verwahrt
Gemurmel	Gemurmel
umkämen	umkämen
Gegebenheiten	Gegebenheiten
Bär	Bär
verliere	verliere
besucht	besucht
Selbstsicherheit	Selbstsicherheit
umarbeiten	umarbeiten
kreierten	kreierten
jede	jede
wischt	wischt
erstürmt	erstürmt
lauf	lauf
erpress	erpress
kritzelet	kritzelet
Einsatz	Einsatz
Fürst	Fürst
gehörst	gehörst
Kassettenrekorder	Kassettenrekorder
schimmerest	schimmerest
Aussätzige	Aussätzige
zittertest	zittertest
schämet	schämet
dürfe	dürfe
entschleiert	entschleiert
Tiefe	Tiefe
gelangte	gelangte
Aphasie	Aphasie
nahte	nahte
repräsentierten	repräsentierten
Deckenzapfen	Deckenzapfen
verständige	verständige
protestieret	protestieret
erklinge	erklinge
eures	eures
Seehechte	Seehechte
designiertet	designiertet
Ansteckern	Ansteckern
veranstaltest	veranstaltest
reim	reim
heftetest	heftetest
verunglimpfen	verunglimpfen
Basilisk	Basilisk
verkapselten	verkapselten
folterst	folterst
Irrtumes	Irrtumes
dramatisiert	dramatisiert
Gigapascal	Gigapascal
wollt	wollt
porträtiert	porträtiert
Bube	Bube
Bilderstürmer	Bilderstürmer
pflanzt	pflanzt
emailliert	emailliert
glauben	glauben
verbündet	verbündet
schwadronierten	schwadronierten
Grießen	Grießen
Halbmonden	Halbmonden
Präservativen	Präservativen
läutetet	läutetet
Überschüssen	Überschüssen
Polizeisprechern	Polizeisprechern
Zitronensäften	Zitronensäften
rekonstruieret	rekonstruieret
Paradiesapfel	Paradiesapfel
wärme	wärme
Schläge	Schläge
Mönche	Mönche
brechen	brechen
drängst	drängst
zerrisset	zerrisset
strandeten	strandeten
erkundigte	erkundigte
vergiftet	vergiftet
aufkämen	aufkämen
Peptids	Peptids
stiege	stiege
Essigsäurechloriden	Essigsäurechloriden
Untiefe	Untiefe
Blitzen	Blitzen
quantisierte	quantisierte
kooperierte	kooperierte
Neuigkeiten	Neuigkeiten
meinen	meinen
aufkäme	aufkäme
Brotkästen	Brotkästen
entstände	entstände
Fussel	Fussel
opfern	opfern
hörest	hörest
widerriefe	widerriefe
schauspieleren	schauspieleren
Bären	Bären
Plüschtier	Plüschtier
auszieht	auszieht
Prozeduren	Prozeduren
Optimisten	Optimisten
süsse	süsse
verbleibet	verbleibet
klettert	klettert
Polyphosphat	Polyphosphat
brandeten	brandeten
fokussieret	fokussieret
kaserniert	kaserniert
Kräfte	Kräfte
kaufe	kaufe
Zwingburgen	Zwingburgen
verhörest	verhörest
schenket	schenket
entkörperlichten	entkörperlichten
Hallelujas	Hallelujas
ölt	ölt
funktionalisiertest	funktionalisiertest
Meinem	Meinem
reife	reife
colorierten	colorierten
Asiatin	Asiatin
Schneepflügen	Schneepflügen
Ausnahme	Ausnahme
Sanatoriums	Sanatoriums
Bankettes	Bankettes
Chlorat	Chlorat
Magiern	Magiern
arbeiten	arbeiten
Neumonde	Neumonde
lege	lege
mobilisieret	mobilisieret
dritte	dritte
erlauben	erlauben
Laubbaum	Laubbaum
trotze	trotze
vereinigte	vereinigte
lodert	lodert
kauten	kauten
Radiergummi	Radiergummi
zeugten	zeugten
bücktest	bücktest
tunet	tunet
strullerst	strullerst
Wachteln	Wachteln
erstarrten	erstarrten
Nehmet	Nehmet
Rücktrittbremsen	Rücktrittbremsen
diskutierst	diskutierst
nähte	nähte
revoltieren	revoltieren
erstehst	erstehst
Sippe	Sippe
Bevölkerungsdichten	Bevölkerungsdichten
Aspartame	Aspartame
Leiste	Leiste
Sogen	Sogen
überfischte	überfischte
eroberte	eroberte
liege	liege
bekehrten	bekehrten
Schafen	Schafen
eure	eure
pensionierten	pensionierten
zweifel	zweifel
recycelten	recycelten
Wasserquellen	Wasserquellen
Selbstversuch	Selbstversuch
gedolmetscht	gedolmetscht
Reißnagel	Reißnagel
restaurierten	restaurierten
möge	möge
elften	elften
Würze	Würze
Reststoffen	Reststoffen
Gehilfe	Gehilfe
grübelte	grübelte
ärgerst	ärgerst
Strontiumamalgamen	Strontiumamalgamen
Konifere	Konifere
möchtest	möchtest
Bonzen	Bonzen
entheilige	entheilige
privatisiert	privatisiert
Ablösung	Ablösung
skypst	skypst
harrtest	harrtest
Atemlüfte	Atemlüfte
Händedrücken	Händedrücken
Samen	Samen
hoben	hoben
entständen	entständen
plagte	plagte
beherrscht	beherrscht
Anachronismus	Anachronismus
Bürzeln	Bürzeln
spähet	spähet
träumte	träumte
Weiblein	Weiblein
Ersten	Ersten
drescht	drescht
ärgerte	ärgerte
Kaktusfeige	Kaktusfeige
Zahnfleischentzündung	Zahnfleischentzündung
herrschest	herrschest
vertiefet	vertiefet
Primärenergie	Primärenergie
erkannte	erkannte
preise	preise
Emmer	Emmer
Massenanteil	Massenanteil
Inauguration	Inauguration
Altären	Altären
prangte	prangte
Ausbeuterei	Ausbeuterei
kehrst	kehrst
folget	folget
Wache	Wache
opferte	opferte
Spannt	Spannt
Fingerhüten	Fingerhüten
erbauet	erbauet
Fremdwort	Fremdwort
belohnte	belohnte
mehr	mehr
kichern	kichern
blitze	blitze
haste	haste
herrschen	herrschen
Abfahrtslisten	Abfahrtslisten
Blattgeweben	Blattgeweben
Honigbär	Honigbär
repräsentieret	repräsentieret
Höhle	Höhle
Einbrecher	Einbrecher
Menschenhandel	Menschenhandel
dirigiert	dirigiert
lehrest	lehrest
faul	faul
Mähnenwolf	Mähnenwolf
jedes	jedes
Katamarane	Katamarane
stickten	stickten
kupieren	kupieren
Fußmatten	Fußmatten
belohnten	belohnten
knüpfen	knüpfen
Sekretärinnen	Sekretärinnen
Halsabschneidern	Halsabschneidern
Martyrologien	Martyrologien
grüne	grüne
lauten	lauten
Uteri	Uteri
Dewargefäße	Dewargefäße
Maximierung	Maximierung
Dominicanerinnen	Dominicanerinnen
Friedensforscherinnen	Friedensforscherinnen
recycele	recycele
föhnten	föhnten
meinet	meinet
funktionalisierte	funktionalisierte
Hure	Hure
erst	erst
beichten	beichten
Seile	Seile
Eins	Eins
Maxima	Maxima
Konfitüren	Konfitüren
beantragt	beantragt
glaubet	glaubet
besänne	besänne
versuchst	versuchst
Chlorats	Chlorats
handhabt	handhabt
posierst	posierst
erfreute	erfreute
Gewalttätern	Gewalttätern
entsetzen	entsetzen
verführten	verführten
formirend	formirend
habest	habest
Schauen	Schauen
Lobgesänge	Lobgesänge
solchem	solchem
gedenke	gedenke
naschst	naschst
Oheim	Oheim
Euphemismus	Euphemismus
Hummel	Hummel
Aderhäuten	Aderhäuten
bekannt	bekannt
Sportlerin	Sportlerin
Gässchen	Gässchen
funkelet	funkelet
fastetet	fastetet
benütztest	benütztest
leben	leben
glaubte	glaubte
filzte	filzte
parfümierst	parfümierst
versüße	versüße
verbot	verbot
höbet	höbet
Aufpralle	Aufpralle
erratet	erratet
schwängen	schwängen
erlabe	erlabe
Sterne	Sterne
reizet	reizet
Schreibtischtäter	Schreibtischtäter
Crescendos	Crescendos
Könige	Könige
privilegiere	privilegiere
mogelest	mogelest
steuerte	steuerte
Ranzigkeit	Ranzigkeit
Indianern	Indianern
hinterlegt	hinterlegt
erniedrigst	erniedrigst
Privatsachen	Privatsachen
Orgel	Orgel
suchest	suchest
schenken	schenken
sabbre	sabbre
Pfarrerinnen	Pfarrerinnen
begehrt	begehrt
Flensern	Flensern
Mobilfunknetze	Mobilfunknetze
begrabest	begrabest
bewahrst	bewahrst
bedeckt	bedeckt
Möbiusbändern	Möbiusbändern
unseren	unseren
besitzest	besitzest
Judenräte	Judenräte
Leuchtstoff	Leuchtstoff
höhnte	höhnte
Anlässe	Anlässe
stärken	stärken
Nährmedien	Nährmedien
gehorcht	gehorcht
Säcke	Säcke
schluchze	schluchze
vertagest	vertagest
unterstützet	unterstützet
antworte	antworte
Alltag	Alltag
verseucht	verseucht
fragte	fragte
anzeige	anzeige
Unwahrheit	Unwahrheit
peilst	peilst
wälzt	wälzt
wallet	wallet
hättest	hättest
Dezernat	Dezernat
unterwerfe	unterwerfe
lögest	lögest
Möbiusbänder	Möbiusbänder
optimiert	optimiert
heiligten	heiligten
erntet	erntet
sagten	sagten
Trockendocks	Trockendocks
hydrolysierend	hydrolysierend
leistete	leistete
Sexte	Sexte
Diethylether	Diethylether
Theologien	Theologien
Bevölkerungsdichte	Bevölkerungsdichte
eingehst	eingehst
einführte	einführte
Fetzen	Fetzen
schlabberten	schlabberten
hegten	hegten
verwaiset	verwaiset
seist	seist
Bademäntel	Bademäntel
Briketten	Briketten
brachen	brachen
sucht	sucht
Schnallen	Schnallen
plissiere	plissiere
Vollkornbrot	Vollkornbrot
Vorstädten	Vorstädten
Negermusik	Negermusik
Linguisten	Linguisten
Trinkgefäße	Trinkgefäße
Mikrometern	Mikrometern
unschuldigen	unschuldigen
Schnipseln	Schnipseln
Finanzminister	Finanzminister
Werkzeuge	Werkzeuge
exmatrikuliertet	exmatrikuliertet
Oxalate	Oxalate
glaube	glaube
Strafraum	Strafraum
reifst	reifst
untertreten	untertreten
gedachten	gedachten
Bertrandite	Bertrandite
Libelle	Libelle
filteret	filteret
funzen	funzen
Edelsteinen	Edelsteinen
fünften	fünften
binde	binde
Zunge	Zunge
Geliebte	Geliebte
stäupte	stäupte
regieret	regieret
gelobtet	gelobtet
schonte	schonte
auflegte	auflegte
Küsserei	Küsserei
Politologen	Politologen
dringest	dringest
Schafe	Schafe
wehrte	wehrte
Kettenraucher	Kettenraucher
Tintenklecks	Tintenklecks
trage	trage
Schatten	Schatten
Schnipsel	Schnipsel
aase	aase
weg	weg
Abfertigungsschalters	Abfertigungsschalters
erbrütet	erbrütet
trüb	trüb
Anrufbeantworter	Anrufbeantworter
verunzierte	verunzierte
Amnestie	Amnestie
Laib	Laib
Recitativen	Recitativen
feire	feire
Linke	Linke
eine	eine
verkleidete	verkleidete
bleibest	bleibest
Fluoratomen	Fluoratomen
Gaschromatographie	Gaschromatographie
erlöse	erlöse
Berufe	Berufe
Rehböcken	Rehböcken
falle	falle
Arbeitsbereich	Arbeitsbereich
Geschrei	Geschrei
schmuggle	schmuggle
nötige	nötige
Elementarzelle	Elementarzelle
Trägergasen	Trägergasen
sabbelt	sabbelt
Strontiumamalgams	Strontiumamalgams
emendierte	emendierte
wert	wert
Adhäsionen	Adhäsionen
Wegen	Wegen
speiste	speiste
egalisierten	egalisierten
Träumer	Träumer
verunglimpftet	verunglimpftet
betrübt	betrübt
nötig	nötig
billigen	billigen
pulsiert	pulsiert
lehre	lehre
verstrahlet	verstrahlet
dürfest	dürfest
kürzest	kürzest
Bagger	Bagger
Silbererzen	Silbererzen
Sauberfrau	Sauberfrau
Schnarchralle	Schnarchralle
dekoriere	dekoriere
nächste	nächste
Lüsten	Lüsten
destabilisierte	destabilisierte
pflegte	pflegte
Paragraphenreiter	Paragraphenreiter
Nährmediums	Nährmediums
erziehst	erziehst
bedeckest	bedeckest
duzet	duzet
Abkömmling	Abkömmling
Lusitaners	Lusitaners
zwängtet	zwängtet
Vorstädte	Vorstädte
Asthenosphäre	Asthenosphäre
Mikrometer	Mikrometer
Vogelscheuchen	Vogelscheuchen
erbringen	erbringen
verringeret	verringeret
hämmerte	hämmerte
bringst	bringst
versuchet	versuchet
klickte	klickte
jappte	jappte
zirpe	zirpe
Verehrer	Verehrer
Apotheose	Apotheose
Königen	Königen
Funktionalität	Funktionalität
werdest	werdest
Briten	Briten
Hochsommer	Hochsommer
protokollierst	protokollierst
höbest	höbest
Mops	Mops
Fußbodens	Fußbodens
Päckchens	Päckchens
verziehe	verziehe
verlassen	verlassen
Beryll	Beryll
substituierten	substituierten
streuen	streuen
verschickte	verschickte
Wühltische	Wühltische
emittiert	emittiert
Buchfink	Buchfink
süsst	süsst
Ringeltaube	Ringeltaube
verfolgt	verfolgt
Scheißkerlen	Scheißkerlen
bürsteten	bürsteten
Portal	Portal
Abschiedsbriefe	Abschiedsbriefe
Drillinge	Drillinge
machte	machte
Sollten	Sollten
zeugt	zeugt
pressiert	pressiert
Verdacht	Verdacht
Scherzen	Scherzen
Lautwandeln	Lautwandeln
Kernladungszahlen	Kernladungszahlen
Schlagern	Schlagern
Dudelsäcken	Dudelsäcken
deckst	deckst
übet	übet
mußte	mußte
parlieren	parlieren
Glaubet	Glaubet
Sollst	Sollst
flenstet	flenstet
Ochse	Ochse
kämpfet	kämpfet
brecht	brecht
Kerzenlichtern	Kerzenlichtern
Gewicht	Gewicht
verwirfst	verwirfst
Lümmeltüte	Lümmeltüte
breche	breche
Heringe	Heringe
soll	soll
Puffersystem	Puffersystem
Traubenlesen	Traubenlesen
Herr	Herr
argumentierten	argumentierten
Pausbacken	Pausbacken
stoppten	stoppten
folgend	folgend
solle	solle
Führe	Führe
belauere	belauere
vibrierend	vibrierend
drängest	drängest
schätzt	schätzt
vernehmest	vernehmest
stirbst	stirbst
parametrisierst	parametrisierst
wünscht	wünscht
rekrutierest	rekrutierest
beschotteret	beschotteret
freuet	freuet
Spektroskopie	Spektroskopie
bromiert	bromiert
Krankenschein	Krankenschein
haltest	haltest
Name	Name
Fremdwörter	Fremdwörter
Herd	Herd
kürzt	kürzt
erlaube	erlaube
Bausch	Bausch
buddelten	buddelten
Apportierhund	Apportierhund
beansprucht	beansprucht
zentrifugierst	zentrifugierst
lohnten	lohnten
Weinen	Weinen
pulsiere	pulsiere
fertigte	fertigte
Penis	Penis
Für	Für
Fetzens	Fetzens
diversifiziere	diversifiziere
Reinstoff	Reinstoff
Ich	Ich
werten	werten
Hahnenkämme	Hahnenkämme
warnet	warnet
vertraget	vertraget
Werk	Werk
Freeganer	Freeganer
säumen	säumen
stellen	stellen
verkehrte	verkehrte
Palästen	Palästen
Portale	Portale
Chelatkomplex	Chelatkomplex
plumpsten	plumpsten
Elektronenschale	Elektronenschale
Trichtern	Trichtern
Sphäre	Sphäre
Drillingen	Drillingen
Technetiumatom	Technetiumatom
steinigte	steinigte
seien	seien
Feierabend	Feierabend
zwang	zwang
boßte	boßte
Tasten	Tasten
sagen	sagen
Gehorcht	Gehorcht
winke	winke
Bunde	Bunde
arrivierst	arrivierst
sedimentiert	sedimentiert
tage	tage
weinet	weinet
Kirgisinnen	Kirgisinnen
bewieset	bewieset
seufzt	seufzt
bereitete	bereitete
vernickele	vernickele
Flitzer	Flitzer
Premieren	Premieren
scheiterest	scheiterest
Krustentier	Krustentier
Riese	Riese
predigt	predigt
besprächen	besprächen
betrügen	betrügen
Gewürzen	Gewürzen
Bleiglanzes	Bleiglanzes
konntet	konntet
Kräften	Kräften
Membranen	Membranen
Reiterschwert	Reiterschwert
Stechpalmen	Stechpalmen
Gründungsprivilegien	Gründungsprivilegien
könnten	könnten
Kirchhof	Kirchhof
kremierten	kremierten
gequasselt	gequasselt
borgst	borgst
Zeitplanes	Zeitplanes
gewährte	gewährte
Wollte	Wollte
dissentierten	dissentierten
prangest	prangest
schwirret	schwirret
sedimentiertet	sedimentiertet
betrübte	betrübte
bekriegtet	bekriegtet
Grabbeltisch	Grabbeltisch
erwähnet	erwähnet
säst	säst
duckmäuseret	duckmäuseret
erwürgtest	erwürgtest
ihres	ihres
Meinet	Meinet
ziehst	ziehst
nehmest	nehmest
stirbt	stirbt
Mobilfunknetzen	Mobilfunknetzen
Aromastoffen	Aromastoffen
Gefäßen	Gefäßen
Perle	Perle
mußten	mußten
Schwächung	Schwächung
Teilnehmerin	Teilnehmerin
predige	predige
trüge	trüge
vermischen	vermischen
Mutagen	Mutagen
ladest	ladest
pflanzest	pflanzest
Schaffnerinnen	Schaffnerinnen
vernickelte	vernickelte
mißverstehet	mißverstehet
maßen	maßen
Radiergummis	Radiergummis
rede	rede
schreibst	schreibst
erhörst	erhörst
salz	salz
stickt	stickt
speichertest	speichertest
Gegenleistungen	Gegenleistungen
zuteil	zuteil
Hainbuche	Hainbuche
hinterzöge	hinterzöge
Abartigkeit	Abartigkeit
Mikrowellenfilter	Mikrowellenfilter
Erbsen	Erbsen
sponsertest	sponsertest
impfte	impfte
Gammastrahlen	Gammastrahlen
Ratsherren	Ratsherren
kooperierst	kooperierst
erzeigte	erzeigte
vorn	vorn
Abkürzungsverzeichnisse	Abkürzungsverzeichnisse
Botokuden	Botokuden
frohlockten	frohlockten
Letzten	Letzten
hastete	hastete
sagt	sagt
Gebeine	Gebeine
Kohlrübe	Kohlrübe
Denkmünzen	Denkmünzen
Reichweite	Reichweite
wolle	wolle
durchwacht	durchwacht
rangierst	rangierst
emaillieret	emaillieret
Kupferkiese	Kupferkiese
deponiere	deponiere
lachte	lachte
Auszüge	Auszüge
verzweigt	verzweigt
Diäresen	Diäresen
Kürass	Kürass
Zehe	Zehe
wären	wären
predigend	predigend
benehme	benehme
Gläubigen	Gläubigen
Ypecaharallen	Ypecaharallen
evaluierten	evaluierten
referenzierst	referenzierst
verfügten	verfügten
Radsatzes	Radsatzes
stoßt	stoßt
fehlet	fehlet
Mönchen	Mönchen
Pläsier	Pläsier
flense	flense
plaziert	plaziert
Klappertöpfen	Klappertöpfen
Mache	Mache
kommest	kommest
Oxalaten	Oxalaten
verbitterte	verbitterte
Anhang	Anhang
gaffest	gaffest
Anarchisten	Anarchisten
tragen	tragen
bekotete	bekotete
Zeitüberschreitung	Zeitüberschreitung
Eines	Eines
funktioniertest	funktioniertest
Freunde	Freunde
heiße	heiße
abweichet	abweichet
verbluten	verbluten
unsre	unsre
schnürest	schnürest
trompete	trompete
Fettes	Fettes
touchierte	touchierte
Gummibaumes	Gummibaumes
sortierte	sortierte
verstörte	verstörte
überprüfte	überprüfte
torpedieret	torpedieret
Fusselbart	Fusselbart
Verwaltungsakten	Verwaltungsakten
dringst	dringst
Generationen	Generationen
Darlehen	Darlehen
Judenrat	Judenrat
verscheißerte	verscheißerte
konsumieren	konsumieren
verschmelzen	verschmelzen
attackieret	attackieret
radierte	radierte
tendiertet	tendiertet
behütet	behütet
laut	laut
verstört	verstört
Gaunern	Gaunern
kämpfte	kämpfte
Verwundeten	Verwundeten
losest	losest
zersetzte	zersetzte
bündelest	bündelest
Abfertigungsgebäude	Abfertigungsgebäude
Platte	Platte
klicket	klicket
Butzemann	Butzemann
fluppten	fluppten
Stärket	Stärket
laben	laben
Schwirrvogel	Schwirrvogel
beschwören	beschwören
seine	seine
Schwänzchen	Schwänzchen
zürnest	zürnest
kommet	kommet
Massage	Massage
Numerus	Numerus
greife	greife
tragest	tragest
schau	schau
Kaufhäuser	Kaufhäuser
blitz	blitz
Nanoteslan	Nanoteslan
formulieren	formulieren
rodete	rodete
konsumiere	konsumiere
blättertet	blättertet
Ställe	Ställe
wechselwirkt	wechselwirkt
Stempeluhren	Stempeluhren
gründen	gründen
Bertrandit	Bertrandit
grüße	grüße
Bluff	Bluff
frappiere	frappiere
Spielen	Spielen
erstaunte	erstaunte
wiederholte	wiederholte
sündiget	sündiget
jaulst	jaulst
Abarten	Abarten
Treppe	Treppe
verwirft	verwirft
Zeitbomben	Zeitbomben
trägst	trägst
gähnten	gähnten
deklarierten	deklarierten
Blockflöten	Blockflöten
Lautschriften	Lautschriften
stoppte	stoppte
Pis	Pis
Halleluja	Halleluja
narret	narret
reif	reif
bewies	bewies
schmuggele	schmuggele
erbaust	erbaust
dürften	dürften
gehorchte	gehorchte
Wände	Wände
unserer	unserer
wurden	wurden
downloadet	downloadet
stürzen	stürzen
unterwirft	unterwirft
endlagern	endlagern
still	still
Bleigehalten	Bleigehalten
setzte	setzte
Hochhäusern	Hochhäusern
konntest	konntest
unterschieden	unterschieden
Falzen	Falzen
parkierst	parkierst
Technetate	Technetate
Gästen	Gästen
Coventrisierung	Coventrisierung
blasen	blasen
bekannten	bekannten
verführest	verführest
vereinigt	vereinigt
zerschlaget	zerschlaget
schnattert	schnattert
lanciertet	lanciertet
hingeht	hingeht
verzieh	verzieh
raubest	raubest
touchiere	touchiere
kehret	kehret
Verwaltungsakte	Verwaltungsakte
tattre	tattre
verdränget	verdränget
fragst	fragst
Lasten	Lasten
Schlagzeuger	Schlagzeuger
erliegst	erliegst
verdamm	verdamm
Dorsche	Dorsche
Excimerlaser	Excimerlaser
konstatiere	konstatiere
Ansichtskarte	Ansichtskarte
Ion	Ion
Futtermittel	Futtermittel
Rutheniumisotopen	Rutheniumisotopen
kurz	kurz
Donoren	Donoren
vergrubt	vergrubt
Gedrängen	Gedrängen
unterschiede	unterschiede
Armen	Armen
erkälteten	erkälteten
Acht	Acht
einer	einer
Elementarzellen	Elementarzellen
addieren	addieren
Ring	Ring
Solcher	Solcher
schmeichelest	schmeichelest
Samarskite	Samarskite
stolze	stolze
danket	danket
Trägerwellen	Trägerwellen
Marokkaners	Marokkaners
führst	führst
Gemeinden	Gemeinden
mopst	mopst
Feldbett	Feldbett
Mopps	Mopps
Muster	Muster
lebte	lebte
Stiefvater	Stiefvater
Steuerwagen	Steuerwagen
vandalieren	vandalieren
rächte	rächte
erwähnten	erwähnten
bejubelte	bejubelte
Randbemerkung	Randbemerkung
Angabe	Angabe
Verdachtes	Verdachtes
reizen	reizen
eurer	eurer
gehorchest	gehorchest
beide	beide
liebend	liebend
schickte	schickte
Bruchstrich	Bruchstrich
lang	lang
UND-Gatter	UND-Gatter
appellierst	appellierst
Quelle	Quelle
besorgend	besorgend
Pi	Pi
gedurft	gedurft
verklärest	verklärest
benützt	benützt
Saiblinge	Saiblinge
ermutigt	ermutigt
Schnitzeljagd	Schnitzeljagd
moppst	moppst
verbrauchet	verbrauchet
Brite	Brite
konsolidierend	konsolidierend
zwingst	zwingst
lochtest	lochtest
Haarshampoos	Haarshampoos
zagest	zagest
nachwandelst	nachwandelst
Kassettenrekordern	Kassettenrekordern
Ölfässern	Ölfässern
Reisebüro	Reisebüro
schwellen	schwellen
könnest	könnest
mache	mache
spiele	spiele
tiefe	tiefe
Alkin	Alkin
Spiralen	Spiralen
Knöllchen	Knöllchen
pflegst	pflegst
leget	leget
regierte	regierte
wachte	wachte
Schläfchen	Schläfchen
Schal	Schal
besichtiget	besichtiget
zürnten	zürnten
fladerst	fladerst
Vergeltungen	Vergeltungen
außen	außen
Sehnen	Sehnen
baten	baten
Tintenklecksen	Tintenklecksen
respektieren	respektieren
verkürzte	verkürzte
skypet	skypet
widerrufe	widerrufe
Fehlen	Fehlen
Carbid	Carbid
Organisationen	Organisationen
kühl	kühl
erste	erste
platz	platz
enterten	enterten
Jagdhunden	Jagdhunden
Bezeugungen	Bezeugungen
steuerst	steuerst
Rinde	Rinde
Astat	Astat
finanzierest	finanzierest
missversteht	missversteht
Europameisters	Europameisters
brenne	brenne
Zebrahai	Zebrahai
beauftragt	beauftragt
flehst	flehst
verlähmte	verlähmte
reden	reden
bereuest	bereuest
ballaste	ballaste
überweist	überweist
Basiliken	Basiliken
Haltepunkten	Haltepunkten
tobte	tobte
Wille	Wille
Spitzen	Spitzen
ältesten	ältesten
lösend	lösend
Brauhaus	Brauhaus
verfliegest	verfliegest
kasernierte	kasernierte
tappst	tappst
Habe	Habe
heile	heile
All	All
ackerest	ackerest
ehrst	ehrst
Abfertigungsgebäuden	Abfertigungsgebäuden
nähert	nähert
fingieret	fingieret
dunkelten	dunkelten
wäre	wäre
Wäre	Wäre
Antitranspiranten	Antitranspiranten
colorierend	colorierend
Zerfall	Zerfall
Kriegen	Kriegen
ach	ach
entzögen	entzögen
unterdrücke	unterdrücke
pendelt	pendelt
Rhodochrosite	Rhodochrosite
changieren	changieren
Rechten	Rechten
abalieniertest	abalieniertest
vernehmen	vernehmen
vermeße	vermeße
bedrückest	bedrückest
Kurkumen	Kurkumen
drifte	drifte
Zebrahaies	Zebrahaies
annektierten	annektierten
verkleinerest	verkleinerest
entsetzten	entsetzten
gewähr	gewähr
Lärchen	Lärchen
Brieföffners	Brieföffners
erziehen	erziehen
Tyrann	Tyrann
erzürnst	erzürnst
implodiere	implodiere
Deinem	Deinem
Apostel	Apostel
Fadenlauf	Fadenlauf
Isobars	Isobars
ersparen	ersparen
widerlegest	widerlegest
ermahnet	ermahnet
auflegst	auflegst
dringen	dringen
blende	blende
raubet	raubet
verfolgst	verfolgst
Klappertopf	Klappertopf
imitiert	imitiert
löst	löst
glänzten	glänzten
geleitest	geleitest
verdunsten	verdunsten
fällst	fällst
entwendet	entwendet
Messiassen	Messiassen
fällte	fällte
tastet	tastet
Pedant	Pedant
Gedränge	Gedränge
Kerls	Kerls
Friesen	Friesen
Trioxid	Trioxid
schenke	schenke
Flame	Flame
berufe	berufe
fallen	fallen
motivierten	motivierten
Stimme	Stimme
Einöden	Einöden
raubte	raubte
besetzen	besetzen
verbasele	verbasele
Schwester	Schwester
grübelt	grübelt
Angaben	Angaben
wünschtest	wünschtest
labe	labe
kürzten	kürzten
ruhe	ruhe
schlachtet	schlachtet
reichtest	reichtest
Kriegsschauplätze	Kriegsschauplätze
stifte	stifte
Bete	Bete
Primatologen	Primatologen
mühe	mühe
Deuteriums	Deuteriums
Bruchstriches	Bruchstriches
verstehet	verstehet
Ebenen	Ebenen
winkt	winkt
bummeltet	bummeltet
dressierten	dressierten
Silbergeschirr	Silbergeschirr
dechiffriere	dechiffriere
leite	leite
verliert	verliert
begebe	begebe
Zähnen	Zähnen
Brieföffner	Brieföffner
Golfplatz	Golfplatz
malträtiert	malträtiert
erniedrigt	erniedrigt
höhnest	höhnest
Edelsteine	Edelsteine
scheltet	scheltet
füllen	füllen
Seine	Seine
Fiebermittel	Fiebermittel
torpediert	torpediert
grünst	grünst
begrübest	begrübest
einigst	einigst
verarbeite	verarbeite
vermischten	vermischten
Montagmittagen	Montagmittagen
sterilisiert	sterilisiert
Reflexionen	Reflexionen
Schickse	Schickse
Innenschau	Innenschau
Mein	Mein
Silberdrähten	Silberdrähten
kristallisiertest	kristallisiertest
gestaltest	gestaltest
öle	öle
Aacheners	Aacheners
löste	löste
Spieße	Spieße
speisend	speisend
Enden	Enden
emigriert	emigriert
lügst	lügst
Nachteile	Nachteile
blaset	blaset
Kanzlei	Kanzlei
Adeliepinguins	Adeliepinguins
Pflanzenwachstum	Pflanzenwachstum
Wandergesellen	Wandergesellen
erwärmet	erwärmet
buddeln	buddeln
Sitz	Sitz
erdachten	erdachten
belüftet	belüftet
bauest	bauest
berühret	berühret
sehnte	sehnte
Atommodellen	Atommodellen
selber	selber
jauchzte	jauchzte
Euphemismen	Euphemismen
initiierten	initiierten
Höschen	Höschen
Gelobet	Gelobet
Gewichten	Gewichten
Bifurkationen	Bifurkationen
Wahnen	Wahnen
kappet	kappet
Gebete	Gebete
Bedenken	Bedenken
Wembley-Tore	Wembley-Tore
Carbiden	Carbiden
sinkest	sinkest
eurem	eurem
Berufen	Berufen
nächsten	nächsten
zerschlagt	zerschlagt
Stärkungsmittel	Stärkungsmittel
Lazarette	Lazarette
Halbgott	Halbgott
näht	näht
Alibis	Alibis
verbrauchte	verbrauchte
konnte	konnte
beäugen	beäugen
zeugest	zeugest
verzeigt	verzeigt
bist	bist
Theistin	Theistin
Schneidern	Schneidern
beneidest	beneidest
merken	merken
aufheben	aufheben
liebten	liebten
verewiget	verewiget
nähernd	nähernd
bereitet	bereitet
Sportlerinnen	Sportlerinnen
Adamsapfel	Adamsapfel
pilgerte	pilgerte
scheinet	scheinet
darfst	darfst
Galoppen	Galoppen
schützt	schützt
gehörten	gehörten
bedürft	bedürft
unterforderten	unterforderten
ernteten	ernteten
verwechsele	verwechsele
Collagen	Collagen
fluchten	fluchten
Fluorgehalt	Fluorgehalt
Überweisung	Überweisung
bestellt	bestellt
bemächtigest	bemächtigest
Löwen	Löwen
Sinnen	Sinnen
Peptid	Peptid
Ruße	Ruße
Arresten	Arresten
verschont	verschont
Heiratsgütern	Heiratsgütern
pflücktet	pflücktet
simuliertet	simuliertet
Obszönität	Obszönität
Mop	Mop
erzeigen	erzeigen
Taufen	Taufen
punkteten	punkteten
Fellachin	Fellachin
Gallanen	Gallanen
entfachten	entfachten
verspielest	verspielest
Streichen	Streichen
Wiederbelebung	Wiederbelebung
Puder	Puder
dürft	dürft
verschränkest	verschränkest
taufet	taufet
Unterseiten	Unterseiten
Fermium	Fermium
Abschreckung	Abschreckung
bedürftet	bedürftet
Automatikgetrieben	Automatikgetrieben
Unterschlagungen	Unterschlagungen
Schätze	Schätze
verstehst	verstehst
evaluiert	evaluiert
prediget	prediget
flambierest	flambierest
Generation	Generation
idealisierest	idealisierest
Unterseite	Unterseite
gewinnet	gewinnet
sitzest	sitzest
legte	legte
Welchen	Welchen
Zahnfleischentzündungen	Zahnfleischentzündungen
regieren	regieren
Empörung	Empörung
aßet	aßet
Denunziationen	Denunziationen
generalisiert	generalisiert
Türkinnen	Türkinnen
erkennet	erkennet
schlaget	schlaget
überliefere	überliefere
sinnst	sinnst
knutschest	knutschest
filtern	filtern
Haarverlusten	Haarverlusten
niemanden	niemanden
filzen	filzen
pflanzet	pflanzet
wacht	wacht
ringe	ringe
Hochsommern	Hochsommern
Minimierungen	Minimierungen
analysieret	analysieret
desensibilisierten	desensibilisierten
Dingen	Dingen
eigenen	eigenen
Leuchtkäfern	Leuchtkäfern
Kronsbeere	Kronsbeere
besprachen	besprachen
verstecktet	verstecktet
erwärmst	erwärmst
Herbstwinde	Herbstwinde
grünet	grünet
generiertet	generiertet
Zirkelbeweis	Zirkelbeweis
erkanntet	erkanntet
Spitze	Spitze
Rücktrittes	Rücktrittes
Thioacetalen	Thioacetalen
Genies	Genies
Ausnahmen	Ausnahmen
Paragraphenreitern	Paragraphenreitern
Republikflucht	Republikflucht
verzieht	verzieht
verkürzt	verkürzt
Rücktritt	Rücktritt
Funkfeuer	Funkfeuer
bombardiert	bombardiert
schlachten	schlachten
Fluorkohlenwasserstoff	Fluorkohlenwasserstoff
Adler	Adler
meinem	meinem
gewähret	gewähret
liehe	liehe
überqueren	überqueren
gafften	gafften
fotzte	fotzte
plissierten	plissierten
tagen	tagen
klaget	klaget
Kehre	Kehre
grün	grün
Soge	Soge
Weg	Weg
Halogenatom	Halogenatom
Backpflaumen	Backpflaumen
kämpfen	kämpfen
urbanisiert	urbanisiert
sterbest	sterbest
stimmen	stimmen
Küchenmaschinen	Küchenmaschinen
Bildschirmfoto	Bildschirmfoto
Thioester	Thioester
Gipfeltreffen	Gipfeltreffen
haltet	haltet
Totenglocke	Totenglocke
Maßen	Maßen
backen	backen
knuffend	knuffend
Erdkruste	Erdkruste
folgte	folgte
Organistin	Organistin
Tintenfisch	Tintenfisch
harrest	harrest
Strohhälmchen	Strohhälmchen
eskaliert	eskaliert
Anführern	Anführern
Gemeinde	Gemeinde
verzeichne	verzeichne
Kanzlerinnen	Kanzlerinnen
Eisenkräutern	Eisenkräutern
ungeistlichen	ungeistlichen
Apostels	Apostels
addieret	addieret
Harpunen	Harpunen
offenbartest	offenbartest
drängte	drängte
Schreiben	Schreiben
liegen	liegen
stand	stand
meinst	meinst
Regent	Regent
drücken	drücken
Schade	Schade
fluppt	fluppt
producieret	producieret
lockerte	lockerte
Tetraiodiden	Tetraiodiden
Milzen	Milzen
frohlockest	frohlockest
Beziehungen	Beziehungen
Buchhalterin	Buchhalterin
Gefilden	Gefilden
schnorrtet	schnorrtet
diskutiere	diskutiere
schnatternd	schnatternd
beeindruckt	beeindruckt
Kairiner	Kairiner
Bilderstürmers	Bilderstürmers
Kristalle	Kristalle
ermächtige	ermächtige
strecke	strecke
ungehorsame	ungehorsame
erweckst	erweckst
fritieret	fritieret
Ruß	Ruß
tyrannisierte	tyrannisierte
Eilande	Eilande
eher	eher
bewässerst	bewässerst
Überfamilie	Überfamilie
belüftete	belüftete
Landstreicher	Landstreicher
obfuskierten	obfuskierten
verabschiedeten	verabschiedeten
Heeren	Heeren
Mäusespeck	Mäusespeck
keulst	keulst
Abnahmen	Abnahmen
Flöße	Flöße
bedingten	bedingten
Jungfernflug	Jungfernflug
verwertete	verwertete
betrübst	betrübst
Bauwerken	Bauwerken
konnotierst	konnotierst
Trinken	Trinken
solch	solch
egalisiertet	egalisiertet
Kompassen	Kompassen
beschottert	beschottert
Leichenschauhäuser	Leichenschauhäuser
führe	führe
Vesper	Vesper
Wänden	Wänden
benähmen	benähmen
Bienenstock	Bienenstock
Transportweg	Transportweg
ziere	ziere
binden	binden
klage	klage
entgehe	entgehe
suchten	suchten
Forschung	Forschung
konnotieret	konnotieret
Gichten	Gichten
lösest	lösest
erweckest	erweckest
Zinkat	Zinkat
Zeitungsente	Zeitungsente
Testamenten	Testamenten
schwirrt	schwirrt
Baisers	Baisers
vertreiben	vertreiben
Händen	Händen
Rußen	Rußen
ermordetet	ermordetet
Einöde	Einöde
bezieht	bezieht
meldet	meldet
entsündigten	entsündigten
föchte	föchte
Gauner	Gauner
überreichst	überreichst
grauten	grauten
Suchanfragen	Suchanfragen
überfällst	überfällst
keulte	keulte
ausführte	ausführte
versteckt	versteckt
seufzest	seufzest
pustet	pustet
Omnibus	Omnibus
aber	aber
Ass	Ass
deine	deine
vierte	vierte
Besuch	Besuch
Aprikosen	Aprikosen
sortierest	sortierest
stigmatisierest	stigmatisierest
verwahret	verwahret
frottier	frottier
dotiere	dotiere
Äther	Äther
extemporiere	extemporiere
Schamentzündungen	Schamentzündungen
gebot	gebot
Myriade	Myriade
Schwebfliegen	Schwebfliegen
zerstreuten	zerstreuten
Worte	Worte
zürnst	zürnst
malt	malt
interagierte	interagierte
Ichs	Ichs
ratschlagten	ratschlagten
Erstlinge	Erstlinge
Adelungen	Adelungen
instanziiere	instanziiere
gewöhnte	gewöhnte
Tritt	Tritt
besorgest	besorgest
Panzerschreck	Panzerschreck
Hallen	Hallen
idealisierten	idealisierten
Farbstoffen	Farbstoffen
Wolfesgrube	Wolfesgrube
gern	gern
zierte	zierte
regeln	regeln
meldeten	meldeten
koexistierten	koexistierten
widmet	widmet
Seehechten	Seehechten
Gründungsprivileg	Gründungsprivileg
klöne	klöne
versuchtet	versuchtet
putzt	putzt
referenziere	referenziere
glühten	glühten
gründe	gründe
beißet	beißet
föchten	föchten
Linguistinnen	Linguistinnen
Ångström	Ångström
verdreht	verdreht
Zeitschlitze	Zeitschlitze
immunisiere	immunisiere
eingeht	eingeht
attackieren	attackieren
teilen	teilen
Rückumlauten	Rückumlauten
gewährtest	gewährtest
erhöhet	erhöhet
prostete	prostete
pressierten	pressierten
Zement	Zement
füllst	füllst
aufrichte	aufrichte
jaule	jaule
berührt	berührt
Münzsammlung	Münzsammlung
Haue	Haue
lösten	lösten
Kuckucke	Kuckucke
Kardinal	Kardinal
setze	setze
Kerzenlichter	Kerzenlichter
Fanatiker	Fanatiker
verbärgen	verbärgen
verforme	verforme
setzten	setzten
Ochsen	Ochsen
einst	einst
gestatteten	gestatteten
ermordeten	ermordeten
begehret	begehret
Psi	Psi
hängen	hängen
Böreks	Böreks
dehydrierten	dehydrierten
Raucherinnen	Raucherinnen
Gewürze	Gewürze
verführen	verführen
erkannten	erkannten
handhabest	handhabest
auflöst	auflöst
bezahlt	bezahlt
kämmt	kämmt
Trinkgefäßen	Trinkgefäßen
ausführen	ausführen
Lopariten	Lopariten
Fiebermitteln	Fiebermitteln
Vordenkern	Vordenkern
spekulieren	spekulieren
Galeeren	Galeeren
graben	graben
verwirkliche	verwirkliche
deines	deines
watet	watet
Gasgemisch	Gasgemisch
verschicket	verschicket
Astats	Astats
Orten	Orten
Taufe	Taufe
stapfst	stapfst
bündelet	bündelet
wehte	wehte
implodier	implodier
Monden	Monden
erkältete	erkältete
jedem	jedem
schwächend	schwächend
beleidige	beleidige
erwachet	erwachet
Fragen	Fragen
Girls	Girls
Zwergschwan	Zwergschwan
Einrad	Einrad
Playlist	Playlist
Außenministerien	Außenministerien
stillte	stillte
Taschenwörterbuches	Taschenwörterbuches
reiftet	reiftet
käbbelnd	käbbelnd
lauft	lauft
Gleitzeiten	Gleitzeiten
Minischweine	Minischweine
verzögerte	verzögerte
imprägnieret	imprägnieret
werde	werde
erliegen	erliegen
fraget	fraget
ritze	ritze
Falle	Falle
Anfänger	Anfänger
aufsteht	aufsteht
verachte	verachte
wehrend	wehrend
sprüht	sprüht
Laken	Laken
verlieren	verlieren
Seiten	Seiten
fünfte	fünfte
transportiere	transportiere
betrübend	betrübend
verallgemeinerest	verallgemeinerest
Ringeltauben	Ringeltauben
bestellte	bestellte
Maultier	Maultier
schmuste	schmuste
Hardwareentwicklerin	Hardwareentwicklerin
Kuckucken	Kuckucken
setzt	setzt
kitzele	kitzele
Firnis	Firnis
Heiratsgut	Heiratsgut
Besuchen	Besuchen
Verkehrsflugzeug	Verkehrsflugzeug
Hurriter	Hurriter
erzeigest	erzeigest
beliefen	beliefen
Gepäckträgern	Gepäckträgern
Mähnenwolfes	Mähnenwolfes
reglementierte	reglementierte
klagte	klagte
Fahrt	Fahrt
verdeckt	verdeckt
redete	redete
Amtsträger	Amtsträger
erfahret	erfahret
Knüppeln	Knüppeln
verletzt	verletzt
faule	faule
babbeltet	babbeltet
verkaufst	verkaufst
Drehtüren	Drehtüren
Sonderberichte	Sonderberichte
löset	löset
Last	Last
wollest	wollest
beunruhigte	beunruhigte
Beilen	Beilen
Gespenst	Gespenst
halle	halle
besicheret	besicheret
vergiften	vergiften
Solch	Solch
Tyrannen	Tyrannen
Atemgas	Atemgas
malochet	malochet
bölkte	bölkte
Chinakohl	Chinakohl
Füllen	Füllen
Volkslehre	Volkslehre
Unrecht	Unrecht
Dithiolan	Dithiolan
Notstand	Notstand
kurbelte	kurbelte
entkörperlichte	entkörperlichte
Rückumschlages	Rückumschlages
Videoaufzeichnungen	Videoaufzeichnungen
widmeten	widmeten
Tiegel	Tiegel
Arsenolithen	Arsenolithen
Hubschraubern	Hubschraubern
kreieren	kreieren
Stätte	Stätte
scheucht	scheucht
Kraftfahrzeuges	Kraftfahrzeuges
Mähnenwölfen	Mähnenwölfen
kritzeln	kritzeln
weichst	weichst
sündigt	sündigt
empört	empört
Stücken	Stücken
Metonymie	Metonymie
Anachronismen	Anachronismen
Kalb	Kalb
wispern	wispern
Schilden	Schilden
Sprödmetallen	Sprödmetallen
Einfältigkeit	Einfältigkeit
Türkenbünden	Türkenbünden
ihrem	ihrem
Imperialismen	Imperialismen
Germanist	Germanist
kühle	kühle
Fusselbärten	Fusselbärten
dampfte	dampfte
berücksichtigt	berücksichtigt
Afrikaner	Afrikaner
besprenget	besprenget
war	war
Sorge	Sorge
schaust	schaust
sabbere	sabbere
gereicht	gereicht
überfischt	überfischt
Fiesling	Fiesling
trägt	trägt
Zeitbombe	Zeitbombe
schwöllen	schwöllen
bemühet	bemühet
schaben	schaben
ärgernd	ärgernd
Sucht	Sucht
verschlimmere	verschlimmere
Streiten	Streiten
versagt	versagt
Schlöte	Schlöte
Kassiterits	Kassiterits
verkriechst	verkriechst
steige	steige
sterbet	sterbet
enttäuschet	enttäuschet
Heringen	Heringen
Einwirkungen	Einwirkungen
Cholesterin	Cholesterin
Chlorwasserstoffmoleküls	Chlorwasserstoffmoleküls
zerstreut	zerstreut
Heere	Heere
entmineralisierst	entmineralisierst
aufstehet	aufstehet
besitze	besitze
treibest	treibest
schnorrest	schnorrest
schleiß	schleiß
Amputierte	Amputierte
halte	halte
Steuerwagens	Steuerwagens
strafe	strafe
Schläfchens	Schläfchens
Maultieren	Maultieren
Geschichtsbücher	Geschichtsbücher
explodierten	explodierten
überdenkst	überdenkst
raffinier	raffinier
listeten	listeten
gelang	gelang
verschlungen	verschlungen
knistert	knistert
Namen	Namen
deponierte	deponierte
blenden	blenden
verführte	verführte
Kadavergehorsam	Kadavergehorsam
bestimmt	bestimmt
Rooibos	Rooibos
Träumers	Träumers
bedingst	bedingst
scherzt	scherzt
Geburtsnamen	Geburtsnamen
versklavt	versklavt
austilgest	austilgest
heben	heben
Schlaraffenlandes	Schlaraffenlandes
umgaben	umgaben
demütigst	demütigst
Lusitaner	Lusitaner
beschwöre	beschwöre
beschlug	beschlug
gravierten	gravierten
gönnst	gönnst
Bundesgebiet	Bundesgebiet
geratest	geratest
hatten	hatten
sagtet	sagtet
Finanzministern	Finanzministern
überreichend	überreichend
überbewertet	überbewertet
verschonet	verschonet
Weihen	Weihen
liebst	liebst
Weinberge	Weinberge
euren	euren
kletteret	kletteret
Provinzen	Provinzen
sezierte	sezierte
lebst	lebst
Chemikerinnen	Chemikerinnen
Markisen	Markisen
Rasterkraftmikroskop	Rasterkraftmikroskop
zerreißt	zerreißt
Waren	Waren
verdammt	verdammt
Schneider	Schneider
Werte	Werte
Genkinit	Genkinit
Heide	Heide
Mensch	Mensch
Beteiligten	Beteiligten
Lammfellhandschuhs	Lammfellhandschuhs
Schleppern	Schleppern
Campingplatzes	Campingplatzes
solchen	solchen
prostet	prostet
Wiedergutmachungen	Wiedergutmachungen
strullerte	strullerte
gare	gare
Genetikerin	Genetikerin
vermutet	vermutet
folge	folge
concessioniert	concessioniert
steig	steig
lösen	lösen
herrschst	herrschst
geahnt	geahnt
Geflecktheit	Geflecktheit
Ein	Ein
spaltetest	spaltetest
Scheck	Scheck
verprügelet	verprügelet
schlafet	schlafet
maximierten	maximierten
zähle	zähle
Noseanen	Noseanen
Hinkelstein	Hinkelstein
sprachen	sprachen
zügelten	zügelten
Dudelsack	Dudelsack
sedimentiere	sedimentiere
gelobend	gelobend
Erstarren	Erstarren
kommst	kommst
Seelöwen	Seelöwen
optimierte	optimierte
allen	allen
schauen	schauen
wünschst	wünschst
foppten	foppten
Raute	Raute
brausen	brausen
Floß	Floß
Druckfehler	Druckfehler
Stimmen	Stimmen
besorg	besorg
bedeckst	bedeckst
Gerücht	Gerücht
verhalte	verhalte
Magier	Magier
seht	seht
Pimmel	Pimmel
Shortcut	Shortcut
falteten	falteten
stammelest	stammelest
entwaffnest	entwaffnest
gelobte	gelobte
aufrichtet	aufrichtet
Würzen	Würzen
ungehorsam	ungehorsam
Falz	Falz
Fischzucht	Fischzucht
heiligte	heiligte
Jungfernflüge	Jungfernflüge
weissagst	weissagst
Videoaufzeichnung	Videoaufzeichnung
Pforten	Pforten
Energiespeicher	Energiespeicher
glawbte	glawbte
suchst	suchst
Stilllegung	Stilllegung
besinnen	besinnen
Händedruck	Händedruck
Philerast	Philerast
Taschenwörterbuch	Taschenwörterbuch
salzen	salzen
Dürre	Dürre
Malaysiers	Malaysiers
Schwestern	Schwestern
linke	linke
drücke	drücke
blitzen	blitzen
Geflecktheiten	Geflecktheiten
Stadtbezirken	Stadtbezirken
gedächten	gedächten
Lautschrift	Lautschrift
erzeigten	erzeigten
predigten	predigten
Aktienkurs	Aktienkurs
vergast	vergast
Garten	Garten
Briefwechsel	Briefwechsel
verderben	verderben
Zipfelmütze	Zipfelmütze
Sanatorien	Sanatorien
irrte	irrte
Freitagnachmittage	Freitagnachmittage
Aufträgen	Aufträgen
Zitronensaft	Zitronensaft
Anmeldern	Anmeldern
wähnet	wähnet
bleiben	bleiben
entkämen	entkämen
gebäre	gebäre
reanimierten	reanimierten
Großfürsten	Großfürsten
Gedächtnissen	Gedächtnissen
Trioxiden	Trioxiden
Zehnt	Zehnt
schnitt	schnitt
wiederkamen	wiederkamen
schaffte	schaffte
Würfen	Würfen
Adlerbussard	Adlerbussard
fehlen	fehlen
zürntet	zürntet
wurde	wurde
zerfetzt	zerfetzt
Berichterstattungen	Berichterstattungen
solche	solche
Brieftaubenzüchter	Brieftaubenzüchter
laufe	laufe
schlag	schlag
zensierten	zensierten
schneide	schneide
Kopfsalaten	Kopfsalaten
Hode	Hode
Eissteinen	Eissteinen
dankte	dankte
nähe	nähe
ungefälschtem	ungefälschtem
Maultiere	Maultiere
charakterisiert	charakterisiert
Schanktisch	Schanktisch
häufe	häufe
gelobst	gelobst
Kassiteriten	Kassiteriten
Klotz	Klotz
werdet	werdet
hinterfragten	hinterfragten
Bäusche	Bäusche
knüpfte	knüpfte
Trümmersprache	Trümmersprache
Füchsinnen	Füchsinnen
inszenierst	inszenierst
Adlerbussarden	Adlerbussarden
langte	langte
produzierten	produzierten
übersteht	übersteht
Domäne	Domäne
Kryostat	Kryostat
lüg	lüg
ermordetest	ermordetest
erkaltest	erkaltest
grabest	grabest
Unglaube	Unglaube
Alibi	Alibi
endlagerten	endlagerten
höben	höben
verbitterten	verbitterten
wallfahrteten	wallfahrteten
Leide	Leide
zeuget	zeuget
Drang	Drang
Blumenstrauß	Blumenstrauß
hebet	hebet
liebe	liebe
kollidierte	kollidierte
Polierstahl	Polierstahl
Reiterschwertern	Reiterschwertern
begehrest	begehrest
kapiert	kapiert
Mäusen	Mäusen
harmoniert	harmoniert
nähet	nähet
zwölfte	zwölfte
brillierest	brillierest
punktest	punktest
Fallen	Fallen
glawbten	glawbten
vollendest	vollendest
erriet	erriet
stelle	stelle
knitterte	knitterte
Kriegsenden	Kriegsenden
Fahlflanken-Ameisenwürger	Fahlflanken-Ameisenwürger
reichet	reichet
revoltiert	revoltiert
lüge	lüge
überweis	überweis
umhüllt	umhüllt
sage	sage
Zeithorizonten	Zeithorizonten
Ärzteblatt	Ärzteblatt
Flussbetten	Flussbetten
Meldezettel	Meldezettel
nippend	nippend
Handbüchern	Handbüchern
überwachten	überwachten
teilet	teilet
dienest	dienest
Stall	Stall
Einzelgänger	Einzelgänger
Kriegsknechte	Kriegsknechte
desensibilisierte	desensibilisierte
überreicht	überreicht
sinterte	sinterte
den	den
Hüftgelenken	Hüftgelenken
lobte	lobte
überschneidet	überschneidet
verkaufte	verkaufte
schaut	schaut
karikieret	karikieret
hasse	hasse
erschütterte	erschütterte
pensionierest	pensionierest
Gar	Gar
Stearat	Stearat
Membran	Membran
Spektralbereichen	Spektralbereichen
wehr	wehr
Ypecaharalle	Ypecaharalle
Blicksilber	Blicksilber
Reizen	Reizen
schäumtest	schäumtest
Flaschenhälsen	Flaschenhälsen
installiert	installiert
unsres	unsres
löstet	löstet
spritzt	spritzt
lade	lade
heilte	heilte
Sphären	Sphären
Hanse	Hanse
gedächtet	gedächtet
Alkali	Alkali
bescheißt	bescheißt
berücksichtiget	berücksichtiget
gedenkest	gedenkest
bequemte	bequemte
Setzt	Setzt
kehren	kehren
unterbewertete	unterbewertete
Gesetze	Gesetze
regierest	regierest
schlafe	schlafe
Hirschen	Hirschen
Buchstabe	Buchstabe
Küstenwache	Küstenwache
stolz	stolz
verführtest	verführtest
Schlössern	Schlössern
überschnitten	überschnitten
stoßest	stoßest
sterbt	sterbt
zerstreust	zerstreust
Eiszapfen	Eiszapfen
zwänget	zwänget
Gasflasche	Gasflasche
Zankapfels	Zankapfels
grien	grien
designierst	designierst
Wert	Wert
verkehrten	verkehrten
bespracht	bespracht
stigmatisierst	stigmatisierst
entzweiest	entzweiest
Geschwindigkeitsmessern	Geschwindigkeitsmessern
befehlt	befehlt
föhnest	föhnest
stärkte	stärkte
möpperst	möpperst
assimiliertest	assimiliertest
tanzen	tanzen
Märchenbüchern	Märchenbüchern
quasselten	quasselten
demütige	demütige
Diesen	Diesen
Nachweisreagenzien	Nachweisreagenzien
bemerket	bemerket
Füllfederhalter	Füllfederhalter
wachse	wachse
beeinflusst	beeinflusst
bekennst	bekennst
bezahlest	bezahlest
Kleinode	Kleinode
gefügt	gefügt
Alterität	Alterität
zeltest	zeltest
Zapfhähnen	Zapfhähnen
Führet	Führet
Kompass	Kompass
planschtest	planschtest
Gleitzeit	Gleitzeit
karikierten	karikierten
Elfen	Elfen
tasteten	tasteten
schauend	schauend
Sprechers	Sprechers
Prüfberichten	Prüfberichten
schaffest	schaffest
Atemluft	Atemluft
nähre	nähre
geräuchert	geräuchert
erstehen	erstehen
begehrtet	begehrtet
flupptest	flupptest
Alles	Alles
merket	merket
laden	laden
bemühst	bemühst
Heiden	Heiden
parfümierte	parfümierte
helft	helft
Marjellchens	Marjellchens
bewürben	bewürben
hasset	hasset
Autoklaven	Autoklaven
sprechet	sprechet
Automatikgetriebe	Automatikgetriebe
gelobt	gelobt
Hehler	Hehler
aufnahmen	aufnahmen
aufhebt	aufhebt
Kaliumdichromat	Kaliumdichromat
bombardiertet	bombardiertet
verstrahlten	verstrahlten
schauspielert	schauspielert
Wirtschaftswissenschaft	Wirtschaftswissenschaft
Gemütes	Gemütes
ehre	ehre
Würfelspiel	Würfelspiel
Streite	Streite
frohlockte	frohlockte
schmusen	schmusen
respektiert	respektiert
nachwandelte	nachwandelte
Erbse	Erbse
Sonderbericht	Sonderbericht
Remis	Remis
Politologe	Politologe
Kälber	Kälber
Worten	Worten
knüpfet	knüpfet
reichtet	reichtet
Pinguin	Pinguin
bequemest	bequemest
Subspezies	Subspezies
elfte	elfte
Kreise	Kreise
umhüll	umhüll
Cyanat	Cyanat
Prophet	Prophet
Gicht	Gicht
dümpelst	dümpelst
anrufen	anrufen
anrührte	anrührte
besser	besser
Nullpunktes	Nullpunktes
Fußmatte	Fußmatte
Trichter	Trichter
Monarchien	Monarchien
Introjektion	Introjektion
Trübsale	Trübsale
Laubholz	Laubholz
scheinen	scheinen
tragt	tragt
folgst	folgst
nähret	nähret
Bushaltestelle	Bushaltestelle
verbesserten	verbesserten
verringerten	verringerten
Lebenskraft	Lebenskraft
quantisiere	quantisiere
erzürnt	erzürnt
überschatteten	überschatteten
entheiligten	entheiligten
Planern	Planern
geleite	geleite
schabst	schabst
verstehest	verstehest
Seetaucher	Seetaucher
verleumdetest	verleumdetest
könnet	könnet
generiert	generiert
Gesamtmengen	Gesamtmengen
übte	übte
Hobbys	Hobbys
spielen	spielen
Ionenaustauscher	Ionenaustauscher
Fahlflanken-Ameisenwürgern	Fahlflanken-Ameisenwürgern
verschärftet	verschärftet
steckte	steckte
Verbindungsdrähten	Verbindungsdrähten
saget	saget
wehrtest	wehrtest
Huren	Huren
überlebest	überlebest
zentrifugieren	zentrifugieren
versteckend	versteckend
Theologie	Theologie
halben	halben
entwischtet	entwischtet
kautest	kautest
Ösophagospasmen	Ösophagospasmen
Glühwürmchen	Glühwürmchen
strafen	strafen
baggerte	baggerte
globalisier	globalisier
erwärmte	erwärmte
sedimentieret	sedimentieret
wohnte	wohnte
wilde	wilde
bemerken	bemerken
Grabbeltischen	Grabbeltischen
Fische	Fische
Halter	Halter
Briefe	Briefe
velarisiert	velarisiert
Kompromissen	Kompromissen
verfinstert	verfinstert
Nachruf	Nachruf
fluktuiert	fluktuiert
Unglauben	Unglauben
befürchtet	befürchtet
heiligem	heiligem
ringelten	ringelten
Palme	Palme
dehydrierte	dehydrierte
äussern	äussern
Pflanzung	Pflanzung
Reliquiar	Reliquiar
pflüget	pflüget
verwirrte	verwirrte
Europium	Europium
verberge	verberge
gebieten	gebieten
Gase	Gase
quatschest	quatschest
schmuggelest	schmuggelest
Wiederauferstehung	Wiederauferstehung
rinnt	rinnt
Kriegsschauplatz	Kriegsschauplatz
parliere	parliere
schnüren	schnüren
Feuerteufel	Feuerteufel
Generatoren	Generatoren
Anwendungsgebiet	Anwendungsgebiet
kochte	kochte
Flossen	Flossen
Deutung	Deutung
Theistinnen	Theistinnen
Märtyrern	Märtyrern
Willst	Willst
Welteninsel	Welteninsel
losten	losten
Spurensicherung	Spurensicherung
unser	unser
Molybdit	Molybdit
unserem	unserem
Dorngesträuchen	Dorngesträuchen
hadere	hadere
Entsetzen	Entsetzen
Andrologie	Andrologie
Kerfe	Kerfe
Westen	Westen
surrst	surrst
Denkmünze	Denkmünze
boykottierst	boykottierst
Speere	Speere
Hornung	Hornung
grünte	grünte
Piratensender	Piratensender
Treppen	Treppen
erhebest	erhebest
begäben	begäben
steigerten	steigerten
Weichloten	Weichloten
haare	haare
seit	seit
koche	koche
erforschest	erforschest
strafst	strafst
straftet	straftet
bereue	bereue
ausziehst	ausziehst
Minischwein	Minischwein
erzürnet	erzürnet
verkündigten	verkündigten
bereiteten	bereiteten
führet	führet
schautest	schautest
Schober	Schober
Kruste	Kruste
erbrüte	erbrüte
duckmäusere	duckmäusere
amenagier	amenagier
Recitativ	Recitativ
Briefköpfen	Briefköpfen
zählte	zählte
Augen	Augen
Puffersystemen	Puffersystemen
Seit	Seit
versuchen	versuchen
Ausstiegstüren	Ausstiegstüren
Held	Held
offenbarten	offenbarten
raffiniere	raffiniere
Zwetschge	Zwetschge
Kosten	Kosten
UND-Gattern	UND-Gattern
untersagtest	untersagtest
Solche	Solche
Fingerspitze	Fingerspitze
fritierten	fritierten
Metallothionein	Metallothionein
Essigsäurechlorid	Essigsäurechlorid
massakrierten	massakrierten
Altbau	Altbau
log	log
stürze	stürze
Säcken	Säcken
lispelt	lispelt
machst	machst
Märtyrer	Märtyrer
leid	leid
vermutest	vermutest
Gefilde	Gefilde
Mischelement	Mischelement
Türklingeln	Türklingeln
erlöset	erlöset
sponseret	sponseret
rebellieret	rebellieret
Proton	Proton
geboten	geboten
frottierten	frottierten
grüßend	grüßend
ausrufest	ausrufest
fehle	fehle
Gaschromatographien	Gaschromatographien
enttäusche	enttäusche
Prüfbericht	Prüfbericht
Fetten	Fetten
zeug	zeug
plazierest	plazierest
ermutigte	ermutigte
Rückwege	Rückwege
behalte	behalte
gewinnen	gewinnen
rolltet	rolltet
dolmetschst	dolmetschst
imkernd	imkernd
Abschußring	Abschußring
Hehlern	Hehlern
Pumpellyiten	Pumpellyiten
kauerten	kauerten
Rundbriefen	Rundbriefen
beziehen	beziehen
babbelt	babbelt
überquerst	überquerst
hinterfragst	hinterfragst
reinstitutionalisiert	reinstitutionalisiert
Rheumatismus	Rheumatismus
befestigte	befestigte
Urheimaten	Urheimaten
Monate	Monate
Auge	Auge
Schulleiterin	Schulleiterin
wurdet	wurdet
gebt	gebt
erbet	erbet
Monde	Monde
Wachen	Wachen
Ihren	Ihren
charakterisierend	charakterisierend
fladern	fladern
Übelkeit	Übelkeit
gehören	gehören
Anker	Anker
freute	freute
verachtet	verachtet
Robe	Robe
flöteten	flöteten
Volkslehren	Volkslehren
liebte	liebte
tote	tote
fotzt	fotzt
Freibrief	Freibrief
Fettsack	Fettsack
Preis	Preis
puddelst	puddelst
nagelte	nagelte
stärke	stärke
rufet	rufet
scherze	scherze
Malaysierin	Malaysierin
Same	Same
Ölfasses	Ölfasses
Ölspuren	Ölspuren
stärket	stärket
Geldautomat	Geldautomat
Reinelementen	Reinelementen
Epidemien	Epidemien
Teilen	Teilen
deklarierte	deklarierte
gelost	gelost
inhalierest	inhalierest
strömt	strömt
assimilierten	assimilierten
Fehden	Fehden
bückest	bückest
flitzte	flitzte
Forschungen	Forschungen
bestrafe	bestrafe
erdacht	erdacht
Schuhe	Schuhe
Schlaraffenländern	Schlaraffenländern
Asylrechten	Asylrechten
bewahrheitetet	bewahrheitetet
Däumlingen	Däumlingen
predigte	predigte
Bilderstürmereien	Bilderstürmereien
erscheine	erscheine
Blaumeisen	Blaumeisen
scheitern	scheitern
Kautschuke	Kautschuke
Samstagnachmittagen	Samstagnachmittagen
Trägergas	Trägergas
schlabberte	schlabberte
replizieret	replizieret
Referenzen	Referenzen
pharyngalisierst	pharyngalisierst
Hirnstämmen	Hirnstämmen
flitzen	flitzen
Nehmt	Nehmt
Kohlenstoffgehalt	Kohlenstoffgehalt
Vanadaten	Vanadaten
Eselsohren	Eselsohren
meuterest	meuterest
wehen	wehen
legest	legest
fresse	fresse
fabulierte	fabulierte
gedacht	gedacht
Katalanen	Katalanen
Montagmittag	Montagmittag
Dachdecker	Dachdecker
lancierst	lancierst
Noseans	Noseans
Komponistin	Komponistin
tyrannisiertest	tyrannisiertest
gabelt	gabelt
besetzest	besetzest
Autonomie	Autonomie
Loparite	Loparite
Zipfelmützen	Zipfelmützen
Gasflaschen	Gasflaschen
anders	anders
Bushaltestellen	Bushaltestellen
gewitterest	gewitterest
defragmentierten	defragmentierten
verbitterest	verbitterest
übersiehst	übersiehst
Weinet	Weinet
übrigbleiben	übrigbleiben
fassest	fassest
Woge	Woge
huren	huren
trödeltest	trödeltest
prophezeie	prophezeie
beäugst	beäugst
ertönst	ertönst
schlaf	schlaf
Karer	Karer
jeden	jeden
initiieret	initiieret
Wasserquelle	Wasserquelle
Irrtümern	Irrtümern
konvertiere	konvertiere
Naturen	Naturen
Safran	Safran
spukest	spukest
Thioacetal	Thioacetal
Milchflasche	Milchflasche
Beiblätter	Beiblätter
Abbindebeschleuniger	Abbindebeschleuniger
negierte	negierte
eng	eng
vertuest	vertuest
Rumänin	Rumänin
widerlegte	widerlegte
Stufe	Stufe
Sprichwort	Sprichwort
beanspruchet	beanspruchet
Schauet	Schauet
emendieret	emendieret
Brechnüssen	Brechnüssen
wehrt	wehrt
bereite	bereite
schließt	schließt
stürzest	stürzest
aufstanden	aufstanden
Aase	Aase
Pflanzenstoff	Pflanzenstoff
koexistierte	koexistierte
verfinstere	verfinstere
ärgertest	ärgertest
Heteroatome	Heteroatome
tränke	tränke
reichen	reichen
Brikette	Brikette
Leitkegeln	Leitkegeln
Dienstgrade	Dienstgrade
Buben	Buben
kabbelet	kabbelet
fette	fette
zürn	zürn
wohnet	wohnet
leiten	leiten
entzogen	entzogen
Buchfinken	Buchfinken
weinen	weinen
dritten	dritten
Nadelbäumen	Nadelbäumen
fahret	fahret
Teppichen	Teppichen
stürzte	stürzte
jeder	jeder
stehet	stehet
beweist	beweist
schnappet	schnappet
Bleiglanz	Bleiglanz
Sabbaten	Sabbaten
fluppst	fluppst
quietsche	quietsche
Chronisten	Chronisten
folgen	folgen
kaufte	kaufte
betrübten	betrübten
sitzt	sitzt
Fiasko	Fiasko
steigeret	steigeret
gebären	gebären
gratuliere	gratuliere
Ärgernissen	Ärgernissen
Riegel	Riegel
liebet	liebet
Schrei	Schrei
schmuggelte	schmuggelte
kriegte	kriegte
Fluoratome	Fluoratome
Butzemänner	Butzemänner
changiere	changiere
Wucher	Wucher
flucht	flucht
spezialisiere	spezialisiere
Leugnungen	Leugnungen
Deinen	Deinen
erwache	erwache
stapelten	stapelten
Besteck	Besteck
schauet	schauet
verbaselte	verbaselte
erwachend	erwachend
überschattete	überschattete
begehren	begehren
Eistaucher	Eistaucher
Suchanfrage	Suchanfrage
heißt	heißt
feiert	feiert
werden	werden
heulte	heulte
