versüße	versüße
überschatteten	überschatteten
fabulierest	fabulierest
Buntwaschmittel	Buntwaschmittel
plissierten	plissierten
Schaffe	Schaffe
platzt	platzt
liebt	liebt
Zitronensäften	Zitronensäften
Kanzlei	Kanzlei
erbte	erbte
Nigger	Nigger
Kriegsschauplatz	Kriegsschauplatz
Saiblingen	Saiblingen
besorgt	besorgt
zürnst	zürnst
knistern	knistern
feiere	feiere
referenziere	referenziere
sedimentiert	sedimentiert
Temperaturanstiege	Temperaturanstiege
wachen	wachen
weichet	weichet
Münzsammlungen	Münzsammlungen
instanziier	instanziier
Kehre	Kehre
spritzet	spritzet
schnatternd	schnatternd
enträtselst	enträtselst
verzieht	verzieht
Bärenfelle	Bärenfelle
Meine	Meine
schließt	schließt
verwahret	verwahret
Brikette	Brikette
Gepäckträger	Gepäckträger
beäugst	beäugst
fotzte	fotzte
Dürren	Dürren
gebäre	gebäre
verschärfst	verschärfst
Abnahmen	Abnahmen
Recitativen	Recitativen
belauerten	belauerten
schneide	schneide
Sitzfleisch	Sitzfleisch
bölket	bölket
stiege	stiege
versuchen	versuchen
Schreibtischtätern	Schreibtischtätern
analysierest	analysierest
aufkommt	aufkommt
wehe	wehe
fistet	fistet
Verdacht	Verdacht
Gammastrahlen	Gammastrahlen
Minischwein	Minischwein
Kosten	Kosten
Lenkstange	Lenkstange
faschieren	faschieren
verklärest	verklärest
kaufet	kaufet
Planer	Planer
Berufe	Berufe
gebäret	gebäret
Stierkämpfe	Stierkämpfe
Erzeugung	Erzeugung
planschtest	planschtest
kappet	kappet
glawbte	glawbte
verkürze	verkürze
verdrehet	verdrehet
Monden	Monden
Zwingburg	Zwingburg
missversteht	missversteht
Ratsherren	Ratsherren
begehrtest	begehrtest
pensionierten	pensionierten
Gemurmel	Gemurmel
erlöse	erlöse
verschafft	verschafft
endlagern	endlagern
revoltierte	revoltierte
Oxalaten	Oxalaten
lockerst	lockerst
Grenze	Grenze
Beiblätter	Beiblätter
Tieren	Tieren
Efeu	Efeu
Verwaltungsakten	Verwaltungsakten
zeichnet	zeichnet
schau	schau
Zankapfels	Zankapfels
Lärchen	Lärchen
auflegt	auflegt
attestiertet	attestiertet
Stadtbezirke	Stadtbezirke
Deck	Deck
liebet	liebet
Paradiesäpfeln	Paradiesäpfeln
reparieret	reparieret
protestiere	protestiere
Vogelscheuche	Vogelscheuche
verlautet	verlautet
erinnerest	erinnerest
nähet	nähet
belauere	belauere
klumpe	klumpe
misstrauet	misstrauet
umgaben	umgaben
verboten	verboten
genehmigt	genehmigt
bewieset	bewieset
Unterseiten	Unterseiten
Fußballweltmeisterschaftsqualifikationsspielen	Fußballweltmeisterschaftsqualifikationsspielen
betrete	betrete
Münzsammlung	Münzsammlung
schwöllen	schwöllen
Teilen	Teilen
Erfahrungen	Erfahrungen
Langschwanzpinguinen	Langschwanzpinguinen
Wille	Wille
ernteten	ernteten
gehörst	gehörst
spähet	spähet
hicksest	hicksest
Fussel	Fussel
Abbindebeschleunigern	Abbindebeschleunigern
Leitungswegs	Leitungswegs
verbündend	verbündend
vereinigte	vereinigte
dressierten	dressierten
verabschiedeten	verabschiedeten
hängte	hängte
übersiehst	übersiehst
Agoraphobie	Agoraphobie
erben	erben
malochet	malochet
Luftschiff	Luftschiff
Sprachräumen	Sprachräumen
bequemte	bequemte
leihe	leihe
Druckfehlern	Druckfehlern
werde	werde
Reinelementen	Reinelementen
Adelungen	Adelungen
eggte	eggte
Reiseleitern	Reiseleitern
Leitungsweg	Leitungsweg
Gehorchet	Gehorchet
Metapher	Metapher
Affenbrotbaum	Affenbrotbaum
pflanzte	pflanzte
Bunde	Bunde
Aggressoren	Aggressoren
Uranerzen	Uranerzen
eingeht	eingeht
blaset	blaset
Normdatum	Normdatum
freiwilligen	freiwilligen
trefft	trefft
Beteiligte	Beteiligte
Botokuden	Botokuden
Ratsherr	Ratsherr
punktest	punktest
tun	tun
benachrichtiget	benachrichtiget
Raute	Raute
Abschreckung	Abschreckung
benütztest	benütztest
Cola	Cola
boykottierst	boykottierst
Genkinits	Genkinits
Katamaranen	Katamaranen
zerbrechest	zerbrechest
stammelest	stammelest
legte	legte
ausgeht	ausgeht
liege	liege
Anzeichens	Anzeichens
Kindergeldern	Kindergeldern
Stoffwechselwegen	Stoffwechselwegen
stifte	stifte
durchzuckest	durchzuckest
Kontrollkästchen	Kontrollkästchen
erbringen	erbringen
gewähr	gewähr
Suchanfragen	Suchanfragen
besuche	besuche
bracht	bracht
hievten	hievten
schnorrtet	schnorrtet
Kautschuken	Kautschuken
verdammend	verdammend
Erzeugungen	Erzeugungen
listeten	listeten
Leichenschauhäusern	Leichenschauhäusern
Ringen	Ringen
verkürzest	verkürzest
klappen	klappen
Hornung	Hornung
prahlet	prahlet
amenagieren	amenagieren
mehret	mehret
Adelung	Adelung
addierest	addierest
verallgemeinerst	verallgemeinerst
Früchtchen	Früchtchen
gähne	gähne
mögt	mögt
Hahnenkämmen	Hahnenkämmen
zürntest	zürntest
Almanachen	Almanachen
verschicket	verschicket
brachen	brachen
unterscheide	unterscheide
Schau	Schau
Lusitaner	Lusitaner
Türkenbünden	Türkenbünden
Feuerteufel	Feuerteufel
Pfleglinge	Pfleglinge
Dorsche	Dorsche
Kryostat	Kryostat
stickten	stickten
verunreinigst	verunreinigst
protokollieren	protokollieren
wallet	wallet
Zipfelmütze	Zipfelmütze
Skorpionen	Skorpionen
Marokkanern	Marokkanern
Polizeisprecher	Polizeisprecher
Markise	Markise
Grabbeltischen	Grabbeltischen
klemmen	klemmen
erriet	erriet
verantwortetest	verantwortetest
polymerisier	polymerisier
Tintenklecks	Tintenklecks
begrabe	begrabe
Rutheniumkomplexen	Rutheniumkomplexen
betrüge	betrüge
erwischten	erwischten
betätigest	betätigest
Streite	Streite
Malaysiers	Malaysiers
verbaselte	verbaselte
Halter	Halter
Metallquirlen	Metallquirlen
schlafest	schlafest
gründe	gründe
kollidierten	kollidierten
Reiterschwertern	Reiterschwertern
stirbst	stirbst
knuffend	knuffend
raubte	raubte
verfange	verfange
Chemikerinnen	Chemikerinnen
Kompromissen	Kompromissen
colorierten	colorierten
Judenrat	Judenrat
preisen	preisen
Unrecht	Unrecht
funktionalisiertest	funktionalisiertest
wollt	wollt
tobend	tobend
liegst	liegst
verschlungen	verschlungen
klage	klage
initiierst	initiierst
gedachtest	gedachtest
Wiederauferstehungen	Wiederauferstehungen
Ställe	Ställe
verbaseln	verbaseln
grabe	grabe
schneidend	schneidend
frohlockte	frohlockte
älteste	älteste
Backpflaumen	Backpflaumen
gewitterest	gewitterest
zuppte	zuppte
parfümierte	parfümierte
Germanisten	Germanisten
Schild	Schild
säumen	säumen
Beobachtung	Beobachtung
drosselt	drosselt
Brechnuss	Brechnuss
erkennet	erkennet
Asiatin	Asiatin
konnotierst	konnotierst
Bleigehalt	Bleigehalt
kehrst	kehrst
Mutagenen	Mutagenen
entheilige	entheilige
Emmer	Emmer
Schneepflug	Schneepflug
türmt	türmt
kritzelst	kritzelst
sagen	sagen
sedimentierte	sedimentierte
fabuliert	fabuliert
antworte	antworte
Schwester	Schwester
gehet	gehet
Heuhaufen	Heuhaufen
erschüttere	erschüttere
Feierabende	Feierabende
Physikerinnen	Physikerinnen
erklinge	erklinge
pharyngalisierst	pharyngalisierst
Schneidern	Schneidern
Komplexionen	Komplexionen
kritzele	kritzele
Meter	Meter
schubset	schubset
Euter	Euter
Polierstahl	Polierstahl
Reichweiten	Reichweiten
Hummel	Hummel
Kürass	Kürass
kickend	kickend
Geheimdienst	Geheimdienst
folgen	folgen
sehnet	sehnet
betrüben	betrüben
gehorchet	gehorchet
Küstenwachen	Küstenwachen
repräsentieret	repräsentieret
pfände	pfände
Brite	Brite
Verkehrsflugzeug	Verkehrsflugzeug
vergast	vergast
unterdrücke	unterdrücke
hastete	hastete
Schwarzseherin	Schwarzseherin
zählend	zählend
Dachdeckerin	Dachdeckerin
Schleppern	Schleppern
karikierten	karikierten
Eselsohren	Eselsohren
malen	malen
besorgest	besorgest
glänzte	glänzte
tagest	tagest
schwangt	schwangt
deaktiviere	deaktiviere
bücktest	bücktest
Fellhandschuh	Fellhandschuh
lebte	lebte
schaffest	schaffest
gehorchest	gehorchest
beleuchte	beleuchte
Pausbacke	Pausbacke
hämmerte	hämmerte
Abschirmung	Abschirmung
blätteret	blätteret
entmineralisierten	entmineralisierten
erlabet	erlabet
amenagiere	amenagiere
Durchbruches	Durchbruches
Flussbetten	Flussbetten
säuselest	säuselest
Myriade	Myriade
Einsätzen	Einsätzen
lohnt	lohnt
maximiere	maximiere
spielen	spielen
steigest	steigest
lügen	lügen
watete	watete
beschert	beschert
konnotieret	konnotieret
harmoniere	harmoniere
flitzte	flitzte
Kerzenfischen	Kerzenfischen
Treibhausgasen	Treibhausgasen
Schnute	Schnute
wart	wart
betrübend	betrübend
besichtiget	besichtiget
deponierte	deponierte
Langzeichen	Langzeichen
verspätete	verspätete
ruckelst	ruckelst
kaufte	kaufte
zerschlagt	zerschlagt
wiederholten	wiederholten
Machet	Machet
wichste	wichste
Frieden	Frieden
finanziert	finanziert
Denkmünzen	Denkmünzen
streifte	streifte
nippend	nippend
Erdkruste	Erdkruste
glaubten	glaubten
hingehet	hingehet
säet	säet
parfümierst	parfümierst
zuppt	zuppt
erbet	erbet
Schulleiterin	Schulleiterin
kategorisierst	kategorisierst
Organistin	Organistin
Robe	Robe
verunziere	verunziere
Dobermännern	Dobermännern
Totgeburten	Totgeburten
verwiesen	verwiesen
denaturierte	denaturierte
Atommodellen	Atommodellen
schätze	schätze
Organisationen	Organisationen
überweiset	überweiset
moppte	moppte
Acetat	Acetat
defragmentierten	defragmentierten
duzen	duzen
lögen	lögen
Schanktisch	Schanktisch
maß	maß
begehrte	begehrte
Jünger	Jünger
Wasserbades	Wasserbades
schwenkt	schwenkt
verscheißerte	verscheißerte
Loparite	Loparite
verbündest	verbündest
raubet	raubet
zweifeln	zweifeln
liehen	liehen
kristallisiertest	kristallisiertest
Sonnenfinsternis	Sonnenfinsternis
Lautschrift	Lautschrift
Hände	Hände
erkaltest	erkaltest
Küchenmaschine	Küchenmaschine
Hochsommern	Hochsommern
zuppe	zuppe
Stearat	Stearat
befestigten	befestigten
überweisend	überweisend
kabbelnd	kabbelnd
parametrisierte	parametrisierte
Kürasse	Kürasse
spurtest	spurtest
kapiert	kapiert
gelobest	gelobest
tappst	tappst
Hochzeitstorten	Hochzeitstorten
höret	höret
grüßend	grüßend
führst	führst
infiziertet	infiziertet
Panzerschreck	Panzerschreck
absolviertet	absolviertet
hingehst	hingehst
Zehen	Zehen
Traggasen	Traggasen
überweise	überweise
baute	baute
Fanmeilen	Fanmeilen
erhebest	erhebest
Hacker	Hacker
keulst	keulst
Assistentinnen	Assistentinnen
überschnitten	überschnitten
Steuerwagens	Steuerwagens
kreieren	kreieren
Bundesgebieten	Bundesgebieten
verstört	verstört
Lötzinn	Lötzinn
ruhest	ruhest
Deckenfarbe	Deckenfarbe
bemerket	bemerket
veranstaltest	veranstaltest
Gespenst	Gespenst
Chlorid	Chlorid
blitze	blitze
beschlaget	beschlaget
ausführen	ausführen
verdammst	verdammst
glaubest	glaubest
simulierst	simulierst
opfern	opfern
deponiere	deponiere
Leugnungen	Leugnungen
Pflanzenwachstum	Pflanzenwachstum
Lazarett	Lazarett
graben	graben
zerstreuest	zerstreuest
verdreht	verdreht
Türkin	Türkin
Zebrahai	Zebrahai
Hörst	Hörst
diskutierst	diskutierst
räumen	räumen
Nanotesla	Nanotesla
Komponisten	Komponisten
Bildschirmfotos	Bildschirmfotos
bestrafe	bestrafe
Moren	Moren
Päckchens	Päckchens
bemühten	bemühten
Zeitbomben	Zeitbomben
Ebene	Ebene
Herabsetzung	Herabsetzung
besichtigt	besichtigt
steinigst	steinigst
wetzte	wetzte
geselle	geselle
wünschet	wünschet
Metallspiegel	Metallspiegel
ritzten	ritzten
Pläsier	Pläsier
Mischelement	Mischelement
Zubrötchen	Zubrötchen
Möbiusbänder	Möbiusbänder
tage	tage
lüftetet	lüftetet
zersetzet	zersetzet
heilet	heilet
Enthärtungen	Enthärtungen
verlötest	verlötest
predigtest	predigtest
Seehechte	Seehechte
Held	Held
Politologe	Politologe
Ochs	Ochs
Dolde	Dolde
Langeweile	Langeweile
Stilllegungen	Stilllegungen
deklarierten	deklarierten
schmeichelest	schmeichelest
sabbelt	sabbelt
Schneepflügen	Schneepflügen
Lautschriften	Lautschriften
entzogen	entzogen
gehörten	gehörten
imprägnieret	imprägnieret
Nanosatelliten	Nanosatelliten
Hirnstämme	Hirnstämme
Garten	Garten
Heeren	Heeren
Isolatoren	Isolatoren
gesellt	gesellt
verkleinern	verkleinern
Adeliepinguin	Adeliepinguin
Unternehmensanwendungsintegrationen	Unternehmensanwendungsintegrationen
härte	härte
Kernladungszahlen	Kernladungszahlen
Blaumeise	Blaumeise
quantisiere	quantisiere
zerfielen	zerfielen
stoße	stoße
Abarten	Abarten
trage	trage
hure	hure
klumpt	klumpt
Sippe	Sippe
bestellte	bestellte
Oxonium	Oxonium
Wurzelwachstum	Wurzelwachstum
Überschüssen	Überschüssen
dehydrierten	dehydrierten
polymerisierte	polymerisierte
vertiefet	vertiefet
tastet	tastet
changiere	changiere
säusele	säusele
Hochsommer	Hochsommer
substituierest	substituierest
gönnst	gönnst
Meerschweinchen	Meerschweinchen
Hinterwäldlern	Hinterwäldlern
versteckte	versteckte
Schlagzeugern	Schlagzeugern
hängen	hängen
schubse	schubse
warst	warst
desensibilisierten	desensibilisierten
Gläubigen	Gläubigen
Hanse	Hanse
faule	faule
beantrage	beantrage
parkierten	parkierten
verunglimpftet	verunglimpftet
spekuliere	spekuliere
Reststoffen	Reststoffen
überschattet	überschattet
foppst	foppst
Füllfederhalter	Füllfederhalter
Bevölkerungsdichten	Bevölkerungsdichten
rangierst	rangierst
schlängelt	schlängelt
chloroformiere	chloroformiere
spaltest	spaltest
vernickele	vernickele
föchten	föchten
blondieren	blondieren
versuchet	versuchet
Taufe	Taufe
Lautwandeln	Lautwandeln
glaubt	glaubt
fälle	fälle
koexistierten	koexistierten
Imperialismen	Imperialismen
kommest	kommest
flötete	flötete
Mikrometer	Mikrometer
zerfielest	zerfielest
Hadith	Hadith
konsumiere	konsumiere
Bebauungsplänen	Bebauungsplänen
wässerten	wässerten
charakterisierend	charakterisierend
entwischtet	entwischtet
Tumult	Tumult
konvergierest	konvergierest
Radsätzen	Radsätzen
Holzquirl	Holzquirl
blockiert	blockiert
betrübest	betrübest
weinet	weinet
erstaunst	erstaunst
linsten	linsten
stehet	stehet
Kairiner	Kairiner
bemächtigte	bemächtigte
Indianern	Indianern
behauptest	behauptest
zentrierest	zentrierest
berufe	berufe
Grab	Grab
Suffix	Suffix
verglühest	verglühest
Graphem	Graphem
Schwächung	Schwächung
folgtet	folgtet
bollerte	bollerte
Girls	Girls
verjährte	verjährte
scheiterest	scheiterest
UND-Gattern	UND-Gattern
knurrt	knurrt
Wasserquellen	Wasserquellen
täuschte	täuschte
Halbmonden	Halbmonden
injizierest	injizierest
Gaschromatographie	Gaschromatographie
erstürmet	erstürmet
Kontrollboxen	Kontrollboxen
arrivierst	arrivierst
Möbelstoff	Möbelstoff
Noseanen	Noseanen
hegt	hegt
Autoklav	Autoklav
schimmerst	schimmerst
Massenanteil	Massenanteil
Rechnung	Rechnung
läuten	läuten
Wucher	Wucher
Radiergummi	Radiergummi
denaturierten	denaturierten
kauern	kauern
Thioacetalen	Thioacetalen
Kutter	Kutter
Butzemänner	Butzemänner
verrosteten	verrosteten
Haarverlust	Haarverlust
feierst	feierst
Epoxide	Epoxide
Puffersystemen	Puffersystemen
stellen	stellen
gelobtet	gelobtet
konstatiertest	konstatiertest
feiertest	feiertest
Eisenkraut	Eisenkraut
addieren	addieren
Hüfte	Hüfte
tätowiertet	tätowiertet
rammte	rammte
Päderast	Päderast
reformierten	reformierten
Platte	Platte
hintertrieben	hintertrieben
meuterest	meuterest
prophezeie	prophezeie
gehorchten	gehorchten
schwellen	schwellen
reifte	reifte
beweiset	beweiset
wechselwirkte	wechselwirkte
panaschieren	panaschieren
verurteilen	verurteilen
dekoriere	dekoriere
klettert	klettert
Bettlers	Bettlers
pipettierten	pipettierten
emendierte	emendierte
platz	platz
geboten	geboten
Thioacetal	Thioacetal
Pater	Pater
überfischte	überfischte
lautete	lautete
Päckchen	Päckchen
Baisers	Baisers
lüg	lüg
Basilisk	Basilisk
Seile	Seile
Abbildern	Abbildern
beseht	beseht
bromiert	bromiert
steigerten	steigerten
Würfen	Würfen
verstecke	verstecke
empört	empört
Achsel	Achsel
klagte	klagte
überdächte	überdächte
Abhängen	Abhängen
aufrichtet	aufrichtet
Bertrandit	Bertrandit
UND-Gatter	UND-Gatter
Wehre	Wehre
schlabbere	schlabbere
vertrage	vertrage
mögest	mögest
Kleptokratien	Kleptokratien
Eiszapfens	Eiszapfens
Raucherin	Raucherin
Stärkungsmittel	Stärkungsmittel
reiche	reiche
Aspartamen	Aspartamen
konsumieren	konsumieren
fahret	fahret
bildest	bildest
Excimerlasern	Excimerlasern
Wehklage	Wehklage
Kerzenlichtern	Kerzenlichtern
googelest	googelest
Gebäcken	Gebäcken
verschlimmerte	verschlimmerte
arbeit	arbeit
Einrad	Einrad
Kleinodien	Kleinodien
Brieftaubenzüchters	Brieftaubenzüchters
Bienenzüchter	Bienenzüchter
Grenzwert	Grenzwert
befehle	befehle
Bote	Bote
vereinigt	vereinigt
Libellen	Libellen
anrührte	anrührte
Hochhäusern	Hochhäusern
Rücktrittbremse	Rücktrittbremse
wehrtest	wehrtest
Futur	Futur
Stoffwechselweg	Stoffwechselweg
frikassiert	frikassiert
Animation	Animation
Enden	Enden
ärgerte	ärgerte
beschwindele	beschwindele
mehrte	mehrte
bemühet	bemühet
Gedicht	Gedicht
schmuggele	schmuggele
Haltepunkt	Haltepunkt
Marjellchens	Marjellchens
impfst	impfst
Sorget	Sorget
Würze	Würze
harrest	harrest
weg	weg
Rechtsruck	Rechtsruck
klemmt	klemmt
Komponistinnen	Komponistinnen
Brechnüssen	Brechnüssen
spannt	spannt
reicht	reicht
verzweigt	verzweigt
Staatsanleihe	Staatsanleihe
babbelt	babbelt
Lazarette	Lazarette
Dachdecker	Dachdecker
Aggressor	Aggressor
kürzest	kürzest
schmetterst	schmetterst
spracht	spracht
berücksichtigt	berücksichtigt
sitzt	sitzt
Blitzen	Blitzen
repräsentierten	repräsentierten
gebührt	gebührt
Aprikose	Aprikose
ermahnt	ermahnt
Kardinal	Kardinal
begehrend	begehrend
entwischten	entwischten
flambierest	flambierest
Falzen	Falzen
ermordetet	ermordetet
Rotzinkerzen	Rotzinkerzen
Assistentin	Assistentin
still	still
Blumenstrauß	Blumenstrauß
verantwortet	verantwortet
gelobet	gelobet
pflügten	pflügten
Zeitbombe	Zeitbombe
Katalanen	Katalanen
konvertiere	konvertiere
dolmetschst	dolmetschst
Drohkulisse	Drohkulisse
sollst	sollst
gleitest	gleitest
helft	helft
protestieret	protestieret
bewiesen	bewiesen
klonet	klonet
ringe	ringe
erbaust	erbaust
defragmentierest	defragmentierest
besehet	besehet
fingiere	fingiere
Brieföffners	Brieföffners
Basilikum	Basilikum
Tetraiodide	Tetraiodide
Gemüt	Gemüt
Seetauchers	Seetauchers
streutet	streutet
wirft	wirft
Stechpalmen	Stechpalmen
Kardinäle	Kardinäle
Videoaufzeichnung	Videoaufzeichnung
stoppte	stoppte
grüße	grüße
googelten	googelten
durchwachen	durchwachen
schnitt	schnitt
bedeckst	bedeckst
segeln	segeln
Kanzlerinnen	Kanzlerinnen
vernickelte	vernickelte
Tyrannen	Tyrannen
Leset	Leset
Lusitaners	Lusitaners
glaubte	glaubte
wehrte	wehrte
thematisierten	thematisierten
Außenministerien	Außenministerien
Beten	Beten
schießen	schießen
sedimentiere	sedimentiere
aufrichte	aufrichte
gelobt	gelobt
Stufe	Stufe
parlieren	parlieren
erntest	erntest
Arme	Arme
recycelten	recycelten
mikrominiaturisiere	mikrominiaturisiere
Lebenskraft	Lebenskraft
klingest	klingest
wehen	wehen
Sauberfrauen	Sauberfrauen
bauet	bauet
scheuchtest	scheuchtest
knautsche	knautsche
Metallspiegeln	Metallspiegeln
reden	reden
waren	waren
gedachte	gedachte
verpufftest	verpufftest
heißt	heißt
verwirklicht	verwirklicht
pflanzest	pflanzest
Unwahrheit	Unwahrheit
Maße	Maße
dotiere	dotiere
Empfängnisverhütungen	Empfängnisverhütungen
tatteret	tatteret
schöpfest	schöpfest
interagierte	interagierte
erlösen	erlösen
wachsen	wachsen
Berge	Berge
Schlagzeuger	Schlagzeuger
schauest	schauest
fluppt	fluppt
Trickbetrügern	Trickbetrügern
gestattest	gestattest
Krustentier	Krustentier
amenagierst	amenagierst
stürze	stürze
versteigernd	versteigernd
Monarchien	Monarchien
köderet	köderet
Zahnfleischentzündung	Zahnfleischentzündung
recycele	recycele
sezierte	sezierte
betrübst	betrübst
gelobte	gelobte
erscheinest	erscheinest
funzen	funzen
berufen	berufen
drillest	drillest
erstarrten	erstarrten
Trinket	Trinket
kabeln	kabeln
Leuchtstoffen	Leuchtstoffen
erwärmten	erwärmten
Unternehmung	Unternehmung
stapfst	stapfst
vertiefe	vertiefe
fraget	fraget
Sprödmetallen	Sprödmetallen
imprägniere	imprägniere
häufe	häufe
verfehle	verfehle
regelet	regelet
geleiteten	geleiteten
Montagmittagen	Montagmittagen
Suchanfrage	Suchanfrage
Melanteriten	Melanteriten
Drillingen	Drillingen
Diagnostik	Diagnostik
beschlug	beschlug
Shortcuts	Shortcuts
Schnittlauche	Schnittlauche
Adlerbussard	Adlerbussard
Zehnt	Zehnt
sicherst	sicherst
Wegen	Wegen
wehren	wehren
Eissteinen	Eissteinen
Republikflucht	Republikflucht
Leuchtkäfer	Leuchtkäfer
verbluten	verbluten
gafften	gafften
destabilisierst	destabilisierst
grübelte	grübelte
Anhängsel	Anhängsel
blitzen	blitzen
Schal	Schal
driftete	driftete
Laiben	Laiben
Antitranspiranten	Antitranspiranten
privatisierest	privatisierest
gereicht	gereicht
Fettsack	Fettsack
orgelt	orgelt
Genetikerin	Genetikerin
Dünungen	Dünungen
Traubenlese	Traubenlese
separieret	separieret
verdrängt	verdrängt
Schreiben	Schreiben
Samarskite	Samarskite
Krankenschein	Krankenschein
erwürgest	erwürgest
verseuchen	verseuchen
prangest	prangest
NAND-Gatter	NAND-Gatter
haben	haben
Epidemie	Epidemie
Anhängseln	Anhängseln
vergiftet	vergiftet
türmen	türmen
reanimiere	reanimiere
Ackerschachtelhalme	Ackerschachtelhalme
Friesen	Friesen
lösten	lösten
dividiert	dividiert
infizieret	infizieret
schenket	schenket
Penis	Penis
Kleinod	Kleinod
werden	werden
Mähnenwölfen	Mähnenwölfen
Decks	Decks
funkeln	funkeln
Gehirnwelle	Gehirnwelle
Bilderstürmers	Bilderstürmers
Eutern	Eutern
Notstand	Notstand
malt	malt
käbbelnd	käbbelnd
blase	blase
rühmet	rühmet
Honigbären	Honigbären
Trümmersprache	Trümmersprache
reizet	reizet
Ecke	Ecke
Tollkirsche	Tollkirsche
Blaumeisen	Blaumeisen
Trinken	Trinken
leerst	leerst
Treppen	Treppen
schrecken	schrecken
kappten	kappten
merkte	merkte
Excimerlaser	Excimerlaser
Vaginen	Vaginen
Türmen	Türmen
glänzt	glänzt
thematisierte	thematisierte
fehlte	fehlte
Galopps	Galopps
reifst	reifst
Festons	Festons
sedimentieret	sedimentieret
knusperst	knusperst
sagt	sagt
Hurriter	Hurriter
Fluorgehalte	Fluorgehalte
linstest	linstest
verkleinerest	verkleinerest
Entsetzt	Entsetzt
glaubtet	glaubtet
zürnest	zürnest
egalisiertet	egalisiertet
Gelobet	Gelobet
Brandbeschleuniger	Brandbeschleuniger
herrschen	herrschen
schälte	schälte
erliegest	erliegest
scheuchen	scheuchen
Öfchen	Öfchen
erstände	erstände
Lobe	Lobe
Magier	Magier
löst	löst
gewöhnte	gewöhnte
verschont	verschont
bessere	bessere
glaubet	glaubet
Aerosolen	Aerosolen
grauten	grauten
Hallelujas	Hallelujas
besitzet	besitzet
Version	Version
sterilisierten	sterilisierten
füllte	füllte
behaltest	behaltest
beauftragt	beauftragt
binde	binde
initiieret	initiieret
Begrenzung	Begrenzung
formulieren	formulieren
Bauwerken	Bauwerken
kramst	kramst
tunet	tunet
langweiltest	langweiltest
Inkarnationen	Inkarnationen
ausführt	ausführt
fehlet	fehlet
parametrisierten	parametrisierten
frohlockten	frohlockten
Bazziten	Bazziten
Zinkat	Zinkat
Skorpione	Skorpione
berücksichtiget	berücksichtiget
Reisebüros	Reisebüros
Lärche	Lärche
entstände	entstände
Panzerschrecke	Panzerschrecke
bemühst	bemühst
haschiert	haschiert
Orgeln	Orgeln
Gefängnissen	Gefängnissen
verlassen	verlassen
drängte	drängte
Westen	Westen
Hadithe	Hadithe
verringertet	verringertet
knüpfet	knüpfet
Hubschraubern	Hubschraubern
Kompass	Kompass
heißet	heißet
Politologen	Politologen
verberge	verberge
Gegebenheiten	Gegebenheiten
Roben	Roben
Knüppels	Knüppels
wünscht	wünscht
verkleidete	verkleidete
vibriere	vibriere
Trägerwellen	Trägerwellen
hetzte	hetzte
bezahlst	bezahlst
Besprechung	Besprechung
leite	leite
umarbeiten	umarbeiten
Lasten	Lasten
huren	huren
danke	danke
Pailletten	Pailletten
grünte	grünte
Halogenatomen	Halogenatomen
Banknoten	Banknoten
ackerest	ackerest
Rinde	Rinde
fragest	fragest
Hobby	Hobby
plärrt	plärrt
jaule	jaule
Dominicanerin	Dominicanerin
schlabberten	schlabberten
wallte	wallte
gestalten	gestalten
Asylrechte	Asylrechte
bückest	bückest
Augengläsern	Augengläsern
verselbständigst	verselbständigst
fritierten	fritierten
Fluoratome	Fluoratome
Nukleinsäuren	Nukleinsäuren
hörest	hörest
Buchhalterinnen	Buchhalterinnen
Anmelder	Anmelder
blockierten	blockierten
Pfründe	Pfründe
dirigiert	dirigiert
Übelkeit	Übelkeit
Azubi	Azubi
genieret	genieret
Baiser	Baiser
strafen	strafen
Anarchisten	Anarchisten
grünet	grünet
frottier	frottier
Bäusche	Bäusche
predigen	predigen
Homodimeren	Homodimeren
prosteten	prosteten
verdeckst	verdeckst
steiget	steiget
klicket	klicket
sponsertest	sponsertest
Dewargefäße	Dewargefäße
stimme	stimme
Fusseln	Fusseln
spukte	spukte
inhalierest	inhalierest
Gesetzen	Gesetzen
Massenanteilen	Massenanteilen
Spirale	Spirale
harmonierte	harmonierte
Monarchie	Monarchie
Pflaumen	Pflaumen
Sucht	Sucht
beanspruchet	beanspruchet
Großstädtern	Großstädtern
fritierst	fritierst
Stall	Stall
mampfen	mampfen
verbitterte	verbitterte
Ion	Ion
widmet	widmet
schlage	schlage
begnügte	begnügte
ladest	ladest
gewährte	gewährte
Märchenbüchern	Märchenbüchern
Chronisten	Chronisten
Briefe	Briefe
preiset	preiset
bereitend	bereitend
begehrt	begehrt
pulsiere	pulsiere
eingehest	eingehest
Fußmatte	Fußmatte
Serverzugriffen	Serverzugriffen
zierte	zierte
benähmen	benähmen
zähltet	zähltet
Rotzinkerz	Rotzinkerz
Brötchen	Brötchen
Stimmen	Stimmen
vereinbaren	vereinbaren
Kalb	Kalb
ältesten	ältesten
sitzest	sitzest
legten	legten
Händen	Händen
könnt	könnt
verunglimpfest	verunglimpfest
stellet	stellet
brechet	brechet
auflegst	auflegst
wünschst	wünschst
verlobte	verlobte
Männlein	Männlein
rufe	rufe
Gleitzeit	Gleitzeit
Playlist	Playlist
Abschreckungen	Abschreckungen
traueret	traueret
nagelest	nagelest
hasset	hasset
Geburtsnamen	Geburtsnamen
Wembley-Tore	Wembley-Tore
Fluoratomen	Fluoratomen
ärgerst	ärgerst
plissiere	plissiere
ausgehst	ausgehst
Hallen	Hallen
Weinberge	Weinberge
Keile	Keile
Otaviten	Otaviten
harmonierest	harmonierest
nahte	nahte
Blockflöten	Blockflöten
piesacken	piesacken
erscheine	erscheine
Substanz	Substanz
begliche	begliche
zerstreust	zerstreust
duschten	duschten
Gnaden	Gnaden
verzierten	verzierten
Staatsführungen	Staatsführungen
Psi	Psi
spritzt	spritzt
Schanktischen	Schanktischen
Schreibtischtäter	Schreibtischtäter
Ahnen	Ahnen
erfüllst	erfüllst
Siglen	Siglen
Tollkirschen	Tollkirschen
Gewinnungen	Gewinnungen
Suffixen	Suffixen
Auszüge	Auszüge
emaillieret	emaillieret
verkröchet	verkröchet
amenagier	amenagier
Piratensender	Piratensender
borgte	borgte
Adamsapfel	Adamsapfel
Raucherinnen	Raucherinnen
prediget	prediget
Fischzucht	Fischzucht
dekompilierten	dekompilierten
verliert	verliert
köderte	köderte
kräuselten	kräuselten
Germanist	Germanist
erziehst	erziehst
Bajonetten	Bajonetten
demoralisiere	demoralisiere
Leichenschauhäuser	Leichenschauhäuser
Steuerberatern	Steuerberatern
querte	querte
Domäne	Domäne
Pausbacken	Pausbacken
Nehmet	Nehmet
verleumdetest	verleumdetest
Kristalle	Kristalle
Führe	Führe
aase	aase
Schneider	Schneider
Schnittlauch	Schnittlauch
Bluff	Bluff
dringen	dringen
negierest	negierest
kabelst	kabelst
Fiasko	Fiasko
producieret	producieret
Zensus	Zensus
regieret	regieret
verblutete	verblutete
Fische	Fische
Kirgisinnen	Kirgisinnen
Rücktrittbremsen	Rücktrittbremsen
Hinkelsteine	Hinkelsteine
sponseret	sponseret
sagte	sagte
Organisation	Organisation
Membran	Membran
frappiere	frappiere
schauspielert	schauspielert
tattre	tattre
verwirkliche	verwirkliche
kaufest	kaufest
hingeht	hingeht
nähret	nähret
verbasele	verbasele
wünschest	wünschest
Ablösung	Ablösung
Mauten	Mauten
griffen	griffen
designiertet	designiertet
kupieren	kupieren
säst	säst
baust	baust
zerstreuet	zerstreuet
sinkest	sinkest
schaut	schaut
verziehen	verziehen
flenstet	flenstet
demütigte	demütigte
Trümmersprachen	Trümmersprachen
holst	holst
stehest	stehest
Akkadierinnen	Akkadierinnen
punkten	punkten
erzwangt	erzwangt
Sprichwörtern	Sprichwörtern
Taschenwörterbuches	Taschenwörterbuches
blast	blast
beneidest	beneidest
besprengen	besprengen
strafte	strafte
zweifel	zweifel
verbraucht	verbraucht
dringst	dringst
pressiere	pressiere
verbüßest	verbüßest
Grüßet	Grüßet
ermächtigest	ermächtigest
lispelt	lispelt
pflücktet	pflücktet
Bruchstriches	Bruchstriches
Hochhäuser	Hochhäuser
Linguistinnen	Linguistinnen
beleidigst	beleidigst
Konfitüren	Konfitüren
Randbemerkung	Randbemerkung
Gässchen	Gässchen
gedenkst	gedenkst
Atommassen	Atommassen
Brüder	Brüder
Stempeluhren	Stempeluhren
Artischocken	Artischocken
auflöst	auflöst
separieren	separieren
Berber	Berber
duckmäuseret	duckmäuseret
manövrierte	manövrierte
Freibergit	Freibergit
bereitet	bereitet
Tiegel	Tiegel
haare	haare
emittiert	emittiert
mästet	mästet
möppertet	möppertet
malet	malet
schlachtet	schlachtet
ahnten	ahnten
Flamingo	Flamingo
Arbeitsleistung	Arbeitsleistung
Senkung	Senkung
Pforten	Pforten
tätowierest	tätowierest
Brieföffner	Brieföffner
schleimte	schleimte
wohnte	wohnte
Arsch	Arsch
zählet	zählet
Elstern	Elstern
Kraftfahrzeugen	Kraftfahrzeugen
zwängtet	zwängtet
erhebst	erhebst
unterschiede	unterschiede
offenbarest	offenbarest
Arsenite	Arsenite
vertrieb	vertrieb
Junge	Junge
kaufst	kaufst
hurst	hurst
hievst	hievst
hupet	hupet
Apportierhunde	Apportierhunde
weiche	weiche
bewässern	bewässern
Grizzlybär	Grizzlybär
ärgertest	ärgertest
verkündet	verkündet
reichet	reichet
scheltet	scheltet
weissagten	weissagten
Komponistin	Komponistin
häuftet	häuftet
steigeret	steigeret
verwechseltet	verwechseltet
scherze	scherze
Ausbeuterei	Ausbeuterei
sollte	sollte
Feinde	Feinde
aufwachte	aufwachte
fluchet	fluchet
verführten	verführten
Wühltischen	Wühltischen
Frettchen	Frettchen
rangieret	rangieret
injiziert	injiziert
geahnt	geahnt
Willen	Willen
Fingerhüten	Fingerhüten
ausfuhren	ausfuhren
Sonderbericht	Sonderbericht
sprühend	sprühend
verzögerte	verzögerte
Zähne	Zähne
evaluiert	evaluiert
entmineralisierst	entmineralisierst
Magiern	Magiern
Generation	Generation
pflügest	pflügest
evakuieret	evakuieret
henken	henken
Flöte	Flöte
Philerast	Philerast
Kacke	Kacke
Wechselstuben	Wechselstuben
Geldautomat	Geldautomat
Nukleinsäure	Nukleinsäure
verselbständigt	verselbständigt
einigte	einigte
Fahrzeugkatalysatoren	Fahrzeugkatalysatoren
Wadenbein	Wadenbein
pensionierest	pensionierest
begnadigte	begnadigte
ausführte	ausführte
Finanzministerien	Finanzministerien
verbitterten	verbitterten
rekrutierest	rekrutierest
Hirnstämmen	Hirnstämmen
pfänden	pfänden
predig	predig
Sprichwort	Sprichwort
fassest	fassest
optimierte	optimierte
weinte	weinte
Finanzministern	Finanzministern
betreten	betreten
Milzen	Milzen
strafe	strafe
Sichelzellenanämien	Sichelzellenanämien
lispelten	lispelten
verfehlten	verfehlten
Basilisken	Basilisken
dampfst	dampfst
Butzemann	Butzemann
wälzet	wälzet
entwendet	entwendet
bekennt	bekennt
Aphasie	Aphasie
begehr	begehr
nütze	nütze
Paradiesapfel	Paradiesapfel
errötest	errötest
Flöten	Flöten
Händedrücken	Händedrücken
bereite	bereite
jagst	jagst
vertrieben	vertrieben
Volkslehren	Volkslehren
Honigbär	Honigbär
sabbelten	sabbelten
Küstenwache	Küstenwache
inszenierst	inszenierst
Kriegsenden	Kriegsenden
Charakteristikan	Charakteristikan
faul	faul
Türme	Türme
Schlüchten	Schlüchten
Nagellackentferner	Nagellackentferner
Krumen	Krumen
erfüllet	erfüllet
Stör	Stör
fluche	fluche
Flossen	Flossen
decke	decke
Ionen	Ionen
Putschisten	Putschisten
Zeitüberschreitung	Zeitüberschreitung
massierst	massierst
filzte	filzte
Vesper	Vesper
Bushaltestellen	Bushaltestellen
steckst	steckst
schaffst	schaffst
piesackest	piesackest
eskaliert	eskaliert
Funktionalität	Funktionalität
Arm	Arm
Patres	Patres
begehren	begehren
ziehst	ziehst
Pfählen	Pfählen
konsolidierend	konsolidierend
Generatoren	Generatoren
klingt	klingt
konvertieren	konvertieren
brillierest	brillierest
nehmet	nehmet
schwirrt	schwirrt
tust	tust
schauen	schauen
Gehorsams	Gehorsams
Schlot	Schlot
Fahlflanken-Ameisenwürger	Fahlflanken-Ameisenwürger
Krankenscheinen	Krankenscheinen
flitzen	flitzen
brauche	brauche
kasernierte	kasernierte
Gram	Gram
radiertest	radiertest
Berichterstattungen	Berichterstattungen
boß	boß
erklingt	erklingt
brandeten	brandeten
Lammfellhandschuhs	Lammfellhandschuhs
reinigst	reinigst
Leuchtstoff	Leuchtstoff
Shortcut	Shortcut
falteten	falteten
Retter	Retter
verdammtet	verdammtet
ziere	ziere
glänzen	glänzen
bequemen	bequemen
Milchflasche	Milchflasche
liebte	liebte
filzen	filzen
Liebchen	Liebchen
Höret	Höret
Lehrkörpers	Lehrkörpers
Radfahrer	Radfahrer
seufzest	seufzest
Unrechten	Unrechten
addieret	addieret
zuhört	zuhört
Klärung	Klärung
Elementarzelle	Elementarzelle
Chlorat	Chlorat
entwickele	entwickele
Minischweine	Minischweine
observiertest	observiertest
räumet	räumet
Unter	Unter
Geschäften	Geschäften
verkaufte	verkaufte
Mopp	Mopp
umgäben	umgäben
Körpergeruch	Körpergeruch
greifen	greifen
ballaste	ballaste
vertonten	vertonten
Sollst	Sollst
Privatsachen	Privatsachen
verunreinigt	verunreinigt
verkaufe	verkaufe
wispern	wispern
Buchfink	Buchfink
Abfertigungsschalters	Abfertigungsschalters
verfliegest	verfliegest
Halbgott	Halbgott
Eingaben	Eingaben
Zainen	Zainen
grüne	grüne
Beiblättern	Beiblättern
Zehe	Zehe
kämmtet	kämmtet
Gaschromatographien	Gaschromatographien
bereuest	bereuest
Briten	Briten
gewöhnt	gewöhnt
Campingplatzes	Campingplatzes
stoßest	stoßest
Gedächtnissen	Gedächtnissen
Mäppchen	Mäppchen
Gase	Gase
anzeigte	anzeigte
Borhydride	Borhydride
schlabberte	schlabberte
Tintenfisch	Tintenfisch
Gehorsam	Gehorsam
erkältete	erkältete
Weihe	Weihe
Klassenzimmern	Klassenzimmern
peilst	peilst
entrümpelest	entrümpelest
Träumers	Träumers
hüpfen	hüpfen
billigte	billigte
Klappertopf	Klappertopf
trotzest	trotzest
gabelt	gabelt
gelobend	gelobend
Einrädern	Einrädern
fahrest	fahrest
Auszügen	Auszügen
Ausbeutern	Ausbeutern
leertet	leertet
verstehest	verstehest
argumentierten	argumentierten
Anwendungsgebiete	Anwendungsgebiete
Schönredner	Schönredner
Normdaten	Normdaten
träumte	träumte
kichern	kichern
dampfte	dampfte
alarmieren	alarmieren
Tut	Tut
markiere	markiere
verschonet	verschonet
laufe	laufe
kooperierst	kooperierst
Effekt	Effekt
Mache	Mache
vergrabest	vergrabest
grün	grün
erkundigte	erkundigte
extemporiere	extemporiere
überqueren	überqueren
kramten	kramten
Dithiolane	Dithiolane
concessionieren	concessionieren
Aufprall	Aufprall
lose	lose
rüste	rüste
Linien	Linien
Denunziationen	Denunziationen
danket	danket
Nehmt	Nehmt
billigen	billigen
Taufen	Taufen
gebt	gebt
Darlehen	Darlehen
entzweiest	entzweiest
Ärztinnen	Ärztinnen
verkürzte	verkürzte
untersagest	untersagest
Grizzlybären	Grizzlybären
Grufti	Grufti
Tischen	Tischen
bekriegt	bekriegt
Schneepflüge	Schneepflüge
Karikaturistinnen	Karikaturistinnen
Erbse	Erbse
Kochfeldern	Kochfeldern
beichteten	beichteten
Weh	Weh
Brotkästen	Brotkästen
Zeithorizonten	Zeithorizonten
bestimmt	bestimmt
lös	lös
schämest	schämest
Anspielungen	Anspielungen
Habe	Habe
drängten	drängten
Gasen	Gasen
Minimierung	Minimierung
Safrane	Safrane
Chelatkomplex	Chelatkomplex
putzt	putzt
klöne	klöne
mobilisieret	mobilisieret
knusperten	knusperten
tränkten	tränkten
Kernspaltung	Kernspaltung
Seilen	Seilen
transportierten	transportierten
Schläfchens	Schläfchens
Tintenklecksen	Tintenklecksen
Epiker	Epiker
Massenarbeitslosigkeit	Massenarbeitslosigkeit
reim	reim
verweise	verweise
Mikrometern	Mikrometern
kremierten	kremierten
Blässe	Blässe
zeug	zeug
Kerls	Kerls
Fetzens	Fetzens
Unterwerfungen	Unterwerfungen
Beschuldigungen	Beschuldigungen
sagtest	sagtest
gehst	gehst
substituieren	substituieren
Theologien	Theologien
stürzt	stürzt
Deuteriums	Deuteriums
Taschendieb	Taschendieb
Speere	Speere
sagten	sagten
weisen	weisen
Futtermittel	Futtermittel
Stätte	Stätte
pilgerte	pilgerte
schleißt	schleißt
ersparet	ersparet
Astats	Astats
heben	heben
dehydrierte	dehydrierte
Zirkelschluss	Zirkelschluss
verirrt	verirrt
verbluteten	verbluteten
restaurieret	restaurieret
verdamme	verdamme
Anmeldern	Anmeldern
Quellen	Quellen
reizen	reizen
Werken	Werken
Zapfen	Zapfen
reglementierte	reglementierte
Radiergummis	Radiergummis
Fallen	Fallen
spannen	spannen
Gibt	Gibt
schlag	schlag
erstarre	erstarre
Asteroide	Asteroide
implodier	implodier
Äther	Äther
schlafe	schlafe
Bundesgebiet	Bundesgebiet
Amputierte	Amputierte
verknüpfet	verknüpfet
kabelte	kabelte
Sündern	Sündern
versuchten	versuchten
sorge	sorge
Bienenstock	Bienenstock
Wahn	Wahn
dürfe	dürfe
Verselbstständigung	Verselbstständigung
Vorstädte	Vorstädte
werdet	werdet
herrschte	herrschte
ernte	ernte
kramen	kramen
mißversteht	mißversteht
Pforte	Pforte
emendieret	emendieret
kriegte	kriegte
vertuest	vertuest
auflöste	auflöste
schwöret	schwöret
Dessous	Dessous
fritiert	fritiert
stapele	stapele
zeiget	zeiget
Wehklagen	Wehklagen
Regierung	Regierung
Argyroditen	Argyroditen
strömt	strömt
nähre	nähre
Kriegsschauplätze	Kriegsschauplätze
Ringeltaube	Ringeltaube
missverstände	missverstände
Zehnten	Zehnten
Darlegungen	Darlegungen
Sehnen	Sehnen
Kettenraucher	Kettenraucher
Nährmedien	Nährmedien
folgt	folgt
ärgernd	ärgernd
ramme	ramme
flirtest	flirtest
grabbelten	grabbelten
Krieg	Krieg
teil	teil
inspirierten	inspirierten
Satzungen	Satzungen
Gläubiger	Gläubiger
streckte	streckte
zupfte	zupfte
Freibergits	Freibergits
vollendete	vollendete
offenbarten	offenbarten
Konzentrate	Konzentrate
meinst	meinst
brillieren	brillieren
Brettspiele	Brettspiele
Paillette	Paillette
Fallet	Fallet
setzest	setzest
bewahrest	bewahrest
mästest	mästest
trübe	trübe
kaufe	kaufe
Gicht	Gicht
Verkehrsflugzeuge	Verkehrsflugzeuge
Mönche	Mönche
verewigt	verewigt
beschuldiget	beschuldiget
Arsenbergwerk	Arsenbergwerk
treibest	treibest
schauten	schauten
hadere	hadere
Regenwald	Regenwald
Wachtel	Wachtel
Eilande	Eilande
tendierst	tendierst
Silberdrähten	Silberdrähten
Beobachtungen	Beobachtungen
Leitkegeln	Leitkegeln
drängst	drängst
Abkömmling	Abkömmling
verspielest	verspielest
Höhlen	Höhlen
Armband	Armband
Spielen	Spielen
schluchzte	schluchzte
Tatsachenbeschöniger	Tatsachenbeschöniger
liegen	liegen
schwirret	schwirret
folget	folget
verpuffe	verpuffe
Geber	Geber
verführe	verführe
schlafet	schlafet
Äquatoren	Äquatoren
vermischten	vermischten
hegten	hegten
Charakteristika	Charakteristika
pflegte	pflegte
beklagte	beklagte
Zeilen	Zeilen
langweilst	langweilst
Alkine	Alkine
Atemgasen	Atemgasen
Dödeln	Dödeln
Weiblein	Weiblein
dechiffriere	dechiffriere
lauf	lauf
Elektronenschale	Elektronenschale
posiertet	posiertet
enterten	enterten
Herd	Herd
Erzherzogshüten	Erzherzogshüten
habe	habe
Gar	Gar
halbierte	halbierte
versucht	versucht
finanzierest	finanzierest
respektierten	respektierten
merke	merke
Zementen	Zementen
zupftet	zupftet
parkierst	parkierst
schmierte	schmierte
regierest	regierest
schämet	schämet
Rutheniumisotop	Rutheniumisotop
schauspieleren	schauspieleren
funktionalisierte	funktionalisierte
faltest	faltest
lobte	lobte
Kakao	Kakao
Schenken	Schenken
Betainen	Betainen
Ringeltauben	Ringeltauben
vertraute	vertraute
äusserst	äusserst
erwürgten	erwürgten
Schaffnerinnen	Schaffnerinnen
dürfest	dürfest
meuternd	meuternd
Managementsystemen	Managementsystemen
Arsenbergwerken	Arsenbergwerken
wünschen	wünschen
Außenministerium	Außenministerium
grüßen	grüßen
lehre	lehre
Preisen	Preisen
murmelst	murmelst
Bedenken	Bedenken
Fahrt	Fahrt
kugele	kugele
Puffersystem	Puffersystem
entwaffneten	entwaffneten
Zipfelmützen	Zipfelmützen
Überweisung	Überweisung
frottierten	frottierten
verringert	verringert
rühmst	rühmst
ortete	ortete
harmoniert	harmoniert
brandet	brandet
plumpse	plumpse
losten	losten
Notärztin	Notärztin
verhungert	verhungert
Metaphern	Metaphern
Däumlingen	Däumlingen
Marokkaners	Marokkaners
Flame	Flame
Abhänge	Abhänge
könne	könne
hobt	hobt
verkriechst	verkriechst
schämst	schämst
babbeltet	babbeltet
stimmet	stimmet
Gigapascaln	Gigapascaln
zerbrechen	zerbrechen
verblute	verblute
Füchsinnen	Füchsinnen
Ludwigsburger	Ludwigsburger
verbärgen	verbärgen
kram	kram
beeinflusst	beeinflusst
führen	führen
überprüftest	überprüftest
Eutektikum	Eutektikum
setzen	setzen
sehnte	sehnte
freuet	freuet
erfreu	erfreu
grabest	grabest
Carbids	Carbids
Begünstigungen	Begünstigungen
Arbeitskreis	Arbeitskreis
mißverstehet	mißverstehet
Beilen	Beilen
legst	legst
Brüdern	Brüdern
tragest	tragest
beißet	beißet
vandaliere	vandaliere
begrabt	begrabt
reichen	reichen
freiwillige	freiwillige
Judenräte	Judenräte
duschte	duschte
Wadenbeines	Wadenbeines
zerbräche	zerbräche
Gefängnisse	Gefängnisse
knufften	knufften
herrschst	herrschst
legend	legend
Gipfeltreffen	Gipfeltreffen
Märchenbuches	Märchenbuches
fresse	fresse
verzieh	verzieh
bekehrt	bekehrt
Homodimere	Homodimere
zerreißt	zerreißt
erlaube	erlaube
Bund	Bund
benachrichtige	benachrichtige
Ich	Ich
verzehrt	verzehrt
Argentits	Argentits
warntet	warntet
zittere	zittere
verwirrte	verwirrte
Laubbläser	Laubbläser
scheinest	scheinest
Fahlflanken-Ameisenwürgern	Fahlflanken-Ameisenwürgern
feierte	feierte
benehme	benehme
drillte	drillte
Strafräume	Strafräume
assimilierten	assimilierten
gabelst	gabelst
vertagest	vertagest
wischt	wischt
erstaunte	erstaunte
löstest	löstest
Dudelsäcken	Dudelsäcken
Fiebermittel	Fiebermittel
zirpe	zirpe
erzürnet	erzürnet
Dattel	Dattel
Aufpralle	Aufpralle
Gangster	Gangster
velarisierend	velarisierend
Gallanen	Gallanen
unterstützten	unterstützten
bescherten	bescherten
Kronsbeeren	Kronsbeeren
mopst	mopst
erforschest	erforschest
erweckest	erweckest
Extremen	Extremen
Merkel-Rauten	Merkel-Rauten
schwadronierten	schwadronierten
besorg	besorg
Fortsetzungen	Fortsetzungen
gedenken	gedenken
flirre	flirre
fette	fette
entschädiget	entschädiget
ackerst	ackerst
Überschüsse	Überschüsse
Biokraftstoff	Biokraftstoff
Diamantringen	Diamantringen
tut	tut
fabuliere	fabuliere
Dochten	Dochten
säume	säume
Mopps	Mopps
bombardiere	bombardiere
fertig	fertig
Reinigungsschritten	Reinigungsschritten
beschrifte	beschrifte
grünten	grünten
grausten	grausten
Nadelbäumen	Nadelbäumen
Somiten	Somiten
öle	öle
beichten	beichten
Speeren	Speeren
Abgaskatalysatoren	Abgaskatalysatoren
unschuldige	unschuldige
ehret	ehret
vierte	vierte
Landstreichereien	Landstreichereien
stoppten	stoppten
Handbuch	Handbuch
Ångström	Ångström
säte	säte
Apotheose	Apotheose
kämpfte	kämpfte
Herbstwinde	Herbstwinde
lostest	lostest
erbringst	erbringst
Tausche	Tausche
Reisebüro	Reisebüro
legen	legen
zählten	zählten
dürftet	dürftet
Trinkgefäßen	Trinkgefäßen
schneidet	schneidet
fabulierte	fabulierte
durchwacht	durchwacht
speiste	speiste
mein	mein
Gründungsprivileg	Gründungsprivileg
wehre	wehre
Kaliumdichromat	Kaliumdichromat
Bildpunkt	Bildpunkt
Lüste	Lüste
ölt	ölt
zügelten	zügelten
Schuhe	Schuhe
schöben	schöben
begrabet	begrabet
vergaste	vergaste
Galeeren	Galeeren
erkalten	erkalten
deckst	deckst
verachtet	verachtet
Pflicht	Pflicht
grübelten	grübelten
verdammte	verdammte
Mageninhalt	Mageninhalt
kehret	kehret
leget	leget
strandend	strandend
Großfürst	Großfürst
beschotterten	beschotterten
Wühltische	Wühltische
zuhörte	zuhörte
benützt	benützt
tränke	tränke
erbrütet	erbrütet
verklärt	verklärt
Almanache	Almanache
decket	decket
Anker	Anker
verwechsele	verwechsele
Treppe	Treppe
Satzung	Satzung
unterwerfest	unterwerfest
Coventrisierung	Coventrisierung
gefügt	gefügt
bewahret	bewahret
Friede	Friede
sortierte	sortierte
schmusen	schmusen
Palisade	Palisade
bereiteten	bereiteten
Maximierung	Maximierung
Atommasse	Atommasse
Gedrängen	Gedrängen
versagen	versagen
schnitten	schnitten
sterbet	sterbet
Schilden	Schilden
Konifere	Konifere
verbrauchte	verbrauchte
Tasten	Tasten
Klaue	Klaue
Schlepper	Schlepper
verspäteten	verspäteten
Leiste	Leiste
konsolidierest	konsolidierest
trotze	trotze
Ansichtskarte	Ansichtskarte
absolviere	absolviere
hadertet	hadertet
moppet	moppet
Palme	Palme
vernehmest	vernehmest
pflanzet	pflanzet
plaziert	plaziert
Gruftis	Gruftis
Domänen	Domänen
Hälmchen	Hälmchen
Linie	Linie
erwähnet	erwähnet
surrst	surrst
gratuliere	gratuliere
Böreks	Böreks
Stiefmütterchen	Stiefmütterchen
bescheiße	bescheiße
Anlass	Anlass
Flussbett	Flussbett
Busen	Busen
Impedanz	Impedanz
Affenbrotbäumen	Affenbrotbäumen
Tiefschutz	Tiefschutz
Wimpertierchen	Wimpertierchen
Gehorcht	Gehorcht
Nährmediums	Nährmediums
Sphäre	Sphäre
mischt	mischt
schließen	schließen
schenke	schenke
Dachdeckerinnen	Dachdeckerinnen
Pfarrerinnen	Pfarrerinnen
Samarskit	Samarskit
gewurstelt	gewurstelt
sterbt	sterbt
Krusten	Krusten
tanze	tanze
schöpfen	schöpfen
Ösophagospasmen	Ösophagospasmen
Reinelemente	Reinelemente
Europium	Europium
Schamentzündungen	Schamentzündungen
webet	webet
Herkünften	Herkünften
Haarverlusten	Haarverlusten
Meinst	Meinst
überbewertet	überbewertet
schämte	schämte
bombardiert	bombardiert
zensierten	zensierten
Abfertigungsgebäude	Abfertigungsgebäude
erstehet	erstehet
Käsereibe	Käsereibe
tobte	tobte
befestigte	befestigte
Polizeisprechern	Polizeisprechern
denaturieret	denaturieret
egge	egge
Gammastrahl	Gammastrahl
Darlegung	Darlegung
beantragt	beantragt
Markisen	Markisen
legt	legt
Anachronismen	Anachronismen
kichert	kichert
dotierst	dotierst
babbelst	babbelst
Wänden	Wänden
vergiften	vergiften
Blechen	Blechen
Bajonette	Bajonette
Steige	Steige
geliebt	geliebt
Sauberfrau	Sauberfrau
bedingst	bedingst
vertreiben	vertreiben
regiere	regiere
Streiten	Streiten
darfst	darfst
Abschirmungen	Abschirmungen
Buche	Buche
Sanatorien	Sanatorien
schäumt	schäumt
heiß	heiß
bromiertet	bromiertet
süsse	süsse
träumen	träumen
quatschen	quatschen
emigriert	emigriert
Tiefschutzen	Tiefschutzen
unterforderten	unterforderten
beklage	beklage
laben	laben
lösend	lösend
diversifiziert	diversifiziert
Sonderberichte	Sonderberichte
bündelet	bündelet
Felsboden	Felsboden
Suchet	Suchet
tat	tat
Banketten	Banketten
Inder	Inder
kitzeln	kitzeln
Katz-und-Maus-Spiele	Katz-und-Maus-Spiele
Uranerz	Uranerz
lösen	lösen
beleidige	beleidige
Ambiguitäten	Ambiguitäten
Laufringen	Laufringen
verschärftet	verschärftet
Blattgeweben	Blattgeweben
blamierten	blamierten
skypet	skypet
demütigst	demütigst
karikieret	karikieret
gebühren	gebühren
Funkfeuer	Funkfeuer
gründen	gründen
drängest	drängest
Drehtüren	Drehtüren
Assimilationen	Assimilationen
gebären	gebären
Golfplatz	Golfplatz
Martyrologium	Martyrologium
Rasterkraftmikroskop	Rasterkraftmikroskop
leiden	leiden
haschieret	haschieret
verzweigst	verzweigst
Telefonnummern	Telefonnummern
bewiest	bewiest
Selbstversuche	Selbstversuche
Mutagen	Mutagen
steuerst	steuerst
Dorngesträuch	Dorngesträuch
wärme	wärme
zittertest	zittertest
verseift	verseift
überschattete	überschattete
Kortholt	Kortholt
zeugte	zeugte
Verehrer	Verehrer
Zeitplanes	Zeitplanes
reiftet	reiftet
entmineralisieren	entmineralisieren
Technetate	Technetate
Schober	Schober
Schaden	Schaden
Atomphysiker	Atomphysiker
bewies	bewies
demütiget	demütiget
vertreibt	vertreibt
Körpergeruches	Körpergeruches
habt	habt
plärrtest	plärrtest
Schwebfliegen	Schwebfliegen
verreisest	verreisest
beweise	beweise
bewahrt	bewahrt
gaffest	gaffest
Weißflügelpinguin	Weißflügelpinguin
erwache	erwache
motivierten	motivierten
Ärzteblatt	Ärzteblatt
Steuerborden	Steuerborden
zagt	zagt
Dominicanerinnen	Dominicanerinnen
begehrtet	begehrtet
kickst	kickst
Lümmeltüten	Lümmeltüten
hydrolysierest	hydrolysierest
Mähnenwolf	Mähnenwolf
Bärenfellen	Bärenfellen
spiele	spiele
nippst	nippst
bescheißt	bescheißt
speisest	speisest
verdunsten	verdunsten
Elf	Elf
Lümmeltüte	Lümmeltüte
bezichtigt	bezichtigt
zerfetzte	zerfetzte
Bleche	Bleche
destabilisierte	destabilisierte
Gemeinden	Gemeinden
weinest	weinest
Martyrologien	Martyrologien
laufet	laufet
Flaschenhälsen	Flaschenhälsen
machet	machet
Vergrößerungen	Vergrößerungen
überreichend	überreichend
dümpelst	dümpelst
plagte	plagte
Molybdit	Molybdit
zuppen	zuppen
machest	machest
Seelöwe	Seelöwe
verprügelte	verprügelte
Gesamtmenge	Gesamtmenge
Wollte	Wollte
behalte	behalte
berühret	berühret
fahrt	fahrt
hintertreiben	hintertreiben
verführest	verführest
folgend	folgend
nähert	nähert
Klärungen	Klärungen
Sprödmetall	Sprödmetall
stolze	stolze
labert	labert
drosselten	drosselten
Rhodochrosite	Rhodochrosite
foppte	foppte
beteuerest	beteuerest
Füllfederhalters	Füllfederhalters
Fettes	Fettes
Seehechten	Seehechten
Gummibaumes	Gummibaumes
fragen	fragen
erfüllt	erfüllt
gewinne	gewinne
Fiebermitteln	Fiebermitteln
radierte	radierte
verfolgst	verfolgst
bewiese	bewiese
Vorstädten	Vorstädten
falle	falle
gereichte	gereichte
reizte	reizte
Rücktritt	Rücktritt
überprüfte	überprüfte
Besuch	Besuch
rächest	rächest
strafest	strafest
verforme	verforme
ruhe	ruhe
erhörst	erhörst
sagest	sagest
Saiblinge	Saiblinge
balkanisierten	balkanisierten
überreichst	überreichst
stützet	stützet
Rekursionen	Rekursionen
ermordeten	ermordeten
Fischen	Fischen
Atombombe	Atombombe
kabelten	kabelten
sabbere	sabbere
verbitterest	verbitterest
Pfahl	Pfahl
Fadenlauf	Fadenlauf
auszieht	auszieht
Überziehen	Überziehen
knutschest	knutschest
verschränken	verschränken
fülle	fülle
fehlen	fehlen
Halbzeiten	Halbzeiten
unterfordern	unterfordern
tagten	tagten
langte	langte
harrten	harrten
belüftet	belüftet
verhören	verhören
Rhabarber	Rhabarber
Perlen	Perlen
referenzierst	referenzierst
Bademantel	Bademantel
Bushaltestelle	Bushaltestelle
Wiederbelebung	Wiederbelebung
unterwerft	unterwerft
plagest	plagest
gebet	gebet
Kreise	Kreise
buddeln	buddeln
stützen	stützen
Galeere	Galeere
schaue	schaue
peiltest	peiltest
gedächten	gedächten
handhaben	handhaben
Spannt	Spannt
begäben	begäben
reparierten	reparierten
Tetraiodiden	Tetraiodiden
anrichten	anrichten
Anachronismus	Anachronismus
gedenke	gedenke
weissagst	weissagst
beanspruchte	beanspruchte
koexistierte	koexistierte
schnüren	schnüren
verdrängen	verdrängen
Hackern	Hackern
Scherzen	Scherzen
Sagen	Sagen
Gelobt	Gelobt
Stärke	Stärke
Hahnenkämme	Hahnenkämme
Atemlüfte	Atemlüfte
kristallisierest	kristallisierest
entert	entert
Zankapfel	Zankapfel
Freibrief	Freibrief
schleim	schleim
Teekessel	Teekessel
Arbeitsbereichen	Arbeitsbereichen
verzehre	verzehre
Gläubige	Gläubige
zeugt	zeugt
interagiert	interagiert
winke	winke
wisperten	wisperten
blenden	blenden
rodet	rodet
Aprikosen	Aprikosen
Aluminaten	Aluminaten
Sexten	Sexten
abalieniertest	abalieniertest
deaktivierst	deaktivierst
Leichnamen	Leichnamen
helfest	helfest
heparinisiere	heparinisiere
Lebenskräften	Lebenskräften
Abbild	Abbild
rodete	rodete
Arsenolithen	Arsenolithen
erforschet	erforschet
Schobern	Schobern
appellierte	appellierte
Rheumatismus	Rheumatismus
unschuldigen	unschuldigen
föchte	föchte
unterwerfe	unterwerfe
schaffe	schaffe
ziehet	ziehet
Büchereien	Büchereien
müssest	müssest
bräunen	bräunen
Wirtschaftswissenschaft	Wirtschaftswissenschaft
Kurkumen	Kurkumen
Desserts	Desserts
Ypecaharalle	Ypecaharalle
gravierst	gravierst
Sage	Sage
kehrte	kehrte
entflöhen	entflöhen
wähnt	wähnt
beschlügen	beschlügen
Fischer	Fischer
Falltürme	Falltürme
Schuldner	Schuldner
glawbten	glawbten
machst	machst
Menschenhandel	Menschenhandel
Wände	Wände
Prozeduren	Prozeduren
bummeltet	bummeltet
Sogen	Sogen
gratuliert	gratuliert
täuschet	täuschet
höbet	höbet
Bergsteiger	Bergsteiger
stationierten	stationierten
dunkelten	dunkelten
feierten	feierten
geschämt	geschämt
führe	führe
amputiere	amputiere
frappierte	frappierte
Haltepunkten	Haltepunkten
Klappertöpfen	Klappertöpfen
versuchte	versuchte
Safran	Safran
verbrauchet	verbrauchet
Bildschirmfoto	Bildschirmfoto
überdenkest	überdenkest
Mischung	Mischung
exmatrikuliertet	exmatrikuliertet
verurteile	verurteile
Fußboden	Fußboden
schmettern	schmettern
Cyanat	Cyanat
Trägergas	Trägergas
Senkungen	Senkungen
Anzeichen	Anzeichen
Reinstoffen	Reinstoffen
grien	grien
Schaffet	Schaffet
Bagger	Bagger
Oheim	Oheim
zanket	zanket
Pläsieren	Pläsieren
Ausbeuter	Ausbeuter
Dienstgrad	Dienstgrad
begründest	begründest
Bittersüß	Bittersüß
Alkalien	Alkalien
Heptamolybdat	Heptamolybdat
reinstitutionalisierten	reinstitutionalisierten
verbündet	verbündet
quietschest	quietschest
Höschens	Höschens
Sitz	Sitz
Bankettes	Bankettes
erobern	erobern
Meinet	Meinet
Urologe	Urologe
bequemtet	bequemtet
nähte	nähte
Neuigkeiten	Neuigkeiten
Messiassen	Messiassen
Futtermitteln	Futtermitteln
solle	solle
gedenkt	gedenkt
Freizeitzentrum	Freizeitzentrum
Urheimaten	Urheimaten
kürzt	kürzt
erstürmt	erstürmt
Androiden	Androiden
Küsserei	Küsserei
Wandergewerbe	Wandergewerbe
Werke	Werke
umhüllt	umhüllt
Bedeutung	Bedeutung
Prophet	Prophet
urbanisiert	urbanisiert
lieget	lieget
besitze	besitze
speisen	speisen
Sitzfleisches	Sitzfleisches
Bevölkerungsdichte	Bevölkerungsdichte
zirpen	zirpen
Rückumlauten	Rückumlauten
schmiert	schmiert
beherrschest	beherrschest
stirbt	stirbt
Californium	Californium
Stärket	Stärket
warnet	warnet
bemächtigest	bemächtigest
beanspruchest	beanspruchest
Äthern	Äthern
Erstlinge	Erstlinge
anzeigt	anzeigt
heiße	heiße
revoltieren	revoltieren
enttäusche	enttäusche
unterbewertete	unterbewertete
Verbindungsdrähten	Verbindungsdrähten
Sorgen	Sorgen
soll	soll
schaust	schaust
Abschußring	Abschußring
ersparen	ersparen
schenkest	schenkest
enträtselten	enträtselten
zentrifugieren	zentrifugieren
Theistinnen	Theistinnen
generiert	generiert
Forschungen	Forschungen
geleitest	geleitest
zeichnest	zeichnest
faschierst	faschierst
Zeitungsenten	Zeitungsenten
Preisanstieg	Preisanstieg
hydrogentartrat	hydrogentartrat
mühte	mühte
Trichter	Trichter
überfallen	überfallen
räucheret	räucheret
desertiertet	desertiertet
Blumensträußen	Blumensträußen
eingehst	eingehst
Strohhälmchen	Strohhälmchen
Schotten	Schotten
vollendest	vollendest
explodierst	explodierst
Schaffnerin	Schaffnerin
bräunst	bräunst
Operationssaal	Operationssaal
Reiseleiter	Reiseleiter
versuchest	versuchest
Minimierungen	Minimierungen
predige	predige
kugelten	kugelten
reif	reif
Gewalttäter	Gewalttäter
kreierten	kreierten
erbest	erbest
begehret	begehret
inspirierest	inspirierest
Wege	Wege
stigmatisierest	stigmatisierest
erfreute	erfreute
Landwirt	Landwirt
Düften	Düften
Fallturm	Fallturm
kriegen	kriegen
lochten	lochten
Kontraindikationen	Kontraindikationen
verteidigte	verteidigte
bollerest	bollerest
brauchte	brauchte
strafst	strafst
Füllfeder	Füllfeder
Treibhausgase	Treibhausgase
steige	steige
spanne	spanne
Gehilfe	Gehilfe
parliere	parliere
Greyerzer	Greyerzer
geherrscht	geherrscht
Adler	Adler
Ring	Ring
Finanzminister	Finanzminister
Adeliepinguins	Adeliepinguins
betätigtet	betätigtet
Abflug	Abflug
dringest	dringest
Playlists	Playlists
bekehrst	bekehrst
beeindrucket	beeindrucket
plazierest	plazierest
gepuddelt	gepuddelt
Effekten	Effekten
annektierst	annektierst
Aacheners	Aacheners
Nanosatellit	Nanosatellit
leiste	leiste
substituierten	substituierten
lehrte	lehrte
Prüfberichten	Prüfberichten
Inauguration	Inauguration
rännen	rännen
löste	löste
reich	reich
erlaubest	erlaubest
pendele	pendele
scheinet	scheinet
verselbstständigest	verselbstständigest
teilen	teilen
wohnest	wohnest
Pflanzungen	Pflanzungen
Notständen	Notständen
ermächtige	ermächtige
Blitze	Blitze
blondierten	blondierten
verunglimpfte	verunglimpfte
Gummibäumen	Gummibäumen
Ringe	Ringe
Wiedergutmachungen	Wiedergutmachungen
Thioester	Thioester
ärger	ärger
Tore	Tore
besichert	besichert
Notizen	Notizen
Transportwegen	Transportwegen
stürzest	stürzest
unterbewerte	unterbewerte
verbaselt	verbaselt
Anhänge	Anhänge
Ypecaharallen	Ypecaharallen
Renegat	Renegat
freute	freute
neidest	neidest
schwöre	schwöre
werft	werft
Mähnenwolfes	Mähnenwolfes
bestraft	bestraft
kitzele	kitzele
wohnst	wohnst
Ruße	Ruße
schabst	schabst
bitte	bitte
Strafraum	Strafraum
Bombardierung	Bombardierung
Wachen	Wachen
parametrisierst	parametrisierst
Linke	Linke
evakuierte	evakuierte
Dunkelkammern	Dunkelkammern
liebest	liebest
finanzieret	finanzieret
Kaffeelöffel	Kaffeelöffel
babbelten	babbelten
Alibis	Alibis
bezahlest	bezahlest
Fußbodens	Fußbodens
gehöre	gehöre
Däumlings	Däumlings
Teufel	Teufel
Ausnahme	Ausnahme
bewahrheitete	bewahrheitete
Schnitzeljagd	Schnitzeljagd
applizirst	applizirst
Bienenstöcke	Bienenstöcke
Pfleglingen	Pfleglingen
herrschten	herrschten
kürzten	kürzten
Vollkornbrot	Vollkornbrot
beeinflusste	beeinflusste
übersteht	übersteht
hintertreibt	hintertreibt
chloroformieret	chloroformieret
verbündete	verbündete
zertifizierst	zertifizierst
musizierte	musizierte
Bürzel	Bürzel
Mitwisserschaft	Mitwisserschaft
zürnte	zürnte
Ansteckern	Ansteckern
Kehret	Kehret
Adlerbussarden	Adlerbussarden
Hörspiel	Hörspiel
Harpunen	Harpunen
verformen	verformen
beneidete	beneidete
gedenket	gedenket
meißelt	meißelt
weine	weine
beißt	beißt
schwächend	schwächend
Schnipsel	Schnipsel
betrügen	betrügen
Buchfinken	Buchfinken
Alkali	Alkali
Monde	Monde
klone	klone
irre	irre
loste	loste
Welteninsel	Welteninsel
besuchen	besuchen
steig	steig
Lüsten	Lüsten
Besprechungen	Besprechungen
erhebet	erhebet
reimte	reimte
Rutheniumkomplex	Rutheniumkomplex
erstehen	erstehen
ermutigt	ermutigt
umarmen	umarmen
Ausgangssperren	Ausgangssperren
straften	straften
wollte	wollte
gewinnet	gewinnet
moppen	moppen
Gepäckträgern	Gepäckträgern
Locken	Locken
zürne	zürne
Linguist	Linguist
Trägergasen	Trägergasen
bündelest	bündelest
verunglimpfen	verunglimpfen
stoßt	stoßt
gezählt	gezählt
wärmet	wärmet
verdeckten	verdeckten
entmineralisieret	entmineralisieret
bebet	bebet
bedeckest	bedeckest
zankte	zankte
Abfertigungsgebäuden	Abfertigungsgebäuden
Heteroatome	Heteroatome
Gefilden	Gefilden
Rückwege	Rückwege
Gasgemisch	Gasgemisch
Tübinger	Tübinger
ehrst	ehrst
inhalier	inhalier
halte	halte
Höschen	Höschen
demütig	demütig
Freunden	Freunden
Mageninhalten	Mageninhalten
Störe	Störe
Altbau	Altbau
Erfahrung	Erfahrung
vertraget	vertraget
exmatrikulierte	exmatrikulierte
Gurt	Gurt
zentriert	zentriert
betrübte	betrübte
scheitern	scheitern
Wache	Wache
Arbeitsunfähigkeit	Arbeitsunfähigkeit
installiert	installiert
Stadtbezirken	Stadtbezirken
Plüschtiere	Plüschtiere
Schatten	Schatten
velarisiert	velarisiert
Wanderfalken	Wanderfalken
Heere	Heere
Einfältigkeit	Einfältigkeit
zeugen	zeugen
transportierst	transportierst
Riegel	Riegel
anzeige	anzeige
bereitete	bereitete
entdeckst	entdeckst
Premieren	Premieren
aufwacht	aufwacht
seht	seht
Zeile	Zeile
verkürztet	verkürztet
verlöteten	verlöteten
Sünders	Sünders
Schwan	Schwan
Schönrednern	Schönrednern
mopsend	mopsend
Trichtern	Trichtern
erliegen	erliegen
Chasaren	Chasaren
Unterschlagung	Unterschlagung
Unwahrheiten	Unwahrheiten
Elastomer	Elastomer
fluppst	fluppst
Fallt	Fallt
schlaf	schlaf
eggten	eggten
aasend	aasend
Geckos	Geckos
Lammfellhandschuhen	Lammfellhandschuhen
Ausnahmen	Ausnahmen
ermordetest	ermordetest
Überziehens	Überziehens
Kleinode	Kleinode
Somite	Somite
streiten	streiten
porträtiert	porträtiert
lavierend	lavierend
Gegebenheit	Gegebenheit
Erstlingen	Erstlingen
Grenzen	Grenzen
tatet	tatet
maximierten	maximierten
lodertet	lodertet
verfügten	verfügten
Pest	Pest
Mensch	Mensch
Würfelspiele	Würfelspiele
Nadelbäume	Nadelbäume
heile	heile
grüntet	grüntet
torpedieret	torpedieret
gönnest	gönnest
ruckeln	ruckeln
panaschieret	panaschieret
liebst	liebst
wünschte	wünschte
oxidierte	oxidierte
verkleide	verkleide
Gemüseläden	Gemüseläden
beziehen	beziehen
gelobten	gelobten
Wolle	Wolle
dissentierte	dissentierte
schimmerest	schimmerest
drückte	drückte
koste	koste
hantierte	hantierte
Malen	Malen
blitzt	blitzt
Wespen	Wespen
betrübet	betrübet
harren	harren
aufkommen	aufkommen
ärgere	ärgere
weinst	weinst
preise	preise
begründetest	begründetest
Antimustern	Antimustern
Weg	Weg
plumpsten	plumpsten
Ächselchen	Ächselchen
extemporieret	extemporieret
schicke	schicke
Kraftfahrzeuges	Kraftfahrzeuges
Montagmittag	Montagmittag
höhnest	höhnest
Freitagnachmittagen	Freitagnachmittagen
Sinnen	Sinnen
henket	henket
Katamarane	Katamarane
klappest	klappest
Amokläuferinnen	Amokläuferinnen
zerschlaget	zerschlaget
verkriechet	verkriechet
Kuckucken	Kuckucken
Irrtümern	Irrtümern
Fromme	Fromme
Provinz	Provinz
kremieren	kremieren
taufe	taufe
Lehne	Lehne
boykottierten	boykottierten
Europameistern	Europameistern
Argentit	Argentit
Ärschen	Ärschen
dunkelt	dunkelt
heilte	heilte
nagelte	nagelte
verringeret	verringeret
entflieht	entflieht
Konfitüre	Konfitüre
Alteritäten	Alteritäten
Konzentrat	Konzentrat
spaltetest	spaltetest
Grießen	Grießen
negierte	negierte
gestatteten	gestatteten
Euphemismus	Euphemismus
besprächen	besprächen
hickste	hickste
beschrifteten	beschrifteten
attestierten	attestierten
braust	braust
Kuckucke	Kuckucke
haltest	haltest
verzieret	verzieret
desensibilisierte	desensibilisierte
rüstetest	rüstetest
produzierest	produzierest
schiebest	schiebest
idealisieret	idealisieret
Geliebten	Geliebten
fingieret	fingieret
Aktienkursen	Aktienkursen
Pumpellyiten	Pumpellyiten
porträtiere	porträtiere
hüte	hüte
urbanisier	urbanisier
Geschrei	Geschrei
Fluoratom	Fluoratom
posiert	posiert
Feind	Feind
Obszönität	Obszönität
speise	speise
bewässertet	bewässertet
Hure	Hure
Schlagern	Schlagern
Astat	Astat
Borhydrid	Borhydrid
klönen	klönen
schaben	schaben
verspäte	verspäte
addierte	addierte
verifizieret	verifizieret
möget	möget
revoltiert	revoltiert
christianisiere	christianisiere
kennest	kennest
Automatikgetrieben	Automatikgetrieben
behütet	behütet
Glühwürmchen	Glühwürmchen
Male	Male
Aktienkurs	Aktienkurs
war	war
Signal	Signal
Schade	Schade
Kindergeld	Kindergeld
gedurft	gedurft
verachte	verachte
verfanget	verfanget
Dochte	Dochte
Polyphosphat	Polyphosphat
Erlösungen	Erlösungen
fasset	fasset
laute	laute
offenbar	offenbar
ziert	ziert
sedimentiertet	sedimentiertet
Badezimmer	Badezimmer
Einsatz	Einsatz
Berylle	Berylle
Pi	Pi
verklagst	verklagst
entzögen	entzögen
Gerücht	Gerücht
Anfänger	Anfänger
ermahnet	ermahnet
Fusselbart	Fusselbart
breche	breche
surre	surre
rundet	rundet
Geflecktheiten	Geflecktheiten
begehrst	begehrst
losen	losen
Würzen	Würzen
Ruß	Ruß
Rechenbrett	Rechenbrett
Hehlern	Hehlern
malträtiere	malträtiere
Tretlager	Tretlager
Geliebte	Geliebte
Stellen	Stellen
Selbstsicherheit	Selbstsicherheit
pustet	pustet
formirte	formirte
stiftest	stiftest
strandeten	strandeten
begrübest	begrübest
Mops	Mops
funzt	funzt
Abkürzungsverzeichnis	Abkürzungsverzeichnis
koordinierte	koordinierte
Strontiumamalgamen	Strontiumamalgamen
verdunstet	verdunstet
Freitagnachmittage	Freitagnachmittage
Anliegen	Anliegen
sinterte	sinterte
Kleptokratie	Kleptokratie
stickt	stickt
Höhle	Höhle
Tust	Tust
Optimisten	Optimisten
wisperest	wisperest
Isobar	Isobar
Klotzes	Klotzes
kühl	kühl
Beschuldigung	Beschuldigung
schwängen	schwängen
Zain	Zain
kategorisierte	kategorisierte
Adventskalender	Adventskalender
analysiere	analysiere
betreibet	betreibet
notlandet	notlandet
Entsetzet	Entsetzet
fasse	fasse
häufen	häufen
versüßtet	versüßtet
Borkenkäfer	Borkenkäfer
Mobilfunknetze	Mobilfunknetze
lobe	lobe
geschlummert	geschlummert
Maultieren	Maultieren
kurbelte	kurbelte
Kruste	Kruste
Spurensicherung	Spurensicherung
bespracht	bespracht
fladerten	fladerten
misstrauest	misstrauest
Euphemismen	Euphemismen
schmuggelte	schmuggelte
Petersfisch	Petersfisch
quantisierte	quantisierte
verliere	verliere
kritzeln	kritzeln
regierte	regierte
stimmte	stimmte
blitz	blitz
sortierest	sortierest
Selbstversuchen	Selbstversuchen
jappen	jappen
Panamaer	Panamaer
Arbeitsgruppen	Arbeitsgruppen
reagierte	reagierte
Europameisters	Europameisters
begebe	begebe
Setzt	Setzt
Kautschuke	Kautschuke
stillte	stillte
setztet	setztet
Gegenleistungen	Gegenleistungen
lohnten	lohnten
reagiert	reagiert
bekotete	bekotete
Strahlentierchen	Strahlentierchen
schießt	schießt
treibst	treibst
Durchbruch	Durchbruch
Hummer	Hummer
bewässerst	bewässerst
herrschest	herrschest
wohnet	wohnet
Kassettenrekordern	Kassettenrekordern
Hinkelstein	Hinkelstein
unterstützet	unterstützet
schautet	schautet
verwaiset	verwaiset
Karern	Karern
Maut	Maut
bilden	bilden
wache	wache
Buntspechte	Buntspechte
meinte	meinte
Donoren	Donoren
verletzt	verletzt
mehr	mehr
Fiesling	Fiesling
rekonstruieren	rekonstruieren
naschst	naschst
Zuschauer	Zuschauer
tappten	tappten
funkelet	funkelet
machte	machte
Lunisolarkalender	Lunisolarkalender
folge	folge
Fanmeile	Fanmeile
Freeganer	Freeganer
Theistin	Theistin
überliefere	überliefere
bewahrst	bewahrst
Vorstoß	Vorstoß
Taschenwörterbuch	Taschenwörterbuch
bekehrten	bekehrten
konjugiere	konjugiere
wacht	wacht
Fettsäcken	Fettsäcken
Provinzen	Provinzen
beschuldigt	beschuldigt
verführtest	verführtest
Aha-Erlebnisse	Aha-Erlebnisse
Bete	Bete
Lesen	Lesen
emittierte	emittierte
beförderet	beförderet
Fülle	Fülle
scheuchten	scheuchten
Kleinoden	Kleinoden
Technikerinnen	Technikerinnen
lochtest	lochtest
heischten	heischten
Geschichtsbüchern	Geschichtsbüchern
Bleigehalten	Bleigehalten
Steuerwagen	Steuerwagen
stiegen	stiegen
nützt	nützt
Oberlandesgericht	Oberlandesgericht
Schreien	Schreien
Aha-Erlebnis	Aha-Erlebnis
Beziehungen	Beziehungen
kritzelet	kritzelet
Chasar	Chasar
bürsteten	bürsteten
sabbre	sabbre
überweist	überweist
knüpfte	knüpfte
Apfelbäume	Apfelbäume
Grabe	Grabe
reichte	reichte
bimmelten	bimmelten
Dorngesträuchen	Dorngesträuchen
Fellachin	Fellachin
Badezimmers	Badezimmers
bestellten	bestellten
motivieren	motivieren
Adenosin	Adenosin
Füllfedern	Füllfedern
posierst	posierst
fladerst	fladerst
Indianer	Indianer
Arresten	Arresten
raffinier	raffinier
Pis	Pis
Märtyrern	Märtyrern
verknüpft	verknüpft
schwächst	schwächst
Introjektion	Introjektion
dresche	dresche
Prostylos	Prostylos
Lehrkörpern	Lehrkörpern
Perle	Perle
lanciertet	lanciertet
Ackerschachtelhalm	Ackerschachtelhalm
ducktest	ducktest
Halle	Halle
Geflecktheit	Geflecktheit
Krume	Krume
überfällst	überfällst
entfolgst	entfolgst
entrümpelst	entrümpelst
Beile	Beile
Besteck	Besteck
Gesetze	Gesetze
Programmiererinnen	Programmiererinnen
kaserniert	kaserniert
Einwirkungen	Einwirkungen
Würfelspiel	Würfelspiel
entfolgte	entfolgte
interpretierten	interpretierten
teilte	teilte
erpress	erpress
massakrierten	massakrierten
Abnahme	Abnahme
stärket	stärket
gehetzt	gehetzt
trauerten	trauerten
rollten	rollten
lüge	lüge
überbewerte	überbewerte
lausche	lausche
Mönchen	Mönchen
Agoraphobien	Agoraphobien
bekehrte	bekehrte
Spitzen	Spitzen
Reflexionen	Reflexionen
Entmachtung	Entmachtung
blondiert	blondiert
Dingen	Dingen
mischst	mischst
überwiese	überwiese
produzierten	produzierten
kontaktieret	kontaktieret
Erdbirnen	Erdbirnen
Fahrzeugkatalysator	Fahrzeugkatalysator
löge	löge
Abkömmlingen	Abkömmlingen
Rechenbrettern	Rechenbrettern
wehrten	wehrten
Drachenblut	Drachenblut
hassest	hassest
Kalifeldspate	Kalifeldspate
immunisiere	immunisiere
Gedränge	Gedränge
Aromastoffe	Aromastoffe
verunzierte	verunzierte
Oxalate	Oxalate
verkehrte	verkehrte
liebtest	liebtest
klickte	klickte
verstecktet	verstecktet
Ölspuren	Ölspuren
referenzierte	referenzierte
begebet	begebet
verselbstständige	verselbstständige
Füllen	Füllen
Sollte	Sollte
schaute	schaute
verwechselet	verwechselet
Streich	Streich
Abszisse	Abszisse
strömte	strömte
schwadroniert	schwadroniert
bezichtigten	bezichtigten
filtern	filtern
Anrufbeantworter	Anrufbeantworter
nahest	nahest
gedenkest	gedenkest
reglementiert	reglementiert
besitzest	besitzest
Jungen	Jungen
Omnibusse	Omnibusse
beansprucht	beansprucht
Abfertigungsschalter	Abfertigungsschalter
pharyngalisierten	pharyngalisierten
frohlockest	frohlockest
Präservativs	Präservativs
Amputierten	Amputierten
verdränget	verdränget
verscheißert	verscheißert
Reichweite	Reichweite
kürze	kürze
instanziiere	instanziiere
Gefilde	Gefilde
schauend	schauend
stärkte	stärkte
Schicksen	Schicksen
beherrscht	beherrscht
boßte	boßte
pflanzen	pflanzen
Spektroskopie	Spektroskopie
gezügelt	gezügelt
suchte	suchte
zagest	zagest
Kandidaturen	Kandidaturen
Firnisse	Firnisse
Trotzkisten	Trotzkisten
Steigen	Steigen
Pardelkatze	Pardelkatze
Kavalier	Kavalier
salzen	salzen
Großstädter	Großstädter
verführen	verführen
replizieret	replizieret
Idolatrien	Idolatrien
Kissenschlacht	Kissenschlacht
verschmelzen	verschmelzen
forschte	forschte
verseifet	verseifet
neigte	neigte
globalisieret	globalisieret
erliegst	erliegst
sorgen	sorgen
Spanne	Spanne
Kerzenfische	Kerzenfische
Fetzen	Fetzen
Drohkulissen	Drohkulissen
rächte	rächte
besorgend	besorgend
predigt	predigt
Signalen	Signalen
Klotz	Klotz
leistete	leistete
erwähnten	erwähnten
schlachten	schlachten
halltet	halltet
gebündelt	gebündelt
Gebäck	Gebäck
zürn	zürn
vandalieren	vandalieren
Kassiterits	Kassiterits
Genies	Genies
Massage	Massage
Vordenker	Vordenker
ausführe	ausführe
verbesserten	verbesserten
Habt	Habt
Silbererzen	Silbererzen
Omnibus	Omnibus
deklarierte	deklarierte
Maßen	Maßen
Klauen	Klauen
Jungfernflüge	Jungfernflüge
Fehden	Fehden
Frommen	Frommen
Trickbetrüger	Trickbetrüger
näht	näht
erpresst	erpresst
bimmelte	bimmelte
vertagt	vertagt
zerstreute	zerstreute
Amnestie	Amnestie
Rußen	Rußen
folgst	folgst
Recitativ	Recitativ
vermischen	vermischen
Iberer	Iberer
beweisen	beweisen
handhabt	handhabt
verspätest	verspätest
kletteret	kletteret
bombardiertet	bombardiertet
Hinterwäldler	Hinterwäldler
kämmt	kämmt
Haben	Haben
fragmentiert	fragmentiert
Menschen	Menschen
entschädigte	entschädigte
Totenglocke	Totenglocke
Crescendos	Crescendos
Ärzteblättern	Ärzteblättern
Kaufhäusern	Kaufhäusern
Referenzen	Referenzen
erbrüte	erbrüte
verdammet	verdammet
foppten	foppten
Strahlentierchens	Strahlentierchens
Träumer	Träumer
Kommoden	Kommoden
begeben	begeben
downloadet	downloadet
sehnst	sehnst
Rückumschlägen	Rückumschlägen
betrübten	betrübten
Braunrallen	Braunrallen
späht	späht
bezahlt	bezahlt
Hornunges	Hornunges
schwebte	schwebte
schämten	schämten
Verwaltungsakte	Verwaltungsakte
wachte	wachte
sehn	sehn
Suche	Suche
erstehst	erstehst
entgehe	entgehe
rebellieret	rebellieret
Eisstein	Eisstein
grüßte	grüßte
Thioestere	Thioestere
erweckst	erweckst
Oberlippe	Oberlippe
Asteroid	Asteroid
Gefügen	Gefügen
Kassettenrekorder	Kassettenrekorder
Aktivisten	Aktivisten
Kakadu	Kakadu
Chlorats	Chlorats
Jungfernflug	Jungfernflug
grüßet	grüßet
schichtet	schichtet
blitzte	blitzte
pflanze	pflanze
Lotterien	Lotterien
Vetter	Vetter
Schauen	Schauen
fluppten	fluppten
zappten	zappten
Attentäter	Attentäter
verwertete	verwertete
steckte	steckte
verdeckte	verdeckte
bereiten	bereiten
feiert	feiert
Carbid	Carbid
filzten	filzten
gräbst	gräbst
Metallothioneinen	Metallothioneinen
Gewicht	Gewicht
Nachteile	Nachteile
tyrannisiertest	tyrannisiertest
Deckenzapfen	Deckenzapfen
Dilettanten	Dilettanten
Brettspielen	Brettspielen
gewärtigten	gewärtigten
respektiert	respektiert
Pfandgeld	Pfandgeld
evaluierten	evaluierten
Bademäntel	Bademäntel
Collagen	Collagen
begleicht	begleicht
tendiertet	tendiertet
drescht	drescht
Stierkämpfen	Stierkämpfen
anrichte	anrichte
fragst	fragst
Otavit	Otavit
Bifurkationen	Bifurkationen
Samstagnachmittag	Samstagnachmittag
Laken	Laken
bediene	bediene
Herabsetzungen	Herabsetzungen
replizierten	replizierten
Vordenkern	Vordenkern
Abschiedsbriefe	Abschiedsbriefe
verladet	verladet
Wembley-Toren	Wembley-Toren
nähe	nähe
Zirkelschlüssen	Zirkelschlüssen
glänzten	glänzten
sterbest	sterbest
Forschung	Forschung
sucht	sucht
besetzest	besetzest
heparinisierten	heparinisierten
vernichtete	vernichtete
Teile	Teile
ersparten	ersparten
vergaset	vergaset
privilegiere	privilegiere
haarte	haarte
Nullpunkt	Nullpunkt
Serverzugriffe	Serverzugriffe
punkteten	punkteten
Eistaucher	Eistaucher
Rhabarbern	Rhabarbern
besänne	besänne
Laib	Laib
Kaufkraft	Kaufkraft
lavierte	lavierte
Büstenhalters	Büstenhalters
Schnipseln	Schnipseln
Aromastoffen	Aromastoffen
entkörperlichten	entkörperlichten
Milchflaschen	Milchflaschen
Zirkelbeweis	Zirkelbeweis
tagen	tagen
Schrei	Schrei
trüb	trüb
behütetest	behütetest
Milz	Milz
sortiert	sortiert
regierten	regierten
werfet	werfet
verspielte	verspielte
Zahnfleischentzündungen	Zahnfleischentzündungen
Bluffs	Bluffs
sprecht	sprecht
bleibet	bleibet
Druckfehler	Druckfehler
liste	liste
Eingabe	Eingabe
Radsatzes	Radsatzes
Glatteis	Glatteis
predigte	predigte
Geschreis	Geschreis
schlaget	schlaget
dankte	dankte
Blutgefäß	Blutgefäß
Schilde	Schilde
Kernspaltungen	Kernspaltungen
unterbrächen	unterbrächen
Rhodochrositen	Rhodochrositen
Halogenatom	Halogenatom
endlagerten	endlagerten
verbarg	verbarg
strullerte	strullerte
Asylrechten	Asylrechten
frohlocke	frohlocke
dürfen	dürfen
Heringen	Heringen
dressieret	dressieret
Fluorkohlenwasserstoffe	Fluorkohlenwasserstoffe
wollten	wollten
Generationen	Generationen
Zeitungsente	Zeitungsente
hantiert	hantiert
verdammt	verdammt
heulte	heulte
besinnen	besinnen
Sigle	Sigle
verdamm	verdamm
egalisierten	egalisierten
durften	durften
Kommet	Kommet
befehlt	befehlt
Exzentriker	Exzentriker
zerrisset	zerrisset
winkt	winkt
torpediert	torpediert
Gallan	Gallan
verdammten	verdammten
meißeltest	meißeltest
speiset	speiset
Lehnen	Lehnen
schnappet	schnappet
Schnarchralle	Schnarchralle
protokollierst	protokollierst
Öfchens	Öfchens
Fluorkohlenwasserstoff	Fluorkohlenwasserstoff
Verbrechen	Verbrechen
punktetest	punktetest
Zeitschlitzen	Zeitschlitzen
prostituieret	prostituieret
attackieren	attackieren
Landstreicher	Landstreicher
Telefonnummer	Telefonnummer
dechiffrierend	dechiffrierend
präsentier	präsentier
stärke	stärke
Schwermetallion	Schwermetallion
begnadigst	begnadigst
versuchtet	versuchtet
schauet	schauet
Membranen	Membranen
Propheten	Propheten
Kriege	Kriege
Grüße	Grüße
erziehen	erziehen
Ausländern	Ausländern
verkürzten	verkürzten
vernichtest	vernichtest
Halbmond	Halbmond
Zwetschge	Zwetschge
malten	malten
Barbareien	Barbareien
Seelöwen	Seelöwen
Bruchstrich	Bruchstrich
verstrahlten	verstrahlten
widerriefe	widerriefe
führet	führet
erhöhet	erhöhet
Schlager	Schlager
Knöllchen	Knöllchen
erlagst	erlagst
bedingten	bedingten
Kronsbeere	Kronsbeere
Gemütes	Gemütes
Feldzug	Feldzug
Bettler	Bettler
Hirsche	Hirsche
versteigerest	versteigerest
Primärenergien	Primärenergien
Rückumschlages	Rückumschlages
irrte	irrte
Teufeln	Teufeln
gestaltest	gestaltest
warntest	warntest
jappte	jappte
malträtiert	malträtiert
Kerzenlichter	Kerzenlichter
läutet	läutet
grause	grause
Höhe	Höhe
überreicht	überreicht
Wiedergutmachung	Wiedergutmachung
Steuerberater	Steuerberater
Smaragdkehlkolibris	Smaragdkehlkolibris
fritieret	fritieret
entgehst	entgehst
Pentaborat	Pentaborat
Schwermetallionen	Schwermetallionen
Traubenlesen	Traubenlesen
beweisest	beweisest
glaubst	glaubst
predigend	predigend
Bienen	Bienen
optimiert	optimiert
Mischelementen	Mischelementen
schließe	schließe
Farbstoffe	Farbstoffe
Zerfall	Zerfall
belohnten	belohnten
Beziehung	Beziehung
bandagiert	bandagiert
Irrtumes	Irrtumes
Aussätzigen	Aussätzigen
bitten	bitten
Qualifikationen	Qualifikationen
beschottert	beschottert
Sekretärinnen	Sekretärinnen
Erstarren	Erstarren
Zwetschgen	Zwetschgen
zürnten	zürnten
beläufst	beläufst
Knöllchens	Knöllchens
säumet	säumet
wallfahrten	wallfahrten
Rotgüssen	Rotgüssen
mampfte	mampfte
Tyrann	Tyrann
hämmerst	hämmerst
stutzt	stutzt
griffe	griffe
knistert	knistert
verewiget	verewiget
Pflichten	Pflichten
webte	webte
Buchhalterin	Buchhalterin
verzeigt	verzeigt
tabuisierten	tabuisierten
gelobtest	gelobtest
Gewinnung	Gewinnung
käbbelte	käbbelte
Unterseite	Unterseite
flöteten	flöteten
ringet	ringet
scheitertet	scheitertet
verkürzt	verkürzt
sollten	sollten
privatisiert	privatisiert
gähnten	gähnten
vier	vier
Brieftaubenzüchter	Brieftaubenzüchter
fokussieret	fokussieret
verleumdete	verleumdete
trompete	trompete
begrub	begrub
binden	binden
erniedrigt	erniedrigt
Kristallen	Kristallen
Vergeltungen	Vergeltungen
verludet	verludet
bedürft	bedürft
überstehend	überstehend
schickte	schickte
schichteten	schichteten
müsse	müsse
Fremdwort	Fremdwort
meinen	meinen
Rosinenkuchenmodell	Rosinenkuchenmodell
Rubinen	Rubinen
flieh	flieh
föhnten	föhnten
Kontaktierungen	Kontaktierungen
könnten	könnten
reife	reife
vergliche	vergliche
lodert	lodert
More	More
Gespenstern	Gespenstern
leiten	leiten
fluchten	fluchten
eskalieret	eskalieret
Schläfchen	Schläfchen
erbauet	erbauet
lackieren	lackieren
besucht	besucht
spezialisiere	spezialisiere
Kohlenstoffgehalt	Kohlenstoffgehalt
erweckt	erweckt
installierten	installierten
Nahrungsbestandteilen	Nahrungsbestandteilen
Anfechtung	Anfechtung
Halleluja	Halleluja
grünen	grünen
Funkfeuern	Funkfeuern
Gasgemischen	Gasgemischen
trödele	trödele
gehört	gehört
ahne	ahne
bestimmst	bestimmst
begehrest	begehrest
Welpen	Welpen
Flammen	Flammen
obfuskieren	obfuskieren
unterbrächest	unterbrächest
Keilen	Keilen
knutschst	knutschst
Scherzes	Scherzes
verglühte	verglühte
Rumänin	Rumänin
verkehrten	verkehrten
verkapselten	verkapselten
impfte	impfte
sponsert	sponsert
Rauten	Rauten
bringet	bringet
kontaktiere	kontaktiere
entschleieret	entschleieret
kollidierte	kollidierte
Schenke	Schenke
Plüschtier	Plüschtier
verschränkest	verschränkest
Elektrophil	Elektrophil
Überfamilie	Überfamilie
Fremdwörter	Fremdwörter
stammeln	stammeln
bemerken	bemerken
Kost	Kost
leistest	leistest
loben	loben
Kopfverletzungen	Kopfverletzungen
Blicksilber	Blicksilber
setzten	setzten
liehe	liehe
bleibst	bleibst
Epoxiden	Epoxiden
Abschußringe	Abschußringe
Teekesseln	Teekesseln
knackt	knackt
Wiederauferstehung	Wiederauferstehung
Denkmünze	Denkmünze
erniedrigst	erniedrigst
Schlaraffenländern	Schlaraffenländern
bebten	bebten
massakrierte	massakrierte
Bausch	Bausch
offenbartest	offenbartest
weich	weich
fluktuiert	fluktuiert
prophezeiet	prophezeiet
Noseans	Noseans
Anfängern	Anfängern
Silberdrahts	Silberdrahts
Deutung	Deutung
Schätzen	Schätzen
Wollt	Wollt
steinigte	steinigte
Türkinnen	Türkinnen
attackieret	attackieret
schnattert	schnattert
Sprachraum	Sprachraum
gravierten	gravierten
laden	laden
möpperst	möpperst
Floß	Floß
schwelle	schwelle
ringele	ringele
Einöden	Einöden
eiterte	eiterte
Hüllenelektronen	Hüllenelektronen
dienet	dienet
Managementsystem	Managementsystem
Trübsal	Trübsal
hydrolysierend	hydrolysierend
bröckeln	bröckeln
gewärtigt	gewärtigt
gelost	gelost
reinige	reinige
Fußmatten	Fußmatten
Prüfbericht	Prüfbericht
Pudern	Pudern
vereinbarten	vereinbarten
reinstitutionalisiert	reinstitutionalisiert
Abschiedsbrief	Abschiedsbrief
Vipernatter	Vipernatter
Mammut	Mammut
opferte	opferte
Heiratsgütern	Heiratsgütern
hebe	hebe
Spitze	Spitze
könnte	könnte
Greyerzern	Greyerzern
Trioxiden	Trioxiden
folgte	folgte
verletzte	verletzte
verstörten	verstörten
lügt	lügt
entwickelten	entwickelten
klappst	klappst
begrubt	begrubt
Ente	Ente
illustriertet	illustriertet
verbrauchten	verbrauchten
Nullpunktes	Nullpunktes
fallen	fallen
Fischotters	Fischotters
brauchst	brauchst
Flamme	Flamme
Haue	Haue
Ebenen	Ebenen
Augenglases	Augenglases
überdenkend	überdenkend
musizieret	musizieret
verkauften	verkauften
lehren	lehren
Frage	Frage
knitterte	knitterte
schöpfte	schöpfte
deckte	deckte
Muster	Muster
Uterus	Uterus
verprügelet	verprügelet
Falle	Falle
streue	streue
erhöhest	erhöhest
bemüht	bemüht
Portal	Portal
Kaktusfeige	Kaktusfeige
Flöße	Flöße
widerlegest	widerlegest
geleite	geleite
hinterlegt	hinterlegt
hinterfragten	hinterfragten
Angabe	Angabe
Verbindungsdraht	Verbindungsdraht
Schätze	Schätze
Arsenit	Arsenit
Halsabschneider	Halsabschneider
weisest	weisest
Leuchtkäfern	Leuchtkäfern
gewähret	gewähret
Gedächtnisse	Gedächtnisse
glaube	glaube
verkapselt	verkapselt
segelte	segelte
fragmentierst	fragmentierst
Technetiumatom	Technetiumatom
reichst	reichst
habet	habet
Schamentzündung	Schamentzündung
Präservativen	Präservativen
Halbzeit	Halbzeit
Ass	Ass
Zeugen	Zeugen
Zur-Schau-Stellen	Zur-Schau-Stellen
Peptids	Peptids
Untier	Untier
Quelle	Quelle
formulierst	formulierst
nehmt	nehmt
gelegt	gelegt
imitiert	imitiert
Sterne	Sterne
beunruhige	beunruhige
gehören	gehören
Diäresen	Diäresen
gewarnt	gewarnt
schmeicheln	schmeicheln
Seetaucher	Seetaucher
Sphären	Sphären
inszeniere	inszeniere
verschlingt	verschlingt
Kommst	Kommst
Citrat	Citrat
Argyrodite	Argyrodite
grau	grau
fladern	fladern
Trioxid	Trioxid
verhörest	verhörest
brausen	brausen
Landesverräterinnen	Landesverräterinnen
assimilieret	assimilieret
überweis	überweis
Hansen	Hansen
trotzt	trotzt
begräbt	begräbt
rolltet	rolltet
mobilisierten	mobilisierten
Sorge	Sorge
krieget	krieget
Binde	Binde
Sabotagen	Sabotagen
Schlaraffenlandes	Schlaraffenlandes
Zebrahaies	Zebrahaies
beleuchteten	beleuchteten
Spieße	Spieße
lösest	lösest
lang	lang
Schreibern	Schreibern
beäugen	beäugen
speisend	speisend
Toypudeln	Toypudeln
schlummerte	schlummerte
funktioniertest	funktioniertest
vergleichet	vergleichet
Aase	Aase
zürnet	zürnet
Alkin	Alkin
zeuget	zeuget
Malaysierinnen	Malaysierinnen
Pflanzenstoff	Pflanzenstoff
wirfst	wirfst
Paragraphenreiter	Paragraphenreiter
Schlöte	Schlöte
Schwärmereien	Schwärmereien
baue	baue
Reststoff	Reststoff
Ende	Ende
verschreibt	verschreibt
wichsten	wichsten
lobet	lobet
verrostet	verrostet
verführt	verführt
interpretiert	interpretiert
reichtet	reichtet
umarbeitest	umarbeitest
Reliquiar	Reliquiar
betrübtest	betrübtest
scheiterst	scheiterst
entwaffnest	entwaffnest
Prozedur	Prozedur
Kernladungszahl	Kernladungszahl
helfet	helfet
Kerfe	Kerfe
Coventrisierungen	Coventrisierungen
Cyclodextrinen	Cyclodextrinen
folterte	folterte
Jagdhund	Jagdhund
Ding	Ding
Friedensforscherinnen	Friedensforscherinnen
schnappt	schnappt
beeindruckt	beeindruckt
Bleiglanz	Bleiglanz
Hobbys	Hobbys
Untern	Untern
Fetten	Fetten
flupptest	flupptest
Metonymie	Metonymie
verwahrst	verwahrst
Haarshampoos	Haarshampoos
übet	übet
Barschaften	Barschaften
gewinnen	gewinnen
kühle	kühle
lockerte	lockerte
Ärztin	Ärztin
changieren	changieren
rekrutiere	rekrutiere
sagst	sagst
Wachteln	Wachteln
Anlässe	Anlässe
Sternen	Sternen
formirend	formirend
pflanzt	pflanzt
Musters	Musters
verfinstert	verfinstert
generalisiere	generalisiere
Flenser	Flenser
Garben	Garben
Kirchhof	Kirchhof
Schuhen	Schuhen
Blockflöte	Blockflöte
erntet	erntet
Zeitplan	Zeitplan
Stilllegung	Stilllegung
erwärmet	erwärmet
blende	blende
Selbstversuch	Selbstversuch
Dienstgrade	Dienstgrade
Silbererze	Silbererze
quatschest	quatschest
meine	meine
speiest	speiest
ringelten	ringelten
erfreuen	erfreuen
baggerst	baggerst
Tukanen	Tukanen
grabble	grabble
nehmest	nehmest
dividiere	dividiere
bejubelte	bejubelte
Böse	Böse
hasse	hasse
begnügt	begnügt
Scheck	Scheck
WebHook	WebHook
desertierst	desertierst
Flensern	Flensern
entkäme	entkäme
bölkte	bölkte
süsst	süsst
widmend	widmend
ehre	ehre
wollest	wollest
anrührt	anrührt
Alltag	Alltag
läute	läute
Donnerstagabenden	Donnerstagabenden
Erzherzogshüte	Erzherzogshüte
Zement	Zement
Ochsen	Ochsen
strafend	strafend
Palästen	Palästen
pflügen	pflügen
gesagt	gesagt
berührt	berührt
posierten	posierten
greinen	greinen
meldet	meldet
erhöht	erhöht
harrtest	harrtest
Premierministerinnen	Premierministerinnen
Scheißkerlen	Scheißkerlen
Büstenhaltern	Büstenhaltern
Negermusik	Negermusik
Leichname	Leichname
Bürzeln	Bürzeln
pressiert	pressiert
stimmen	stimmen
Rückweg	Rückweg
illustriere	illustriere
log	log
gekröst	gekröst
Setzet	Setzet
verdeckt	verdeckt
höben	höben
Deutungen	Deutungen
wegen	wegen
Landwirte	Landwirte
überquerst	überquerst
gestatte	gestatte
schaffet	schaffet
bereue	bereue
kauerten	kauerten
Tiere	Tiere
fokussierten	fokussierten
Trinkgefäße	Trinkgefäße
Muhme	Muhme
Cholesterin	Cholesterin
faschieret	faschieret
heil	heil
betrieben	betrieben
Genkinit	Genkinit
fistete	fistete
kommst	kommst
fegst	fegst
bandagierte	bandagierte
vertonet	vertonet
Trübsale	Trübsale
anzeigest	anzeigest
zerstreut	zerstreut
erlabe	erlabe
Urbare	Urbare
reformieren	reformieren
ertönst	ertönst
taufet	taufet
segmentierten	segmentierten
Empörungen	Empörungen
fladerest	fladerest
verwirrest	verwirrest
Nachteilen	Nachteilen
Fokus	Fokus
Ranzigkeit	Ranzigkeit
Adamsäpfeln	Adamsäpfeln
präsentiere	präsentiere
härten	härten
Remisen	Remisen
steigen	steigen
Quellfluss	Quellfluss
handhabest	handhabest
entschleiert	entschleiert
Linken	Linken
amputierten	amputierten
stoßet	stoßet
schlaft	schlaft
klappten	klappten
erfahrt	erfahrt
Wasserbädern	Wasserbädern
setze	setze
Stiefvater	Stiefvater
fertigte	fertigte
Schote	Schote
gestikulierst	gestikulierst
Hirschen	Hirschen
versteckend	versteckend
Exilanten	Exilanten
Libelle	Libelle
Achseln	Achseln
Kapitalverkehr	Kapitalverkehr
verzeichne	verzeichne
Gewürzen	Gewürzen
setzte	setzte
Gauner	Gauner
rebellieren	rebellieren
Uteri	Uteri
füllst	füllst
Dezernat	Dezernat
Kerl	Kerl
Wahnen	Wahnen
Tukans	Tukans
gedächte	gedächte
gedächtet	gedächtet
Falz	Falz
verfängt	verfängt
Aderhaut	Aderhaut
hüten	hüten
Iberers	Iberers
fügt	fügt
Primärenergie	Primärenergie
rede	rede
Dewargefäß	Dewargefäß
Schwirrvogel	Schwirrvogel
höhnte	höhnte
Gurten	Gurten
fegte	fegte
predigten	predigten
Ausstiegstüren	Ausstiegstüren
Angaben	Angaben
Zerfällen	Zerfällen
privilegierst	privilegierst
bündelten	bündelten
Tintenfische	Tintenfische
schöpfe	schöpfe
erschütterte	erschütterte
Wandergesellen	Wandergesellen
Geigerzähler	Geigerzähler
Reliquiare	Reliquiare
fällst	fällst
blamierte	blamierte
entsetzt	entsetzt
schlängelest	schlängelest
Paläste	Paläste
geknautscht	geknautscht
rufet	rufet
sterilisiert	sterilisiert
Hypochlorit	Hypochlorit
tobet	tobet
Lehrbücher	Lehrbücher
Schlössern	Schlössern
überstehst	überstehst
erhört	erhört
Rehbock	Rehbock
verseucht	verseucht
halbierest	halbierest
Briefen	Briefen
nahe	nahe
zählte	zählte
keulte	keulte
verschmelze	verschmelze
Berufen	Berufen
dramatisiert	dramatisiert
schenkst	schenkst
Kupferkiesen	Kupferkiesen
Atomphysikern	Atomphysikern
Mitschuld	Mitschuld
entsetzet	entsetzet
Katz-und-Maus-Spielen	Katz-und-Maus-Spielen
Herzchen	Herzchen
produziert	produziert
verführte	verführte
abalienierest	abalienierest
Bertrandite	Bertrandite
reifen	reifen
Schlüchte	Schlüchte
entsetzte	entsetzte
suchst	suchst
Gebern	Gebern
Anhang	Anhang
lieben	lieben
Blattgewebe	Blattgewebe
verblieben	verblieben
eggt	eggt
Nachweisreagenzien	Nachweisreagenzien
grübelt	grübelt
puddelst	puddelst
teile	teile
Hummern	Hummern
Hainbuche	Hainbuche
Fieberanfall	Fieberanfall
Hehler	Hehler
Wehret	Wehret
produzierte	produzierte
Gibst	Gibst
kommet	kommet
initiierten	initiierten
Butike	Butike
aufrichten	aufrichten
Samstagnachmittagen	Samstagnachmittagen
zuppst	zuppst
Polierstählen	Polierstählen
Türkenbund	Türkenbund
verstehet	verstehet
Temperaturanstieg	Temperaturanstieg
assimilierte	assimilierte
Geschichtsbücher	Geschichtsbücher
Korrosionsschutzen	Korrosionsschutzen
Ichs	Ichs
heulet	heulet
Gasflaschen	Gasflaschen
Stufen	Stufen
Fett	Fett
Datentypen	Datentypen
Malaysier	Malaysier
Binden	Binden
klaget	klaget
begruben	begruben
verließen	verließen
Zähnen	Zähnen
Beryll	Beryll
charakterisiert	charakterisiert
grünest	grünest
verteidigt	verteidigt
widmeten	widmeten
Nanokondensatoren	Nanokondensatoren
Peptid	Peptid
Düfte	Düfte
geloben	geloben
warne	warne
instrumentalisierest	instrumentalisierest
Diethylether	Diethylether
Küchenmaschinen	Küchenmaschinen
schnorrest	schnorrest
veranstalten	veranstalten
Literaturen	Literaturen
bezieht	bezieht
Weihen	Weihen
Ehren	Ehren
schautest	schautest
sinnst	sinnst
Lopariten	Lopariten
Eisenkräutern	Eisenkräutern
konstatiere	konstatiere
besicheret	besicheret
Laubbaum	Laubbaum
Seil	Seil
bewährt	bewährt
Grabbeltisch	Grabbeltisch
Tumulten	Tumulten
empörte	empörte
Gewürze	Gewürze
hinterzögen	hinterzögen
Abfahrtslisten	Abfahrtslisten
Apportierhund	Apportierhund
Pianos	Pianos
rekonstruieret	rekonstruieret
wach	wach
Videoaufzeichnungen	Videoaufzeichnungen
Urbaren	Urbaren
schummelst	schummelst
entheiligten	entheiligten
kauten	kauten
macht	macht
Bällchen	Bällchen
Paragraphenreitern	Paragraphenreitern
deute	deute
Kohlrübe	Kohlrübe
ritze	ritze
wiederholte	wiederholte
zeltest	zeltest
erzwinget	erzwinget
Isobars	Isobars
Dinge	Dinge
treffen	treffen
verabschiedetet	verabschiedetet
transportiere	transportiere
Elementarzellen	Elementarzellen
Narkotikum	Narkotikum
Abbindebeschleuniger	Abbindebeschleuniger
fällte	fällte
einigst	einigst
Nadel	Nadel
pflücke	pflücke
Talismanen	Talismanen
begraben	begraben
Stätten	Stätten
füllen	füllen
schaffte	schaffte
Tische	Tische
substituierend	substituierend
stolz	stolz
gewitterte	gewitterte
Rundbriefen	Rundbriefen
Autokraten	Autokraten
lüftet	lüftet
imkeret	imkeret
Proton	Proton
Fingerspitze	Fingerspitze
beweist	beweist
liebe	liebe
verbot	verbot
Wechselstube	Wechselstube
Massagen	Massagen
wähnet	wähnet
scheucht	scheucht
tasteten	tasteten
stapelten	stapelten
Gasflasche	Gasflasche
Buch	Buch
schreie	schreie
Automatikgetriebe	Automatikgetriebe
Rotgusses	Rotgusses
Hüftgelenken	Hüftgelenken
fehle	fehle
prostituierte	prostituierte
Eiland	Eiland
prostete	prostete
regelten	regelten
Entrées	Entrées
Donor	Donor
lehrest	lehrest
Physikerin	Physikerin
Marjellchen	Marjellchen
Welteninseln	Welteninseln
versagt	versagt
sagtet	sagtet
bummelet	bummelet
Chlorwasserstoffmoleküls	Chlorwasserstoffmoleküls
unterschieden	unterschieden
Sportlerin	Sportlerin
neigest	neigest
dümpelte	dümpelte
diskutiere	diskutiere
hydrogentartrate	hydrogentartrate
Apfelbäumen	Apfelbäumen
Zeithorizonte	Zeithorizonte
bewahrheitetet	bewahrheitetet
Referenz	Referenz
Weichloten	Weichloten
Nervenzellen	Nervenzellen
applizirte	applizirte
Planern	Planern
lauschte	lauschte
Brauhaus	Brauhaus
implodiere	implodiere
Steuerbord	Steuerbord
Laufringe	Laufringe
Kurkuma	Kurkuma
enttäuschtest	enttäuschtest
Großfürsten	Großfürsten
Sinne	Sinne
Crescendo	Crescendo
legest	legest
arrivieren	arrivieren
Linguisten	Linguisten
sollt	sollt
Nanoteslan	Nanoteslan
Toren	Toren
Volkslehre	Volkslehre
Schreiber	Schreiber
verlobt	verlobt
Dithiolan	Dithiolan
schiesst	schiesst
gare	gare
erwachend	erwachend
versklavte	versklavte
Aussätzige	Aussätzige
fluchte	fluchte
widerrufe	widerrufe
Geldautomaten	Geldautomaten
Bestechungsgelder	Bestechungsgelder
erinnre	erinnre
glaubend	glaubend
Rücktrittes	Rücktrittes
Kompromiss	Kompromiss
Autonomien	Autonomien
Sexte	Sexte
wallfahrteten	wallfahrteten
Android	Android
sezierst	sezierst
Drang	Drang
neige	neige
Kompassen	Kompassen
wachse	wachse
verbündeten	verbündeten
Gewichten	Gewichten
duzet	duzet
Renegaten	Renegaten
Mäusespeck	Mäusespeck
Metallquirle	Metallquirle
übersehest	übersehest
holte	holte
generiertet	generiertet
Arreste	Arreste
Aktenkoffer	Aktenkoffer
ehren	ehren
Galoppen	Galoppen
zelte	zelte
mineralisierten	mineralisierten
hinterzöge	hinterzöge
vermutest	vermutest
frikassierend	frikassierend
scherzt	scherzt
versuche	versuche
Vogelscheuchen	Vogelscheuchen
erlauben	erlauben
seufzt	seufzt
überschneidet	überschneidet
sichere	sichere
überfischt	überfischt
Hubschrauber	Hubschrauber
Fahret	Fahret
kostet	kostet
gehorchst	gehorchst
besetzen	besetzen
Antimusters	Antimusters
finanziere	finanziere
entkörperlichte	entkörperlichte
bekennet	bekennet
Laubholz	Laubholz
ruhte	ruhte
Flamen	Flamen
schummelten	schummelten
Molybdite	Molybdite
vernehmen	vernehmen
Reinstoff	Reinstoff
lauft	lauft
Kunstgeschichte	Kunstgeschichte
fluppe	fluppe
sintertest	sintertest
Spektralbereich	Spektralbereich
Oberbegriff	Oberbegriff
duckmäusere	duckmäusere
losest	losest
überwachten	überwachten
buddelten	buddelten
verlasse	verlasse
Apostels	Apostels
zappen	zappen
Plumpse	Plumpse
knüpfen	knüpfen
bekennst	bekennst
concessioniert	concessioniert
Stimme	Stimme
moppst	moppst
Anwendungsgebiet	Anwendungsgebiet
begehrten	begehrten
verdränge	verdränge
Dreieinigkeit	Dreieinigkeit
tabuisiert	tabuisiert
Höhen	Höhen
härtet	härtet
watet	watet
stillest	stillest
zwingst	zwingst
Karer	Karer
kautest	kautest
Paralipse	Paralipse
massierend	massierend
reanimierten	reanimierten
kämpfet	kämpfet
Basiliken	Basiliken
Fokusse	Fokusse
sprüht	sprüht
Gewalttätern	Gewalttätern
ummantelten	ummantelten
Aderhäuten	Aderhäuten
verschlimmere	verschlimmere
Gitarrenspieler	Gitarrenspieler
Lautwandel	Lautwandel
trödeltest	trödeltest
sticke	sticke
Atemgas	Atemgas
Bezeugungen	Bezeugungen
Drillinge	Drillinge
überreichen	überreichen
stelle	stelle
touchierte	touchierte
ausfuhr	ausfuhr
gewünscht	gewünscht
Fragen	Fragen
bestellt	bestellt
Teilnehmerin	Teilnehmerin
blamierest	blamierest
kochte	kochte
ziehest	ziehest
Golfplätzen	Golfplätzen
besprachen	besprachen
Maultier	Maultier
Aachener	Aachener
zentrifugierst	zentrifugierst
malträtierte	malträtierte
Bromidquellen	Bromidquellen
Zwingburgen	Zwingburgen
versklavt	versklavt
belüftete	belüftete
weichst	weichst
ertragen	ertragen
Leichtmetallen	Leichtmetallen
grüble	grüble
Kupferkiese	Kupferkiese
Nussknacker	Nussknacker
streite	streite
Ölspur	Ölspur
enttäuschet	enttäuschet
Malaysierin	Malaysierin
haderte	haderte
Dorsch	Dorsch
Bilderstürmer	Bilderstürmer
Rundbriefe	Rundbriefe
bedrückest	bedrückest
Hektaren	Hektaren
Händedruck	Händedruck
grünst	grünst
erwärmst	erwärmst
glauben	glauben
ehrest	ehrest
Fluorgehalt	Fluorgehalt
Dampfschiffen	Dampfschiffen
zerrissen	zerrissen
folterst	folterst
Sehne	Sehne
kabbelet	kabbelet
schaffen	schaffen
zähle	zähle
suchest	suchest
löset	löset
gespeist	gespeist
Nussknackern	Nussknackern
geleitet	geleitet
streckst	streckst
Ecken	Ecken
schreiet	schreiet
Füchsin	Füchsin
Spiralen	Spiralen
verhungerte	verhungerte
stapften	stapften
pulsiert	pulsiert
Metallothionein	Metallothionein
wechselwirkt	wechselwirkt
Lehrbüchern	Lehrbüchern
Antitranspirante	Antitranspirante
duckt	duckt
ankern	ankern
grüßten	grüßten
überwachest	überwachest
Füllet	Füllet
Innenschau	Innenschau
bekehret	bekehret
greife	greife
verwechselst	verwechselst
Katamaran	Katamaran
Gaunern	Gaunern
strecken	strecken
widerlegte	widerlegte
wallfahrest	wallfahrest
Geschäfte	Geschäfte
zieren	zieren
forschet	forschet
erzürnt	erzürnt
lebet	lebet
Einzelgänger	Einzelgänger
Verdachtes	Verdachtes
kupiert	kupiert
verstörte	verstörte
designierst	designierst
besorgten	besorgten
Wolfesgrube	Wolfesgrube
Mop	Mop
Macht	Macht
meldeten	meldeten
Atommodelle	Atommodelle
mikrominiaturisierten	mikrominiaturisierten
WebHooks	WebHooks
Geringschätzung	Geringschätzung
Mikrowellenfilter	Mikrowellenfilter
Apostel	Apostel
Pimmel	Pimmel
verschickte	verschickte
fotzt	fotzt
lögest	lögest
baggerte	baggerte
hoben	hoben
verließet	verließet
Briketten	Briketten
tyrannisierte	tyrannisierte
Gehirnwellen	Gehirnwellen
fetten	fetten
läutetet	läutetet
Heringe	Heringe
regiert	regiert
regiertest	regiertest
koche	koche
putzte	putzte
Kälber	Kälber
bewürben	bewürben
murmelten	murmelten
feiern	feiern
Handbüchern	Handbüchern
Führet	Führet
Operationssälen	Operationssälen
schäme	schäme
Fußballweltmeisterschaftsqualifikationsspiel	Fußballweltmeisterschaftsqualifikationsspiel
könnest	könnest
widmest	widmest
Kuttern	Kuttern
Radfahrern	Radfahrern
Geschwindigkeitsmessern	Geschwindigkeitsmessern
wehrt	wehrt
fällt	fällt
zürntet	zürntet
Beteiligten	Beteiligten
Plumpsen	Plumpsen
Bestecken	Bestecken
suchen	suchen
äussern	äussern
Schwirrvögel	Schwirrvögel
dekompiliertest	dekompiliertest
analysiert	analysiert
Insulaner	Insulaner
transportierte	transportierte
protestierest	protestierest
betrübt	betrübt
Technetaten	Technetaten
werdest	werdest
Graben	Graben
Maxima	Maxima
touchiere	touchiere
Silbersulfidbelag	Silbersulfidbelag
Chinakohl	Chinakohl
hüpfest	hüpfest
verringerten	verringerten
Spießen	Spießen
Waldbränden	Waldbränden
Bleiglanzes	Bleiglanzes
hintertriebe	hintertriebe
Kanzleien	Kanzleien
regieren	regieren
rinnt	rinnt
Quatsch	Quatsch
geniertest	geniertest
filzst	filzst
stigmatisierst	stigmatisierst
Bombardierungen	Bombardierungen
suchten	suchten
lieb	lieb
schätzte	schätzte
verkürztest	verkürztest
kooperierte	kooperierte
spezialisierst	spezialisierst
Pflanzung	Pflanzung
haste	haste
Halsabschneidern	Halsabschneidern
Carbiden	Carbiden
Einfältigkeiten	Einfältigkeiten
verfolgt	verfolgt
Begünstigung	Begünstigung
Kassiteriten	Kassiteriten
Gemeinde	Gemeinde
Biokraftstoffes	Biokraftstoffes
speichertest	speichertest
dekorieren	dekorieren
querest	querest
erntete	erntete
dürfte	dürfte
kehre	kehre
durchzuck	durchzuck
Briefköpfen	Briefköpfen
Sachen	Sachen
jappten	jappten
Breiten	Breiten
Herbstwinden	Herbstwinden
tattert	tattert
emailliert	emailliert
überlebest	überlebest
offenbare	offenbare
umarmet	umarmet
gedenk	gedenk
verzögerten	verzögerten
hupen	hupen
Transportweg	Transportweg
Kriegen	Kriegen
reichtest	reichtest
Kreisen	Kreisen
schmuste	schmuste
emigrieret	emigrieret
Hardwareentwicklerin	Hardwareentwicklerin
Jüngern	Jüngern
strecke	strecke
Leitkegel	Leitkegel
bewähret	bewähret
aktualisiere	aktualisiere
verdinglichtest	verdinglichtest
Lob	Lob
Anführern	Anführern
prahlte	prahlte
Zeitschlitze	Zeitschlitze
Rechnungen	Rechnungen
Numerus	Numerus
Begrenzungen	Begrenzungen
Preis	Preis
schluchze	schluchze
Ausländer	Ausländer
naschten	naschten
Feldbett	Feldbett
Firnis	Firnis
sinke	sinke
Filzläusen	Filzläusen
erwärmte	erwärmte
Ankern	Ankern
Aspartame	Aspartame
erforscht	erforscht
versteckten	versteckten
Anfechtungen	Anfechtungen
herrschet	herrschet
lancierst	lancierst
vergrubt	vergrubt
kräusle	kräusle
Kohlenstoffgehalten	Kohlenstoffgehalten
Deuterium	Deuterium
bedeckt	bedeckt
prostet	prostet
Industrienation	Industrienation
Entmachtungen	Entmachtungen
Zwergschwan	Zwergschwan
Kadavergehorsam	Kadavergehorsam
Aphasien	Aphasien
demütige	demütige
ummantle	ummantle
ankerst	ankerst
mogelten	mogelten
Piratensendern	Piratensendern
merket	merket
Innenministerien	Innenministerien
verkaufst	verkaufst
gehorchte	gehorchte
Aerosole	Aerosole
sage	sage
erwachte	erwachte
maßen	maßen
verdammen	verdammen
pflüget	pflüget
Campingplätzen	Campingplätzen
Anführer	Anführer
Gesamtmengen	Gesamtmengen
rundest	rundest
malochte	malochte
vibrierend	vibrierend
oxidierst	oxidierst
Zinkionen	Zinkionen
gequasselt	gequasselt
wälzt	wälzt
betrübe	betrübe
ausziehst	ausziehst
bewässerest	bewässerest
ermutigte	ermutigte
Petersfischen	Petersfischen
Pentaboraten	Pentaboraten
besprenget	besprenget
haltet	haltet
Helden	Helden
Gläubigern	Gläubigern
hegst	hegst
drücke	drücke
Möbiusbändern	Möbiusbändern
partitionierten	partitionierten
Fanatiker	Fanatiker
heißest	heißest
dürft	dürft
ertraget	ertraget
Andrologie	Andrologie
flehte	flehte
verallgemeinerest	verallgemeinerest
borgst	borgst
argumentierest	argumentierest
Pflaume	Pflaume
Zwergschwanes	Zwergschwanes
bürsten	bürsten
Erbsen	Erbsen
Mittelaltermarkt	Mittelaltermarkt
Amtsträger	Amtsträger
strullerst	strullerst
Rehböcken	Rehböcken
observierst	observierst
alarmiere	alarmiere
annektierten	annektierten
geräuchert	geräuchert
verifizierten	verifizierten
wolle	wolle
Kontraindikation	Kontraindikation
Meldezettel	Meldezettel
befestigt	befestigt
labe	labe
Soge	Soge
Taschendiebe	Taschendiebe
downloadete	downloadete
trompetete	trompetete
verwahrt	verwahrt
Huren	Huren
besprichst	besprichst
Zapfhähnen	Zapfhähnen
Übertretung	Übertretung
Nahrungsbestandteil	Nahrungsbestandteil
Sprecher	Sprecher
Zitronensaft	Zitronensaft
Maultiere	Maultiere
Märtyrer	Märtyrer
überdenkst	überdenkst
plissieren	plissieren
leide	leide
höbest	höbest
wünsche	wünsche
flambierten	flambierten
denaturiert	denaturiert
bringst	bringst
colorierend	colorierend
Energiespeicher	Energiespeicher
Heiratsgut	Heiratsgut
zersetzte	zersetzte
beunruhigte	beunruhigte
Boten	Boten
bewerbet	bewerbet
segmentiere	segmentiere
Kirgisin	Kirgisin
Eiszapfen	Eiszapfen
Gigapascal	Gigapascal
Flitzer	Flitzer
bedient	bedient
steuerte	steuerte
verzeichnete	verzeichnete
untersagtest	untersagtest
flense	flense
blondieret	blondieret
grienest	grienest
vertreibe	vertreibe
flirtete	flirtete
Autoklaven	Autoklaven
brillieret	brillieret
meinet	meinet
erhörest	erhörest
verstehst	verstehst
Färsen	Färsen
sprachen	sprachen
konvergiere	konvergiere
fragte	fragte
gedolmetscht	gedolmetscht
verachtend	verachtend
Puder	Puder
erlöst	erlöst
Rutheniumisotopen	Rutheniumisotopen
formiret	formiret
rühmte	rühmte
arbeiten	arbeiten
weichest	weichest
salz	salz
vermutet	vermutet
Hypochlorite	Hypochlorite
umhüllend	umhüllend
entständen	entständen
Jagdhunden	Jagdhunden
versuchst	versuchst
bejubelst	bejubelst
imitiertet	imitiertet
Alibi	Alibi
schützt	schützt
idealisierest	idealisierest
gelobst	gelobst
Autonomie	Autonomie
entwendete	entwendete
Epidemien	Epidemien
Ansteckers	Ansteckers
drifte	drifte
Einbrecher	Einbrecher
Finanzministerium	Finanzministerium
motivierte	motivierte
erzürnst	erzürnst
Jagdbomber	Jagdbomber
Ehre	Ehre
wünschtest	wünschtest
Dezernaten	Dezernaten
blättertet	blättertet
Döner	Döner
Vanadaten	Vanadaten
Reiterschwert	Reiterschwert
Knüppeln	Knüppeln
Gymnasien	Gymnasien
Trinker	Trinker
Weichseln	Weichseln
Volltreffer	Volltreffer
grünt	grünt
Neuigkeit	Neuigkeit
Streichen	Streichen
grüßest	grüßest
Entree	Entree
Kerf	Kerf
verwaisten	verwaisten
Laubbläsern	Laubbläsern
lärmte	lärmte
Rast	Rast
Freizeitzentren	Freizeitzentren
blitzet	blitzet
wachset	wachset
suchet	suchet
Werk	Werk
kennet	kennet
prangte	prangte
spukest	spukest
Ektoplasmen	Ektoplasmen
Bazzit	Bazzit
erlöset	erlöset
Schnallen	Schnallen
Aas	Aas
flucht	flucht
verstrahlet	verstrahlet
Essigsäurechlorid	Essigsäurechlorid
tragt	tragt
verglichest	verglichest
wurstelten	wurstelten
Feuerteufels	Feuerteufels
Sprechers	Sprechers
Reißnagel	Reißnagel
straftet	straftet
speicherten	speicherten
Gründungsprivilegien	Gründungsprivilegien
drangen	drangen
Sanatoriums	Sanatoriums
glühten	glühten
Asthenosphäre	Asthenosphäre
raffiniere	raffiniere
Geschwindigkeitsmesser	Geschwindigkeitsmesser
Naturen	Naturen
Stiefvätern	Stiefvätern
Rekursion	Rekursion
mogelest	mogelest
vermeße	vermeße
Gehilfen	Gehilfen
Streife	Streife
bedurftest	bedurftest
setzet	setzet
verjährest	verjährest
Theologie	Theologie
misstrauen	misstrauen
taufen	taufen
zeugtest	zeugtest
hänge	hänge
folg	folg
Wüsten	Wüsten
dissentierten	dissentierten
fluktuierte	fluktuierte
grünend	grünend
Zapfhahn	Zapfhahn
sehest	sehest
Prügelstrafen	Prügelstrafen
verschaffte	verschaffte
neiden	neiden
Reinigungsschrittes	Reinigungsschrittes
Remis	Remis
bestimmten	bestimmten
Abartigkeit	Abartigkeit
diversifiziere	diversifiziere
gestikuliere	gestikuliere
verklagt	verklagt
Gleitzeiten	Gleitzeiten
traget	traget
schreckt	schreckt
dümpelt	dümpelt
höbe	höbe
Primatologen	Primatologen
zensiere	zensiere
setztest	setztest
wehr	wehr
Bildpunkten	Bildpunkten
erwachet	erwachet
Chlorwasserstoffmolekül	Chlorwasserstoffmolekül
Grönländer	Grönländer
Unterschlagungen	Unterschlagungen
Käsereiben	Käsereiben
lege	lege
Bromidquelle	Bromidquelle
Flosse	Flosse
Essigsäurechloriden	Essigsäurechloriden
Ösophagospasmus	Ösophagospasmus
liebten	liebten
pendelt	pendelt
generalisiert	generalisiert
Elementen	Elementen
Tier	Tier
bröckelten	bröckelten
grüßt	grüßt
vertäte	vertäte
Koniferen	Koniferen
habest	habest
setzt	setzt
belohnte	belohnte
Möbelstoffen	Möbelstoffen
dirigieret	dirigieret
umhüllst	umhüllst
auflegte	auflegte
begrabest	begrabest
verhalten	verhalten
skypst	skypst
nähernd	nähernd
schmuggle	schmuggle
wehrend	wehrend
Wehe	Wehe
Türklingeln	Türklingeln
speist	speist
zwänget	zwänget
quasselten	quasselten
globalisier	globalisier
plagen	plagen
Fingerhüte	Fingerhüte
Pinguin	Pinguin
Briefwechsel	Briefwechsel
koordinieret	koordinieret
Ionenaustauscher	Ionenaustauscher
bedürftet	bedürftet
Dudelsack	Dudelsack
rauben	rauben
spekulieren	spekulieren
Polarisation	Polarisation
beschotteret	beschotteret
Ingredienzen	Ingredienzen
zertifiziertest	zertifiziertest
zeuge	zeuge
Abkürzungsverzeichnisse	Abkürzungsverzeichnisse
fallest	fallest
explodierten	explodierten
billige	billige
Kopfsalat	Kopfsalat
schnürest	schnürest
Blitzableiter	Blitzableiter
Mittelaltermarktes	Mittelaltermarktes
pressierten	pressierten
dramatisieren	dramatisieren
umhüll	umhüll
schleiß	schleiß
Pedant	Pedant
hinterlege	hinterlege
Kakaos	Kakaos
verfinstere	verfinstere
protestierst	protestierst
Gebete	Gebete
aufstehet	aufstehet
Wasserquelle	Wasserquelle
rebelliere	rebelliere
Trockendocks	Trockendocks
füsilierten	füsilierten
saget	saget
möge	möge
narren	narren
puste	puste
Laufring	Laufring
verbleibet	verbleibet
Kornnattern	Kornnattern
Hektare	Hektare
knacktest	knacktest
Benzol	Benzol
Fotosynthese	Fotosynthese
Farbstoffen	Farbstoffen
fliehe	fliehe
dürften	dürften
erwürgtest	erwürgtest
lostet	lostet
Aufträgen	Aufträgen
gewährtest	gewährtest
Preisanstiegen	Preisanstiegen
eroberte	eroberte
Aktivist	Aktivist
Ölfässern	Ölfässern
blitztet	blitztet
Langschwanzpinguin	Langschwanzpinguin
gebot	gebot
beliefen	beliefen
Weste	Weste
deutete	deutete
Huflattich	Huflattich
verlautete	verlautete
eiterten	eiterten
unterwirft	unterwirft
zwang	zwang
dringt	dringt
Afrikaner	Afrikaner
Augur	Augur
vermeßest	vermeßest
befördert	befördert
beteuerten	beteuerten
Strontiumamalgams	Strontiumamalgams
Leugnung	Leugnung
kennst	kennst
häufte	häufte
Beschleuniger	Beschleuniger
Talisman	Talisman
behauptete	behauptete
Fellachinnen	Fellachinnen
verzehrst	verzehrst
sehet	sehet
dümpelest	dümpelest
lade	lade
Schwestern	Schwestern
Adhäsionen	Adhäsionen
Harpune	Harpune
Abfahrtsliste	Abfahrtsliste
versteckst	versteckst
Notärztinnen	Notärztinnen
Acetaten	Acetaten
schäumtest	schäumtest
besänftiget	besänftiget
Fledermaus	Fledermaus
Quellflüssen	Quellflüssen
regeln	regeln
halle	halle
feire	feire
verkauft	verkauft
Pinguinen	Pinguinen
holet	holet
Rooibos	Rooibos
Messies	Messies
Türklingel	Türklingel
Untiefe	Untiefe
verdinglichest	verdinglichest
füsilierte	füsilierte
löse	löse
überlieferten	überlieferten
Leichtmetalle	Leichtmetalle
besänftigtest	besänftigtest
Arbeitsbereich	Arbeitsbereich
Mobilfunknetzen	Mobilfunknetzen
bequemest	bequemest
Kalifeldspat	Kalifeldspat
filteret	filteret
hänget	hänget
Substanzen	Substanzen
unterdrückte	unterdrückte
warnt	warnt
verflog	verflog
Bauwerke	Bauwerke
Last	Last
vertrauten	vertrauten
zweifelte	zweifelte
Rotscheitelreiher	Rotscheitelreiher
rebelliertet	rebelliertet
gleite	gleite
knurrtet	knurrtet
Leisten	Leisten
schütze	schütze
Tatsachenbeschönigern	Tatsachenbeschönigern
Achatschnecken	Achatschnecken
Pedanten	Pedanten
kapiertet	kapiertet
Schickse	Schickse
narret	narret
Rubine	Rubine
Tübingern	Tübingern
eingehet	eingehet
Atemluft	Atemluft
begehre	begehre
entfachten	entfachten
haarten	haarten
Einöde	Einöde
notlande	notlande
liebend	liebend
weise	weise
Scheißkerl	Scheißkerl
appellierst	appellierst
Bilderstürmereien	Bilderstürmereien
Subspezies	Subspezies
krösest	krösest
Prostyloi	Prostyloi
beschottre	beschottre
Bonzen	Bonzen
Portale	Portale
Herkunft	Herkunft
mühe	mühe
Protonen	Protonen
erfahrest	erfahrest
weichen	weichen
Fette	Fette
Auguren	Auguren
Nachruf	Nachruf
Werkzeugen	Werkzeugen
Extrems	Extrems
ersparte	ersparte
dienest	dienest
pflegst	pflegst
Dödel	Dödel
sannen	sannen
hinterfragst	hinterfragst
Kopfsalaten	Kopfsalaten
Hode	Hode
Besuchen	Besuchen
erfahret	erfahret
funktionierte	funktionierte
ermordet	ermordet
dirigieren	dirigieren
zerstreuten	zerstreuten
zeugest	zeugest
ehrte	ehrte
flambiert	flambiert
Bergen	Bergen
Silbergeschirr	Silbergeschirr
zerfetzt	zerfetzt
Elfen	Elfen
Gegenleistung	Gegenleistung
bauten	bauten
übte	übte
entkämen	entkämen
Atmosphäre	Atmosphäre
Krokus	Krokus
Wüste	Wüste
Toypudel	Toypudel
Dürre	Dürre
betonierte	betonierte
analysieret	analysieret
simuliertet	simuliertet
Trotzkist	Trotzkist
fallt	fallt
lackiere	lackiere
schwebe	schwebe
verhalte	verhalte
Werkzeuge	Werkzeuge
Spektralbereichen	Spektralbereichen
tanzen	tanzen
Blättchen	Blättchen
greinet	greinet
erkälteten	erkälteten
Klassenzimmer	Klassenzimmer
assimiliertest	assimiliertest
wässerst	wässerst
stille	stille
idealisierten	idealisierten
Gebeten	Gebeten
schmuggelest	schmuggelest
verarbeite	verarbeite
Korrosionsschutz	Korrosionsschutz
föhnest	föhnest
Feierabend	Feierabend
mache	mache
Orgel	Orgel
Zunge	Zunge
Empörung	Empörung
jaget	jaget
suche	suche
erratet	erratet
besser	besser
bekriegtet	bekriegtet
streiften	streiften
Kaufhäuser	Kaufhäuser
pilgert	pilgert
Telefonverkäufer	Telefonverkäufer
Weichlote	Weichlote
könnet	könnet
verwerten	verwerten
verlasset	verlasset
Buntspechten	Buntspechten
Tausch	Tausch
Backenbärten	Backenbärten
bauest	bauest
brause	brause
imkernd	imkernd
Trockendock	Trockendock
planschest	planschest
gehorcht	gehorcht
Gichten	Gichten
flehst	flehst
zeugten	zeugten
erkennest	erkennest
entfachet	entfachet
balkanisierte	balkanisierte
respektiere	respektiere
löstet	löstet
fällen	fällen
Blütenachse	Blütenachse
manövrieret	manövrieret
regierst	regierst
Grieße	Grieße
Sonnenfinsternissen	Sonnenfinsternissen
Heteroatom	Heteroatom
aufsteht	aufsteht
Hertz	Hertz
Sizilianer	Sizilianer
fluppen	fluppen
jaulst	jaulst
diente	diente
bedrücktest	bedrücktest
Weinbergen	Weinbergen
sprechet	sprechet
Versorgungen	Versorgungen
Erdboden	Erdboden
Spende	Spende
weinen	weinen
Abartigkeiten	Abartigkeiten
Indern	Indern
Fischotter	Fischotter
Ölfasses	Ölfasses
zeugst	zeugst
liebtet	liebtet
quietsche	quietsche
Sportlerinnen	Sportlerinnen
stellte	stellte
fresset	fresset
Schwänzchen	Schwänzchen
begrübe	begrübe
betrübtet	betrübtet
respektieren	respektieren
restaurierten	restaurierten
entzweit	entzweit
Genie	Genie
verziehe	verziehe
befürchtet	befürchtet
Fermium	Fermium
entdecket	entdecket
Fusselbärten	Fusselbärten
Atombomben	Atombomben
Braunralle	Braunralle
Zwangsarbeiterin	Zwangsarbeiterin
Zeug	Zeug
zeigst	zeigst
Fehlen	Fehlen
obfuskierten	obfuskierten
Schwächungen	Schwächungen
Fellhandschuhen	Fellhandschuhen
Ambiguität	Ambiguität
Alterität	Alterität
verstecken	verstecken
Rückumlaute	Rückumlaute
gelobe	gelobe
Einstufung	Einstufung
sterilisierte	sterilisierte
