extentor	extentor
fritös	fritös
gäsparna	gäsparna
älgar	älgar
käre	käre
klistra	klistra
tillgodogör	tillgodogör
förståndets	förståndets
hycklare	hycklare
vattenkannans	vattenkannans
rov	rov
utgiftstaken	utgiftstaken
absiderna	absiderna
böjen	böjen
tjugofemöringens	tjugofemöringens
justitieministrar	justitieministrar
tandvårdens	tandvårdens
tjeckiskorna	tjeckiskorna
kombinerade	kombinerade
visen	visen
killingar	killingar
affint	affint
lavs	lavs
gäckade	gäckade
gravvårdarnas	gravvårdarnas
närstående	närstående
borstars	borstars
mon	mon
oskadliggjorde	oskadliggjorde
inträffades	inträffades
ponerad	ponerad
svastikornas	svastikornas
halvimperialen	halvimperialen
provisoriers	provisoriers
sedvänja	sedvänja
spanjorerna	spanjorerna
deklarerar	deklarerar
källingars	källingars
räknestickors	räknestickors
krypta	krypta
justeras	justeras
åklagar	åklagar
avhärvlat	avhärvlat
löses	löses
altruistiskt	altruistiskt
tyglades	tyglades
baltiskt	baltiskt
småländskan	småländskan
olivträdets	olivträdets
namne	namne
snarast	snarast
jagat	jagat
kantrad	kantrad
åskådade	åskådade
papperskniv	papperskniv
vektorfälts	vektorfälts
åskvädren	åskvädren
ändligdimensionellt	ändligdimensionellt
vattenkannas	vattenkannas
överleva	överleva
Fourierserier	Fourierserier
upptäcktsresa	upptäcktsresa
tröghet	tröghet
skottdags	skottdags
kontextuelle	kontextuelle
matchs	matchs
firas	firas
borra	borra
redigeringskrigs	redigeringskrigs
besviken	besviken
nämna	nämna
valrossar	valrossar
svavelstickan	svavelstickan
utför	utför
pappersknivar	pappersknivar
tystades	tystades
barnbördshuset	barnbördshuset
indikera	indikera
äggulans	äggulans
ekobrott	ekobrott
beaktandeledens	beaktandeledens
fegisars	fegisars
svordom	svordom
anställa	anställa
particips	particips
gårdsplaner	gårdsplaner
insamlade	insamlade
kostande	kostande
bältes	bältes
förmörkas	förmörkas
beskrivningsspråk	beskrivningsspråk
federationer	federationer
trombs	trombs
myste	myste
duka	duka
konsortiets	konsortiets
sänd	sänd
uzbeks	uzbeks
allmänspråklige	allmänspråklige
tågade	tågade
kristadelfianernas	kristadelfianernas
suspensoarens	suspensoarens
lösts	lösts
förmörkade	förmörkade
lågt	lågt
bridges	bridges
jordskredet	jordskredet
kufarna	kufarna
genomslaget	genomslaget
fingeravtryckets	fingeravtryckets
kompilerar	kompilerar
förtövande	förtövande
blåmesarnas	blåmesarnas
beställningsarbetes	beställningsarbetes
flädermärgskulors	flädermärgskulors
anrättningar	anrättningar
oxars	oxars
byttor	byttor
pages	pages
beskriver	beskriver
gorillor	gorillor
kläck	kläck
ruinera	ruinera
lydelse	lydelse
hämmas	hämmas
historiska	historiska
konservburks	konservburks
upptäckte	upptäckte
beteckna	beteckna
femöring	femöring
förnimma	förnimma
tretalets	tretalets
kröner	kröner
ytteröra	ytteröra
glidyta	glidyta
sidensvans	sidensvans
pråmar	pråmar
kapitalisternas	kapitalisternas
satt	satt
arbetskamrat	arbetskamrat
narkomanens	narkomanens
ringmuskels	ringmuskels
systematiserad	systematiserad
bokriser	bokriser
kufen	kufen
säkrades	säkrades
inägorna	inägorna
spåra	spåra
årtusendena	årtusendena
utbudet	utbudet
Fourierseriens	Fourierseriens
bagatells	bagatells
annex	annex
konverterades	konverterades
fungerar	fungerar
anklagats	anklagats
preciserade	preciserade
släktes	släktes
nyktre	nyktre
stickmygga	stickmygga
uppmanande	uppmanande
gäckas	gäckas
ögonhålas	ögonhålas
kläckts	kläckts
utträdesarbetet	utträdesarbetet
åran	åran
uppmana	uppmana
palindroms	palindroms
departementssekreterare	departementssekreterare
sjöboden	sjöboden
rymdfysiks	rymdfysiks
rötmånadernas	rötmånadernas
barrskog	barrskog
resecheckens	resecheckens
fritösers	fritösers
anställs	anställs
barberar	barberar
sedvänjor	sedvänjor
annandagens	annandagens
juices	juices
bältens	bältens
tryckas	tryckas
dyrkade	dyrkade
statschefers	statschefers
nickas	nickas
dräp	dräp
granden	granden
restaurerades	restaurerades
fjortondel	fjortondel
tåga	tåga
knarkats	knarkats
zappade	zappade
bokmärkes	bokmärkes
bestämmande	bestämmande
gravvårdar	gravvårdar
tatuerarnas	tatuerarnas
rodna	rodna
kroppsvätskors	kroppsvätskors
givandets	givandets
säkrast	säkrast
snören	snören
altruisters	altruisters
konfiskerad	konfiskerad
odjuret	odjuret
rättvisan	rättvisan
uppenbarades	uppenbarades
påve	påve
fagottisterna	fagottisterna
hitlistas	hitlistas
rötternas	rötternas
hajade	hajade
indoktrinerings	indoktrinerings
munskänken	munskänken
täckte	täckte
pilsnerns	pilsnerns
slickepinnes	slickepinnes
åskväder	åskväder
rötmånaders	rötmånaders
munskänkar	munskänkar
småländskas	småländskas
snöre	snöre
tigs	tigs
kvällstidningarnas	kvällstidningarnas
utbjudande	utbjudande
patenterade	patenterade
kvaddar	kvaddar
ond	ond
tremänningen	tremänningen
kulminera	kulminera
äppelträds	äppelträds
fäst	fäst
varieras	varieras
filatelister	filatelister
potentielle	potentielle
landstingsdirektören	landstingsdirektören
doktorsgraders	doktorsgraders
holländska	holländska
respekterad	respekterad
förvånas	förvånas
polisbyråerna	polisbyråerna
tunnbrödsrullen	tunnbrödsrullen
karoliners	karoliners
ripjaktens	ripjaktens
lin	lin
skämtsamt	skämtsamt
meddelade	meddelade
peruans	peruans
utvandrande	utvandrande
sydnäktergalarna	sydnäktergalarna
fångenskaps	fångenskaps
dominikans	dominikans
bastat	bastat
korskrankens	korskrankens
avbildades	avbildades
laktosintolerant	laktosintolerant
muskedundren	muskedundren
blottats	blottats
albanskas	albanskas
snörena	snörena
tromb	tromb
vinylskivornas	vinylskivornas
raggare	raggare
grundämnet	grundämnet
panteisters	panteisters
barnbördshus	barnbördshus
viktiga	viktiga
utgjord	utgjord
censors	censors
agitatorer	agitatorer
dödsdagarna	dödsdagarna
upptagen	upptagen
kvantifiera	kvantifiera
tålmodigt	tålmodigt
antänt	antänt
studium	studium
fängelsehålans	fängelsehålans
könskromosomernas	könskromosomernas
vägrade	vägrade
framstegen	framstegen
tv:n	tv:n
fästenas	fästenas
fästes	fästes
antändande	antändande
golfklubbs	golfklubbs
återlämnats	återlämnats
pilar	pilar
cerebrospinalvätska	cerebrospinalvätska
systersonen	systersonen
beryll	beryll
äppelträden	äppelträden
bifloder	bifloder
inramningen	inramningen
jordbävningen	jordbävningen
magsmärta	magsmärta
kulsprutorna	kulsprutorna
luggs	luggs
anlöpt	anlöpt
tennislag	tennislag
retades	retades
ordstävets	ordstävets
terapeuter	terapeuter
brassas	brassas
nypon	nypon
utsträcker	utsträcker
fågelskådarnas	fågelskådarnas
kulsprutas	kulsprutas
bilagorna	bilagorna
vålds	vålds
förstår	förstår
gårdsplanens	gårdsplanens
selleri	selleri
inrättat	inrättat
emigreras	emigreras
förvånade	förvånade
undersöka	undersöka
steningar	steningar
välkomnad	välkomnad
utfärdas	utfärdas
radavståndet	radavståndet
värmebehandlat	värmebehandlat
leksakerna	leksakerna
korsförhöret	korsförhöret
bränn	bränn
känd	känd
inrikesministeriums	inrikesministeriums
arvedelen	arvedelen
utsträckt	utsträckt
cellulosanitrats	cellulosanitrats
visheten	visheten
kemikaliens	kemikaliens
isotoner	isotoner
citrusfrukten	citrusfrukten
kompletteras	kompletteras
vidlyftig	vidlyftig
bedrövande	bedrövande
arbetsveckorna	arbetsveckorna
samfunds	samfunds
piercings	piercings
halsband	halsband
eolsharpors	eolsharpors
specialtecknets	specialtecknets
äppelmos	äppelmos
talat	talat
morfismerna	morfismerna
överseende	överseende
modets	modets
tillkommelsens	tillkommelsens
köpingens	köpingens
ugglors	ugglors
rödingars	rödingars
monsuners	monsuners
färgbildernas	färgbildernas
slipas	slipas
tvillingar	tvillingar
hyresnämnden	hyresnämnden
homografens	homografens
kulminerar	kulminerar
möers	möers
ödmjuke	ödmjuke
såpbubblors	såpbubblors
juicen	juicen
svågers	svågers
sedeslöshetens	sedeslöshetens
doktorsexamens	doktorsexamens
törsta	törsta
fördelaktiga	fördelaktiga
signera	signera
släktens	släktens
kuddes	kuddes
nagellackets	nagellackets
nöjt	nöjt
filatelisterna	filatelisterna
lärkas	lärkas
fallerar	fallerar
inrättande	inrättande
indiskorna	indiskorna
annexet	annexet
dubbelklicka	dubbelklicka
arrendes	arrendes
spisoffrets	spisoffrets
karoliner	karoliner
derivatas	derivatas
kommutatorns	kommutatorns
tävlingsbana	tävlingsbana
täckt	täckt
uppenbarad	uppenbarad
gravitationens	gravitationens
inrikesministerium	inrikesministerium
ryggsims	ryggsims
åskvädrens	åskvädrens
vilddjuret	vilddjuret
komikers	komikers
arkiverats	arkiverats
förgöras	förgöras
chilenares	chilenares
modedockan	modedockan
dominerad	dominerad
sökas	sökas
ringfingret	ringfingret
skjul	skjul
utfärdad	utfärdad
korsfästes	korsfästes
befästes	befästes
mångfacetterade	mångfacetterade
sjöslag	sjöslag
utkom	utkom
departementssekreterarens	departementssekreterarens
modet	modet
blattarna	blattarna
infiltrerades	infiltrerades
minimera	minimera
slickepinnens	slickepinnens
fiskmaten	fiskmaten
lösaste	lösaste
borrar	borrar
renas	renas
spenderas	spenderas
docerade	docerade
intrångs	intrångs
tennislaget	tennislaget
bajskorvarna	bajskorvarna
assisterar	assisterar
50-öringarna	50-öringarna
deklarera	deklarera
årtusendes	årtusendes
rot	rot
anpassningars	anpassningars
rasmassa	rasmassa
blixtnedslaget	blixtnedslaget
förtövades	förtövades
elektronhjärnorna	elektronhjärnorna
undermenyernas	undermenyernas
katalansk	katalansk
högskolelags	högskolelags
småvilts	småvilts
adelssläktens	adelssläktens
knackas	knackas
förkunnats	förkunnats
intellektuella	intellektuella
inrop	inrop
bränns	bränns
50-öring	50-öring
anfangen	anfangen
provocerade	provocerade
bildordboken	bildordboken
ystats	ystats
kloridernas	kloridernas
närståendes	närståendes
knäveckets	knäveckets
filtren	filtren
skymd	skymd
graverar	graverar
flunsornas	flunsornas
kela	kela
nittondels	nittondels
odjur	odjur
matchen	matchen
traditionella	traditionella
spände	spände
jugoslaviskor	jugoslaviskor
cyklotroners	cyklotroners
långstrumpas	långstrumpas
årsfest	årsfest
existentiellt	existentiellt
ögonglobs	ögonglobs
terrorismens	terrorismens
fästande	fästande
eftersträvar	eftersträvar
singlas	singlas
satsar	satsar
ändligdimensionelle	ändligdimensionelle
allegorin	allegorin
smaragden	smaragden
adelssläkt	adelssläkt
byrådirektörer	byrådirektörer
dödsfalls	dödsfalls
torts	torts
kriteriet	kriteriet
masochists	masochists
förenas	förenas
egyptologis	egyptologis
tillkommelsen	tillkommelsen
döve	döve
legitimiteten	legitimiteten
tysthetens	tysthetens
datavetenskap	datavetenskap
efterfrågans	efterfrågans
brunbjörnar	brunbjörnar
givandet	givandet
tålmodiga	tålmodiga
signerade	signerade
förkunnat	förkunnat
formas	formas
versioner	versioner
möttes	möttes
består	består
avbildande	avbildande
passusar	passusar
lur	lur
translationer	translationer
gena	gena
fotgängaren	fotgängaren
rötterna	rötterna
rörmokaren	rörmokaren
verklighets	verklighets
initiativtagares	initiativtagares
översikts	översikts
klämdag	klämdag
kulsprutor	kulsprutor
etiketten	etiketten
åttondelars	åttondelars
tyglas	tyglas
tumnagelns	tumnagelns
gallerior	gallerior
fattat	fattat
räddare	räddare
garantifond	garantifond
ansträng	ansträng
bovs	bovs
clowneri	clowneri
röding	röding
uppställde	uppställde
cypriotiskas	cypriotiskas
delat	delat
fakultet	fakultet
kulturliv	kulturliv
antimaterian	antimaterian
vittnande	vittnande
getingarna	getingarna
davnad	davnad
accelerationens	accelerationens
misshandlas	misshandlas
önskans	önskans
sväng	sväng
muggar	muggar
talas	talas
bergochdalbanors	bergochdalbanors
smyckena	smyckena
uddens	uddens
oscillation	oscillation
matlagning	matlagning
ytterörats	ytterörats
kuf	kuf
omdefinierar	omdefinierar
dunstar	dunstar
öknamnens	öknamnens
grymme	grymme
slipat	slipat
mitokondries	mitokondries
utföras	utföras
mäta	mäta
blottat	blottat
mentor	mentor
nominera	nominera
möjliggjord	möjliggjord
mons	mons
kartografisk	kartografisk
ögonhålornas	ögonhålornas
utsträcka	utsträcka
svordomars	svordomars
signalementet	signalementet
morgonsofforna	morgonsofforna
blöt	blöt
omdefinierades	omdefinierades
trakasserat	trakasserat
gladd	gladd
diskuteras	diskuteras
regenter	regenter
deisters	deisters
sänts	sänts
snar	snar
flunsorna	flunsorna
dalarna	dalarna
beskyddare	beskyddare
sålde	sålde
finländaren	finländaren
indoktrineringen	indoktrineringen
flydde	flydde
upptagne	upptagne
gasta	gasta
räknestickans	räknestickans
dominikaners	dominikaners
dropp	dropp
byrådirektören	byrådirektören
expanderas	expanderas
retsticka	retsticka
utesluts	utesluts
licentiats	licentiats
plommon	plommon
meterna	meterna
ryggsäcken	ryggsäcken
fagottisten	fagottisten
avlagde	avlagde
tillgängligheten	tillgängligheten
förläts	förläts
sornas	sornas
nyårsaftons	nyårsaftons
marinbiologs	marinbiologs
kokades	kokades
öppnades	öppnades
terrorists	terrorists
rekommenderade	rekommenderade
skickad	skickad
barrskogar	barrskogar
blåmes	blåmes
läroverket	läroverket
judoutövaren	judoutövaren
transaktioner	transaktioner
använda	använda
öppna	öppna
åtnjuta	åtnjuta
luffarens	luffarens
oxarnas	oxarnas
påvars	påvars
fria	fria
trollade	trollade
senare	senare
indiskans	indiskans
mögs	mögs
önskningarna	önskningarna
fononernas	fononernas
tyristorerna	tyristorerna
översikt	översikt
arvedelar	arvedelar
näpet	näpet
luffarnas	luffarnas
luftmassan	luftmassan
oboerna	oboerna
utrikespolitiken	utrikespolitiken
surdegen	surdegen
talades	talades
tröstas	tröstas
renades	renades
krokodilers	krokodilers
altruistisk	altruistisk
domäns	domäns
förflyttningarnas	förflyttningarnas
kombinerat	kombinerat
spanjorens	spanjorens
stödstrumpans	stödstrumpans
marinbiologis	marinbiologis
blattes	blattes
systematiseras	systematiseras
bröas	bröas
blidkad	blidkad
essenserna	essenserna
tryckarna	tryckarna
förtrycker	förtrycker
skörten	skörten
avhärvlade	avhärvlade
tjugofemöringarna	tjugofemöringarna
kolonisters	kolonisters
mysande	mysande
bigamis	bigamis
slangordets	slangordets
lärd	lärd
anticyklonens	anticyklonens
särk	särk
lagstiftningens	lagstiftningens
volten	volten
komiker	komiker
diskuterats	diskuterats
batteriholken	batteriholken
arkivråden	arkivråden
ponerar	ponerar
nattduksbord	nattduksbord
skriftlig	skriftlig
5-öringens	5-öringens
könsnormer	könsnormer
uppställa	uppställa
rödhaken	rödhaken
släktets	släktets
kanslisekreterare	kanslisekreterare
hjortar	hjortar
klaffelen	klaffelen
gendriver	gendriver
dementerad	dementerad
erinrade	erinrade
upplösas	upplösas
kloner	kloner
fästas	fästas
utgjordes	utgjordes
förtryckts	förtryckts
nonan	nonan
bajskorven	bajskorven
mikrofonens	mikrofonens
terosens	terosens
fisket	fisket
lärt	lärt
arbetskamraterna	arbetskamraterna
grundämne	grundämne
sökt	sökt
utspelad	utspelad
skulptörs	skulptörs
embarkeringskort	embarkeringskort
störtkrukors	störtkrukors
misshandlar	misshandlar
satsa	satsa
preciserat	preciserat
sandas	sandas
koncentrerande	koncentrerande
dateras	dateras
torkare	torkare
prokrastinerande	prokrastinerande
limpan	limpan
partistyrelses	partistyrelses
drängen	drängen
åtgärdsbedömningar	åtgärdsbedömningar
räkor	räkor
vilddjur	vilddjur
asbest	asbest
interagera	interagera
panteistens	panteistens
möjliggör	möjliggör
uppvärmning	uppvärmning
redigeringskrig	redigeringskrig
borras	borras
fackverket	fackverket
förutsätts	förutsätts
kombinerande	kombinerande
bedrivne	bedrivne
mårkorna	mårkorna
rovs	rovs
racingbanors	racingbanors
ungdomsförbundet	ungdomsförbundet
malströmmarna	malströmmarna
särkarnas	särkarnas
fras	fras
spårade	spårade
packets	packets
justitiekanslerns	justitiekanslerns
återbesökets	återbesökets
återbesöket	återbesöket
återbesök	återbesök
ekobrottet	ekobrottet
pluskvamperfekten	pluskvamperfekten
altarets	altarets
riksantikvarien	riksantikvarien
kursfordran	kursfordran
skotskt	skotskt
förbehålla	förbehålla
kortslutande	kortslutande
klövens	klövens
inspekterades	inspekterades
brandväggarnas	brandväggarnas
bröar	bröar
villkoren	villkoren
justitiekanslerer	justitiekanslerer
savat	savat
anpassningar	anpassningar
ripjakts	ripjakts
lösa	lösa
bosatte	bosatte
drogerna	drogerna
mopps	mopps
saltstångs	saltstångs
aktivismen	aktivismen
spelpjäsen	spelpjäsen
jeeparna	jeeparna
sjöds	sjöds
bilfärjornas	bilfärjornas
bovarna	bovarna
epitetet	epitetet
snökedjorna	snökedjorna
börja	börja
matlagningen	matlagningen
5-öring	5-öring
avstånds	avstånds
tvivlande	tvivlande
förenklad	förenklad
roande	roande
borgaren	borgaren
utökas	utökas
köksön	köksön
framsäte	framsäte
rekommenderat	rekommenderat
bränna	bränna
kvitterande	kvitterande
bevisad	bevisad
bakhåll	bakhåll
blåhaken	blåhaken
polisbyrås	polisbyrås
kabinettssekreteraren	kabinettssekreteraren
blidkas	blidkas
sjungs	sjungs
oskadliggör	oskadliggör
drogens	drogens
givet	givet
blotta	blotta
rulltårtan	rulltårtan
fattas	fattas
domänerna	domänerna
duetts	duetts
julaftnarnas	julaftnarnas
fagott	fagott
klaffels	klaffels
arkiverad	arkiverad
trollas	trollas
minimum	minimum
tyngste	tyngste
tänkares	tänkares
atommassornas	atommassornas
rökrutor	rökrutor
bridge	bridge
beröms	beröms
öppnat	öppnat
kolumnbredder	kolumnbredder
kålrots	kålrots
förleder	förleder
tryckte	tryckte
klövarna	klövarna
maskuliner	maskuliner
namnars	namnars
förledets	förledets
stöttes	stöttes
kläckt	kläckt
förvarande	förvarande
cykloheptanets	cykloheptanets
eskimåer	eskimåer
kattdjur	kattdjur
elektriciteten	elektriciteten
redaktionssekreterarnas	redaktionssekreterarnas
ospontant	ospontant
accent	accent
galningarna	galningarna
katalanske	katalanske
energifrågor	energifrågor
halshuggande	halshuggande
koffertarnas	koffertarnas
datavetenskapens	datavetenskapens
löse	löse
ejder	ejder
beskärde	beskärde
syrgas	syrgas
korsfästande	korsfästande
slagares	slagares
odjurets	odjurets
fegis	fegis
aqvedukt	aqvedukt
kelar	kelar
förståndet	förståndet
socialförsäkringsministers	socialförsäkringsministers
nattklubb	nattklubb
påbuden	påbuden
kombineras	kombineras
modernt	modernt
rannsakas	rannsakas
ordningens	ordningens
jobbs	jobbs
täcke	täcke
konsekvente	konsekvente
skymmas	skymmas
färgat	färgat
spisoffret	spisoffret
memen	memen
markörers	markörers
flygas	flygas
svavelstickors	svavelstickors
bilägger	bilägger
vädurarna	vädurarna
departementschefers	departementschefers
namnens	namnens
gräslöken	gräslöken
svepts	svepts
retronym	retronym
beaktandeleds	beaktandeleds
konvojers	konvojers
lagstiftningar	lagstiftningar
snutits	snutits
pack	pack
ungkarl	ungkarl
repmånaden	repmånaden
gifts	gifts
nonanet	nonanet
klon	klon
svavelstickas	svavelstickas
uppfyll	uppfyll
homofons	homofons
muggen	muggen
överser	överser
grossen	grossen
krockars	krockars
gräslökens	gräslökens
redaktionssekreteraren	redaktionssekreteraren
murarnas	murarnas
chipspåsars	chipspåsars
stjärtars	stjärtars
jeeparnas	jeeparnas
slagverkaren	slagverkaren
förordnandet	förordnandet
förtvivlat	förtvivlat
antropologin	antropologin
ljudlöse	ljudlöse
kaoset	kaoset
gorillas	gorillas
handlägg	handlägg
härdsmältors	härdsmältors
transporterande	transporterande
sitt	sitt
linjekartor	linjekartor
preliminäre	preliminäre
retronymens	retronymens
rumänen	rumänen
nästen	nästen
flickväns	flickväns
gömda	gömda
argentinskorna	argentinskorna
basta	basta
väduren	väduren
krullparentesens	krullparentesens
qvadrater	qvadrater
lästes	lästes
huvens	huvens
regleringsbrevets	regleringsbrevets
rustningarnas	rustningarnas
stativens	stativens
offras	offras
polygonernas	polygonernas
ordlistors	ordlistors
böjs	böjs
bordas	bordas
rörmokares	rörmokares
bagateller	bagateller
släkten	släkten
infogade	infogade
västliga	västliga
betäckas	betäckas
terapeuts	terapeuts
transporterade	transporterade
stadsstadgan	stadsstadgan
arkivrådens	arkivrådens
skulptör	skulptör
prissummas	prissummas
förfars	förfars
fängelsehålorna	fängelsehålorna
protestera	protestera
marinbiologin	marinbiologin
bundna	bundna
förhandlad	förhandlad
örfilarna	örfilarna
offrade	offrade
sköter	sköter
nöjer	nöjer
krondikena	krondikena
haverera	haverera
förmörkat	förmörkat
medfödde	medfödde
krockarnas	krockarnas
annandagars	annandagars
murare	murare
vrida	vrida
bebodde	bebodde
patrullerar	patrullerar
allegorier	allegorier
rövas	rövas
minikjols	minikjols
reduktions	reduktions
sköts	sköts
konverterad	konverterad
inropen	inropen
underavdelningars	underavdelningars
fångenskapens	fångenskapens
chiffers	chiffers
joniske	joniske
applicera	applicera
delgrupperna	delgrupperna
svågrarnas	svågrarnas
stimulerat	stimulerat
galningars	galningars
ovanor	ovanor
essensers	essensers
bronsmedaljer	bronsmedaljer
cabbarna	cabbarna
tvilling	tvilling
användande	användande
fornengelskan	fornengelskan
täcken	täcken
seds	seds
signalement	signalement
narra	narra
finansmarknadens	finansmarknadens
doktriners	doktriners
cichlids	cichlids
flata	flata
slickepinnen	slickepinnen
villig	villig
löst	löst
stiftades	stiftades
centralafrikaners	centralafrikaners
vattnar	vattnar
byrådirektörernas	byrådirektörernas
avlägsna	avlägsna
delgrupp	delgrupp
fiskmatens	fiskmatens
snödroppe	snödroppe
kedjehus	kedjehus
kokande	kokande
inägas	inägas
elddop	elddop
buks	buks
gäspar	gäspar
vishet	vishet
ungdomsförbund	ungdomsförbund
utbuden	utbuden
kvantifierade	kvantifierade
utökades	utökades
kokas	kokas
prissumman	prissumman
sälj	sälj
vilt	vilt
rastade	rastade
borgarens	borgarens
vävstolens	vävstolens
väljares	väljares
påbud	påbud
sköt	sköt
halvimperials	halvimperials
talats	talats
raggarna	raggarna
saknade	saknade
anställdes	anställdes
fjäderbrickans	fjäderbrickans
ratificerades	ratificerades
pärmars	pärmars
hjorts	hjorts
gångjärnens	gångjärnens
skämtsamme	skämtsamme
köksöars	köksöars
tystande	tystande
stenas	stenas
byttan	byttan
bevarades	bevarades
berylls	berylls
kommutatorn	kommutatorn
äggulor	äggulor
upplag	upplag
kruciverbisten	kruciverbisten
laotiskans	laotiskans
lösande	lösande
mitokondriers	mitokondriers
getingars	getingars
använd	använd
ringmuskelns	ringmuskelns
vittnesbördets	vittnesbördets
vittnesbörden	vittnesbörden
förvånande	förvånande
örfilarnas	örfilarnas
bytas	bytas
söks	söks
twittras	twittras
besegra	besegra
vitsars	vitsars
assisterade	assisterade
spanjorers	spanjorers
kompletterade	kompletterade
arkeologens	arkeologens
pagens	pagens
bebott	bebott
beställningsarbete	beställningsarbete
upplys	upplys
uppenbarande	uppenbarande
underskrifts	underskrifts
beskrivit	beskrivit
racingbanan	racingbanan
kommuteras	kommuteras
retirera	retirera
blottande	blottande
ässen	ässen
lugg	lugg
begått	begått
dyrkades	dyrkades
kaos	kaos
upphävande	upphävande
segra	segra
könsnorm	könsnorm
vindhåls	vindhåls
gärningsmannen	gärningsmannen
twittrats	twittrats
basketbollar	basketbollar
överdomstols	överdomstols
utgjorde	utgjorde
sökts	sökts
hämta	hämta
minska	minska
länsledningens	länsledningens
gemak	gemak
förhindra	förhindra
cykelpumparna	cykelpumparna
fakultetsnämnden	fakultetsnämnden
konfigurera	konfigurera
pärlugglorna	pärlugglorna
förfrågans	förfrågans
spritt	spritt
sava	sava
möjliggörande	möjliggörande
lövträdets	lövträdets
flunsors	flunsors
deister	deister
släktet	släktet
tanzanier	tanzanier
ambassadsekreteraren	ambassadsekreteraren
lyste	lyste
trofastheten	trofastheten
bildsidor	bildsidor
draget	draget
abonnemangsavgiften	abonnemangsavgiften
hämtar	hämtar
befästas	befästas
påvisar	påvisar
linjekartans	linjekartans
könskromosom	könskromosom
kroppsvätskans	kroppsvätskans
kortslutas	kortslutas
mysterier	mysterier
ekobrottets	ekobrottets
statsrådsberedningars	statsrådsberedningars
församla	församla
webbplatser	webbplatser
sedeslöshet	sedeslöshet
epitets	epitets
trofasthet	trofasthet
undkom	undkom
stötte	stötte
cichliders	cichliders
fattar	fattar
mät	mät
bedrövas	bedrövas
kvacksalvares	kvacksalvares
sedens	sedens
koordinatsystem	koordinatsystem
index	index
hyresvärden	hyresvärden
ansade	ansade
doktorsavhandling	doktorsavhandling
pilspetsen	pilspetsen
svängdes	svängdes
läser	läser
trycka	trycka
tillgodogöra	tillgodogöra
retstickor	retstickor
kommutativ	kommutativ
departementsråds	departementsråds
mittpunkts	mittpunkts
lärda	lärda
inrätta	inrätta
ryggsimmet	ryggsimmet
nominerat	nominerat
uteslöts	uteslöts
uppenbara	uppenbara
arresterar	arresterar
glåpords	glåpords
upptagnare	upptagnare
determinant	determinant
stötande	stötande
inramningars	inramningars
trugad	trugad
tågas	tågas
duande	duande
överdomstolen	överdomstolen
mikroelektronikens	mikroelektronikens
godtycklige	godtycklige
raggmunkarna	raggmunkarna
döva	döva
homograferna	homograferna
lösdriverskas	lösdriverskas
reklamationen	reklamationen
automatiska	automatiska
expanderade	expanderade
klöven	klöven
åtalar	åtalar
bryggkaffets	bryggkaffets
bryggkaffet	bryggkaffet
överblickas	överblickas
fordrande	fordrande
förgör	förgör
livstids	livstids
kolumnbredd	kolumnbredd
koffertarna	koffertarna
blöte	blöte
qväljes	qväljes
utbjuda	utbjuda
ellipsen	ellipsen
pudel	pudel
viktige	viktige
oxe	oxe
modedockorna	modedockorna
upptagnast	upptagnast
höjningars	höjningars
guldfiskarna	guldfiskarna
polerar	polerar
radianer	radianer
beskyddarens	beskyddarens
långtradares	långtradares
mentorer	mentorer
institutionelle	institutionelle
ministeriers	ministeriers
telegrafis	telegrafis
omdefinierande	omdefinierande
mös	mös
säljs	säljs
tillgänglighet	tillgänglighet
snödroppens	snödroppens
enslinjerna	enslinjerna
ungkarlens	ungkarlens
kolväten	kolväten
cabbars	cabbars
ässets	ässets
låta	låta
kontrasterades	kontrasterades
gross	gross
vises	vises
sjungits	sjungits
förenklats	förenklats
drängs	drängs
regleringsbrev	regleringsbrev
nyponen	nyponen
egyptier	egyptier
tänkte	tänkte
sänt	sänt
hämtats	hämtats
kines	kines
tryckande	tryckande
täckta	täckta
gruvstolparnas	gruvstolparnas
oxideras	oxideras
nigande	nigande
utfärdades	utfärdades
jugoslaviskorna	jugoslaviskorna
dal	dal
ambassadsekreterarnas	ambassadsekreterarnas
stärk	stärk
fontäners	fontäners
ylande	ylande
daterat	daterat
inträffa	inträffa
högskolestyrelsernas	högskolestyrelsernas
tanzanierna	tanzanierna
nästes	nästes
oboens	oboens
eftersträvas	eftersträvas
löjtnanten	löjtnanten
morgonsoffas	morgonsoffas
fyllda	fyllda
pråmars	pråmars
trigonometrin	trigonometrin
vits	vits
censor	censor
afrikanskors	afrikanskors
fegisens	fegisens
systerson	systerson
trugat	trugat
vifta	vifta
graverad	graverad
uppfylls	uppfylls
vidhäftande	vidhäftande
alkoholismens	alkoholismens
ackuschör	ackuschör
mustens	mustens
örtagård	örtagård
fattades	fattades
bollklubb	bollklubb
joden	joden
sprängmedel	sprängmedel
utplånades	utplånades
cypriotiska	cypriotiska
förmörkades	förmörkades
upphävdes	upphävdes
eldgaffelns	eldgaffelns
dubbelklickets	dubbelklickets
qvadrats	qvadrats
metansyra	metansyra
författningen	författningen
brunbjörnarna	brunbjörnarna
örlogsskolas	örlogsskolas
skalärprodukter	skalärprodukter
markörerna	markörerna
lamans	lamans
åsens	åsens
bereds	bereds
besiktigades	besiktigades
respekterades	respekterades
mäter	mäter
patrullerats	patrullerats
benämns	benämns
anklagade	anklagade
a-kassornas	a-kassornas
överblickat	överblickat
accenterna	accenterna
ackuschören	ackuschören
exponerade	exponerade
åtgärdsbedömning	åtgärdsbedömning
stridsmedlen	stridsmedlen
öppnande	öppnande
snedstrecks	snedstrecks
tågstationerna	tågstationerna
konstartens	konstartens
existentielle	existentielle
bedrivet	bedrivet
galleriorna	galleriorna
hons	hons
jordreforms	jordreforms
judoutövares	judoutövares
inmatningsfältet	inmatningsfältet
episteln	episteln
tryckt	tryckt
svänger	svänger
vridas	vridas
rulltårta	rulltårta
historisk	historisk
förordnandenas	förordnandenas
blidka	blidka
marinbiologers	marinbiologers
åttondedelar	åttondedelar
vinklande	vinklande
hedersbetygelsens	hedersbetygelsens
rumäner	rumäner
kära	kära
friat	friat
kvällstidnings	kvällstidnings
lokaliserande	lokaliserande
grymmare	grymmare
värnpliktskongress	värnpliktskongress
åttondelar	åttondelar
isotonens	isotonens
konsekventa	konsekventa
urladdningars	urladdningars
notställens	notställens
nobelpristagares	nobelpristagares
malströmmar	malströmmar
kronologiske	kronologiske
exponerad	exponerad
anställas	anställas
ystades	ystades
svängts	svängts
propan	propan
rättfärdiga	rättfärdiga
förgöra	förgöra
gastade	gastade
platåerna	platåerna
homeopatis	homeopatis
konfigurerande	konfigurerande
radian	radian
funderades	funderades
doktorands	doktorands
lämpande	lämpande
lodjurens	lodjurens
förvånad	förvånad
åttiondelarna	åttiondelarna
snigelns	snigelns
faktisk	faktisk
bildrullens	bildrullens
oxar	oxar
fackverk	fackverk
sändande	sändande
besiktigas	besiktigas
chipspåsarnas	chipspåsarnas
mångfacetterat	mångfacetterat
talade	talade
sidensvansar	sidensvansar
stadsbiblioteks	stadsbiblioteks
penningkistor	penningkistor
vingarnas	vingarnas
förkunnade	förkunnade
sexhörningars	sexhörningars
pennalens	pennalens
bevisande	bevisande
underskattat	underskattat
omnämnandenas	omnämnandenas
afrikanskorna	afrikanskorna
oxens	oxens
konverteras	konverteras
killingars	killingars
sporde	sporde
lägsta	lägsta
ringaren	ringaren
ondast	ondast
förkunnar	förkunnar
kantrar	kantrar
blåhakarna	blåhakarna
altaret	altaret
läroverk	läroverk
tyristorer	tyristorer
klövs	klövs
skyhöge	skyhöge
utfärdat	utfärdat
livstiders	livstiders
tvillingars	tvillingars
konvoluts	konvoluts
lönnmördas	lönnmördas
bältets	bältets
noggranne	noggranne
kolgruvors	kolgruvors
blidkats	blidkats
möts	möts
avgudens	avgudens
sjöslagen	sjöslagen
disponerad	disponerad
surjektionen	surjektionen
läs	läs
trakassera	trakassera
psykologers	psykologers
krullparentesers	krullparentesers
besöka	besöka
lagats	lagats
debattörer	debattörer
byråassistents	byråassistents
elektronhjärnas	elektronhjärnas
mött	mött
kokat	kokat
radiostationens	radiostationens
upphandlingars	upphandlingars
huvars	huvars
näpna	näpna
kämpad	kämpad
reta	reta
våte	våte
teros	teros
nattduksbordets	nattduksbordets
vilddjurs	vilddjurs
försynens	försynens
porträtterad	porträtterad
vinrankors	vinrankors
konungadömes	konungadömes
omstruktureras	omstruktureras
ellipser	ellipser
besveks	besveks
äggulors	äggulors
intressera	intressera
blottades	blottades
ordnings	ordnings
renat	renat
utsträck	utsträck
bestämmer	bestämmer
kids	kids
anställd	anställd
bergochdalbanorna	bergochdalbanorna
isters	isters
referera	referera
blankstegen	blankstegen
talande	talande
sköte	sköte
sprängmedlen	sprängmedlen
spridd	spridd
underskriften	underskriften
kombinerar	kombinerar
bilfärja	bilfärja
byråassistenterna	byråassistenterna
kombinerad	kombinerad
distributive	distributive
borrmaskinens	borrmaskinens
höghjulingarna	höghjulingarna
hjälpsam	hjälpsam
ospontane	ospontane
byråkratiskt	byråkratiskt
minimumet	minimumet
använt	använt
långtradaren	långtradaren
duetterna	duetterna
förgätit	förgätit
niga	niga
pärms	pärms
varulvs	varulvs
svensexorna	svensexorna
akvarellmålares	akvarellmålares
rättfärdigade	rättfärdigade
kokosnöts	kokosnöts
ryggsäckens	ryggsäckens
undantagen	undantagen
upplyses	upplyses
cerebrospinalvätskans	cerebrospinalvätskans
svindeln	svindeln
begrundas	begrundas
samvetena	samvetena
rökrutas	rökrutas
ruinerande	ruinerande
dyrkad	dyrkad
sen	sen
killingarna	killingarna
oändligaste	oändligaste
sanerade	sanerade
simbassängernas	simbassängernas
pennvässares	pennvässares
droppat	droppat
bordläggande	bordläggande
sambands	sambands
kommunicerat	kommunicerat
vårdkasens	vårdkasens
beröm	beröm
bromsade	bromsade
nyanseras	nyanseras
kexets	kexets
sy	sy
jagas	jagas
rötter	rötter
förenklar	förenklar
bröade	bröade
dubbelmackorna	dubbelmackorna
besök	besök
handläggare	handläggare
renad	renad
antände	antände
lövträdet	lövträdet
påbuds	påbuds
busschaufförerna	busschaufförerna
kvantiteter	kvantiteter
korsfästs	korsfästs
åtalas	åtalas
koncentrationer	koncentrationer
substraten	substraten
kofferts	kofferts
årorna	årorna
diarieför	diarieför
rappad	rappad
besegrades	besegrades
kulturlivs	kulturlivs
radavståndets	radavståndets
sutenören	sutenören
lösdriverska	lösdriverska
regentens	regentens
svastikans	svastikans
slaktas	slaktas
embarkeringskortets	embarkeringskortets
brandväggar	brandväggar
rastades	rastades
moppen	moppen
färgbild	färgbild
rustningars	rustningars
kejsares	kejsares
tågades	tågades
assisterad	assisterad
jodens	jodens
intellektuellt	intellektuellt
anrättade	anrättade
roa	roa
versionerna	versionerna
vävstol	vävstol
epistel	epistel
åttondels	åttondels
morfism	morfism
arkeologen	arkeologen
rättfärdigas	rättfärdigas
butikskedja	butikskedja
bagerier	bagerier
resecheckars	resecheckars
benämnande	benämnande
enas	enas
gifta	gifta
ispravniks	ispravniks
värdemängds	värdemängds
barkas	barkas
bevarad	bevarad
eforn	eforn
terroristen	terroristen
kommunicera	kommunicera
koka	koka
jagad	jagad
mikrofonerna	mikrofonerna
flickvänner	flickvänner
arkivarierna	arkivarierna
åskådar	åskådar
licentiaten	licentiaten
restaurerar	restaurerar
socialförsäkringsministrar	socialförsäkringsministrar
fågelskådares	fågelskådares
kvitteras	kvitteras
blottade	blottade
antända	antända
vidhäftade	vidhäftade
flyttas	flyttas
lösare	lösare
tala	tala
stickmyggor	stickmyggor
öknamn	öknamn
lexikografisk	lexikografisk
limpans	limpans
stötas	stötas
dieseln	dieseln
uttagningars	uttagningars
energikälla	energikälla
förkunnas	förkunnas
presenning	presenning
bastet	bastet
oxidationstal	oxidationstal
ventilens	ventilens
oxidationstalet	oxidationstalet
lönnmördats	lönnmördats
klistrande	klistrande
holonymens	holonymens
davnas	davnas
uttalas	uttalas
leverera	leverera
lurarnas	lurarnas
utsändas	utsändas
ringare	ringare
trädstammen	trädstammen
determinanter	determinanter
indoktrinera	indoktrinera
qvald	qvald
dragne	dragne
finskors	finskors
gestaltning	gestaltning
klädd	klädd
radiostationen	radiostationen
krattors	krattors
fjättrade	fjättrade
prokrastinera	prokrastinera
fjäderbrickorna	fjäderbrickorna
kämpade	kämpade
mårkor	mårkor
betecknad	betecknad
ministerium	ministerium
örtagårdars	örtagårdars
palindromers	palindromers
kräftor	kräftor
extentans	extentans
löste	löste
snigel	snigel
fagotts	fagotts
länders	länders
förspel	förspel
hycklarnas	hycklarnas
försynen	försynen
slagverkares	slagverkares
skottdagen	skottdagen
bildordbokens	bildordbokens
trigonometri	trigonometri
tensorns	tensorns
fogas	fogas
utrikespolitiks	utrikespolitiks
dörjande	dörjande
händelsehorisonter	händelsehorisonter
röva	röva
underavdelningarnas	underavdelningarnas
bageriers	bageriers
maskros	maskros
paketera	paketera
potentiellt	potentiellt
tigits	tigits
konstarter	konstarter
örlogsskolor	örlogsskolor
gendrivande	gendrivande
etiketterna	etiketterna
befäst	befäst
hyresnämnderna	hyresnämnderna
hajande	hajande
efor	efor
webbplats	webbplats
tranbärs	tranbärs
hon	hon
fästens	fästens
kvaddas	kvaddas
bilagt	bilagt
förgörs	förgörs
preciseras	preciseras
lärde	lärde
lagstiftningen	lagstiftningen
justerande	justerande
kirrande	kirrande
golfklubbens	golfklubbens
anglicismen	anglicismen
fjättras	fjättras
polera	polera
asbestens	asbestens
upphäver	upphäver
enslinjes	enslinjes
diarieförande	diarieförande
tänkare	tänkare
förgiftade	förgiftade
hitlistornas	hitlistornas
diss	diss
egyptierna	egyptierna
varierades	varierades
tagen	tagen
altares	altares
asgarvar	asgarvar
comebackerna	comebackerna
provocerats	provocerats
kvantifierar	kvantifierar
knacka	knacka
korskrank	korskrank
falsifierad	falsifierad
svindel	svindel
landstingsrådens	landstingsrådens
kraftkabels	kraftkabels
hakar	hakar
smittskydd	smittskydd
doktorsgraderna	doktorsgraderna
trädstammens	trädstammens
utgiftstakets	utgiftstakets
nejlikan	nejlikan
bergfinkars	bergfinkars
fordra	fordra
vattenplaningen	vattenplaningen
byrådirektör	byrådirektör
sänds	sänds
minskade	minskade
kakkalas	kakkalas
abonnemangsavgifts	abonnemangsavgifts
beskärt	beskärt
sökte	sökte
kristadelfians	kristadelfians
voltens	voltens
stödstrumpors	stödstrumpors
droppen	droppen
altruisternas	altruisternas
vindhålets	vindhålets
moppars	moppars
bifloderna	bifloderna
anfangers	anfangers
småviltet	småviltet
butikskedjor	butikskedjor
ymnighetens	ymnighetens
undersökande	undersökande
ordstäv	ordstäv
bronsmedaljen	bronsmedaljen
kolvätets	kolvätets
massförstörelsevapen	massförstörelsevapen
används	används
pluskvamperfekt	pluskvamperfekt
hållplats	hållplats
tungt	tungt
anklagas	anklagas
epiteten	epiteten
förkastas	förkastas
förkortningens	förkortningens
trumpetare	trumpetare
anklagades	anklagades
murares	murares
spenderar	spenderar
firad	firad
söka	söka
galningen	galningen
skärvors	skärvors
antikvarien	antikvarien
levererade	levererade
massakerns	massakerns
lös	lös
nejs	nejs
nertiders	nertiders
tvivla	tvivla
fungerade	fungerade
skickade	skickade
prutten	prutten
fatta	fatta
passusens	passusens
nämner	nämner
byråkratiske	byråkratiske
förbehåller	förbehåller
bombarderades	bombarderades
domänens	domänens
jeepars	jeepars
additionens	additionens
vattenkonster	vattenkonster
penningkistorna	penningkistorna
kursfordrans	kursfordrans
korsfästa	korsfästa
vittna	vittna
falsifierade	falsifierade
lokaliserad	lokaliserad
dukades	dukades
knarka	knarka
klätt	klätt
asgarvande	asgarvande
dissekera	dissekera
uzbekerna	uzbekerna
psykologs	psykologs
reduktioners	reduktioners
domän	domän
singla	singla
bukar	bukar
pudels	pudels
kuddarnas	kuddarnas
påvar	påvar
utgörande	utgörande
cellulosanitrat	cellulosanitrat
glåporden	glåporden
bundne	bundne
föräldralösa	föräldralösa
arrendena	arrendena
eldgaffel	eldgaffel
roten	roten
modernast	modernast
stött	stött
cykelhandlaren	cykelhandlaren
händelsehorisonten	händelsehorisonten
debattörerna	debattörerna
räkornas	räkornas
kontrabasens	kontrabasens
rödhakars	rödhakars
sandades	sandades
relaterar	relaterar
antikvarier	antikvarier
chilenarens	chilenarens
korsord	korsord
doktrins	doktrins
kolonistens	kolonistens
homogene	homogene
linslusar	linslusar
hämma	hämma
droppade	droppade
clowneriet	clowneriet
åtnjutas	åtnjutas
påvisat	påvisat
konvojens	konvojens
förtryckas	förtryckas
utträdesarbete	utträdesarbete
vattnades	vattnades
utvandrade	utvandrade
barrträdets	barrträdets
killingarnas	killingarnas
musikinstruments	musikinstruments
tänker	tänker
plusteckens	plusteckens
stridsmedlet	stridsmedlet
steningen	steningen
ymnighets	ymnighets
ketonerna	ketonerna
givna	givna
linslusens	linslusens
förkortningarna	förkortningarna
skatbo	skatbo
naturvårds	naturvårds
torkarnas	torkarnas
lydelses	lydelses
paketerar	paketerar
vakansers	vakansers
anarkister	anarkister
använde	använde
begrundades	begrundades
bollklubbens	bollklubbens
ansträngd	ansträngd
yla	yla
utplåna	utplåna
bergfinken	bergfinken
participet	participet
draksegel	draksegel
öppnas	öppnas
årsfester	årsfester
anklaga	anklaga
länderna	länderna
nattduksbordet	nattduksbordet
kolgruvan	kolgruvan
återlämnande	återlämnande
förflyttningar	förflyttningar
emigrerade	emigrerade
slickepinnar	slickepinnar
ås	ås
svängande	svängande
sanera	sanera
plommons	plommons
täcka	täcka
afrikanskan	afrikanskan
hakens	hakens
flatas	flatas
vridande	vridande
bronsmedalj	bronsmedalj
noggrant	noggrant
vädur	vädur
snöret	snöret
korsordet	korsordet
bokriserna	bokriserna
tryckarens	tryckarens
dubbelklickar	dubbelklickar
hotfull	hotfull
försona	försona
världsmästaren	världsmästaren
anlöpte	anlöpte
blankstegs	blankstegs
bildrullars	bildrullars
linets	linets
handlade	handlade
årors	årors
sörgårdsidyllers	sörgårdsidyllers
livslängden	livslängden
fraser	fraser
piruetters	piruetters
begås	begås
anglicism	anglicism
tävlingsbanors	tävlingsbanors
grindarnas	grindarnas
ledarsidorna	ledarsidorna
dubbelmacka	dubbelmacka
utkommen	utkommen
länsledningar	länsledningar
bereder	bereder
landstingsdirektörens	landstingsdirektörens
frisörers	frisörers
kokosnötters	kokosnötters
dödsfallet	dödsfallet
framsteg	framsteg
upplöst	upplöst
svensexors	svensexors
jordskreds	jordskreds
pub	pub
provisoriets	provisoriets
ackumuleras	ackumuleras
fiskades	fiskades
såld	såld
kartografiska	kartografiska
mötande	mötande
mysteriums	mysteriums
rövande	rövande
knäveck	knäveck
tremänningarna	tremänningarna
varulvarna	varulvarna
fyllde	fyllde
graverades	graverades
förutsatt	förutsatt
kattdjuret	kattdjuret
atommassor	atommassor
snedstreck	snedstreck
saknas	saknas
retirerat	retirerat
terroriserande	terroriserande
avtagne	avtagne
ordlistor	ordlistor
substrat	substrat
tvillings	tvillings
dyrkande	dyrkande
avtaget	avtaget
departementsråd	departementsråd
nallens	nallens
svågern	svågern
överlever	överlever
syddes	syddes
skånks	skånks
femörings	femörings
nittondelar	nittondelar
snörens	snörens
initiativtagarna	initiativtagarna
plommonen	plommonen
sydnäktergalarnas	sydnäktergalarnas
blixtnedslagen	blixtnedslagen
rättvisans	rättvisans
punktlistan	punktlistan
åttiondelars	åttiondelars
stöts	stöts
ax	ax
kuddars	kuddars
duad	duad
sexpacket	sexpacket
fanfaronaders	fanfaronaders
gemaket	gemaket
bröades	bröades
egyptologins	egyptologins
anrättningars	anrättningars
leksak	leksak
antimaterias	antimaterias
meter	meter
refererande	refererande
bokmärken	bokmärken
vinge	vinge
förändrat	förändrat
affine	affine
undantagna	undantagna
ringfinger	ringfinger
ballongpelare	ballongpelare
stånd	stånd
sexhörningarnas	sexhörningarnas
finsko	finsko
älg	älg
tillgängliggjord	tillgängliggjord
bered	bered
rovets	rovets
finansmarknaderna	finansmarknaderna
citronsyran	citronsyran
förhandlar	förhandlar
agitatorns	agitatorns
tensorer	tensorer
mög	mög
framsäten	framsäten
grandets	grandets
gångjärn	gångjärn
betecknat	betecknat
färgad	färgad
högskolestyrelses	högskolestyrelses
fallera	fallera
dörjade	dörjade
minskar	minskar
fyllt	fyllt
kejsarens	kejsarens
stärkas	stärkas
simbassängens	simbassängens
bromspedal	bromspedal
kraftkabeln	kraftkabeln
departementschefens	departementschefens
högskolelagarna	högskolelagarna
inmatningsfältets	inmatningsfältets
oxes	oxes
rädd	rädd
skörtet	skörtet
manchesters	manchesters
borsten	borsten
utgöra	utgöra
attackeras	attackeras
nejlikornas	nejlikornas
snökedja	snökedja
koncentrationerna	koncentrationerna
sädesledarens	sädesledarens
dräps	dräps
pulver	pulver
tystad	tystad
fajternas	fajternas
smittskyddet	smittskyddet
stativ	stativ
fogat	fogat
upptäcks	upptäcks
doktorsexamen	doktorsexamen
olivträd	olivträd
trycks	trycks
berömde	berömde
förmörka	förmörka
bältena	bältena
flyttats	flyttats
interagerande	interagerande
punktlista	punktlista
insamlande	insamlande
arbetssättet	arbetssättet
epitet	epitet
metern	metern
forskningsbibliotek	forskningsbibliotek
utplånande	utplånande
accelerationen	accelerationen
blottas	blottas
fogar	fogar
fåtöljen	fåtöljen
intrången	intrången
automatiskt	automatiskt
förlett	förlett
källingen	källingen
dämpare	dämpare
äppelträdet	äppelträdet
begynde	begynde
bilagornas	bilagornas
sudda	sudda
berömmande	berömmande
gömde	gömde
koffert	koffert
gelé	gelé
oxarna	oxarna
beställde	beställde
dyrkas	dyrkas
formande	formande
debattören	debattören
stimuleras	stimuleras
kräftans	kräftans
jaga	jaga
sädesledaren	sädesledaren
mötts	mötts
raggmunk	raggmunk
vattna	vattna
massförstörelsevapens	massförstörelsevapens
konsortier	konsortier
basketbollarnas	basketbollarnas
amperena	amperena
filter	filter
förnimmande	förnimmande
strålblomma	strålblomma
anlöpta	anlöpta
planeras	planeras
kruciverbists	kruciverbists
X-kromosomens	X-kromosomens
skrinlägger	skrinlägger
undervattensbåtars	undervattensbåtars
åklagande	åklagande
atomfysik	atomfysik
cykelpump	cykelpump
åttondedelars	åttondedelars
kokar	kokar
X-kromosom	X-kromosom
olla	olla
svågrars	svågrars
oscillations	oscillations
tillgängliggörs	tillgängliggörs
dubbelklicket	dubbelklicket
ventilers	ventilers
försonats	försonats
mätt	mätt
flädermärgskulornas	flädermärgskulornas
fiskas	fiskas
halsbanden	halsbanden
derivatorna	derivatorna
medelhavs	medelhavs
traditionelle	traditionelle
a-kassa	a-kassa
disponeras	disponeras
preliminär	preliminär
baltisk	baltisk
slakta	slakta
kommuterar	kommuterar
ugglas	ugglas
bildsidan	bildsidan
blödd	blödd
oändlig	oändlig
glädjas	glädjas
kilarna	kilarna
täck	täck
undervattensbåts	undervattensbåts
bestå	bestå
havererade	havererade
undermeny	undermeny
delade	delade
maskrosen	maskrosen
citronsyrans	citronsyrans
obegränsae	obegränsae
patentera	patentera
docerande	docerande
ratas	ratas
fotoners	fotoners
kronologiska	kronologiska
dräptes	dräptes
rots	rots
fira	fira
felfortplantningarna	felfortplantningarna
tumnagel	tumnagel
föreställas	föreställas
påves	påves
saltstången	saltstången
flydda	flydda
dräpt	dräpt
kloriderna	kloriderna
lodjuret	lodjuret
antytt	antytt
busschaufförs	busschaufförs
korniskan	korniskan
maskulinet	maskulinet
bakhålls	bakhålls
bromsat	bromsat
förändrade	förändrade
fordrades	fordrades
atomfysikens	atomfysikens
garantifonden	garantifonden
såpbubblorna	såpbubblorna
ödmjuka	ödmjuka
ballonger	ballonger
slutlige	slutlige
överraskas	överraskas
indikerad	indikerad
daggkåpan	daggkåpan
kronprins	kronprins
holonym	holonym
beskrivningsspråken	beskrivningsspråken
begynt	begynt
berömts	berömts
holländsk	holländsk
partistyrelserna	partistyrelserna
kabinettssekreterare	kabinettssekreterare
smaragders	smaragders
vinrankans	vinrankans
kinesens	kinesens
attackerar	attackerar
äggula	äggula
korsfäst	korsfäst
skriftligt	skriftligt
västlig	västlig
antropologins	antropologins
gestaltningars	gestaltningars
skotsk	skotsk
förlät	förlät
kommandoknapps	kommandoknapps
antydde	antydde
forskningsbiblioteks	forskningsbiblioteks
barberad	barberad
defenestrerad	defenestrerad
vinterdäck	vinterdäck
förenar	förenar
dirigistiske	dirigistiske
pubarna	pubarna
berömma	berömma
justitieministrars	justitieministrars
kexet	kexet
förkunnades	förkunnades
värmebehandlar	värmebehandlar
medelhavet	medelhavet
gelés	gelés
defenestrerat	defenestrerat
brassat	brassat
förvarar	förvarar
värka	värka
handläggares	handläggares
svepande	svepande
stridsmedel	stridsmedel
omstrukturerades	omstrukturerades
konungadömens	konungadömens
säkrar	säkrar
överlevnaden	överlevnaden
twittrande	twittrande
lexikografiska	lexikografiska
platås	platås
spenderande	spenderande
krokodilen	krokodilen
porren	porren
studiet	studiet
elverken	elverken
fäste	fäste
översedd	översedd
gravitation	gravitation
rymdfysikens	rymdfysikens
kedjehusets	kedjehusets
inspekterat	inspekterat
son	son
sutenörens	sutenörens
barrträd	barrträd
årornas	årornas
blödas	blödas
väljarnas	väljarnas
pilsners	pilsners
åra	åra
upplagens	upplagens
ödmjuk	ödmjuk
musikinstrument	musikinstrument
fakulteternas	fakulteternas
antänder	antänder
ovanorna	ovanorna
fotgängarna	fotgängarna
tegs	tegs
diesel	diesel
nynorskans	nynorskans
barntås	barntås
utfördes	utfördes
masochisten	masochisten
kommunikationers	kommunikationers
hållplatsers	hållplatsers
pärlugglor	pärlugglor
krondiken	krondiken
borrats	borrats
filialens	filialens
krattorna	krattorna
musikallåtar	musikallåtar
stjärten	stjärten
suddar	suddar
skärva	skärva
kompilerats	kompilerats
rättshaverist	rättshaverist
anlöpas	anlöpas
procentenheten	procentenheten
obetalbar	obetalbar
halshugga	halshugga
möjliggjordes	möjliggjordes
småländska	småländska
villkor	villkor
dräpas	dräpas
peruanen	peruanen
hotfulle	hotfulle
ljudlös	ljudlös
polarforsknings	polarforsknings
specialtecken	specialtecken
fogad	fogad
massakern	massakern
ettstrukna	ettstrukna
förena	förena
additionerna	additionerna
upptäcktsresas	upptäcktsresas
akvarellmålare	akvarellmålare
vilde	vilde
uppenbaras	uppenbaras
monsunernas	monsunernas
formeln	formeln
ösregnens	ösregnens
pennalen	pennalen
sörgårdsidyllen	sörgårdsidyllen
dirigistiskt	dirigistiskt
anrättas	anrättas
förtvivla	förtvivla
önska	önska
pila	pila
arbetssätts	arbetssätts
avlägsnas	avlägsnas
kirrade	kirrade
bordlägga	bordlägga
gruvstolpar	gruvstolpar
begravde	begravde
mustascherna	mustascherna
uddarna	uddarna
slidans	slidans
kryptan	kryptan
infogad	infogad
befordran	befordran
kaktus	kaktus
anklagar	anklagar
sexpacks	sexpacks
ursprungskällans	ursprungskällans
nallarnas	nallarnas
avlagda	avlagda
spanjors	spanjors
upplösande	upplösande
höghjuling	höghjuling
notställ	notställ
fonons	fonons
renade	renade
sjudande	sjudande
utsträcks	utsträcks
förvarade	förvarade
magsmärtan	magsmärtan
gravvårdars	gravvårdars
murarens	murarens
visars	visars
såga	såga
betäck	betäck
ockupationen	ockupationen
jonisk	jonisk
filial	filial
homogena	homogena
köpingen	köpingen
våld	våld
konservburkars	konservburkars
repmånader	repmånader
mjölksyras	mjölksyras
kuddarna	kuddarna
vårdkasarna	vårdkasarna
pingis	pingis
odjurs	odjurs
citrusfrukters	citrusfrukters
löjtnantens	löjtnantens
vattenplanings	vattenplanings
ratificera	ratificera
substansens	substansens
twittra	twittra
uttalad	uttalad
skjuls	skjuls
godtyckliga	godtyckliga
landstingsråds	landstingsråds
tordes	tordes
eskimåernas	eskimåernas
institutionella	institutionella
lagades	lagades
lavarnas	lavarnas
härdsmältans	härdsmältans
bytande	bytande
fajtens	fajtens
påbudens	påbudens
kapitalisterna	kapitalisterna
lokaliserades	lokaliserades
undkomma	undkomma
brassades	brassades
dunstats	dunstats
sändes	sändes
stridsmedels	stridsmedels
fanfaronads	fanfaronads
meddelats	meddelats
förgjort	förgjort
homofoners	homofoners
mittpunkten	mittpunkten
bombarderats	bombarderats
återbesöken	återbesöken
syrgasen	syrgasen
kosta	kosta
skötte	skötte
föreställ	föreställ
grindarna	grindarna
nyårsaftonen	nyårsaftonen
uppenbarat	uppenbarat
rappande	rappande
pennvässare	pennvässare
stöta	stöta
höjningar	höjningar
ollades	ollades
porträtterade	porträtterade
statsbudgetar	statsbudgetar
nagellacker	nagellacker
zappa	zappa
presenningen	presenningen
stadsbibliotek	stadsbibliotek
rövade	rövade
koordinatsystemets	koordinatsystemets
lagade	lagade
befästa	befästa
avgasrörets	avgasrörets
stadsstadgornas	stadsstadgornas
örtagårdar	örtagårdar
dövt	dövt
fattade	fattade
ledarsidor	ledarsidor
ösregns	ösregns
omnämnandes	omnämnandes
enar	enar
musikallåt	musikallåt
korsförhörens	korsförhörens
arkivariens	arkivariens
urladdningen	urladdningen
svavelvätes	svavelvätes
tig	tig
valrossars	valrossars
svavelväte	svavelväte
sändas	sändas
julaftonens	julaftonens
musikliv	musikliv
tjeckiskans	tjeckiskans
genade	genade
bekräftade	bekräftade
låter	låter
fåtölj	fåtölj
slangordet	slangordet
protesterad	protesterad
snuten	snuten
kutad	kutad
undantaget	undantaget
rodnat	rodnat
kontrasterar	kontrasterar
nejets	nejets
öppnats	öppnats
felfortplantningen	felfortplantningen
hyresvärd	hyresvärd
snöres	snöres
surdegarna	surdegarna
beställda	beställda
kålroten	kålroten
barntårs	barntårs
uttagning	uttagning
ursprungskällas	ursprungskällas
kommandoknappar	kommandoknappar
oxiderande	oxiderande
barka	barka
spelpjäserna	spelpjäserna
argentinskans	argentinskans
stiftas	stiftas
beställs	beställs
provisorierna	provisorierna
badvädrets	badvädrets
ispravniken	ispravniken
translationen	translationen
förfors	förfors
stenat	stenat
kutar	kutar
förgjorde	förgjorde
dementeras	dementeras
verkligheten	verkligheten
flugits	flugits
jordbävnings	jordbävnings
handläggas	handläggas
föräldralöst	föräldralöst
utarmande	utarmande
oxen	oxen
bokrisen	bokrisen
statschefer	statschefer
påbudet	påbudet
skånken	skånken
klämdagar	klämdagar
förgätas	förgätas
vittnesbörd	vittnesbörd
fingeravtrycks	fingeravtrycks
lärkorna	lärkorna
nynorskan	nynorskan
kokade	kokade
laman	laman
vishets	vishets
misshandlade	misshandlade
kontrabas	kontrabas
centralafrikan	centralafrikan
kläcka	kläcka
ambassadsekreterares	ambassadsekreterares
moppar	moppar
uppfyller	uppfyller
cykelhandlares	cykelhandlares
flunsa	flunsa
bordat	bordat
tatuerares	tatuerares
världsmästarna	världsmästarna
klämdagarna	klämdagarna
resurskrävande	resurskrävande
blottar	blottar
kommunikations	kommunikations
obetalbara	obetalbara
bromspedalen	bromspedalen
kända	kända
handlägga	handlägga
dissekerat	dissekerat
lämpas	lämpas
alkoholism	alkoholism
genomslagets	genomslagets
vädurs	vädurs
koncentrera	koncentrera
samfund	samfund
vinklades	vinklades
vattenkonsts	vattenkonsts
anticyklons	anticyklons
utbytes	utbytes
ockupationers	ockupationers
antänd	antänd
utsändande	utsändande
handläggs	handläggs
yrkesutövningen	yrkesutövningen
interagerade	interagerade
ståndens	ståndens
utfärdar	utfärdar
renar	renar
indoktrineras	indoktrineras
säker	säker
hedersbetygelsen	hedersbetygelsen
ansad	ansad
strålen	strålen
försonas	försonas
mandatet	mandatet
piercingars	piercingars
bronsmedaljs	bronsmedaljs
dominerade	dominerade
byttornas	byttornas
skötet	skötet
sjöbods	sjöbods
embarkeringskortens	embarkeringskortens
fördelaktig	fördelaktig
polygonen	polygonen
avståndet	avståndet
elektricitet	elektricitet
mustasch	mustasch
hjälpsamma	hjälpsamma
glidytas	glidytas
underskattad	underskattad
bevaras	bevaras
beskärd	beskärd
släktena	släktena
bast	bast
ettstrukne	ettstrukne
frisörens	frisörens
sexpacken	sexpacken
affin	affin
sexpackets	sexpackets
tågats	tågats
legitimitetens	legitimitetens
fontänerna	fontänerna
upplöser	upplöser
sök	sök
utbytena	utbytena
vinterdäckets	vinterdäckets
depå	depå
gaffeln	gaffeln
förstods	förstods
flyttar	flyttar
infiltreras	infiltreras
överlevnad	överlevnad
homeopati	homeopati
preliminärskatt	preliminärskatt
vinylskiva	vinylskiva
naturvården	naturvården
fästena	fästena
efterfrågan	efterfrågan
minikjolars	minikjolars
arrestera	arrestera
surjektionens	surjektionens
förgiftad	förgiftad
skatbons	skatbons
manlige	manlige
preliminärskattens	preliminärskattens
begravt	begravt
bakgrundsstrålnings	bakgrundsstrålnings
trycker	trycker
höljets	höljets
förhindrats	förhindrats
arkivskåp	arkivskåp
säkrande	säkrande
ögonglobers	ögonglobers
mjölksyran	mjölksyran
manliga	manliga
mötas	mötas
badvädret	badvädret
transaktionerna	transaktionerna
ambassadsekreterare	ambassadsekreterare
dissars	dissars
befordrans	befordrans
eolsharpor	eolsharpor
absids	absids
