vanära	vanära
förena	förena
tyckes	tyckes
borrar	borrar
avskära	avskära
avbärgad	avbärgad
menen	menen
Tamar	Tamar
Aten	Aten
sakerna	sakerna
fiskar	fiskar
släckt	släckt
Hul	Hul
Josefs	Josefs
utkräva	utkräva
födde	födde
räknades	räknades
tvagen	tvagen
uppbygga	uppbygga
funna	funna
fyllen	fyllen
ekar	ekar
förödda	förödda
täckes	täckes
förströdda	förströdda
Leviatans	Leviatans
silverbägarna	silverbägarna
Gamaliels	Gamaliels
Abimeleks	Abimeleks
förutbestämt	förutbestämt
Visa	Visa
skilts	skilts
livet	livet
församlade	församlade
marker	marker
inträde	inträde
Mose	Mose
eländet	eländet
korsfästes	korsfästes
arglistig	arglistig
gapet	gapet
jagade	jagade
hörn	hörn
Betuel	Betuel
anklagen	anklagen
blåsa	blåsa
sås	sås
Kains	Kains
dragare	dragare
borgare	borgare
döma	döma
ihågkomma	ihågkomma
blodbadet	blodbadet
Haso	Haso
maka	maka
fördömde	fördömde
undan	undan
strålande	strålande
övertäckt	övertäckt
Mana	Mana
upplöses	upplöses
dröj	dröj
förjagades	förjagades
Maas	Maas
klagade	klagade
slagen	slagen
sådan	sådan
fots	fots
ben	ben
mala	mala
böjt	böjt
Ett	Ett
smida	smida
fullbordade	fullbordade
vittnesbördet	vittnesbördet
förgöra	förgöra
moderlivet	moderlivet
tjänen	tjänen
känna	känna
stigen	stigen
vara	vara
tänke	tänke
ryckes	ryckes
nästen	nästen
stänga	stänga
Lod	Lod
lames	lames
garn	garn
murbruk	murbruk
drives	drives
stenröse	stenröse
Massas	Massas
fordren	fordren
Soan	Soan
förströdde	förströdde
avsatte	avsatte
föden	föden
släkterna	släkterna
bortföra	bortföra
förkunnen	förkunnen
lämnades	lämnades
falle	falle
nämnde	nämnde
lama	lama
droge	droge
driva	driva
fördriva	fördriva
fordran	fordran
vanna	vanna
förmörkades	förmörkades
ryggas	ryggas
bortförd	bortförd
fördärvade	fördärvade
rev	rev
Rahabs	Rahabs
stärken	stärken
Abrams	Abrams
fördolda	fördolda
Balak	Balak
stycke	stycke
hemsökes	hemsökes
förbytt	förbytt
Susa	Susa
vallar	vallar
mörker	mörker
Jasons	Jasons
Kedar	Kedar
uträckt	uträckt
markens	markens
Esau	Esau
tröstade	tröstade
rygga	rygga
libyer	libyer
trängd	trängd
kysst	kysst
alltings	alltings
bortkastade	bortkastade
kända	kända
upphäva	upphäva
övergiva	övergiva
längs	längs
fästa	fästa
mött	mött
kramades	kramades
skugga	skugga
undersökt	undersökt
dryckerna	dryckerna
betrycktas	betrycktas
helas	helas
brev	brev
sin	sin
helgades	helgades
tjäna	tjäna
Balaks	Balaks
sköljes	sköljes
lame	lame
Ussia	Ussia
huvudet	huvudet
slungade	slungade
utrotades	utrotades
Både	Både
upprättades	upprättades
malen	malen
avlämnade	avlämnade
drype	drype
handla	handla
såld	såld
städerna	städerna
väta	väta
hör	hör
rykande	rykande
aga	aga
stjärntydarna	stjärntydarna
Gats	Gats
någon	någon
moln	moln
vrida	vrida
Nebajots	Nebajots
siste	siste
altare	altare
påskalammet	påskalammet
första	första
äppelträd	äppelträd
lamm	lamm
ställt	ställt
sitta	sitta
slaktdjur	slaktdjur
Akbor	Akbor
Akas	Akas
förlite	förlite
grumlade	grumlade
brukade	brukade
Datans	Datans
Abiram	Abiram
hörda	hörda
borgen	borgen
spända	spända
bosätten	bosätten
stängda	stängda
garnet	garnet
Isaks	Isaks
förnimma	förnimma
slaktdjuret	slaktdjuret
huvud	huvud
retade	retade
Simon	Simon
vreden	vreden
korer	korer
upptages	upptages
känd	känd
ringarna	ringarna
anklagades	anklagades
Alexander	Alexander
vredes	vredes
upptänd	upptänd
hyst	hyst
täckta	täckta
utpantning	utpantning
uppfylla	uppfylla
vävare	vävare
sälj	sälj
Nebos	Nebos
frätas	frätas
Ismaels	Ismaels
föreläses	föreläses
spjut	spjut
täckt	täckt
rört	rört
Jeriko	Jeriko
mångas	mångas
loge	loge
vida	vida
Ute	Ute
inställa	inställa
uppenbarades	uppenbarades
hämtades	hämtades
våldsverkare	våldsverkare
Datan	Datan
Josef	Josef
viskas	viskas
läras	läras
smälte	smälte
bosätta	bosätta
Bekers	Bekers
ordspråket	ordspråket
yttersta	yttersta
uppgiven	uppgiven
slickade	slickade
lindade	lindade
vätas	vätas
djuret	djuret
segrar	segrar
vilade	vilade
lika	lika
bortförde	bortförde
uträcker	uträcker
Jonatans	Jonatans
förehaves	förehaves
Guds	Guds
ringar	ringar
skrivare	skrivare
förbund	förbund
Esaus	Esaus
Abirams	Abirams
upptagen	upptagen
sålden	sålden
bredd	bredd
lycka	lycka
stilla	stilla
utsända	utsända
dom	dom
Edens	Edens
bete	bete
plågade	plågade
viska	viska
fetma	fetma
stormades	stormades
betäckt	betäckt
möte	möte
avsatserna	avsatserna
övertäcka	övertäcka
märka	märka
vaken	vaken
Rahab	Rahab
Att	Att
uppfyllen	uppfyllen
befälet	befälet
eds	eds
höjes	höjes
skyddade	skyddade
lytt	lytt
vakar	vakar
prisade	prisade
denna	denna
upplåtna	upplåtna
höljda	höljda
släppt	släppt
drabbades	drabbades
byten	byten
plågas	plågas
bjuda	bjuda
upptänden	upptänden
växt	växt
rädes	rädes
sälja	sälja
Jedutun	Jedutun
talades	talades
fortfarande	fortfarande
tryggade	tryggade
pålägges	pålägges
förlitar	förlitar
trampade	trampade
juble	juble
väckt	väckt
falls	falls
fikonträd	fikonträd
strutsarna	strutsarna
ösa	ösa
läses	läses
förgöres	förgöres
altaret	altaret
Hanes	Hanes
bliva	bliva
dröjen	dröjen
Vårt	Vårt
förehava	förehava
Våra	Våra
mötes	mötes
fogade	fogade
övrigas	övrigas
blotten	blotten
menade	menade
sålda	sålda
förvaltare	förvaltare
betryckt	betryckt
Kabuls	Kabuls
utplånade	utplånade
svarande	svarande
lära	lära
kärve	kärve
görare	görare
strävade	strävade
brända	brända
gileaditer	gileaditer
torka	torka
skrapade	skrapade
lugnade	lugnade
räddas	räddas
överlämnade	överlämnade
inbärgar	inbärgar
stode	stode
Lots	Lots
tabernakels	tabernakels
Jerusalems	Jerusalems
läsa	läsa
frälse	frälse
faste	faste
livs	livs
träd	träd
förtäre	förtäre
tyget	tyget
domar	domar
täcktes	täcktes
tiga	tiga
Uris	Uris
grav	grav
agat	agat
styrkas	styrkas
pelare	pelare
Simma	Simma
frågen	frågen
belopp	belopp
gudsfruktans	gudsfruktans
försåt	försåt
läs	läs
ark	ark
tjäne	tjäne
bevise	bevise
visar	visar
fåren	fåren
tunga	tunga
höljas	höljas
förda	förda
strålade	strålade
rista	rista
Sådan	Sådan
Rebeckas	Rebeckas
Israel	Israel
lärt	lärt
stött	stött
inhägnade	inhägnade
Persien	Persien
hysa	hysa
sätta	sätta
bjudna	bjudna
glädes	glädes
ihågkommen	ihågkommen
stänka	stänka
Sauls	Sauls
Ono	Ono
jublen	jublen
Johanna	Johanna
gläds	gläds
Inga	Inga
beten	beten
insatt	insatt
spikarna	spikarna
slunga	slunga
Hets	Hets
Evad	Evad
återstod	återstod
svälja	svälja
upptända	upptända
libyerna	libyerna
Tagen	Tagen
säge	säge
upplyste	upplyste
tagna	tagna
arks	arks
övergåvo	övergåvo
fatte	fatte
oss	oss
Syriens	Syriens
rest	rest
döpt	döpt
ledda	ledda
stadier	stadier
ödelägges	ödelägges
fläka	fläka
korna	korna
område	område
retas	retas
Sådana	Sådana
mister	mister
råda	råda
orenen	orenen
Allt	Allt
uppbygges	uppbygges
Saras	Saras
vid	vid
brinnande	brinnande
upphäven	upphäven
behövs	behövs
stjärntydare	stjärntydare
klädd	klädd
omgiva	omgiva
hurudana	hurudana
sena	sena
helade	helade
snöre	snöre
betänkte	betänkte
järn	järn
Susan	Susan
lärare	lärare
skilda	skilda
druckna	druckna
nederlag	nederlag
buren	buren
Salems	Salems
dugande	dugande
Melkisedek	Melkisedek
Ordet	Ordet
vedergälle	vedergälle
Arabien	Arabien
sån	sån
vändas	vändas
driven	driven
förskräcka	förskräcka
varandra	varandra
sanna	sanna
nymånadsdagen	nymånadsdagen
fördömen	fördömen
vare	vare
budord	budord
Vilken	Vilken
Hanan	Hanan
fördöma	fördöma
utstött	utstött
avmäta	avmäta
gjutes	gjutes
gripes	gripes
Rubens	Rubens
Nea	Nea
Sanna	Sanna
skjuten	skjuten
inrättades	inrättades
omsluten	omsluten
sann	sann
visas	visas
länder	länder
fyll	fyll
löfte	löfte
smältes	smältes
klappa	klappa
grannarna	grannarna
beskärde	beskärde
åker	åker
det	det
åten	åten
bedragare	bedragare
oxarna	oxarna
omfång	omfång
tillträda	tillträda
förstören	förstören
marks	marks
veten	veten
Råd	Råd
hembäre	hembäre
intagen	intagen
Het	Het
Satans	Satans
uppslukades	uppslukades
fara	fara
kränkt	kränkt
Sina	Sina
förras	förras
försvarade	försvarade
jubelår	jubelår
betrodde	betrodde
förordnade	förordnade
skiftade	skiftade
Berea	Berea
förlitat	förlitat
förstörde	förstörde
strida	strida
pluggarna	pluggarna
dessas	dessas
hörsammades	hörsammades
Land	Land
fästes	fästes
Den	Den
befästa	befästa
vedergäll	vedergäll
kramade	kramade
Obeds	Obeds
finne	finne
sänkas	sänkas
Ut	Ut
bedrives	bedrives
mana	mana
Joab	Joab
flytt	flytt
Jakob	Jakob
ax	ax
Eliesers	Eliesers
stötes	stötes
brunnens	brunnens
uttåg	uttåg
lovade	lovade
genomsöka	genomsöka
klövs	klövs
like	like
välva	välva
fälla	fälla
sända	sända
nästas	nästas
förbudet	förbudet
flyttades	flyttades
kärlet	kärlet
bestämda	bestämda
sky	sky
träffas	träffas
värden	värden
ockrare	ockrare
förra	förra
uppenbaras	uppenbaras
Kanaan	Kanaan
korn	korn
förre	förre
inbärga	inbärga
skrapa	skrapa
nymånadsdagar	nymånadsdagar
Beria	Beria
avskäres	avskäres
berget	berget
vingarna	vingarna
dån	dån
Vars	Vars
märke	märke
täckas	täckas
Tala	Tala
kläder	kläder
domarna	domarna
Judeen	Judeen
ställda	ställda
linda	linda
besöka	besöka
omkommo	omkommo
läsen	läsen
kläda	kläda
uppföda	uppföda
döpes	döpes
skurna	skurna
kallades	kallades
Akaja	Akaja
köpt	köpt
Gudarna	Gudarna
bara	bara
siktades	siktades
Ruben	Ruben
förlösa	förlösa
falla	falla
rena	rena
förökade	förökade
allt	allt
hurudan	hurudan
Naftalis	Naftalis
fördärvades	fördärvades
förkunnades	förkunnades
bytte	bytte
synds	synds
arvet	arvet
hus	hus
utföres	utföres
Amalek	Amalek
burna	burna
Jotam	Jotam
nät	nät
lyfta	lyfta
erövrade	erövrade
svävade	svävade
Onan	Onan
bruke	bruke
Salome	Salome
maakatéernas	maakatéernas
uppväcka	uppväcka
benet	benet
själva	själva
gräte	gräte
avlat	avlat
offrades	offrades
plugg	plugg
vanärade	vanärade
Aner	Aner
brevet	brevet
ockra	ockra
gripna	gripna
budet	budet
dödsrike	dödsrike
tusental	tusental
utsträcka	utsträcka
bröllop	bröllop
Dessa	Dessa
uppfyllda	uppfyllda
beredda	beredda
förföljda	förföljda
utsatte	utsatte
Hans	Hans
utgjutes	utgjutes
egyptierna	egyptierna
drivna	drivna
uppväcken	uppväcken
förskräckte	förskräckte
Meleks	Meleks
våldsverkarna	våldsverkarna
murare	murare
förundran	förundran
siares	siares
Jakobs	Jakobs
bröllopet	bröllopet
omstörtade	omstörtade
tröstar	tröstar
skrivna	skrivna
dragen	dragen
förgörare	förgörare
bära	bära
läkt	läkt
Visar	Visar
jublande	jublande
jubelåret	jubelåret
utför	utför
säljes	säljes
bältet	bältet
mönstrade	mönstrade
dövas	dövas
skapare	skapare
försåtet	försåtet
ende	ende
blottas	blottas
tagen	tagen
Edom	Edom
funne	funne
give	give
Seras	Seras
blive	blive
uppförd	uppförd
förfölja	förfölja
vrides	vrides
modersskötet	modersskötet
henne	henne
stod	stod
anklagare	anklagare
väns	väns
Jafet	Jafet
krig	krig
uppsökte	uppsökte
stenhuggarna	stenhuggarna
resa	resa
blodbad	blodbad
räckt	räckt
förstes	förstes
förste	förste
kommande	kommande
försvunna	försvunna
Hela	Hela
Ard	Ard
bespejade	bespejade
tårarna	tårarna
plåga	plåga
Isebel	Isebel
Ögat	Ögat
höljes	höljes
gripen	gripen
Rabba	Rabba
hörare	hörare
bestänkt	bestänkt
vinn	vinn
Johanan	Johanan
ödmjuka	ödmjuka
Serubbabels	Serubbabels
säg	säg
tillhörande	tillhörande
Lemek	Lemek
funno	funno
Sådant	Sådant
spenabarn	spenabarn
tillreds	tillreds
rike	rike
förutbestämde	förutbestämde
grumlen	grumlen
stjälen	stjälen
rättas	rättas
stoderna	stoderna
öppnades	öppnades
göden	göden
gästabud	gästabud
följe	följe
dricka	dricka
sändebudet	sändebudet
saker	saker
märkt	märkt
uppfylle	uppfylle
vete	vete
plågades	plågades
bygga	bygga
kallade	kallade
möta	möta
betale	betale
Salomo	Salomo
Joa	Joa
tabernakel	tabernakel
betryckte	betryckte
Asien	Asien
segrare	segrare
dyrkades	dyrkades
förhärligade	förhärligade
uppbådades	uppbådades
svängde	svängde
upplagda	upplagda
spejare	spejare
borttagen	borttagen
hölja	hölja
renat	renat
vederkvicka	vederkvicka
dräp	dräp
förtära	förtära
Falla	Falla
stänkes	stänkes
köpebrevet	köpebrevet
Jairs	Jairs
Baal	Baal
rörde	rörde
offrade	offrade
bäckens	bäckens
enes	enes
blinda	blinda
köpare	köpare
Sera	Sera
utvalde	utvalde
öppnen	öppnen
buds	buds
bjude	bjude
Ester	Ester
ute	ute
järnet	järnet
återstodo	återstodo
bon	bon
samlades	samlades
manades	manades
planteren	planteren
viljen	viljen
lägge	lägge
inviga	inviga
synas	synas
städer	städer
täckte	täckte
bäre	bäre
uddar	uddar
före	före
lugna	lugna
torg	torg
Jorams	Jorams
Hagar	Hagar
gileaditen	gileaditen
Asiens	Asiens
förenade	förenade
ålägges	ålägges
förstörs	förstörs
innan	innan
höj	höj
sändes	sändes
Simmas	Simmas
skött	skött
Natan	Natan
lamms	lamms
ryka	ryka
äppelträdet	äppelträdet
uträcka	uträcka
släcka	släcka
odjuret	odjuret
stallet	stallet
maakatéer	maakatéer
stänger	stänger
tystade	tystade
sändebud	sändebud
Milka	Milka
hövdingdöme	hövdingdöme
flyta	flyta
omgivna	omgivna
självt	självt
Ismael	Ismael
plats	plats
förbjuda	förbjuda
togs	togs
denne	denne
utlysa	utlysa
renades	renades
dräpa	dräpa
vandrarna	vandrarna
ingångarna	ingångarna
förskingrades	förskingrades
Farao	Farao
Högstes	Högstes
gravarna	gravarna
åt	åt
fördärven	fördärven
omskäres	omskäres
Vid	Vid
dräpe	dräpe
visa	visa
bevarades	bevarades
uppsatte	uppsatte
kos	kos
klagande	klagande
vetet	vetet
död	död
hemsökt	hemsökt
lyftas	lyftas
krossades	krossades
Seir	Seir
köpa	köpa
anfalla	anfalla
stenröset	stenröset
uttåget	uttåget
Gat	Gat
avsöndrade	avsöndrade
Babel	Babel
hörsammade	hörsammade
sliten	sliten
betrodda	betrodda
sträcka	sträcka
stickade	stickade
stillades	stillades
Hebron	Hebron
fullbordan	fullbordan
anstiftades	anstiftades
ytterst	ytterst
förskingrade	förskingrade
stupade	stupade
tillgiva	tillgiva
frambära	frambära
utspridde	utspridde
fortfare	fortfare
beställt	beställt
pelarna	pelarna
bekännare	bekännare
Vare	Vare
Labans	Labans
anförda	anförda
stadgar	stadgar
utröna	utröna
valkares	valkares
bälte	bälte
stores	stores
lägga	lägga
Sebaots	Sebaots
skrymtarna	skrymtarna
omgives	omgives
inbärgade	inbärgade
försonade	försonade
vädurens	vädurens
utforsken	utforsken
bäres	bäres
böjd	böjd
Noa	Noa
råds	råds
sådana	sådana
ödmjukas	ödmjukas
Hanok	Hanok
Sisaks	Sisaks
tänkt	tänkt
utbreda	utbreda
utgöra	utgöra
slösade	slösade
åte	åte
utfärdades	utfärdades
Ais	Ais
behöves	behöves
dyrkade	dyrkade
armodet	armodet
förgjordes	förgjordes
bindes	bindes
gladas	gladas
tusentals	tusentals
hylla	hylla
stärka	stärka
odjur	odjur
föreläsa	föreläsa
utfören	utfören
klipper	klipper
format	format
än	än
sårande	sårande
fatten	fatten
väva	väva
bjödo	bjödo
under	under
beskära	beskära
besatte	besatte
näpsa	näpsa
Jair	Jair
Lus	Lus
brännande	brännande
gäckade	gäckade
leden	leden
släkt	släkt
hjärta	hjärta
Sereds	Sereds
barn	barn
förtärda	förtärda
Benjamins	Benjamins
Ord	Ord
liden	liden
Joktan	Joktan
rykte	rykte
fattat	fattat
våldet	våldet
Antikrist	Antikrist
utstakade	utstakade
satta	satta
slagna	slagna
uppgives	uppgives
Nilen	Nilen
brus	brus
rulla	rulla
platserna	platserna
mången	mången
given	given
utstöta	utstöta
göras	göras
sköten	sköten
uppgiva	uppgiva
sträva	sträva
lösas	lösas
sökte	sökte
hava	hava
arglistigt	arglistigt
berg	berg
stört	stört
längtan	längtan
granne	granne
fadern	fadern
skyarna	skyarna
dödande	dödande
fördärv	fördärv
omstörtades	omstörtades
nedbrytes	nedbrytes
drucken	drucken
Tres	Tres
råd	råd
Bera	Bera
gemaket	gemaket
Jonatan	Jonatan
spik	spik
minne	minne
byggnadsverket	byggnadsverket
främmande	främmande
seendes	seendes
rovet	rovet
tills	tills
lägg	lägg
besökt	besökt
blottades	blottades
de	de
utsprida	utsprida
hindrade	hindrade
snärjda	snärjda
undersöka	undersöka
fortfara	fortfara
Kemuel	Kemuel
förödes	förödes
lösa	lösa
brännes	brännes
göres	göres
kort	kort
föda	föda
sjuke	sjuke
beskärd	beskärd
båda	båda
avfallna	avfallna
spejade	spejade
resas	resas
slitna	slitna
förgäta	förgäta
gjutna	gjutna
invigda	invigda
Anatots	Anatots
Asa	Asa
röras	röras
resande	resande
Amminadab	Amminadab
avbärgat	avbärgat
tvagna	tvagna
Ars	Ars
betydande	betydande
förordnades	förordnades
hornet	hornet
beloppet	beloppet
gap	gap
hugga	hugga
Sem	Sem
upptaga	upptaga
ringe	ringe
Sadoks	Sadoks
årens	årens
arglistige	arglistige
ordspråk	ordspråk
upphöjd	upphöjd
uppstånden	uppstånden
friköpt	friköpt
stige	stige
ätes	ätes
hövdingdömen	hövdingdömen
vilket	vilket
genomsökt	genomsökt
bevare	bevare
löses	löses
Kemuels	Kemuels
bruse	bruse
Landet	Landet
borttaga	borttaga
skäl	skäl
täckts	täckts
bestänka	bestänka
tjänarna	tjänarna
trälarbetet	trälarbetet
räknade	räknade
böjde	böjde
Ande	Ande
handlade	handlade
gömmas	gömmas
svarade	svarade
uppförde	uppförde
äldste	äldste
gören	gören
förbyta	förbyta
Sans	Sans
betänk	betänk
säga	säga
värde	värde
fylld	fylld
hals	hals
nederlaget	nederlaget
Absalom	Absalom
bedraga	bedraga
byggnadsverk	byggnadsverk
bedragna	bedragna
förtälja	förtälja
förskräckt	förskräckt
befälhavare	befälhavare
spjutet	spjutet
sålde	sålde
berömde	berömde
Rehabeam	Rehabeam
någons	någons
ristade	ristade
dråparna	dråparna
förstörda	förstörda
ut	ut
penningarna	penningarna
borrade	borrade
Bosras	Bosras
övriga	övriga
lysa	lysa
beskäres	beskäres
bärande	bärande
träda	träda
vädurarna	vädurarna
taga	taga
hackade	hackade
utdelat	utdelat
Merari	Merari
pressade	pressade
bereda	bereda
antalet	antalet
omskära	omskära
rycka	rycka
beseglades	beseglades
givna	givna
smädare	smädare
namn	namn
upphöjde	upphöjde
rörande	rörande
Moab	Moab
blåses	blåses
frambäres	frambäres
invigen	invigen
styckade	styckade
Jabin	Jabin
Jered	Jered
vitt	vitt
inställde	inställde
fogades	fogades
kriget	kriget
förtryck	förtryck
faders	faders
breda	breda
uppläsa	uppläsa
springare	springare
frukte	frukte
tillfrisknat	tillfrisknat
kallas	kallas
vänd	vänd
känden	känden
efterfölja	efterfölja
steka	steka
avskilda	avskilda
verkade	verkade
sakens	sakens
avhålle	avhålle
armod	armod
stjäl	stjäl
Omar	Omar
längten	längten
renas	renas
fårs	fårs
fattas	fattas
förunnade	förunnade
ändamål	ändamål
förunne	förunne
firades	firades
bevekande	bevekande
förundrade	förundrade
fördrives	fördrives
vände	vände
slites	slites
bön	bön
skifte	skifte
uppföra	uppföra
tjänare	tjänare
arv	arv
arms	arms
uppsöka	uppsöka
bevaren	bevaren
tog	tog
fast	fast
snår	snår
Lemeks	Lemeks
David	David
insatte	insatte
göra	göra
Orion	Orion
fattades	fattades
skriva	skriva
snöret	snöret
påbudet	påbudet
släppa	släppa
ökade	ökade
sabbat	sabbat
räcken	räcken
rätt	rätt
kännes	kännes
levande	levande
upprest	upprest
fälles	fälles
Alexanders	Alexanders
sista	sista
stjäle	stjäle
jagades	jagades
fruktan	fruktan
köpebrev	köpebrev
näste	näste
värme	värme
amma	amma
Samarias	Samarias
uppsatta	uppsatta
Syrien	Syrien
biträda	biträda
lögnprofeternas	lögnprofeternas
vållen	vållen
invig	invig
mättas	mättas
hos	hos
rätas	rätas
borttappade	borttappade
skapade	skapade
trampa	trampa
tungas	tungas
lyftes	lyftes
mods	mods
Asafs	Asafs
vant	vant
avsatt	avsatt
sökt	sökt
utslag	utslag
drivas	drivas
mödade	mödade
inhägnad	inhägnad
Sutela	Sutela
kastades	kastades
dödade	dödade
drypa	drypa
byta	byta
vändes	vändes
Libanons	Libanons
kasten	kasten
talen	talen
undantagen	undantagen
Barn	Barn
blygs	blygs
utbyta	utbyta
slags	slags
ene	ene
fästas	fästas
uppväckt	uppväckt
Anaks	Anaks
gör	gör
omvände	omvände
Sur	Sur
ögat	ögat
vann	vann
blottade	blottade
armes	armes
Asaf	Asaf
beträden	beträden
inbyggare	inbyggare
Orions	Orions
anställda	anställda
bevisade	bevisade
stinkande	stinkande
svans	svans
smältas	smältas
dömda	dömda
valvet	valvet
vilen	vilen
Ehud	Ehud
Leas	Leas
tår	tår
hålles	hålles
erövrare	erövrare
koken	koken
gräten	gräten
Arabiens	Arabiens
Gad	Gad
upprätta	upprätta
kullar	kullar
laga	laga
vänt	vänt
spände	spände
samma	samma
saknade	saknade
gjorda	gjorda
nätet	nätet
följande	följande
övergiven	övergiven
förlikt	förlikt
Alls	Alls
logarna	logarna
tränges	tränges
dröja	dröja
styrka	styrka
skjuta	skjuta
försvunno	försvunno
fjättrar	fjättrar
antändas	antändas
övrigt	övrigt
betyda	betyda
Svärdet	Svärdet
planterade	planterade
gräto	gräto
löftet	löftet
anföra	anföra
förtryckare	förtryckare
ens	ens
kastade	kastade
skänk	skänk
utgjuta	utgjuta
vakttornet	vakttornet
nämnda	nämnda
Ställ	Ställ
Elia	Elia
utforskade	utforskade
åka	åka
skylde	skylde
gjordes	gjordes
Bered	Bered
äta	äta
fäste	fäste
söks	söks
upptagna	upptagna
föröke	föröke
svin	svin
avhålla	avhålla
Dennes	Dennes
rövade	rövade
backarna	backarna
Iskariot	Iskariot
Judas	Judas
dolde	dolde
friköpa	friköpa
sträckt	sträckt
sjuka	sjuka
utrote	utrote
formade	formade
avfallen	avfallen
födes	födes
utkräves	utkräves
travare	travare
tryckes	tryckes
damm	damm
betänken	betänken
grunda	grunda
sport	sport
mördare	mördare
rätta	rätta
stadiers	stadiers
omfånget	omfånget
räddades	räddades
Manasse	Manasse
utslaget	utslaget
Belas	Belas
fött	fött
smides	smides
Gilead	Gilead
Amon	Amon
vaka	vaka
blygas	blygas
Geras	Geras
beredde	beredde
trängt	trängt
spotten	spotten
förleda	förleda
många	många
våra	våra
jämna	jämna
axet	axet
Babels	Babels
försonas	försonas
Davids	Davids
dåd	dåd
manas	manas
Abia	Abia
gäckas	gäckas
rövar	rövar
Dianas	Dianas
Hesrons	Hesrons
verke	verke
hållna	hållna
Aras	Aras
sabbaterna	sabbaterna
lammet	lammet
näst	näst
Rabbas	Rabbas
talar	talar
anklagade	anklagade
fördraga	fördraga
torn	torn
agas	agas
fruktade	fruktade
loven	loven
ställen	ställen
uppdrag	uppdrag
Assurs	Assurs
varen	varen
förliten	förliten
grunden	grunden
strids	strids
Jabins	Jabins
förvaltade	förvaltade
predikade	predikade
bröderna	bröderna
Lotan	Lotan
utrotade	utrotade
skuggade	skuggade
döpa	döpa
tak	tak
född	född
borttappat	borttappat
folk	folk
anställde	anställde
styrkes	styrkes
Denne	Denne
tillfrisknade	tillfrisknade
våldsverkares	våldsverkares
löst	löst
uppläst	uppläst
gånge	gånge
vedergälla	vedergälla
gifte	gifte
spenabarnet	spenabarnet
förtäljes	förtäljes
namnet	namnet
gränserna	gränserna
böjes	böjes
förvandlade	förvandlade
höjen	höjen
taket	taket
ämnade	ämnade
Libanon	Libanon
Gehenna	Gehenna
ort	ort
döva	döva
förrådshus	förrådshus
kullarna	kullarna
dricke	dricke
varandras	varandras
axens	axens
uppröres	uppröres
dennas	dennas
sida	sida
utgöres	utgöres
dömes	dömes
vetekornet	vetekornet
drömma	drömma
Tabor	Tabor
avskilde	avskilde
fylla	fylla
flyttade	flyttade
trätt	trätt
inbärgen	inbärgen
avfalla	avfalla
Jeremia	Jeremia
kokt	kokt
övergivna	övergivna
säljen	säljen
samme	samme
palatset	palatset
Persiens	Persiens
Obed	Obed
fördärvare	fördärvare
mista	mista
brännsåret	brännsåret
Nebo	Nebo
rättfärdiga	rättfärdiga
Samuel	Samuel
tågade	tågade
hyllade	hyllade
kyssa	kyssa
Faders	Faders
röra	röra
skäras	skäras
hindrades	hindrades
öken	öken
samlas	samlas
betalen	betalen
förtär	förtär
sitter	sitter
beskärt	beskärt
förgjorda	förgjorda
dess	dess
Ehuds	Ehuds
lutade	lutade
förföljare	förföljare
gudarna	gudarna
förlåten	förlåten
djur	djur
Svärd	Svärd
uppdraget	uppdraget
förstånd	förstånd
Eva	Eva
kränka	kränka
upptänts	upptänts
bitens	bitens
friade	friade
frälsare	frälsare
gångar	gångar
överfalla	överfalla
fält	fält
hala	hala
förblive	förblive
vars	vars
hemsöka	hemsöka
brytes	brytes
Samuels	Samuels
fört	fört
sprida	sprida
våld	våld
rädd	rädd
vårdar	vårdar
äldstes	äldstes
lida	lida
dolda	dolda
upploppet	upploppet
hjälpare	hjälpare
rådande	rådande
fallna	fallna
mjöl	mjöl
Isebels	Isebels
hölje	hölje
förfäras	förfäras
förfares	förfares
hugges	hugges
förlåtna	förlåtna
vikt	vikt
krönt	krönt
hoppas	hoppas
förrättade	förrättade
mottaga	mottaga
övermodet	övermodet
viskade	viskade
användas	användas
skarpt	skarpt
bunde	bunde
fattade	fattade
fikonträdet	fikonträdet
sådda	sådda
Baraks	Baraks
stjäla	stjäla
anställd	anställd
tysta	tysta
drages	drages
lögnprofeterna	lögnprofeterna
spännen	spännen
bevarade	bevarade
Stället	Stället
vilddjur	vilddjur
Ned	Ned
tillhöra	tillhöra
använda	använda
bortkastad	bortkastad
allting	allting
Beker	Beker
utsätta	utsätta
förvarade	förvarade
lår	lår
Massa	Massa
skiften	skiften
sikte	sikte
Israels	Israels
inträda	inträda
överfallen	överfallen
funnes	funnes
dukade	dukade
vittnesbörd	vittnesbörd
predikat	predikat
givare	givare
Abram	Abram
De	De
Absaloms	Absaloms
skänkt	skänkt
bortrycktes	bortrycktes
Jafets	Jafets
anställa	anställa
klappade	klappade
Anatot	Anatot
stillade	stillade
uträcken	uträcken
binde	binde
jämt	jämt
ansedde	ansedde
Dans	Dans
skälet	skälet
Milkas	Milkas
draga	draga
nymånadsdag	nymånadsdag
tjänade	tjänade
Sara	Sara
fördömd	fördömd
edens	edens
äras	äras
betäcka	betäcka
Hagars	Hagars
Joram	Joram
Öga	Öga
förstörare	förstörare
knyta	knyta
avla	avla
Asas	Asas
snara	snara
Ain	Ain
Berias	Berias
deltagande	deltagande
omkomma	omkomma
torkade	torkade
översta	översta
fotblad	fotblad
fetmas	fetmas
upphöjt	upphöjt
efterföljd	efterföljd
låte	låte
ställa	ställa
rötterna	rötterna
sjunga	sjunga
bröder	bröder
budbärare	budbärare
klädde	klädde
annat	annat
träta	träta
upptändes	upptändes
efterföljare	efterföljare
skänka	skänka
Bela	Bela
leva	leva
övergåve	övergåve
ära	ära
hämtade	hämtade
utföre	utföre
sälje	sälje
vederkvickt	vederkvickt
Det	Det
havande	havande
gods	gods
förlita	förlita
blyges	blyges
uppfyll	uppfyll
förbud	förbud
skål	skål
avsats	avsats
Marias	Marias
klädda	klädda
Tro	Tro
förhindrades	förhindrades
lämnade	lämnade
Lot	Lot
berövade	berövade
tyg	tyg
Job	Job
skattmästarna	skattmästarna
finna	finna
tillredda	tillredda
dödades	dödades
stötte	stötte
bindas	bindas
Uria	Uria
folket	folket
ändamålet	ändamålet
pressar	pressar
ansiktes	ansiktes
Amons	Amons
betryckta	betryckta
nödgade	nödgade
säljare	säljare
fören	fören
ödelägga	ödelägga
bryta	bryta
dräpes	dräpes
markerna	markerna
Anak	Anak
förtrycka	förtrycka
gileaditerna	gileaditerna
stall	stall
utplånades	utplånades
upptage	upptage
Noas	Noas
lända	lända
Sin	Sin
kokte	kokte
byarna	byarna
skuldoffersväduren	skuldoffersväduren
mätten	mätten
hållen	hållen
Gera	Gera
beställa	beställa
aktade	aktade
förtryckt	förtryckt
Moabs	Moabs
bästa	bästa
gjuta	gjuta
fiskade	fiskade
lagade	lagade
vätt	vätt
upptecknade	upptecknade
förfara	förfara
gemak	gemak
Efraims	Efraims
Hanoks	Hanoks
förbliva	förbliva
tillspillogiven	tillspillogiven
Egyptens	Egyptens
Under	Under
utgjutna	utgjutna
lidandet	lidandet
Surs	Surs
höjd	höjd
Nilens	Nilens
oftare	oftare
gifta	gifta
städ	städ
korsfästas	korsfästas
talade	talade
Et	Et
Gehennas	Gehennas
flyga	flyga
året	året
predikare	predikare
utpantat	utpantat
vette	vette
vakade	vakade
hälsa	hälsa
beträda	beträda
mjölet	mjölet
höre	höre
Nebajot	Nebajot
Benjamin	Benjamin
ammade	ammade
Varde	Varde
bedrage	bedrage
rannsakade	rannsakade
tycke	tycke
Arba	Arba
väges	väges
Tamars	Tamars
förjagade	förjagade
låret	låret
släckes	släckes
Adas	Adas
dyrkar	dyrkar
veta	veta
vittne	vittne
skattmästare	skattmästare
som	som
trygga	trygga
följeslagares	följeslagares
yngstes	yngstes
slakt	slakt
förlitade	förlitade
skuldoffersvädur	skuldoffersvädur
bortförda	bortförda
Gamaliel	Gamaliel
Akan	Akan
förhindrade	förhindrade
Juda	Juda
man	man
svalka	svalka
anlete	anlete
släta	släta
omringades	omringades
orterna	orterna
Fadern	Fadern
hela	hela
uppslukade	uppslukade
Son	Son
främmandes	främmandes
klagoropet	klagoropet
bedriva	bedriva
Jobs	Jobs
dammet	dammet
åter	åter
beta	beta
inbärgat	inbärgat
ända	ända
stiga	stiga
överdragna	överdragna
avståndet	avståndet
vässt	vässt
täcke	täcke
tvaget	tvaget
Dan	Dan
avstånd	avstånd
väcka	väcka
nödgas	nödgas
firade	firade
gives	gives
döm	döm
tigga	tigga
bestämde	bestämde
lärde	lärde
Jotams	Jotams
brinna	brinna
utbredde	utbredde
följda	följda
förbränna	förbränna
Baals	Baals
Mahalalel	Mahalalel
Vilka	Vilka
hennes	hennes
huggen	huggen
räta	räta
huggna	huggna
gästabudet	gästabudet
hjul	hjul
lyckas	lyckas
sans	sans
fordras	fordras
ring	ring
dråp	dråp
utvalda	utvalda
Bosra	Bosra
försörjare	försörjare
undantagna	undantagna
tänka	tänka
förlåte	förlåte
inmönstrade	inmönstrade
flotta	flotta
blotta	blotta
lärda	lärda
Natans	Natans
störste	störste
sändas	sändas
bespejen	bespejen
sårade	sårade
Högste	Högste
bevekt	bevekt
fostrare	fostrare
ingen	ingen
bortryckta	bortryckta
ost	ost
somt	somt
förlika	förlika
hjälpa	hjälpa
dessa	dessa
förödande	förödande
halt	halt
uppenbarade	uppenbarade
upphöjen	upphöjen
ringa	ringa
säkras	säkras
Sjustjärnornas	Sjustjärnornas
murar	murar
förgätna	förgätna
horn	horn
blinde	blinde
daglönares	daglönares
avvända	avvända
glänsa	glänsa
Din	Din
hämnare	hämnare
miste	miste
Kabul	Kabul
överdragen	överdragen
bönerna	bönerna
behållna	behållna
förtorkades	förtorkades
varde	varde
dina	dina
förvandlades	förvandlades
Simons	Simons
fostrade	fostrade
bjudes	bjudes
Bileams	Bileams
lovar	lovar
svinet	svinet
rov	rov
åkerstycket	åkerstycket
Elieser	Elieser
arbete	arbete
förbjudes	förbjudes
föröken	föröken
bjöden	bjöden
antändes	antändes
nedbryta	nedbryta
lyte	lyte
Lamm	Lamm
styra	styra
utfärdade	utfärdade
säkra	säkra
ämne	ämne
Akbors	Akbors
Joabs	Joabs
bytt	bytt
budbärarna	budbärarna
blåste	blåste
tillspillogivna	tillspillogivna
skrymtan	skrymtan
slätt	slätt
Melek	Melek
dödsriket	dödsriket
Sebaot	Sebaot
störstes	störstes
antal	antal
klövarna	klövarna
Samaria	Samaria
födda	födda
skarpa	skarpa
daglönare	daglönare
bitarna	bitarna
förkunnade	förkunnade
värmen	värmen
tacka	tacka
tillreda	tillreda
välvt	välvt
Dina	Dina
Melkisedeks	Melkisedeks
betänkt	betänkt
bakhåll	bakhåll
omsnärjer	omsnärjer
beröven	beröven
smädade	smädade
hjärtat	hjärtat
knyte	knyte
förbrännes	förbrännes
broders	broders
struts	struts
uppbyggda	uppbyggda
anskaffades	anskaffades
bränna	bränna
tankarna	tankarna
vin	vin
döda	döda
avhållen	avhållen
upprört	upprört
borgar	borgar
Folk	Folk
avsöndrades	avsöndrades
ed	ed
smälta	smälta
skålarna	skålarna
avbärgade	avbärgade
tornet	tornet
drabbade	drabbade
vilkas	vilkas
svänga	svänga
vrede	vrede
förlik	förlik
nedgjorde	nedgjorde
rikt	rikt
upplöst	upplöst
räckas	räckas
samtycka	samtycka
Ners	Ners
hålla	hålla
gångerna	gångerna
drog	drog
behållare	behållare
fotbladet	fotbladet
församlas	församlas
låta	låta
påskalamm	påskalamm
bruset	bruset
ödmjukade	ödmjukade
hållare	hållare
Joktans	Joktans
skära	skära
lever	lever
såren	såren
hörsamma	hörsamma
släkte	släkte
Egypten	Egypten
svala	svala
betar	betar
förtryckes	förtryckes
befästas	befästas
spridde	spridde
brunnarna	brunnarna
penningar	penningar
upplopp	upplopp
Hebrons	Hebrons
slaktade	slaktade
arbetade	arbetade
utlyst	utlyst
förslaget	förslaget
skilt	skilt
stekt	stekt
glada	glada
omvända	omvända
skäres	skäres
sväljen	sväljen
Jerikos	Jerikos
låge	låge
arglistighet	arglistighet
bärare	bärare
utsättes	utsättes
Elis	Elis
annan	annan
hembära	hembära
svävande	svävande
svalt	svalt
travarna	travarna
Ussias	Ussias
stickas	stickas
mörka	mörka
anfallen	anfallen
orena	orena
upplösa	upplösa
befäl	befäl
mottages	mottages
förrättades	förrättades
vingar	vingar
store	store
nämnes	nämnes
Gud	Gud
styre	styre
gud	gud
böja	böja
skrymtade	skrymtade
förstöres	förstöres
valkare	valkare
fläkt	fläkt
bohaget	bohaget
bud	bud
Ana	Ana
soven	soven
binda	binda
utsläckes	utsläckes
satte	satte
brännsår	brännsår
Elias	Elias
minska	minska
nitälsken	nitälsken
Hebers	Hebers
bundna	bundna
Abels	Abels
fördolde	fördolde
stormade	stormade
Arbas	Arbas
upplåten	upplåten
vind	vind
bevis	bevis
Jerusalem	Jerusalem
fällda	fällda
visst	visst
råder	råder
omsnärjt	omsnärjt
förtäljen	förtäljen
förtälj	förtälj
uppresa	uppresa
anförare	anförare
vattnade	vattnade
skåden	skåden
läka	läka
betänka	betänka
flöge	flöge
gudsfruktan	gudsfruktan
nästa	nästa
dödas	dödas
förstör	förstör
flyge	flyge
oxens	oxens
höje	höje
smide	smide
din	din
bunden	bunden
nedgjorda	nedgjorda
var	var
seende	seende
stänkt	stänkt
Vakna	Vakna
hjälpt	hjälpt
skölja	skölja
slicke	slicke
mätte	mätte
anletes	anletes
förmörkade	förmörkade
upprättade	upprättade
dragna	dragna
Efron	Efron
läst	läst
både	både
våldföres	våldföres
lösen	lösen
åts	åts
beskärda	beskärda
skada	skada
Meraris	Meraris
vittnade	vittnade
lagen	lagen
vållade	vållade
väckes	väckes
övergive	övergive
vana	vana
fräta	fräta
snärjas	snärjas
bygges	bygges
Kain	Kain
spottade	spottade
tankar	tankar
överdraga	överdraga
konungadöme	konungadöme
söka	söka
predikades	predikades
kröna	kröna
mäta	mäta
Lammet	Lammet
hövdingdömet	hövdingdömet
förtäres	förtäres
byggda	byggda
gödda	gödda
molnet	molnet
tillsättes	tillsättes
våldföra	våldföra
beseglade	beseglade
Salman	Salman
trängde	trängde
Jesajas	Jesajas
sådant	sådant
år	år
frambären	frambären
bägarna	bägarna
Gads	Gads
väljen	väljen
sjukt	sjukt
släppe	släppe
sväljt	sväljt
rötter	rötter
sköta	sköta
Salma	Salma
gripa	gripa
företaga	företaga
döme	döme
bådas	bådas
mätt	mätt
Efraim	Efraim
gräns	gräns
stadga	stadga
fördömda	fördömda
dennes	dennes
ek	ek
utroten	utroten
vissna	vissna
fyllt	fyllt
Seirs	Seirs
mödat	mödat
bars	bars
spänna	spänna
Assyrien	Assyrien
överstes	överstes
inrättade	inrättade
hälsade	hälsade
års	års
bohag	bohag
upprörd	upprörd
siare	siare
vinna	vinna
bin	bin
bortkastat	bortkastat
slån	slån
nära	nära
Heles	Heles
fint	fint
moderssköte	moderssköte
Vilket	Vilket
Moses	Moses
stärkt	stärkt
vilken	vilken
dömen	dömen
stinka	stinka
backar	backar
komma	komma
Sikem	Sikem
Ingen	Ingen
lider	lider
skadade	skadade
ökades	ökades
mödar	mödar
sådanas	sådanas
Rebecka	Rebecka
byar	byar
då	då
palats	palats
Mas	Mas
sova	sova
kalla	kalla
sports	sports
näpst	näpst
välj	välj
tillträde	tillträde
gileaditernas	gileaditernas
Johanans	Johanans
krigarna	krigarna
revo	revo
Iskariots	Iskariots
försvarare	försvarare
sticka	sticka
Ner	Ner
inbyggares	inbyggares
fråga	fråga
hjärtas	hjärtas
vandren	vandren
förres	förres
aktades	aktades
Tabors	Tabors
räddade	räddade
öppnade	öppnade
hoppade	hoppade
bortfört	bortfört
modet	modet
bok	bok
tröstare	tröstare
sättes	sättes
förleder	förleder
vilddjuret	vilddjuret
följd	följd
elände	elände
öga	öga
utbytte	utbytte
inbärgning	inbärgning
gömma	gömma
saknas	saknas
dräpt	dräpt
kläde	kläde
sjunge	sjunge
invånares	invånares
överlämnades	överlämnades
slaktet	slaktet
vita	vita
försörja	försörja
syns	syns
drogs	drogs
deltaga	deltaga
Assyriens	Assyriens
koret	koret
allas	allas
förökades	förökades
blåst	blåst
Hulda	Hulda
företagen	företagen
fyllde	fyllde
frambär	frambär
läggen	läggen
förnimmen	förnimmen
Berit	Berit
utföra	utföra
vetekorn	vetekorn
bäste	bäste
Jesaja	Jesaja
stenhuggare	stenhuggare
frossare	frossare
upptänt	upptänt
vila	vila
uppenbara	uppenbara
Jereds	Jereds
upphäves	upphäves
rycke	rycke
göda	göda
Taga	Taga
följeslagare	följeslagare
biträde	biträde
drömmar	drömmar
länge	länge
tiggare	tiggare
mördande	mördande
jämte	jämte
förbytes	förbytes
tändas	tändas
Heber	Heber
omringade	omringade
Sisak	Sisak
giva	giva
Assur	Assur
förlike	förlike
uppfylles	uppfylles
fullbordades	fullbordades
mönstrades	mönstrades
förkunnare	förkunnare
berömt	berömt
utsatta	utsatta
lägges	lägges
bespejare	bespejare
trälarbete	trälarbete
kärl	kärl
till	till
ringas	ringas
svansarna	svansarna
vika	vika
styrkt	styrkt
rikes	rikes
förskräckes	förskräckes
området	området
etiopierna	etiopierna
minnes	minnes
gileadit	gileadit
säte	säte
skildes	skildes
silverbägare	silverbägare
brunne	brunne
vise	vise
log	log
Gileads	Gileads
Abraham	Abraham
Abel	Abel
stengolv	stengolv
förhärligen	förhärligen
fatet	fatet
ansikte	ansikte
dammarna	dammarna
fostrades	fostrades
Rehabeams	Rehabeams
slås	slås
Isak	Isak
stengolvet	stengolvet
stadgas	stadgas
utdelade	utdelade
ofta	ofta
agade	agade
snåret	snåret
befälhavarna	befälhavarna
viljes	viljes
utsträckt	utsträckt
sköte	sköte
skylt	skylt
oren	oren
ringare	ringare
Meribas	Meribas
utbredda	utbredda
hurudant	hurudant
Laban	Laban
rannsaken	rannsaken
boks	boks
klippa	klippa
Undan	Undan
Jeremias	Jeremias
vässer	vässer
namns	namns
Esters	Esters
Meriba	Meriba
Serubbabel	Serubbabel
fare	fare
Bara	Bara
helgade	helgade
huset	huset
Manasses	Manasses
omgiven	omgiven
väckas	väckas
rädda	rädda
Hesron	Hesron
låga	låga
tillsätta	tillsätta
fot	fot
ålägga	ålägga
utstakat	utstakat
stillas	stillas
fat	fat
Dess	Dess
vet	vet
släktet	släktet
tackade	tackade
förslag	förslag
bägare	bägare
alls	alls
mördade	mördade
Sutelas	Sutelas
betrycktes	betrycktes
Lea	Lea
synderna	synderna
tiger	tiger
ingångens	ingångens
Allas	Allas
förvarades	förvarades
skilde	skilde
fördärvet	fördärvet
hören	hören
Amaleks	Amaleks
valv	valv
Sered	Sered
rådde	rådde
avvändes	avvändes
arbetare	arbetare
utrönt	utrönt
slösare	slösare
glänsande	glänsande
fördragen	fördragen
behövande	behövande
klöv	klöv
äte	äte
omsluta	omsluta
drive	drive
inne	inne
hämnas	hämnas
läkare	läkare
förrådshuset	förrådshuset
trampas	trampas
tänk	tänk
Salem	Salem
stupa	stupa
Antikrists	Antikrists
rättfärdigas	rättfärdigas
vårt	vårt
vett	vett
Judeens	Judeens
fyllda	fyllda
Denna	Denna
Mahalalels	Mahalalels
behöva	behöva
ena	ena
Nod	Nod
tåga	tåga
utvaldas	utvaldas
Diana	Diana
fördrivna	fördrivna
utsläckt	utsläckt
äktenskapsbrottet	äktenskapsbrottet
Folket	Folket
skrämmes	skrämmes
enas	enas
föra	föra
skrämma	skrämma
Johannes	Johannes
mätta	mätta
duga	duga
avmätt	avmätt
höra	höra
uppbådade	uppbådade
murbruket	murbruket
upplåta	upplåta
fiskare	fiskare
förståndet	förståndet
spott	spott
utbyte	utbyte
uppgivna	uppgivna
Eder	Eder
armen	armen
besatta	besatta
bit	bit
förlöst	förlöst
skänke	skänke
bot	bot
mark	mark
skrymtare	skrymtare
Satan	Satan
Abida	Abida
Sikems	Sikems
Ada	Ada
öst	öst
blott	blott
äktenskapsbrott	äktenskapsbrott
berömda	berömda
användes	användes
födas	födas
sänka	sänka
hacka	hacka
uppståndna	uppståndna
uppfört	uppfört
föröda	föröda
samlen	samlen
den	den
flögo	flögo
uppfödd	uppfödd
valla	valla
träffades	träffades
visade	visade
upplysa	upplysa
sov	sov
anskaffade	anskaffade
stöta	stöta
verket	verket
vävda	vävda
växe	växe
tage	tage
hon	hon
Ahabs	Ahabs
intaga	intaga
Helt	Helt
sen	sen
Hanna	Hanna
fällas	fällas
upphöja	upphöja
lånade	lånade
vindarna	vindarna
förundren	förundren
förgör	förgör
sovo	sovo
uppfödde	uppfödde
upphöjda	upphöjda
vägs	vägs
tränga	tränga
Barak	Barak
kor	kor
hjulet	hjulet
minskade	minskade
Jo	Jo
konungadömet	konungadömet
tänken	tänken
göre	göre
råka	råka
förstörd	förstörd
Maria	Maria
Rådet	Rådet
röres	röres
ställde	ställde
släktens	släktens
flottar	flottar
höres	höres
fyllas	fyllas
No	No
samtycke	samtycke
budens	budens
inga	inga
förgjorde	förgjorde
lidandes	lidandes
komme	komme
Vin	Vin
fältet	fältet
Elisas	Elisas
lånen	lånen
invånare	invånare
behålla	behålla
brändes	brändes
ställd	ställd
fjättrade	fjättrade
Anas	Anas
täcka	täcka
inmönstrades	inmönstrades
Abias	Abias
San	San
brodern	brodern
klagorop	klagorop
Tre	Tre
räknen	räknen
skapades	skapades
sina	sina
rullas	rullas
säges	säges
betade	betade
Lud	Lud
vårdare	vårdare
förlåta	förlåta
springande	springande
fria	fria
Ai	Ai
kon	kon
beviset	beviset
råkade	råkade
lärd	lärd
förehaven	förehaven
stadgen	stadgen
rövare	rövare
antända	antända
Betuels	Betuels
frossa	frossa
förtryckta	förtryckta
lidande	lidande
make	make
Edoms	Edoms
vilka	vilka
fullborde	fullborde
hälsades	hälsades
upplagt	upplagt
frälsa	frälsa
son	son
Kanaans	Kanaans
upptändas	upptändas
Hasor	Hasor
beredd	beredd
stycken	stycken
moderliv	moderliv
skuren	skuren
budordet	budordet
dukat	dukat
Fallen	Fallen
enda	enda
förbundet	förbundet
tillredes	tillredes
Vaken	Vaken
Sjustjärnorna	Sjustjärnorna
Abimelek	Abimelek
prisen	prisen
torget	torget
Naftali	Naftali
nitälskan	nitälskan
fötterna	fötterna
utsläcka	utsläcka
frågade	frågade
närande	närande
Kedars	Kedars
Man	Man
anstiftade	anstiftade
avlämnades	avlämnades
viken	viken
tända	tända
Talar	Talar
vakttorn	vakttorn
Hiskias	Hiskias
Om	Om
Leviatan	Leviatan
pålägga	pålägga
udd	udd
uträckte	uträckte
Hiskia	Hiskia
sätet	sätet
vända	vända
vattnas	vattnas
Elisa	Elisa
Ahab	Ahab
övermod	övermod
dräpen	dräpen
förblivande	förblivande
tycka	tycka
svalkas	svalkas
föres	föres
åkerstycken	åkerstycken
Jason	Jason
slita	slita
Urias	Urias
drage	drage
såddes	såddes
lysande	lysande
maakatéerna	maakatéerna
Aran	Aran
påbud	påbud
öppnas	öppnas
visen	visen
spridda	spridda
bekänna	bekänna
skydda	skydda
gode	gode
tages	tages
åkerstycke	åkerstycke
renade	renade
Jona	Jona
Båda	Båda
förstöra	förstöra
tryckte	tryckte
ansedda	ansedda
vandrade	vandrade
Sems	Sems
Saul	Saul
Jedutuns	Jedutuns
krossade	krossade
Faraos	Faraos
finnes	finnes
Abrahams	Abrahams
kors	kors
egyptiers	egyptiers
Bileam	Bileam
luta	luta
upptecknades	upptecknades
förtrycken	förtrycken
Joas	Joas
handlar	handlar
sons	sons
manade	manade
förfärade	förfärade
kärvarna	kärvarna
Efrons	Efrons
eder	eder
Sadok	Sadok
kände	kände
jämnas	jämnas
dryck	dryck
snärja	snärja
skådade	skådade
sänkt	sänkt
yngste	yngste
koka	koka
räcka	räcka
förtorkade	förtorkade
omsnärjde	omsnärjde
avbärga	avbärga
utsändes	utsändes
snart	snart
slaktades	slaktades
arme	arme
Amminadabs	Amminadabs
förgäte	förgäte
trycka	trycka
Akajas	Akajas
förtrycktas	förtrycktas
bäckarna	bäckarna
uträckas	uträckas
tillgiven	tillgiven
bakhållet	bakhållet
blindas	blindas
störes	störes
etiopier	etiopier
korsfästa	korsfästa
fallen	fallen
