zerbrecht	zerbrecht
treffen	treffen
Stricken	Stricken
ihren	ihren
erniedrigt	erniedrigt
erwürgt	erwürgt
meinen	meinen
versuchet	versuchet
Ärgernisse	Ärgernisse
erdacht	erdacht
heilte	heilte
keines	keines
Briefe	Briefe
brechen	brechen
Fahret	Fahret
Wer	Wer
Anschlägen	Anschlägen
wollest	wollest
maßen	maßen
hüte	hüte
bezahlst	bezahlst
lüge	lüge
Fremden	Fremden
Majestät	Majestät
Zeugnissen	Zeugnissen
aufheben	aufheben
Sabbatjahr	Sabbatjahr
Heeren	Heeren
grüßte	grüßte
zieren	zieren
fehlet	fehlet
Altären	Altären
Heiden	Heiden
Basilisken	Basilisken
frage	frage
Letzte	Letzte
dürfe	dürfe
füllte	füllte
decket	decket
bereite	bereite
Füllet	Füllet
Urteil	Urteil
drängten	drängten
stärket	stärket
Pfeilen	Pfeilen
Brüsten	Brüsten
Fallet	Fallet
vertilgt	vertilgt
kehren	kehren
macht	macht
vermöge	vermöge
erniedrigst	erniedrigst
außen	außen
sieht	sieht
beweisest	beweisest
Gebärde	Gebärde
versöhnt	versöhnt
setzet	setzet
Röhren	Röhren
Rechten	Rechten
schreiben	schreiben
gebraucht	gebraucht
suchst	suchst
nachwandeln	nachwandeln
ansehen	ansehen
lachen	lachen
Jünglinge	Jünglinge
standet	standet
seien	seien
gefällt	gefällt
neigte	neigte
hättest	hättest
Fällen	Fällen
schauet	schauet
mögt	mögt
schnell	schnell
suchte	suchte
Könnt	Könnt
Gänge	Gänge
zerrüttet	zerrüttet
soll	soll
aufnahmt	aufnahmt
Mäusen	Mäusen
Einheimische	Einheimische
sündiget	sündiget
Reizt	Reizt
demütiget	demütiget
Pferde	Pferde
erwerbe	erwerbe
gebäret	gebäret
Schmiede	Schmiede
Schlange	Schlange
heiße	heiße
schwimmst	schwimmst
Wegen	Wegen
zeiget	zeiget
Kaufleute	Kaufleute
trüge	trüge
ausrottet	ausrottet
befestigte	befestigte
demütig	demütig
Weichet	Weichet
betrübst	betrübst
Sabbatjahre	Sabbatjahre
müßte	müßte
Schild	Schild
schnelle	schnelle
gern	gern
Kristallen	Kristallen
Majestäten	Majestäten
jagte	jagte
lehnte	lehnte
hebräisch	hebräisch
entsündigten	entsündigten
lehren	lehren
Märkte	Märkte
beißet	beißet
Testamente	Testamente
bebte	bebte
Gäste	Gäste
warnte	warnte
beten	beten
herrschet	herrschet
laben	laben
grün	grün
einer	einer
Trübsale	Trübsale
Schlangen	Schlangen
blitzen	blitzen
meines	meines
leihet	leihet
kühl	kühl
Bleche	Bleche
besäet	besäet
leere	leere
weinet	weinet
wechselte	wechselte
verziehst	verziehst
wenden	wenden
Tauben	Tauben
holst	holst
mußten	mußten
Lobgesängen	Lobgesängen
bewahrst	bewahrst
mangeln	mangeln
Zöpfe	Zöpfe
kurze	kurze
recke	recke
Gras	Gras
hause	hause
Schade	Schade
rührte	rührte
ringst	ringst
umbringet	umbringet
sündigten	sündigten
stäupen	stäupen
berufe	berufe
setzte	setzte
zeugest	zeugest
Jüngern	Jüngern
Teppichen	Teppichen
klagte	klagte
reizest	reizest
empörte	empörte
hinausgehst	hinausgehst
unsres	unsres
geboten	geboten
erkennet	erkennet
Dingen	Dingen
steckst	steckst
Fäusten	Fäusten
reichet	reichet
Gebt	Gebt
verzehrt	verzehrt
Buben	Buben
ziehest	ziehest
wachset	wachset
binden	binden
strafe	strafe
Strömen	Strömen
schreibst	schreibst
speisest	speisest
Wehen	Wehen
Skorpionen	Skorpionen
fragen	fragen
Seine	Seine
schlaf	schlaf
gelobet	gelobet
Stücken	Stücken
pflügte	pflügte
vermag	vermag
ladest	ladest
loben	loben
suchest	suchest
Eingeweide	Eingeweide
beben	beben
Gibt	Gibt
unterrichten	unterrichten
steiget	steiget
Ratsherr	Ratsherr
erlösen	erlösen
einnehmest	einnehmest
schnitten	schnitten
erntete	erntete
glaube	glaube
schließt	schließt
Menschen	Menschen
prüfest	prüfest
Gedanken	Gedanken
kaufte	kaufte
erschreckte	erschreckte
würze	würze
Eingeweiden	Eingeweiden
Gerichten	Gerichten
trinken	trinken
glaubst	glaubst
hebet	hebet
stirbst	stirbst
Feste	Feste
durften	durften
Fragen	Fragen
sorge	sorge
zerstückte	zerstückte
bestellt	bestellt
Unserer	Unserer
machte	machte
verständig	verständig
urteilte	urteilte
schätzen	schätzen
eingehest	eingehest
stiege	stiege
Säuen	Säuen
Erste	Erste
verkürzest	verkürzest
bist	bist
verzweifelten	verzweifelten
trägt	trägt
erhört	erhört
jemanden	jemanden
schläfst	schläfst
vereinigte	vereinigte
bedenken	bedenken
Fahrt	Fahrt
bedürft	bedürft
diesen	diesen
Zerstreut	Zerstreut
fluchet	fluchet
Dank	Dank
ritten	ritten
befragten	befragten
befehle	befehle
fließen	fließen
zwölften	zwölften
aufkämen	aufkämen
laufe	laufe
borgst	borgst
Verheißung	Verheißung
Spieße	Spieße
Gelobet	Gelobet
schenke	schenke
danket	danket
Sorgen	Sorgen
Trübsalen	Trübsalen
bedeckest	bedeckest
Flamme	Flamme
Teil	Teil
Gläubigen	Gläubigen
weiche	weiche
siegte	siegte
schöpfen	schöpfen
zudeckt	zudeckt
herrschest	herrschest
behaltest	behaltest
hilfst	hilfst
tief	tief
konntest	konntest
opfern	opfern
drückte	drückte
pflanzet	pflanzet
wehen	wehen
könnte	könnte
stoßest	stoßest
Wissen	Wissen
vermögen	vermögen
bestellten	bestellten
kostet	kostet
anders	anders
griffen	griffen
würdest	würdest
hieltest	hieltest
verstecke	verstecke
Leuchten	Leuchten
verdeckte	verdeckte
Schuhe	Schuhe
gebrauchte	gebrauchte
Gläubige	Gläubige
Verwundete	Verwundete
blitzte	blitzte
füllst	füllst
Sekte	Sekte
Leiden	Leiden
Tritt	Tritt
wehren	wehren
vergleichen	vergleichen
fahrest	fahrest
wurden	wurden
aufstand	aufstand
stirbt	stirbt
Ringe	Ringe
Meinen	Meinen
bestanden	bestanden
Aas	Aas
frommen	frommen
taufet	taufet
zankte	zankte
trotzet	trotzet
beschwerst	beschwerst
Knabe	Knabe
geratest	geratest
Deutungen	Deutungen
gebären	gebären
Quellen	Quellen
Graben	Graben
Sabbaten	Sabbaten
Lehre	Lehre
einsammelst	einsammelst
vorn	vorn
fünfte	fünfte
Flammen	Flammen
Heuschrecken	Heuschrecken
reizte	reizte
Malen	Malen
Stimme	Stimme
vermagst	vermagst
grüße	grüße
graben	graben
gleiche	gleiche
Märkten	Märkten
rächest	rächest
Ställe	Ställe
betrüge	betrüge
Falle	Falle
ausfuhr	ausfuhr
helfest	helfest
lesen	lesen
helft	helft
Teilen	Teilen
arme	arme
Ehren	Ehren
schaffe	schaffe
Male	Male
zürnte	zürnte
Auge	Auge
Früchten	Früchten
hüten	hüten
Schulden	Schulden
träge	träge
Binden	Binden
rufest	rufest
lobe	lobe
Augen	Augen
Warte	Warte
helle	helle
untergeht	untergeht
schweiget	schweiget
steig	steig
Gevierte	Gevierte
wirkst	wirkst
ernten	ernten
ringet	ringet
Fittiche	Fittiche
ferne	ferne
vergesset	vergesset
Äxte	Äxte
liebst	liebst
Ställen	Ställen
Älteste	Älteste
Regenten	Regenten
heißt	heißt
hinausgeht	hinausgeht
erhörest	erhörest
eins	eins
lernte	lernte
Zäume	Zäume
schmelzen	schmelzen
Seines	Seines
Kohlen	Kohlen
Gemeinde	Gemeinde
Rufe	Rufe
empfange	empfange
Würzen	Würzen
herrschte	herrschte
blast	blast
trage	trage
verzweifelt	verzweifelt
Wogen	Wogen
Staube	Staube
kommest	kommest
könnest	könnest
Vorhäuten	Vorhäuten
wahre	wahre
Edelsteinen	Edelsteinen
strafen	strafen
Sternen	Sternen
ehrte	ehrte
ältesten	ältesten
Löwen	Löwen
Rühmet	Rühmet
erhebst	erhebst
Kaufleuten	Kaufleuten
schon	schon
verschont	verschont
hineingeht	hineingeht
lieget	lieget
Felsen	Felsen
Alte	Alte
lügst	lügst
Schuld	Schuld
kämpfet	kämpfet
drängest	drängest
auszogst	auszogst
entsetzten	entsetzten
Steine	Steine
ausrottest	ausrottest
Abtrünnige	Abtrünnige
Stolze	Stolze
er	er
bekannten	bekannten
anrichtet	anrichtet
linke	linke
Taten	Taten
Gedanke	Gedanke
Sorget	Sorget
schlaft	schlaft
abweichet	abweichet
allen	allen
stillte	stillte
verdammst	verdammst
weichet	weichet
wunderte	wunderte
fange	fange
könne	könne
braust	braust
anzeigte	anzeigte
legst	legst
tust	tust
sitzest	sitzest
konntet	konntet
Wären	Wären
deinen	deinen
wären	wären
erdachten	erdachten
angehören	angehören
Fliegen	Fliegen
verkündigt	verkündigt
Schreiet	Schreiet
begrabet	begrabet
Reife	Reife
Türmen	Türmen
verstehst	verstehst
Altäre	Altäre
lehnen	lehnen
ungeistlichen	ungeistlichen
trübe	trübe
Höhle	Höhle
faul	faul
fraget	fraget
möget	möget
Wir	Wir
erbaut	erbaut
Krieg	Krieg
bewahrt	bewahrt
könnet	könnet
Ein	Ein
Heide	Heide
Herz	Herz
ruhe	ruhe
erzeigen	erzeigen
Mache	Mache
unseres	unseres
Dein	Dein
aufrichte	aufrichte
Gerät	Gerät
Dich	Dich
Töpfen	Töpfen
werdest	werdest
erhebest	erhebest
tote	tote
Perlen	Perlen
ach	ach
führst	führst
jauchzte	jauchzte
gehest	gehest
Kehre	Kehre
Höhlen	Höhlen
Willen	Willen
verzieh	verzieh
Schiffe	Schiffe
einführte	einführte
löste	löste
Kleinoden	Kleinoden
Dieben	Dieben
Hallen	Hallen
stoßt	stoßt
gute	gute
Hauen	Hauen
hinaufgeht	hinaufgeht
wärmet	wärmet
verkündigten	verkündigten
lange	lange
zuschließet	zuschließet
küsse	küsse
Ihren	Ihren
Trübsal	Trübsal
kehret	kehret
Dienet	Dienet
Wege	Wege
spiele	spiele
hatte	hatte
fliegen	fliegen
Hunderten	Hunderten
salzen	salzen
angehört	angehört
Ehre	Ehre
fahrt	fahrt
Regent	Regent
denket	denket
wach	wach
trüb	trüb
traget	traget
Zweige	Zweige
Kosten	Kosten
wogen	wogen
nimmt	nimmt
wiederkamen	wiederkamen
lügen	lügen
Keile	Keile
verdeckten	verdeckten
entsetzen	entsetzen
Räten	Räten
still	still
verkürzt	verkürzt
stürzt	stürzt
regieret	regieret
sollten	sollten
fressen	fressen
Narren	Narren
säumet	säumet
Bär	Bär
Werden	Werden
aufwachte	aufwachte
Schreien	Schreien
niemanden	niemanden
seit	seit
bauet	bauet
frisch	frisch
lade	lade
links	links
Erden	Erden
einsammelte	einsammelte
leihst	leihst
Ochsen	Ochsen
backt	backt
wachte	wachte
ab	ab
stiften	stiften
Deinem	Deinem
gehörten	gehörten
stolz	stolz
zuhöret	zuhöret
küssen	küssen
Sprüchen	Sprüchen
ungefälschter	ungefälschter
lieben	lieben
beides	beides
Kühe	Kühe
führte	führte
suchten	suchten
Äxten	Äxten
erfüllt	erfüllt
verbirgt	verbirgt
verwahrt	verwahrt
verführen	verführen
Drache	Drache
aufmacht	aufmacht
zürnest	zürnest
speise	speise
Knechten	Knechten
Danket	Danket
Äste	Äste
Wäre	Wäre
Bete	Bete
Fröschen	Fröschen
Solche	Solche
werfet	werfet
Halte	Halte
War	War
Aller	Aller
fangt	fangt
vertraut	vertraut
Tausend	Tausend
brenne	brenne
aufrichtest	aufrichtest
lasset	lasset
bleibe	bleibe
fällte	fällte
bekehret	bekehret
Laufet	Laufet
morden	morden
vertilgest	vertilgest
hebe	hebe
seufzt	seufzt
Elle	Elle
stäupte	stäupte
einen	einen
gehörst	gehörst
verzehre	verzehre
Leuchte	Leuchte
krank	krank
Kreisen	Kreisen
besitzt	besitzt
täuschte	täuschte
dürfest	dürfest
Hälse	Hälse
reichte	reichte
rühmst	rühmst
Gebet	Gebet
Decket	Decket
Binde	Binde
lachte	lachte
weichest	weichest
alles	alles
scheide	scheide
Held	Held
stürzte	stürzte
Fette	Fette
leuchten	leuchten
bestimmst	bestimmst
Funken	Funken
urteile	urteile
zudeckte	zudeckte
plagest	plagest
Folge	Folge
junge	junge
blitzt	blitzt
bestand	bestand
gießet	gießet
hebst	hebst
stehet	stehet
haut	haut
übte	übte
begehrte	begehrte
gleich	gleich
verliere	verliere
auszogen	auszogen
Frösche	Frösche
Sehe	Sehe
zerstückt	zerstückt
erzürnet	erzürnet
verstehest	verstehest
gedenket	gedenket
tretet	tretet
vor	vor
Hörst	Hörst
erlaubt	erlaubt
mal	mal
Wollte	Wollte
Steige	Steige
wünsche	wünsche
Als	Als
eingehet	eingehet
fromme	fromme
schöpfest	schöpfest
Sinne	Sinne
erzürnst	erzürnst
erschreckt	erschreckt
Kühen	Kühen
ausführe	ausführe
weinst	weinst
Klaue	Klaue
müßt	müßt
fragest	fragest
Pfeife	Pfeife
Loben	Loben
Grase	Grase
griffe	griffe
Ruder	Ruder
könnten	könnten
Reihe	Reihe
hassest	hassest
erwerben	erwerben
neige	neige
wild	wild
Meeren	Meeren
ausführte	ausführte
unsrer	unsrer
Kommst	Kommst
scheiden	scheiden
erhöhst	erhöhst
zeugte	zeugte
Hebet	Hebet
wart	wart
Schilden	Schilden
Wisset	Wisset
denkst	denkst
besuche	besuche
Decke	Decke
nahe	nahe
Könige	Könige
Schneide	Schneide
ratschlagt	ratschlagt
verboten	verboten
Stämmen	Stämmen
decke	decke
Drachen	Drachen
Weine	Weine
Verwundeten	Verwundeten
Alles	Alles
Grüße	Grüße
Festen	Festen
bracht	bracht
vermahnen	vermahnen
wohnst	wohnst
verunreinigst	verunreinigst
erwürget	erwürget
währet	währet
Zeugen	Zeugen
bitten	bitten
vermöget	vermöget
Plagen	Plagen
hänget	hänget
Suchet	Suchet
Weinen	Weinen
handhaben	handhaben
Helden	Helden
Sollten	Sollten
sündigt	sündigt
wohnest	wohnest
nötig	nötig
holet	holet
Meinem	Meinem
jagst	jagst
ausgehst	ausgehst
sitzet	sitzet
Plage	Plage
ausgereckt	ausgereckt
vergibt	vergibt
Flöte	Flöte
verlieren	verlieren
Welche	Welche
brecht	brecht
hinaufgehst	hinaufgehst
demütige	demütige
gelangen	gelangen
Stufen	Stufen
Kräfte	Kräfte
Bäche	Bäche
malen	malen
Fürst	Fürst
plagte	plagte
hätte	hätte
könnt	könnt
gehorchst	gehorchst
schießt	schießt
Diebe	Diebe
predigst	predigst
bekehrte	bekehrte
erhöht	erhöht
Wachet	Wachet
schreien	schreien
sprichst	sprichst
knüpfte	knüpfte
greifet	greifet
drängst	drängst
Köpfe	Köpfe
dienet	dienet
diese	diese
umbrächte	umbrächte
kehrst	kehrst
Fett	Fett
Monate	Monate
keine	keine
wechseln	wechseln
spannen	spannen
austilgest	austilgest
nahest	nahest
seinem	seinem
zeuge	zeuge
scheute	scheute
Lobe	Lobe
Worte	Worte
rotten	rotten
sitzen	sitzen
gehörte	gehörte
rufe	rufe
erlasset	erlasset
wehte	wehte
Jahre	Jahre
gewöhnt	gewöhnt
Ränke	Ränke
erhöhest	erhöhest
stäupt	stäupt
Säcken	Säcken
jedem	jedem
anruft	anruft
zerstört	zerstört
kennet	kennet
siehst	siehst
Weinstöcken	Weinstöcken
gereichte	gereichte
Eichen	Eichen
verzieht	verzieht
setzest	setzest
Sagte	Sagte
hauest	hauest
Am	Am
kehrte	kehrte
Namen	Namen
wärst	wärst
sage	sage
sonderte	sonderte
heben	heben
sollt	sollt
vertilgst	vertilgst
strafet	strafet
Lichte	Lichte
Leide	Leide
mache	mache
Werk	Werk
Gesell	Gesell
Setzet	Setzet
erbauet	erbauet
fallt	fallt
Stärke	Stärke
ihres	ihres
Einen	Einen
brause	brause
Diese	Diese
müsset	müsset
Urteile	Urteile
versteckst	versteckst
Hunde	Hunde
widerstanden	widerstanden
rittest	rittest
legte	legte
Feinden	Feinden
lauten	lauten
wohnte	wohnte
Tiere	Tiere
Schaffet	Schaffet
Tiefe	Tiefe
Grab	Grab
Vorstädten	Vorstädten
Aase	Aase
höhnte	höhnte
Elfen	Elfen
unsere	unsere
Bleibe	Bleibe
Jahren	Jahren
Mäuse	Mäuse
opferte	opferte
schlafest	schlafest
umkommst	umkommst
Lehren	Lehren
bekennt	bekennt
nehmest	nehmest
Regieren	Regieren
ärger	ärger
warten	warten
reiche	reiche
fluche	fluche
hänge	hänge
ausführen	ausführen
Rudern	Rudern
Zehen	Zehen
Regiert	Regiert
Helmen	Helmen
eingeht	eingeht
Hundert	Hundert
erhaltet	erhaltet
Lobet	Lobet
entgegenkamst	entgegenkamst
kein	kein
fremde	fremde
feierten	feierten
freiwilligen	freiwilligen
ausrichtest	ausrichtest
weist	weist
stahlen	stahlen
besäest	besäest
außer	außer
anhangt	anhangt
Träumen	Träumen
Gründe	Gründe
ein	ein
mögest	mögest
pflanzen	pflanzen
decken	decken
auflegte	auflegte
offenbare	offenbare
Hecken	Hecken
messe	messe
erhörst	erhörst
streckst	streckst
Hunden	Hunden
schlafe	schlafe
stiegen	stiegen
Hure	Hure
meinet	meinet
werden	werden
beschädigte	beschädigte
Bären	Bären
Schwänze	Schwänze
grünte	grünte
lebet	lebet
aufnahmen	aufnahmen
Samen	Samen
gehört	gehört
schmelzt	schmelzt
müsse	müsse
sterbest	sterbest
armen	armen
einem	einem
haue	haue
Speise	Speise
Forsche	Forsche
Köpfen	Köpfen
bleibest	bleibest
Alten	Alten
Merke	Merke
eine	eine
Pflanzung	Pflanzung
möchte	möchte
wacht	wacht
unserer	unserer
erkannte	erkannte
verkaufte	verkaufte
streite	streite
Seit	Seit
Hebe	Hebe
preist	preist
ehrest	ehrest
ernte	ernte
wirket	wirket
Dienst	Dienst
deinem	deinem
gelangt	gelangt
ausbreitete	ausbreitete
pflanze	pflanze
gewinnet	gewinnet
irrte	irrte
naht	naht
Rubine	Rubine
Tust	Tust
rauschen	rauschen
weise	weise
Schwänzen	Schwänzen
verkauft	verkauft
bewahret	bewahret
Jünger	Jünger
griechisch	griechisch
zerschlagt	zerschlagt
zählte	zählte
mußte	mußte
Gibst	Gibst
seht	seht
los	los
Rabe	Rabe
kämpfe	kämpfe
Bette	Bette
Woge	Woge
Anschläge	Anschläge
gehorcht	gehorcht
Essen	Essen
fließt	fließt
absagen	absagen
zerbricht	zerbricht
grüßet	grüßet
erbet	erbet
Ochse	Ochse
Stricke	Stricke
werft	werft
Türkis	Türkis
andere	andere
Empörungen	Empörungen
erkannten	erkannten
verwirfst	verwirfst
schau	schau
gebietet	gebietet
mehret	mehret
lobet	lobet
anderen	anderen
weinen	weinen
treibest	treibest
Lehne	Lehne
harrte	harrte
Merket	Merket
Weile	Weile
Schneiden	Schneiden
brauste	brauste
hasset	hasset
Anklagen	Anklagen
würzen	würzen
laufet	laufet
Gefilden	Gefilden
Entsetzt	Entsetzt
ausgereckten	ausgereckten
abweichest	abweichest
schwelle	schwelle
zeuget	zeuget
lösest	lösest
entgegenkamen	entgegenkamen
am	am
ausgerecktem	ausgerecktem
eile	eile
tretest	tretest
sagst	sagst
anrührt	anrührt
glaubet	glaubet
Raben	Raben
höhnest	höhnest
bitte	bitte
säte	säte
leide	leide
auflöst	auflöst
flehst	flehst
Blechen	Blechen
preisen	preisen
Kommet	Kommet
Weißt	Weißt
nächsten	nächsten
vermahnet	vermahnet
merke	merke
haust	haust
Leichen	Leichen
Wehr	Wehr
betrübet	betrübet
inneren	inneren
freute	freute
bis	bis
rede	rede
ungehorsame	ungehorsame
Steinen	Steinen
ausrichtet	ausrichtet
schaffet	schaffet
verdammt	verdammt
Grieche	Grieche
lassest	lassest
Bunde	Bunde
abtrünnigen	abtrünnigen
Heiße	Heiße
nehmt	nehmt
fresset	fresset
durchbohrte	durchbohrte
erlöst	erlöst
merket	merket
schonte	schonte
verkaufe	verkaufe
hieb	hieb
fette	fette
Reihen	Reihen
Befehle	Befehle
nötige	nötige
sucht	sucht
verderben	verderben
langte	langte
fertig	fertig
wohnet	wohnet
verstört	verstört
Tanne	Tanne
meine	meine
zürnet	zürnet
Ränken	Ränken
schreiet	schreiet
Feiertagen	Feiertagen
weine	weine
empfanget	empfanget
beugst	beugst
scheinest	scheinest
nachwandelte	nachwandelte
baust	baust
säst	säst
Spaltung	Spaltung
kaufe	kaufe
ihr	ihr
fehlen	fehlen
wegführen	wegführen
Tat	Tat
saget	saget
Gesellen	Gesellen
schätzt	schätzt
gewinnen	gewinnen
meinem	meinem
glänzte	glänzte
achten	achten
Herren	Herren
Weil	Weil
scheu	scheu
Predigt	Predigt
hingehet	hingehet
innere	innere
stoße	stoße
heulte	heulte
lobte	lobte
Füßen	Füßen
Würze	Würze
klaget	klaget
zerreißt	zerreißt
Büschen	Büschen
bedeckt	bedeckt
Leiste	Leiste
wegen	wegen
gedenkest	gedenkest
speisen	speisen
Habt	Habt
verwirrt	verwirrt
sehest	sehest
euren	euren
arm	arm
Gehörst	Gehörst
zerstreust	zerstreust
Biene	Biene
begrabest	begrabest
tragt	tragt
Zäunen	Zäunen
bestimmte	bestimmte
gedenkst	gedenkst
neigest	neigest
versteckt	versteckt
ehret	ehret
Prophet	Prophet
Reiche	Reiche
ermahnet	ermahnet
vier	vier
Kein	Kein
Flöten	Flöten
verführe	verführe
Stäbe	Stäbe
durchbohrt	durchbohrt
schenken	schenken
Strafe	Strafe
Früchte	Früchte
dich	dich
beschädigten	beschädigten
Jude	Jude
essest	essest
schmückst	schmückst
schrecke	schrecke
wünschte	wünschte
Werde	Werde
klage	klage
Spitzen	Spitzen
Schläge	Schläge
Deinen	Deinen
werde	werde
verbot	verbot
logen	logen
Schätze	Schätze
gehet	gehet
Verheißungen	Verheißungen
wer	wer
umkehret	umkehret
grüne	grüne
weisen	weisen
Erde	Erde
verkündiget	verkündiget
würde	würde
Klage	Klage
verstopft	verstopft
Entsetzen	Entsetzen
raten	raten
umbrächten	umbrächten
Klauen	Klauen
merken	merken
ausrufest	ausrufest
weichst	weichst
jauchzt	jauchzt
Basilisk	Basilisk
Kristalle	Kristalle
Klüfte	Klüfte
Bahn	Bahn
Ältesten	Ältesten
kennst	kennst
Schilde	Schilde
hörte	hörte
anrichte	anrichte
aßest	aßest
preise	preise
erben	erben
vertrauten	vertrauten
Satzungen	Satzungen
selber	selber
ermahnt	ermahnt
mühte	mühte
Sagen	Sagen
ehre	ehre
erhebet	erhebet
einst	einst
betrübten	betrübten
sitze	sitze
machest	machest
Kannen	Kannen
verklärest	verklärest
allem	allem
fluchte	fluchte
untergehst	untergehst
rote	rote
prediget	prediget
hurst	hurst
lehret	lehret
unserem	unserem
Pfeifen	Pfeifen
Heben	Heben
Perle	Perle
Söhnen	Söhnen
verdeckt	verdeckt
erbaust	erbaust
habest	habest
diente	diente
hoffte	hoffte
vergessest	vergessest
faule	faule
verbannet	verbannet
Willst	Willst
bestimmten	bestimmten
Haben	Haben
steige	steige
Weinet	Weinet
lose	lose
drücke	drücke
Joche	Joche
müßten	müßten
hebräischen	hebräischen
Ei	Ei
schwimmen	schwimmen
behaltet	behaltet
Für	Für
Same	Same
Führet	Führet
lang	lang
Reizen	Reizen
flehte	flehte
Mal	Mal
sagen	sagen
Monaten	Monaten
Unglauben	Unglauben
mehrte	mehrte
pflegte	pflegte
verbirgst	verbirgst
schaffest	schaffest
losen	losen
Tannen	Tannen
wehret	wehret
verstanden	verstanden
pflanzest	pflanzest
verklärt	verklärt
aßet	aßet
ausfuhren	ausfuhren
führe	führe
Klüften	Klüften
Ärzte	Ärzte
halt	halt
deines	deines
bleibet	bleibet
Gefangene	Gefangene
ziehst	ziehst
fallest	fallest
Ärzten	Ärzten
ungehorsam	ungehorsam
Meines	Meines
verfolgst	verfolgst
versuchen	versuchen
webte	webte
ander	ander
untertretet	untertretet
irre	irre
klagen	klagen
Schwelle	Schwelle
Fittichen	Fittichen
ratschlaget	ratschlaget
besehet	besehet
springst	springst
esse	esse
zeugst	zeugst
Last	Last
Warten	Warten
verstörten	verstörten
verstehet	verstehet
zerstörst	zerstörst
leget	leget
reife	reife
lernet	lernet
spracht	spracht
Herrn	Herrn
erzeigest	erzeigest
zuschließt	zuschließt
Schale	Schale
weichen	weichen
koste	koste
Hat	Hat
ratschlagte	ratschlagte
reichen	reichen
zählst	zählst
Schaden	Schaden
dichten	dichten
mahle	mahle
zuteil	zuteil
Gehör	Gehör
Amen	Amen
batest	batest
zuteilte	zuteilte
bekennst	bekennst
Hie	Hie
stürzest	stürzest
kommet	kommet
Stufe	Stufe
trotzt	trotzt
schlagest	schlagest
verwirren	verwirren
trefft	trefft
Westen	Westen
begehret	begehret
beißt	beißt
lehrte	lehrte
solle	solle
vertraget	vertraget
fragte	fragte
Grenzen	Grenzen
griff	griff
gewinne	gewinne
aber	aber
Einheimischen	Einheimischen
habt	habt
Königreiche	Königreiche
übet	übet
wisset	wisset
Zehe	Zehe
Pferden	Pferden
frevler	frevler
Heißt	Heißt
harret	harret
Weinberge	Weinberge
empört	empört
erzeigt	erzeigt
fahret	fahret
traut	traut
erzeigte	erzeigte
Welchen	Welchen
steinigte	steinigte
Ärgernissen	Ärgernissen
Fülle	Fülle
Wesen	Wesen
wiederkamt	wiederkamt
solchem	solchem
Gebeten	Gebeten
löst	löst
sterbt	sterbt
erhöhet	erhöhet
solches	solches
Maultier	Maultier
erbest	erbest
frische	frische
begrabt	begrabt
Ende	Ende
strecke	strecke
eilet	eilet
erkennst	erkennst
Raten	Raten
säume	säume
beharrt	beharrt
Gebirgen	Gebirgen
weg	weg
Zeugnisse	Zeugnisse
Saget	Saget
binde	binde
schlag	schlag
trieben	trieben
taufen	taufen
eure	eure
eurer	eurer
leid	leid
Wehe	Wehe
leider	leider
suchet	suchet
Türkise	Türkise
mußt	mußt
predigte	predigte
begehrst	begehrst
verschonet	verschonet
schaffen	schaffen
Zöpfen	Zöpfen
Gefäßen	Gefäßen
Zäune	Zäune
wert	wert
wahr	wahr
steigest	steigest
verstörte	verstörte
beide	beide
reckte	reckte
blenden	blenden
ehe	ehe
Sehet	Sehet
Spitze	Spitze
sagte	sagte
preiset	preiset
steinigst	steinigst
Hirte	Hirte
Bäumen	Bäumen
Buchstabe	Buchstabe
solcher	solcher
gedacht	gedacht
Blitzen	Blitzen
gerne	gerne
hasse	hasse
brechet	brechet
absagt	absagt
Maßen	Maßen
liebest	liebest
taufst	taufst
Gebirge	Gebirge
suche	suche
forschet	forschet
handhabt	handhabt
anrufe	anrufe
sollst	sollst
Licht	Licht
schläft	schläft
Lobgesänge	Lobgesänge
brausen	brausen
zweite	zweite
erweckst	erweckst
anrufen	anrufen
Halt	Halt
verhalte	verhalte
eilte	eilte
Worten	Worten
überführt	überführt
Sterne	Sterne
hell	hell
regiere	regiere
beugte	beugte
lehrest	lehrest
Ellen	Ellen
Befehlen	Befehlen
Empörung	Empörung
leite	leite
halbe	halbe
schnitt	schnitt
Fällt	Fällt
Macht	Macht
Taufen	Taufen
eines	eines
trotze	trotze
Wunde	Wunde
waren	waren
baue	baue
war	war
feiert	feiert
Teppiche	Teppiche
weite	weite
Fallen	Fallen
vertrage	vertrage
sprachen	sprachen
sehet	sehet
Aufsätze	Aufsätze
nötigte	nötigte
lauft	lauft
fließe	fließe
beiden	beiden
Städte	Städte
aufmachte	aufmachte
wachet	wachet
hausen	hausen
Tyrannen	Tyrannen
beseht	beseht
Haue	Haue
beschädigt	beschädigt
führet	führet
Laie	Laie
wirkte	wirkte
abzieht	abzieht
kühlen	kühlen
lehrst	lehrst
Kreuz	Kreuz
fällst	fällst
Weg	Weg
Strafen	Strafen
Jünglingen	Jünglingen
erkanntet	erkanntet
fremden	fremden
Wollt	Wollt
machet	machet
Narr	Narr
ruhte	ruhte
Schmieden	Schmieden
Banden	Banden
nähret	nähret
Erben	Erben
Höret	Höret
maß	maß
Sucht	Sucht
bereits	bereits
rührst	rührst
springen	springen
frevles	frevles
pflüget	pflüget
spanne	spanne
Säcke	Säcke
wissest	wissest
bezahlt	bezahlt
nachwandelt	nachwandelt
steckte	steckte
Name	Name
Gebot	Gebot
Beten	Beten
Eile	Eile
essen	essen
vergleiche	vergleiche
Setzt	Setzt
Esset	Esset
heißest	heißest
dankte	dankte
ruhest	ruhest
bauten	bauten
anbetest	anbetest
verunreinigt	verunreinigt
Eine	Eine
beider	beider
schwellen	schwellen
zerstreute	zerstreute
Letzten	Letzten
Säge	Säge
anzeige	anzeige
solche	solche
bete	bete
warnst	warnst
Sei	Sei
Glaubst	Glaubst
schweigen	schweigen
möchten	möchten
Taufe	Taufe
Bitte	Bitte
empörten	empörten
nahte	nahte
Solchen	Solchen
Vorhäute	Vorhäute
verlobte	verlobte
verkehrte	verkehrte
teilen	teilen
besuchen	besuchen
nütze	nütze
lebst	lebst
Band	Band
Arme	Arme
greife	greife
Rubinen	Rubinen
schicke	schicke
verwahret	verwahret
mangelte	mangelte
Bube	Bube
Fliege	Fliege
ringe	ringe
Zeuge	Zeuge
Hälsen	Hälsen
bewahrest	bewahrest
vergibst	vergibst
Röhre	Röhre
zerstreuten	zerstreuten
redetest	redetest
Winden	Winden
spannt	spannt
aufrichtet	aufrichtet
bedeckst	bedeckst
bekehrten	bekehrten
demütigst	demütigst
täuschet	täuschet
abtrünnige	abtrünnige
Zeug	Zeug
verbergest	verbergest
Predigten	Predigten
stillest	stillest
taufe	taufe
Meinet	Meinet
stehst	stehst
Vorstädte	Vorstädte
schneide	schneide
Schleifen	Schleifen
wärme	wärme
Mein	Mein
sterbet	sterbet
Lasten	Lasten
möchtet	möchtet
scheinen	scheinen
Rufet	Rufet
tiefe	tiefe
brauchst	brauchst
erbte	erbte
unsre	unsre
Wehklage	Wehklage
auflegst	auflegst
müssest	müssest
hattest	hattest
jedes	jedes
besitzet	besitzet
wurde	wurde
Gebete	Gebete
sprecht	sprecht
gehöre	gehöre
drücken	drücken
beschwert	beschwert
gehorchet	gehorchet
borgte	borgte
Buchstaben	Buchstaben
fallet	fallet
dritten	dritten
bemüht	bemüht
Testamenten	Testamenten
mehr	mehr
tut	tut
spannte	spannte
Maße	Maße
glaubest	glaubest
schweigst	schweigst
schätzte	schätzte
Deutung	Deutung
gebieten	gebieten
regieren	regieren
Gängen	Gängen
Keilen	Keilen
umbringt	umbringt
banden	banden
Pfeile	Pfeile
erfreut	erfreut
Spießen	Spießen
leben	leben
blasen	blasen
einführt	einführt
Seil	Seil
anhangen	anhangen
Orten	Orten
behalte	behalte
wilden	wilden
Jahr	Jahr
bat	bat
lehre	lehre
fällen	fällen
Dinge	Dinge
auszieht	auszieht
Kreise	Kreise
feierte	feierte
zweiten	zweiten
toten	toten
seufzte	seufzte
gebt	gebt
schaffte	schaffte
jeder	jeder
machst	machst
angehöret	angehöret
fluchten	fluchten
erforschet	erforschet
betrübt	betrübt
heißet	heißet
Fremde	Fremde
forschte	forschte
alle	alle
Bergen	Bergen
Dichten	Dichten
fresse	fresse
schmückte	schmückte
kühle	kühle
Hirt	Hirt
halben	halben
besucht	besucht
Nehmet	Nehmet
verständige	verständige
zerstreuest	zerstreuest
rächte	rächte
urteilen	urteilen
Räte	Räte
schwebte	schwebte
hängen	hängen
Einer	Einer
Bande	Bande
mahlen	mahlen
lebte	lebte
ziert	ziert
werten	werten
verdammte	verdammte
zerreißest	zerreißest
Trage	Trage
Ring	Ring
gelobst	gelobst
stahl	stahl
verlobt	verlobt
austilge	austilge
eigenen	eigenen
reizen	reizen
Sage	Sage
Sieb	Sieb
verderbet	verderbet
grabe	grabe
stolze	stolze
austilgen	austilgen
Ochs	Ochs
schätze	schätze
Bleibet	Bleibet
befragte	befragte
tat	tat
gießt	gießt
heftetest	heftetest
streiten	streiten
wachen	wachen
verkaufst	verkaufst
webet	webet
haderte	haderte
Lob	Lob
strafst	strafst
eng	eng
bedürfet	bedürfet
Streite	Streite
Kehret	Kehret
weiten	weiten
heil	heil
kosten	kosten
Sinnen	Sinnen
verdammten	verdammten
Herde	Herde
möge	möge
stimmte	stimmte
versucht	versucht
tragest	tragest
rufet	rufet
taten	taten
trügen	trügen
welchen	welchen
raubet	raubet
meinte	meinte
verführt	verführt
taufte	taufte
linken	linken
Abtrünnigen	Abtrünnigen
führen	führen
Seht	Seht
dienst	dienst
Eiche	Eiche
offenbart	offenbart
löset	löset
Solcher	Solcher
regierest	regierest
hoffet	hoffet
Ihr	Ihr
verkehrten	verkehrten
aufhobt	aufhobt
versöhnst	versöhnst
gebet	gebet
Eilet	Eilet
Füchse	Füchse
gelobten	gelobten
schmierte	schmierte
ärgere	ärgere
heiligte	heiligte
grüßt	grüßt
Taube	Taube
sollte	sollte
zerschlaget	zerschlaget
fern	fern
Unsere	Unsere
Griechen	Griechen
Wehre	Wehre
Grabe	Grabe
Morde	Morde
Bund	Bund
ausgereckte	ausgereckte
heiß	heiß
Buche	Buche
spaltete	spaltete
Schaffe	Schaffe
ungeistlich	ungeistlich
labe	labe
Pauken	Pauken
verderbest	verderbest
lieb	lieb
bekannt	bekannt
Hin	Hin
verlasset	verlasset
schlagt	schlagt
gelobt	gelobt
verkehrt	verkehrt
gehorchest	gehorchest
elfte	elfte
erst	erst
Schauet	Schauet
schmücket	schmücket
Geboten	Geboten
Löwe	Löwe
wehklagen	wehklagen
hingeht	hingeht
Gefäße	Gefäße
wiederkommst	wiederkommst
Pauke	Pauke
rauschte	rauschte
fertige	fertige
stille	stille
kaufest	kaufest
vereinigt	vereinigt
liegst	liegst
rufst	rufst
Jochen	Jochen
halte	halte
Städten	Städten
erforscht	erforscht
liegen	liegen
irren	irren
Könnet	Könnet
Pflanzungen	Pflanzungen
weisest	weisest
Bürden	Bürden
pflügen	pflügen
Brüste	Brüste
Bärte	Bärte
Steiget	Steiget
bleiben	bleiben
kaufst	kaufst
Riese	Riese
zwölfte	zwölfte
Laufen	Laufen
bringst	bringst
Klagen	Klagen
brennen	brennen
dritte	dritte
Edelsteine	Edelsteine
heftete	heftete
Keine	Keine
beweiset	beweiset
Wolle	Wolle
wälzet	wälzet
merkte	merkte
hörest	hörest
schöpfe	schöpfe
schenkest	schenkest
Gründen	Gründen
beschwöre	beschwöre
Sollte	Sollte
Heuschrecke	Heuschrecke
Armen	Armen
Eins	Eins
Stimmen	Stimmen
habe	habe
nützt	nützt
Weiß	Weiß
verwirft	verwirft
befehlt	befehlt
schöpfte	schöpfte
Arm	Arm
heiligem	heiligem
setzt	setzt
trinkest	trinkest
leset	leset
Glaubet	Glaubet
verstand	verstand
redetet	redetet
flucht	flucht
ratet	ratet
zierte	zierte
Ratsherren	Ratsherren
stimmen	stimmen
Deine	Deine
wehre	wehre
trauten	trauten
Seiten	Seiten
ungefälschtem	ungefälschtem
anzeigest	anzeigest
schenket	schenket
weh	weh
bauest	bauest
hätten	hätten
vierte	vierte
Obrigkeit	Obrigkeit
demütigte	demütigte
warst	warst
Söhne	Söhne
Kleinode	Kleinode
bleibst	bleibst
dürft	dürft
älteste	älteste
Wunden	Wunden
wurdest	wurdest
rühmet	rühmet
Gemeinden	Gemeinden
rate	rate
wehe	wehe
steigen	steigen
Gebeinen	Gebeinen
zanket	zanket
Reichen	Reichen
backe	backe
Stärket	Stärket
fetten	fetten
zerstreut	zerstreut
anzeigen	anzeigen
liege	liege
breche	breche
streute	streute
niemand	niemand
fehlte	fehlte
Höfe	Höfe
rauben	rauben
jungen	jungen
Höfen	Höfen
besät	besät
erzeigten	erzeigten
siegen	siegen
Bienen	Bienen
fastete	fastete
dein	dein
grünen	grünen
gereicht	gereicht
wünschet	wünschet
suchen	suchen
aufrichten	aufrichten
gehorchten	gehorchten
Propheten	Propheten
stellen	stellen
lache	lache
stäupten	stäupten
wiederkommt	wiederkommt
widerstand	widerstand
anrichten	anrichten
aufwachst	aufwachst
besorgt	besorgt
vierten	vierten
beschuldigt	beschuldigt
vergießt	vergießt
Aufsätzen	Aufsätzen
Enden	Enden
triebe	triebe
nehmet	nehmet
sorgte	sorgte
würdet	würdet
Schlägst	Schlägst
konnten	konnten
Schwellen	Schwellen
Gerichte	Gerichte
Rühmst	Rühmst
eigene	eigene
bestimmt	bestimmt
lest	lest
blaset	blaset
welche	welche
kranken	kranken
Reif	Reif
griechischen	griechischen
heiligest	heiligest
Scharen	Scharen
Maß	Maß
stand	stand
stärken	stärken
aufhört	aufhört
sorgen	sorgen
sei	sei
Obrigkeiten	Obrigkeiten
folgen	folgen
mühe	mühe
prüfst	prüfst
seufzest	seufzest
Neumonde	Neumonde
Herr	Herr
kehre	kehre
Zweigen	Zweigen
erfahrest	erfahrest
zweifel	zweifel
erweckt	erweckt
Berge	Berge
möchtest	möchtest
hängte	hängte
Christ	Christ
Denn	Denn
wegführe	wegführe
schämet	schämet
Brote	Brote
band	band
höret	höret
Neumonden	Neumonden
legest	legest
reizt	reizt
laut	laut
befragt	befragt
wehklage	wehklage
verbannt	verbannt
log	log
forschen	forschen
verlaß	verlaß
plagen	plagen
Sehnen	Sehnen
wache	wache
leiden	leiden
schlafet	schlafet
Stämme	Stämme
fliege	fliege
sitzt	sitzt
wachsen	wachsen
regiert	regiert
keinem	keinem
erfüllet	erfüllet
liebe	liebe
Leiche	Leiche
gelobte	gelobte
gehorchte	gehorchte
reden	reden
bemühst	bemühst
vergebet	vergebet
schickte	schickte
Ordnungen	Ordnungen
tobte	tobte
warte	warte
seist	seist
solchen	solchen
umkämen	umkämen
laute	laute
Sägen	Sägen
würden	würden
Königen	Königen
Haut	Haut
deckst	deckst
einführen	einführen
handhabest	handhabest
entsetzet	entsetzet
krähen	krähen
stürzen	stürzen
verkündige	verkündige
Herzen	Herzen
fallen	fallen
regte	regte
Herden	Herden
Reich	Reich
erfreuest	erfreuest
zuhörte	zuhörte
wehrte	wehrte
ausziehst	ausziehst
beweist	beweist
Grenze	Grenze
Knaben	Knaben
folge	folge
Felle	Felle
Schlägen	Schlägen
sprechet	sprechet
verhalten	verhalten
folgte	folgte
umkommt	umkommt
hieben	hieben
Wachen	Wachen
übrigbleibet	übrigbleibet
Seinen	Seinen
knüpfst	knüpfst
rühmest	rühmest
gebest	gebest
haltet	haltet
erhalte	erhalte
Streiten	Streiten
zeigte	zeigte
deine	deine
wolle	wolle
Werte	Werte
Helme	Helme
kämpfte	kämpfte
zerbrichst	zerbrichst
halten	halten
Sekten	Sekten
bang	bang
gibt	gibt
glaubte	glaubte
hingehst	hingehst
Halle	Halle
Geviert	Geviert
Schar	Schar
solch	solch
Bitten	Bitten
eingehst	eingehst
befestigten	befestigten
feiern	feiern
Gebeine	Gebeine
Fetten	Fetten
gebiete	gebiete
ziere	ziere
bekehrt	bekehrt
Maultiere	Maultiere
verbergt	verbergt
all	all
verziehe	verziehe
Elf	Elf
Ströme	Ströme
erlaubte	erlaubte
wog	wog
erweckest	erweckest
betrügen	betrügen
salz	salz
liebte	liebte
befestigt	befestigt
ringen	ringen
trieb	trieb
Beinen	Beinen
besitzest	besitzest
nährte	nährte
zürnst	zürnst
Spannt	Spannt
nimmst	nimmst
Hirten	Hirten
Götze	Götze
aufhoben	aufhoben
trotzest	trotzest
vergebt	vergebt
schenkte	schenkte
Schiffen	Schiffen
Staub	Staub
pflanzt	pflanzt
schrecken	schrecken
Tun	Tun
wallte	wallte
streuen	streuen
Fels	Fels
Recht	Recht
bekannte	bekannte
anrührte	anrührte
unser	unser
Hecke	Hecke
Ha	Ha
Wirst	Wirst
ihre	ihre
Pfunde	Pfunde
zweifelte	zweifelte
gebot	gebot
Orte	Orte
Tausenden	Tausenden
regen	regen
wollt	wollt
Glauben	Glauben
schauen	schauen
schaute	schaute
schlage	schlage
raubest	raubest
speist	speist
kriegte	kriegte
säumen	säumen
tragen	tragen
Sehne	Sehne
Tritte	Tritte
gehst	gehst
hatten	hatten
wäre	wäre
nächste	nächste
denen	denen
Huren	Huren
Solch	Solch
aller	aller
wollte	wollte
holte	holte
vergießest	vergießest
weinest	weinest
Ringen	Ringen
gewöhnte	gewöhnte
verkündigest	verkündigest
Kräften	Kräften
verstecken	verstecken
trinket	trinket
Frage	Frage
Briefen	Briefen
Laien	Laien
bricht	bricht
weide	weide
stiftete	stiftete
scheue	scheue
Schafe	Schafe
Stäben	Stäben
wärmte	wärmte
Schleife	Schleife
zerrütteten	zerrütteten
Buch	Buch
blase	blase
Sorge	Sorge
spielen	spielen
Funke	Funke
Kriegsknechte	Kriegsknechte
aufhebt	aufhebt
erschrickt	erschrickt
seine	seine
erlassen	erlassen
Gelobt	Gelobt
führest	führest
aufhörte	aufhörte
rufen	rufen
verzehrst	verzehrst
Raube	Raube
tobst	tobst
erlöse	erlöse
gut	gut
Eines	Eines
Feind	Feind
gießest	gießest
Stücke	Stücke
tatet	tatet
wünschen	wünschen
fragst	fragst
heile	heile
male	male
erlöset	erlöset
Meere	Meere
Füchsen	Füchsen
erfüllst	erfüllst
haben	haben
bange	bange
morde	morde
verlaßt	verlaßt
umkehrt	umkehrt
erschrecket	erschrecket
eurem	eurem
Stühle	Stühle
Steigen	Steigen
Füße	Füße
leiten	leiten
stellst	stellst
reifen	reifen
Türme	Türme
Spaltungen	Spaltungen
verkauften	verkauften
begehrten	begehrten
rühmte	rühmte
Wert	Wert
Habe	Habe
unterrichte	unterrichte
Gebote	Gebote
Seile	Seile
entsetzte	entsetzte
Pfunden	Pfunden
zerrüttete	zerrüttete
verliert	verliert
besitze	besitze
fehle	fehle
kriegen	kriegen
nähre	nähre
Schalen	Schalen
amen	amen
Forschet	Forschet
verdeckst	verdeckst
Sieben	Sieben
greifen	greifen
Rehe	Rehe
hure	hure
Feiertage	Feiertage
Diesen	Diesen
teilet	teilet
gehören	gehören
befehlen	befehlen
pflege	pflege
glänzt	glänzt
glauben	glauben
hilft	hilft
Entsetzet	Entsetzet
verstopften	verstopften
Riesen	Riesen
umkehrte	umkehrte
nachwandelst	nachwandelst
teilte	teilte
aufkäme	aufkäme
ehren	ehren
bringet	bringet
backen	backen
Broten	Broten
Tagen	Tagen
folget	folget
Tragt	Tragt
hineingehst	hineingehst
ersten	ersten
gefällst	gefällst
Acht	Acht
Zerstreuten	Zerstreuten
aufstehet	aufstehet
fastetet	fastetet
ratschlagen	ratschlagen
redete	redete
erste	erste
zerstreuet	zerstreuet
verfolgt	verfolgt
versuche	versuche
schmiert	schmiert
jeden	jeden
weich	weich
wilde	wilde
Schafen	Schafen
jede	jede
gelangte	gelangte
hebräische	hebräische
Heere	Heere
aufhebest	aufhebest
bestellte	bestellte
deckte	deckte
ritt	ritt
messen	messen
schaffst	schaffst
dienest	dienest
füllen	füllen
krieget	krieget
seinen	seinen
eures	eures
All	All
verwahrst	verwahrst
fünften	fünften
schließen	schließen
bedenket	bedenket
wachse	wachse
falle	falle
Leisten	Leisten
ihrem	ihrem
bekennet	bekennet
zeigst	zeigst
batet	batet
jemand	jemand
Machet	Machet
seines	seines
rechten	rechten
vertraute	vertraute
Führe	Führe
auflöste	auflöste
steinigest	steinigest
entsündigte	entsündigte
Weh	Weh
Kriegen	Kriegen
aufsteht	aufsteht
fassest	fassest
Stolz	Stolz
umkäme	umkäme
konnte	konnte
brichst	brichst
Zähne	Zähne
Den	Den
Tage	Tage
Satzung	Satzung
spricht	spricht
murmelte	murmelte
sagest	sagest
aufstanden	aufstanden
Wehret	Wehret
Meine	Meine
speiest	speiest
besorgte	besorgte
entsetzt	entsetzt
Säue	Säue
beharret	beharret
hadere	hadere
baute	baute
Weiche	Weiche
liebet	liebet
lebest	lebest
beschuldiget	beschuldiget
Hast	Hast
keinen	keinen
werte	werte
verlähmt	verlähmt
wurdet	wurdet
stärkte	stärkte
Rechte	Rechte
Kriege	Kriege
Gefangenen	Gefangenen
krähte	krähte
reif	reif
gibst	gibst
stürze	stürze
unseren	unseren
schießen	schießen
teil	teil
Maultieren	Maultieren
Gebärden	Gebärden
sorget	sorget
trägst	trägst
Buchen	Buchen
vertrauet	vertrauet
erschreckten	erschreckten
jammerte	jammerte
Königreichen	Königreichen
säet	säet
Bäume	Bäume
Kriegsknechten	Kriegsknechten
Werke	Werke
verkehre	verkehre
brauchte	brauchte
Grüßet	Grüßet
Suche	Suche
kommst	kommst
huren	huren
wärt	wärt
Waren	Waren
Ersten	Ersten
Kreuze	Kreuze
aufstehst	aufstehst
mein	mein
Mensch	Mensch
spalten	spalten
begehrt	begehrt
Tier	Tier
treibst	treibst
Beine	Beine
Fäuste	Fäuste
enge	enge
Schuhen	Schuhen
drängte	drängte
gesellt	gesellt
Bürde	Bürde
Ding	Ding
lernst	lernst
gelang	gelang
wisse	wisse
währte	währte
ausgeht	ausgeht
Kohle	Kohle
helfet	helfet
brachen	brachen
teile	teile
offenbar	offenbar
Weinbergen	Weinbergen
stellte	stellte
schreie	schreie
Betten	Betten
grüßen	grüßen
berufen	berufen
denn	denn
Skorpione	Skorpione
Bächen	Bächen
Fallt	Fallt
hörst	hörst
Wirte	Wirte
überführen	überführen
Kleinod	Kleinod
Geräte	Geräte
freiwillige	freiwillige
geraten	geraten
Ihre	Ihre
wundere	wundere
Füllen	Füllen
Sollst	Sollst
Schätzen	Schätzen
erfahrt	erfahrt
heulet	heulet
selbst	selbst
zuhört	zuhört
Solches	Solches
fasset	fasset
Wehklagen	Wehklagen
jammern	jammern
stärke	stärke
Alle	Alle
Röcken	Röcken
messet	messet
laden	laden
kaufet	kaufet
Gehilfen	Gehilfen
spielet	spielet
Träume	Träume
reizet	reizet
wälzte	wälzte
zählet	zählet
fülle	fülle
fertigte	fertigte
murmeln	murmeln
betrübte	betrübte
weiden	weiden
Röcke	Röcke
schämst	schämst
Tyrann	Tyrann
Ästen	Ästen
übest	übest
strecken	strecken
beweise	beweise
Soll	Soll
fastetest	fastetest
ausrufen	ausrufen
pflanzte	pflanzte
lachet	lachet
Fellen	Fellen
schneiden	schneiden
Teile	Teile
erfahret	erfahret
Rauben	Rauben
Nehmt	Nehmt
kämpfen	kämpfen
Spanne	Spanne
dürfte	dürfte
den	den
Ach	Ach
ansehet	ansehet
anzeigt	anzeigt
Freunden	Freunden
Ängsten	Ängsten
eher	eher
vielen	vielen
strafte	strafte
schwebe	schwebe
Knechte	Knechte
sondern	sondern
Speisen	Speisen
ausbreitet	ausbreitet
esset	esset
auflegt	auflegt
elften	elften
schlaget	schlaget
Folget	Folget
Büsche	Büsche
spielte	spielte
kurz	kurz
Ängste	Ängste
Ordnung	Ordnung
Decken	Decken
Töpfe	Töpfe
Werdet	Werdet
Tieren	Tieren
Gute	Gute
verlähmte	verlähmte
blende	blende
prüfet	prüfet
fasse	fasse
aufwacht	aufwacht
ratschlagten	ratschlagten
leuchtete	leuchtete
hattet	hattet
Gefilde	Gefilde
verlasse	verlasse
Zähnen	Zähnen
fällt	fällt
speiet	speiet
freuet	freuet
brach	brach
wende	wende
Leid	Leid
predigt	predigt
verziehen	verziehen
unterrichtet	unterrichtet
fälle	fälle
erschrickst	erschrickst
stehest	stehest
zerbrechest	zerbrechest
zweifeln	zweifeln
brauche	brauche
keiner	keiner
schreist	schreist
entsündigen	entsündigen
zeugen	zeugen
Götzen	Götzen
Freunde	Freunde
Quelle	Quelle
Gästen	Gästen
bezahlest	bezahlest
geselle	geselle
heiligten	heiligten
erforschest	erforschest
hauen	hauen
anbetet	anbetet
hättet	hättet
Lehnen	Lehnen
meinst	meinst
schauest	schauest
abziehen	abziehen
Unglaube	Unglaube
schenkst	schenkst
Tut	Tut
trinkst	trinkst
Bahnen	Bahnen
Weinstöcke	Weinstöcke
versuchst	versuchst
wälzt	wälzt
scheinet	scheinet
ausführt	ausführt
Gut	Gut
predigten	predigten
Sprüche	Sprüche
verkündigst	verkündigst
Werken	Werken
einnehmet	einnehmet
heilet	heilet
Stühlen	Stühlen
Anklage	Anklage
erzürnt	erzürnt
erlösest	erlösest
jaget	jaget
Schauen	Schauen
bereitet	bereitet
Rehen	Rehen
beschwören	beschwören
raubte	raubte
Wache	Wache
beweisen	beweisen
Zäumen	Zäumen
schämte	schämte
leer	leer
Christen	Christen
tuest	tuest
Tiefen	Tiefen
streckte	streckte
Meinst	Meinst
Ratet	Ratet
lauf	lauf
gedachten	gedachten
stelle	stelle
übrigbleiben	übrigbleiben
erkennest	erkennest
begehre	begehre
rechte	rechte
stellet	stellet
haltest	haltest
schreckt	schreckt
schließe	schließe
durfte	durfte
Sabbate	Sabbate
Feinde	Feinde
Morden	Morden
Blitze	Blitze
pflegst	pflegst
werdet	werdet
ehrst	ehrst
Kost	Kost
baten	baten
stoßet	stoßet
hieltet	hieltet
Winde	Winde
bekehrst	bekehrst
wollten	wollten
versöhnet	versöhnet
Rufen	Rufen
untertreten	untertreten
weinte	weinte
Kannst	Kannst
Einem	Einem
Gehilfe	Gehilfe
Erbe	Erbe
wallet	wallet
bringest	bringest
Denen	Denen
viele	viele
reich	reich
Schau	Schau
habet	habet
Juden	Juden
danke	danke
Seilen	Seilen
