genehmigt	genehmigt
Gemeinden	Gemeinden
Leuchtstoffen	Leuchtstoffen
Monden	Monden
Dödel	Dödel
lehrest	lehrest
hasset	hasset
erzeigest	erzeigest
pflüget	pflüget
amputierten	amputierten
Grabbeltisch	Grabbeltisch
sitzt	sitzt
Hälse	Hälse
Schatten	Schatten
Komponisten	Komponisten
weinst	weinst
spaltest	spaltest
Tumult	Tumult
blasen	blasen
aufrichtest	aufrichtest
Dessous	Dessous
flirtete	flirtete
faschieren	faschieren
pflanzest	pflanzest
Freunden	Freunden
wachen	wachen
Wespen	Wespen
Affenbrotbaum	Affenbrotbaum
Streite	Streite
suchest	suchest
Grab	Grab
verkröchet	verkröchet
speisen	speisen
anders	anders
Held	Held
Affenbrotbäumen	Affenbrotbäumen
Negermusik	Negermusik
ritze	ritze
Linguistinnen	Linguistinnen
Fallturm	Fallturm
idealisierest	idealisierest
Gemeinde	Gemeinde
Politologe	Politologe
losten	losten
Milz	Milz
blitzet	blitzet
lieget	lieget
Eingabe	Eingabe
Seile	Seile
hängte	hängte
fresset	fresset
Hahnenkämme	Hahnenkämme
fluppten	fluppten
heiß	heiß
kehret	kehret
malochte	malochte
löge	löge
Menschen	Menschen
knistert	knistert
Kleptokratien	Kleptokratien
ankerst	ankerst
addieren	addieren
ausführen	ausführen
Streiten	Streiten
verbot	verbot
Piratensendern	Piratensendern
gedächten	gedächten
einigst	einigst
besprengen	besprengen
bewahrheitetet	bewahrheitetet
Jungfernflug	Jungfernflug
Dezernat	Dezernat
begehrtet	begehrtet
glänzt	glänzt
Erzeugung	Erzeugung
Helden	Helden
Füllet	Füllet
Sterne	Sterne
wehrtest	wehrtest
impfst	impfst
bimmelten	bimmelten
Hornung	Hornung
vertrauten	vertrauten
spaltetest	spaltetest
Lobe	Lobe
kickend	kickend
Brötchen	Brötchen
fluchet	fluchet
rächest	rächest
Garten	Garten
sterilisierten	sterilisierten
schließen	schließen
massakrierte	massakrierte
Antitranspirante	Antitranspirante
haschieret	haschieret
wohnest	wohnest
Nervenzellen	Nervenzellen
beschotterten	beschotterten
bestraft	bestraft
Werte	Werte
stand	stand
Organisationen	Organisationen
Jagdhund	Jagdhund
lochten	lochten
ernteten	ernteten
Grabe	Grabe
Halle	Halle
brillieret	brillieret
Böse	Böse
Blutgefäß	Blutgefäß
Panzerschrecke	Panzerschrecke
Ansteckern	Ansteckern
Pflaume	Pflaume
Cola	Cola
reinstitutionalisiert	reinstitutionalisiert
scheuchtest	scheuchtest
Argentits	Argentits
schauen	schauen
annektierten	annektierten
Tukans	Tukans
befestigt	befestigt
keiner	keiner
erfreu	erfreu
folgend	folgend
Wühltische	Wühltische
Nukleinsäure	Nukleinsäure
attestierten	attestierten
verpuffe	verpuffe
Proton	Proton
hänget	hänget
Pflichten	Pflichten
erstürmet	erstürmet
googelten	googelten
besuchen	besuchen
pflügen	pflügen
Shortcuts	Shortcuts
Berufe	Berufe
eines	eines
Eistaucher	Eistaucher
Abschiedsbriefe	Abschiedsbriefe
Kleinoden	Kleinoden
vertraget	vertraget
Halbzeit	Halbzeit
aufrichtet	aufrichtet
diente	diente
Gauner	Gauner
punkten	punkten
Auszüge	Auszüge
Solch	Solch
kletteret	kletteret
Abartigkeit	Abartigkeit
Alibi	Alibi
Nährmediums	Nährmediums
Gedanken	Gedanken
Wachteln	Wachteln
erstürmt	erstürmt
Adenosin	Adenosin
gewitterest	gewitterest
ermächtige	ermächtige
finanziere	finanziere
ach	ach
verführten	verführten
mögt	mögt
Fiebermittel	Fiebermittel
aufrichten	aufrichten
Malaysiers	Malaysiers
verschränken	verschränken
Wille	Wille
sannen	sannen
Schlepper	Schlepper
downloadet	downloadet
verbraucht	verbraucht
Dunkelkammern	Dunkelkammern
gare	gare
Metonymie	Metonymie
Heteroatome	Heteroatome
suchet	suchet
härtet	härtet
drosselt	drosselt
UND-Gattern	UND-Gattern
Bushaltestellen	Bushaltestellen
murmeln	murmeln
entfachet	entfachet
Fallt	Fallt
Raute	Raute
prahlte	prahlte
Reiterschwert	Reiterschwert
blitzte	blitzte
übrigbleibet	übrigbleibet
Lusitaners	Lusitaners
erwähnet	erwähnet
verunglimpfte	verunglimpfte
übet	übet
Überweisung	Überweisung
deckst	deckst
Paläste	Paläste
Preisen	Preisen
werdest	werdest
bekennet	bekennet
machst	machst
fluchten	fluchten
Pedant	Pedant
Gase	Gase
erliegst	erliegst
brechet	brechet
warntest	warntest
dürftet	dürftet
schlage	schlage
lispelten	lispelten
rechten	rechten
bereiteten	bereiteten
Mitwisserschaft	Mitwisserschaft
murmelst	murmelst
raffiniere	raffiniere
amenagierst	amenagierst
verunglimpfest	verunglimpfest
geräuchert	geräuchert
Keile	Keile
Schanktisch	Schanktisch
beäugen	beäugen
Penis	Penis
verladet	verladet
Geschäfte	Geschäfte
forschet	forschet
winkt	winkt
geniertest	geniertest
umarbeitest	umarbeitest
Ställe	Ställe
wisperest	wisperest
bequemtet	bequemtet
bemüht	bemüht
Unterschlagungen	Unterschlagungen
lüftetet	lüftetet
besprichst	besprichst
Anlässe	Anlässe
stiegen	stiegen
führte	führte
Schnipseln	Schnipseln
scherzt	scherzt
Bürzeln	Bürzeln
Schwestern	Schwestern
produzierest	produzierest
Bürzel	Bürzel
Blumenstrauß	Blumenstrauß
kaufte	kaufte
Fetzens	Fetzens
parliere	parliere
Adamsapfel	Adamsapfel
verkündiget	verkündiget
Gichten	Gichten
Weihen	Weihen
schaut	schaut
Haltepunkt	Haltepunkt
Höschen	Höschen
faul	faul
euren	euren
Zwergschwanes	Zwergschwanes
knautsche	knautsche
entkäme	entkäme
preise	preise
treffen	treffen
fällen	fällen
emigriert	emigriert
Spektralbereich	Spektralbereich
lavierend	lavierend
heparinisierten	heparinisierten
concessioniert	concessioniert
Schwänze	Schwänze
Nanotesla	Nanotesla
harrest	harrest
legt	legt
Sonnenfinsternissen	Sonnenfinsternissen
Bademantel	Bademantel
Einem	Einem
Libellen	Libellen
schmetterst	schmetterst
gleite	gleite
verdrängt	verdrängt
meuterest	meuterest
grübelt	grübelt
Kanzlei	Kanzlei
greinen	greinen
wegen	wegen
Besteck	Besteck
behütet	behütet
prahlet	prahlet
Girls	Girls
meinet	meinet
widmeten	widmeten
Muster	Muster
ermordetest	ermordetest
Kälber	Kälber
sprechet	sprechet
Zähne	Zähne
Bienen	Bienen
Abschiedsbrief	Abschiedsbrief
besorgest	besorgest
Anhängsel	Anhängsel
generalisiert	generalisiert
äussern	äussern
Malaysierinnen	Malaysierinnen
erstarrten	erstarrten
kennst	kennst
schichtet	schichtet
wähnet	wähnet
Stilllegung	Stilllegung
Somiten	Somiten
stoßet	stoßet
Pfleglingen	Pfleglingen
Fusselbärten	Fusselbärten
sedimentiert	sedimentiert
Empfängnisverhütungen	Empfängnisverhütungen
flambierest	flambierest
Kernladungszahlen	Kernladungszahlen
müssest	müssest
mikrominiaturisierten	mikrominiaturisierten
konsumieren	konsumieren
einem	einem
strömt	strömt
benähmen	benähmen
Türkinnen	Türkinnen
Borhydrid	Borhydrid
verdammend	verdammend
Rast	Rast
Vaginen	Vaginen
Dorngesträuchen	Dorngesträuchen
Eutektikum	Eutektikum
zeltest	zeltest
erklinge	erklinge
kurze	kurze
Optimisten	Optimisten
Kassettenrekorder	Kassettenrekorder
Trotzkisten	Trotzkisten
Sitzfleisch	Sitzfleisch
bejubelst	bejubelst
Physikerin	Physikerin
Zinkat	Zinkat
erwachte	erwachte
trefft	trefft
Flitzer	Flitzer
wiederholten	wiederholten
Betten	Betten
Prozedur	Prozedur
Efeu	Efeu
wart	wart
Pläsier	Pläsier
klumpt	klumpt
urbanisier	urbanisier
pflanzte	pflanzte
ermutigte	ermutigte
verkaufe	verkaufe
fokussieret	fokussieret
Eiszapfens	Eiszapfens
bewässertet	bewässertet
lanciertet	lanciertet
Kavalier	Kavalier
Fiesling	Fiesling
generiert	generiert
entfolgst	entfolgst
heilte	heilte
aktualisiere	aktualisiere
fällte	fällte
Altären	Altären
kennest	kennest
Verwaltungsakte	Verwaltungsakte
bitten	bitten
Amokläuferinnen	Amokläuferinnen
denaturiert	denaturiert
kapiert	kapiert
Rücktrittbremsen	Rücktrittbremsen
schnatternd	schnatternd
Alibis	Alibis
Steigen	Steigen
Herkünften	Herkünften
Plumpse	Plumpse
schmuggele	schmuggele
Narkotikum	Narkotikum
Ältesten	Ältesten
Linien	Linien
Erstlinge	Erstlinge
Pest	Pest
Massagen	Massagen
Kunstgeschichte	Kunstgeschichte
spukest	spukest
Freeganer	Freeganer
blamierest	blamierest
Scheißkerl	Scheißkerl
beäugst	beäugst
wallfahrten	wallfahrten
quietschest	quietschest
deines	deines
Schlagern	Schlagern
Tieren	Tieren
Gedanke	Gedanke
Physikerinnen	Physikerinnen
Hanse	Hanse
Gehilfe	Gehilfe
klumpe	klumpe
Milchflasche	Milchflasche
Korrosionsschutz	Korrosionsschutz
hieltest	hieltest
hydrolysierest	hydrolysierest
meinst	meinst
Säcke	Säcke
pflanzet	pflanzet
vertagest	vertagest
strafet	strafet
langte	langte
implodier	implodier
substituierend	substituierend
stürzen	stürzen
Paradiesäpfeln	Paradiesäpfeln
separieret	separieret
Reliquiare	Reliquiare
schiebest	schiebest
Ärschen	Ärschen
Monarchien	Monarchien
empört	empört
bücktest	bücktest
tagten	tagten
reiftet	reiftet
auflöste	auflöste
demütigte	demütigte
Blitzen	Blitzen
meine	meine
sagte	sagte
stationierten	stationierten
streckte	streckte
zerschlagt	zerschlagt
eine	eine
Zainen	Zainen
Maultier	Maultier
schwächst	schwächst
verzieh	verzieh
Haarverlusten	Haarverlusten
begräbt	begräbt
murmelte	murmelte
Gewichten	Gewichten
lodertet	lodertet
Musters	Musters
Spanne	Spanne
koche	koche
putzt	putzt
schäumtest	schäumtest
Überziehen	Überziehen
Linken	Linken
Chinakohl	Chinakohl
reden	reden
Trinkgefäße	Trinkgefäße
bewähret	bewähret
changiere	changiere
warten	warten
wechselwirkt	wechselwirkt
Pimmel	Pimmel
erwärmten	erwärmten
Testamente	Testamente
Tretlager	Tretlager
Abartigkeiten	Abartigkeiten
colorierend	colorierend
hasse	hasse
entwaffnest	entwaffnest
erkalten	erkalten
Hektaren	Hektaren
stäupte	stäupte
aßest	aßest
taufet	taufet
entschleiert	entschleiert
Weinstöcke	Weinstöcke
läutet	läutet
lohnten	lohnten
grünst	grünst
widerlegte	widerlegte
Taufe	Taufe
maßen	maßen
könnte	könnte
Fokus	Fokus
Abfertigungsgebäuden	Abfertigungsgebäuden
Pedanten	Pedanten
dotiere	dotiere
Tumulten	Tumulten
verdammten	verdammten
Speeren	Speeren
keulst	keulst
erstaunte	erstaunte
Generationen	Generationen
Kanzlerinnen	Kanzlerinnen
schämten	schämten
verwaisten	verwaisten
Diäresen	Diäresen
verurteilen	verurteilen
ehret	ehret
überweise	überweise
verprügelet	verprügelet
erliegen	erliegen
Ha	Ha
fügt	fügt
Subspezies	Subspezies
Fallet	Fallet
assimilieret	assimilieret
Prozeduren	Prozeduren
Fußmatten	Fußmatten
Zinkionen	Zinkionen
substituierten	substituierten
Polarisation	Polarisation
verbitterest	verbitterest
erstehst	erstehst
Bällchen	Bällchen
dümpelest	dümpelest
erpresst	erpresst
recycelten	recycelten
folgen	folgen
verkürzten	verkürzten
Buchhalterinnen	Buchhalterinnen
Unterwerfungen	Unterwerfungen
Augenglases	Augenglases
Bundesgebiet	Bundesgebiet
schautet	schautet
strafte	strafte
Notärztin	Notärztin
geknautscht	geknautscht
Besuch	Besuch
verkriechet	verkriechet
verschränkest	verschränkest
hatte	hatte
Coventrisierungen	Coventrisierungen
denaturierten	denaturierten
Gram	Gram
Aufpralle	Aufpralle
beseht	beseht
beunruhige	beunruhige
Trioxiden	Trioxiden
Lötzinn	Lötzinn
Selbstversuch	Selbstversuch
harmonierte	harmonierte
bandagierte	bandagierte
kurz	kurz
wünschet	wünschet
nächsten	nächsten
Hacker	Hacker
ballaste	ballaste
Protonen	Protonen
Wembley-Toren	Wembley-Toren
Kutter	Kutter
gebündelt	gebündelt
befürchtet	befürchtet
zürne	zürne
Zuschauer	Zuschauer
Rechtsruck	Rechtsruck
Sportlerinnen	Sportlerinnen
Heteroatom	Heteroatom
leihe	leihe
leistest	leistest
allen	allen
zerstreuten	zerstreuten
entwickele	entwickele
versteckend	versteckend
Gläubigern	Gläubigern
möget	möget
segelte	segelte
Emmer	Emmer
nähret	nähret
ahnten	ahnten
boykottierst	boykottierst
solle	solle
überreichst	überreichst
schneidend	schneidend
Plüschtiere	Plüschtiere
klappen	klappen
Ichs	Ichs
Klaue	Klaue
baue	baue
Rheumatismus	Rheumatismus
Altbau	Altbau
Stempeluhren	Stempeluhren
Argentit	Argentit
Lesen	Lesen
Volkslehre	Volkslehre
dechiffrierend	dechiffrierend
Abschreckungen	Abschreckungen
stehest	stehest
Zeithorizonten	Zeithorizonten
gehorchten	gehorchten
unterrichten	unterrichten
Katamarane	Katamarane
steigest	steigest
verwirrest	verwirrest
bringst	bringst
sollte	sollte
Donoren	Donoren
Fokusse	Fokusse
Sonderbericht	Sonderbericht
steigen	steigen
Leitkegel	Leitkegel
Klotz	Klotz
konsumiere	konsumiere
Waldbränden	Waldbränden
Aktivisten	Aktivisten
Rückumlauten	Rückumlauten
Fettsack	Fettsack
Ansteckers	Ansteckers
Psi	Psi
Kuckucke	Kuckucke
Adeliepinguins	Adeliepinguins
tagest	tagest
Höschens	Höschens
billigen	billigen
Dachdeckerinnen	Dachdeckerinnen
Lammfellhandschuhen	Lammfellhandschuhen
zuppt	zuppt
Theologie	Theologie
instanziiere	instanziiere
Farbstoffen	Farbstoffen
Meldezettel	Meldezettel
verstecke	verstecke
erfreute	erfreute
transportiere	transportiere
schrecken	schrecken
reichtest	reichtest
Gelobet	Gelobet
Epoxide	Epoxide
Reiseleiter	Reiseleiter
liebte	liebte
Rechnung	Rechnung
Rasterkraftmikroskop	Rasterkraftmikroskop
pflanzt	pflanzt
Organisation	Organisation
kitzele	kitzele
formulierst	formulierst
Friesen	Friesen
Fahret	Fahret
Sekretärinnen	Sekretärinnen
kremierten	kremierten
Quellfluss	Quellfluss
Leichtmetallen	Leichtmetallen
benehme	benehme
erstände	erstände
stellst	stellst
nahest	nahest
Wadenbein	Wadenbein
danke	danke
Ärgernisse	Ärgernisse
verbündeten	verbündeten
Frettchen	Frettchen
Aktenkoffer	Aktenkoffer
Vorhäuten	Vorhäuten
schälte	schälte
Anmeldern	Anmeldern
Reflexionen	Reflexionen
installierten	installierten
Dewargefäß	Dewargefäß
erkaltest	erkaltest
Vordenker	Vordenker
koordinierte	koordinierte
lausche	lausche
erbrüte	erbrüte
betrübend	betrübend
Ackerschachtelhalm	Ackerschachtelhalm
Gehorsams	Gehorsams
Hinkelsteine	Hinkelsteine
verstörten	verstörten
ladest	ladest
thematisierte	thematisierte
halltet	halltet
betrüge	betrüge
Gründungsprivileg	Gründungsprivileg
Beschleuniger	Beschleuniger
türmen	türmen
foppten	foppten
begrabe	begrabe
schmettern	schmettern
Scheck	Scheck
geleite	geleite
hörest	hörest
rekonstruieret	rekonstruieret
klönen	klönen
Zirkelschlüssen	Zirkelschlüssen
Arresten	Arresten
peilst	peilst
scheuchen	scheuchen
Panzerschreck	Panzerschreck
erkundigte	erkundigte
stirbt	stirbt
hydrogentartrat	hydrogentartrat
hingehet	hingehet
Streichen	Streichen
Linguist	Linguist
Ringen	Ringen
Flamingo	Flamingo
dürfen	dürfen
Vogelscheuche	Vogelscheuche
Fragen	Fragen
parfümierst	parfümierst
Oxalate	Oxalate
Firnis	Firnis
Asiatin	Asiatin
Cyanat	Cyanat
Sigle	Sigle
versucht	versucht
Kosten	Kosten
Leuchtstoff	Leuchtstoff
zeugst	zeugst
vernehmen	vernehmen
glaubtet	glaubtet
Alkalien	Alkalien
schummelten	schummelten
Treibhausgase	Treibhausgase
Bankettes	Bankettes
zeuget	zeuget
Remis	Remis
regierest	regierest
Freibergits	Freibergits
solche	solche
Aprikosen	Aprikosen
verstehest	verstehest
bröckeln	bröckeln
erwürgest	erwürgest
Ecke	Ecke
vergiftet	vergiftet
ausziehst	ausziehst
Testamenten	Testamenten
bewahret	bewahret
Unternehmensanwendungsintegrationen	Unternehmensanwendungsintegrationen
verdamm	verdamm
ringst	ringst
vernickele	vernickele
bilden	bilden
inhalierest	inhalierest
unserem	unserem
Möbiusbänder	Möbiusbänder
Träumers	Träumers
Heere	Heere
Stall	Stall
betrübet	betrübet
Azubi	Azubi
tyrannisiertest	tyrannisiertest
verseuchen	verseuchen
demütige	demütige
Rhabarbern	Rhabarbern
Schreibtischtäter	Schreibtischtäter
Pfleglinge	Pfleglinge
schreckt	schreckt
kategorisierte	kategorisierte
dienest	dienest
Gesetzen	Gesetzen
hinterfragten	hinterfragten
gelobten	gelobten
Kontaktierungen	Kontaktierungen
deklarierte	deklarierte
Erlösungen	Erlösungen
dümpelte	dümpelte
hurst	hurst
Würze	Würze
hebräische	hebräische
Propheten	Propheten
treibest	treibest
porträtiere	porträtiere
Kochfeldern	Kochfeldern
Dilettanten	Dilettanten
folterte	folterte
ruckeln	ruckeln
Verdachtes	Verdachtes
Fahlflanken-Ameisenwürger	Fahlflanken-Ameisenwürger
Europameistern	Europameistern
Leugnung	Leugnung
vergaset	vergaset
henken	henken
stapften	stapften
Carbid	Carbid
Kerf	Kerf
Willen	Willen
laufet	laufet
Fehlen	Fehlen
fallt	fallt
erstehen	erstehen
ein	ein
ältesten	ältesten
lügt	lügt
boßte	boßte
aufhebest	aufhebest
liehen	liehen
Wandergewerbe	Wandergewerbe
anzeige	anzeige
bromiert	bromiert
süsst	süsst
Fahrzeugkatalysator	Fahrzeugkatalysator
tragest	tragest
wehen	wehen
Steuerbord	Steuerbord
Schreibern	Schreibern
soll	soll
Kassiteriten	Kassiteriten
stifte	stifte
Rückumschlägen	Rückumschlägen
Leisten	Leisten
UND-Gatter	UND-Gatter
Glaubet	Glaubet
verdeckst	verdeckst
Beiblätter	Beiblätter
Beryll	Beryll
wallfahrteten	wallfahrteten
salzen	salzen
Sabbate	Sabbate
Toypudeln	Toypudeln
Ärzteblatt	Ärzteblatt
regierten	regierten
Maßen	Maßen
Oberlippe	Oberlippe
teilte	teilte
umarmet	umarmet
faschieret	faschieret
blondiert	blondiert
Pater	Pater
tätowierest	tätowierest
hintertreiben	hintertreiben
erliegest	erliegest
rekrutierest	rekrutierest
verdammet	verdammet
Massenarbeitslosigkeit	Massenarbeitslosigkeit
schießen	schießen
Dominicanerin	Dominicanerin
Aktivist	Aktivist
hegten	hegten
Atemluft	Atemluft
schleim	schleim
respektiert	respektiert
Abhängen	Abhängen
Geschwindigkeitsmesser	Geschwindigkeitsmesser
Schnute	Schnute
eingehst	eingehst
Leichenschauhäusern	Leichenschauhäusern
Iberers	Iberers
Kanzleien	Kanzleien
Reliquiar	Reliquiar
Blitze	Blitze
errötest	errötest
Bittersüß	Bittersüß
Elektrophil	Elektrophil
parametrisierst	parametrisierst
eggte	eggte
jaulst	jaulst
Mähnenwolfes	Mähnenwolfes
Strafraum	Strafraum
stickten	stickten
Minischwein	Minischwein
konvergiere	konvergiere
Hat	Hat
behauptete	behauptete
Fischzucht	Fischzucht
bewässerst	bewässerst
Attentäter	Attentäter
Laubbläser	Laubbläser
beläufst	beläufst
konvertieren	konvertieren
Nährmedien	Nährmedien
Gewürzen	Gewürzen
greife	greife
Nahrungsbestandteil	Nahrungsbestandteil
sagten	sagten
Metallothioneinen	Metallothioneinen
verantwortetest	verantwortetest
Hertz	Hertz
Gebeine	Gebeine
Ärgernissen	Ärgernissen
Tatsachenbeschöniger	Tatsachenbeschöniger
dissentierten	dissentierten
strömte	strömte
segmentiere	segmentiere
anruft	anruft
kriegen	kriegen
mikrominiaturisiere	mikrominiaturisiere
verzierten	verzierten
interpretiert	interpretiert
entsetzen	entsetzen
teile	teile
bandagiert	bandagiert
Düfte	Düfte
kasernierte	kasernierte
sterbt	sterbt
steige	steige
funktionierte	funktionierte
Substanzen	Substanzen
notlandet	notlandet
addierte	addierte
Acht	Acht
Kronsbeere	Kronsbeere
gründen	gründen
Arbeitsbereichen	Arbeitsbereichen
Quatsch	Quatsch
ackerst	ackerst
hetzte	hetzte
Langzeichen	Langzeichen
Maxima	Maxima
Schickse	Schickse
geboten	geboten
genieret	genieret
Tetraiodide	Tetraiodide
harrten	harrten
Ratsherren	Ratsherren
führet	führet
Metallquirle	Metallquirle
leiden	leiden
frevler	frevler
Nachruf	Nachruf
beherrschest	beherrschest
höhnest	höhnest
bauet	bauet
Effekt	Effekt
gravierst	gravierst
schämest	schämest
Seit	Seit
frikassierend	frikassierend
Fluorkohlenwasserstoff	Fluorkohlenwasserstoff
stürzest	stürzest
Toypudel	Toypudel
dehydrierten	dehydrierten
habest	habest
concessionieren	concessionieren
Nadelbäumen	Nadelbäumen
frottierten	frottierten
Honigbären	Honigbären
gedenkest	gedenkest
Vetter	Vetter
Fremdwörter	Fremdwörter
Vanadaten	Vanadaten
predigtest	predigtest
Ölfässern	Ölfässern
Baisers	Baisers
Füllfederhalter	Füllfederhalter
Atombombe	Atombombe
ausführt	ausführt
Magiern	Magiern
folgst	folgst
fresse	fresse
erkanntet	erkanntet
infiziertet	infiziertet
Zitronensäften	Zitronensäften
Trioxid	Trioxid
helfest	helfest
begäben	begäben
setztet	setztet
fritierst	fritierst
Greyerzern	Greyerzern
pipettierten	pipettierten
bescheißt	bescheißt
Abkürzungsverzeichnisse	Abkürzungsverzeichnisse
Weinstöcken	Weinstöcken
ruhe	ruhe
applizirte	applizirte
verberge	verberge
jauchzte	jauchzte
Beobachtungen	Beobachtungen
Oberlandesgericht	Oberlandesgericht
Trotzkist	Trotzkist
verleumdetest	verleumdetest
fetten	fetten
Krustentier	Krustentier
verführest	verführest
entsündigten	entsündigten
restaurierten	restaurierten
Wegen	Wegen
gewähret	gewähret
beichteten	beichteten
deute	deute
gewähr	gewähr
elften	elften
überstehend	überstehend
Reinstoff	Reinstoff
Schlot	Schlot
Gigapascaln	Gigapascaln
sichere	sichere
eurer	eurer
Butzemänner	Butzemänner
Plumpsen	Plumpsen
Gasflasche	Gasflasche
decket	decket
kriegte	kriegte
ihres	ihres
bedeckt	bedeckt
Türklingel	Türklingel
Bete	Bete
Schenken	Schenken
gähnten	gähnten
Berge	Berge
erkältete	erkältete
Dezernaten	Dezernaten
dampfte	dampfte
aufrichte	aufrichte
Malaysierin	Malaysierin
knüpfet	knüpfet
Montagmittagen	Montagmittagen
ritzten	ritzten
gewöhnte	gewöhnte
schicke	schicke
leiste	leiste
weisen	weisen
driftete	driftete
sprachen	sprachen
Essigsäurechloriden	Essigsäurechloriden
verdeckte	verdeckte
Ausbeutern	Ausbeutern
Weh	Weh
Gnaden	Gnaden
faschierst	faschierst
ermahnet	ermahnet
formiret	formiret
Fußmatte	Fußmatte
erwärmte	erwärmte
Traubenlese	Traubenlese
zeugte	zeugte
linstest	linstest
parfümierte	parfümierte
Zeile	Zeile
Zeilen	Zeilen
Banknoten	Banknoten
vier	vier
erwischten	erwischten
Warte	Warte
flirtest	flirtest
rebelliere	rebelliere
keinen	keinen
Päderast	Päderast
drillest	drillest
Ahnen	Ahnen
destabilisierte	destabilisierte
Rooibos	Rooibos
klicket	klicket
Bauwerke	Bauwerke
spracht	spracht
Ende	Ende
Bildschirmfoto	Bildschirmfoto
Otaviten	Otaviten
Bilderstürmer	Bilderstürmer
Sprüchen	Sprüchen
Dienstgrade	Dienstgrade
egalisierten	egalisierten
vergliche	vergliche
Pi	Pi
schenken	schenken
erfüllst	erfüllst
dürfte	dürfte
glaubten	glaubten
loben	loben
zirpen	zirpen
duzet	duzet
redetest	redetest
Paragraphenreiter	Paragraphenreiter
fluktuiert	fluktuiert
blitzen	blitzen
klemmt	klemmt
nahe	nahe
Weichloten	Weichloten
bedient	bedient
Oxonium	Oxonium
respektiere	respektiere
Thioacetalen	Thioacetalen
Mauten	Mauten
kämmtet	kämmtet
Tausch	Tausch
Hüftgelenken	Hüftgelenken
predigend	predigend
Wehe	Wehe
plumpse	plumpse
Aprikose	Aprikose
überreichend	überreichend
laden	laden
gewinnet	gewinnet
machest	machest
gewurstelt	gewurstelt
Membranen	Membranen
Reisebüro	Reisebüro
kein	kein
bummeltet	bummeltet
besetzest	besetzest
laben	laben
Gäste	Gäste
überbewertet	überbewertet
verwechselst	verwechselst
Verbindungsdraht	Verbindungsdraht
halbierest	halbierest
fehlet	fehlet
Managementsystem	Managementsystem
protokollierst	protokollierst
Feinde	Feinde
Rechenbrettern	Rechenbrettern
Schauen	Schauen
Irrtümern	Irrtümern
beweisest	beweisest
trüge	trüge
Empörungen	Empörungen
Abhänge	Abhänge
Keilen	Keilen
versklavt	versklavt
ertönst	ertönst
posierst	posierst
kramen	kramen
Strahlentierchen	Strahlentierchen
globalisier	globalisier
referenzierte	referenzierte
knurrt	knurrt
Breiten	Breiten
puste	puste
kappet	kappet
Werke	Werke
zürnet	zürnet
lochtest	lochtest
Thioestere	Thioestere
vermeßest	vermeßest
verunziere	verunziere
Martyrologien	Martyrologien
taufte	taufte
liebe	liebe
touchiere	touchiere
Füllfederhalters	Füllfederhalters
Reiterschwertern	Reiterschwertern
mehret	mehret
beschlügen	beschlügen
leistete	leistete
Excimerlaser	Excimerlaser
kommest	kommest
Zeitplanes	Zeitplanes
Konfitüren	Konfitüren
chloroformieret	chloroformieret
grabble	grabble
redete	redete
Isolatoren	Isolatoren
Kohlrübe	Kohlrübe
Mäppchen	Mäppchen
verzweigst	verzweigst
Kardinal	Kardinal
Döner	Döner
Marjellchen	Marjellchen
Blicksilber	Blicksilber
Name	Name
Mageninhalt	Mageninhalt
bildest	bildest
strafen	strafen
Feldzug	Feldzug
gehörst	gehörst
tatet	tatet
Schönrednern	Schönrednern
schmusen	schmusen
Komponistinnen	Komponistinnen
weinest	weinest
rufet	rufet
arrivierst	arrivierst
erzeigten	erzeigten
Generatoren	Generatoren
schlängelt	schlängelt
unserer	unserer
begebet	begebet
Darlegung	Darlegung
bröckelten	bröckelten
steinigst	steinigst
schwebe	schwebe
Markise	Markise
Atomphysiker	Atomphysiker
Monarchie	Monarchie
bis	bis
Asteroid	Asteroid
Überfamilie	Überfamilie
reizen	reizen
enträtselst	enträtselst
durchzuckest	durchzuckest
verkaufst	verkaufst
Waren	Waren
charakterisiert	charakterisiert
schleiß	schleiß
Notstand	Notstand
Kleptokratie	Kleptokratie
Indern	Indern
Reiseleitern	Reiseleitern
vollendete	vollendete
Ring	Ring
plazierest	plazierest
sortiert	sortiert
verwahrt	verwahrt
malträtiere	malträtiere
Samarskite	Samarskite
Meinst	Meinst
säst	säst
Male	Male
duschte	duschte
rühmet	rühmet
Sprichwörtern	Sprichwörtern
erweckst	erweckst
verunreinigst	verunreinigst
legte	legte
initiierst	initiierst
Marokkaners	Marokkaners
gewünscht	gewünscht
idealisieret	idealisieret
Klappertopf	Klappertopf
Nehmt	Nehmt
Qualifikationen	Qualifikationen
bezichtigt	bezichtigt
enttäuschet	enttäuschet
moppet	moppet
Perlen	Perlen
bewahrst	bewahrst
Ausnahme	Ausnahme
entheilige	entheilige
pflanzen	pflanzen
vereinbarten	vereinbarten
spukte	spukte
Hypochlorite	Hypochlorite
zerbräche	zerbräche
haschiert	haschiert
Milchflaschen	Milchflaschen
beweise	beweise
Blütenachse	Blütenachse
fahrest	fahrest
punktetest	punktetest
Tische	Tische
Automatikgetrieben	Automatikgetrieben
erbte	erbte
keinem	keinem
gewärtigten	gewärtigten
jagst	jagst
vergrubt	vergrubt
verkleinerest	verkleinerest
eggten	eggten
Führe	Führe
kürze	kürze
Mäusen	Mäusen
Einöden	Einöden
bräunst	bräunst
Pflanzenstoff	Pflanzenstoff
Genies	Genies
glaubt	glaubt
Jungen	Jungen
Linie	Linie
schaffest	schaffest
Heiden	Heiden
Wiederbelebung	Wiederbelebung
erbauet	erbauet
wollt	wollt
Höhle	Höhle
Zementen	Zementen
kehren	kehren
Abnahme	Abnahme
Bund	Bund
hattest	hattest
meinem	meinem
beeinflusste	beeinflusste
Ausgangssperren	Ausgangssperren
stiege	stiege
schauest	schauest
Zement	Zement
Anführern	Anführern
Scherzes	Scherzes
verantwortet	verantwortet
tappten	tappten
interpretierten	interpretierten
kristallisiertest	kristallisiertest
Massenanteilen	Massenanteilen
Filzläusen	Filzläusen
dressierten	dressierten
Amen	Amen
lackiere	lackiere
protestieret	protestieret
knitterte	knitterte
Grieße	Grieße
entmineralisierst	entmineralisierst
dringest	dringest
erlaubest	erlaubest
Stadtbezirke	Stadtbezirke
verbündet	verbündet
seines	seines
Hurriter	Hurriter
treibst	treibst
lispelt	lispelt
Fingerhüte	Fingerhüte
Schwermetallionen	Schwermetallionen
quietsche	quietsche
infizieret	infizieret
reichet	reichet
wechselwirkte	wechselwirkte
Höhlen	Höhlen
Durchbruches	Durchbruches
alarmiere	alarmiere
Kaufhäusern	Kaufhäusern
Hörspiel	Hörspiel
watete	watete
tasteten	tasteten
Kirgisinnen	Kirgisinnen
Atomphysikern	Atomphysikern
Rhodochrosite	Rhodochrosite
schmeicheln	schmeicheln
still	still
reiche	reiche
Backenbärten	Backenbärten
zweifel	zweifel
Erdbirnen	Erdbirnen
Wachen	Wachen
Honigbär	Honigbär
blitztet	blitztet
Welteninsel	Welteninsel
stürze	stürze
vermutet	vermutet
fertigte	fertigte
Gedächtnisse	Gedächtnisse
Gehirnwelle	Gehirnwelle
besänftigtest	besänftigtest
brauche	brauche
jappen	jappen
Baiser	Baiser
addierest	addierest
recycele	recycele
nagelte	nagelte
fehlen	fehlen
vertrage	vertrage
Stimmen	Stimmen
erfahret	erfahret
Sachen	Sachen
predigen	predigen
verkleidete	verkleidete
klappst	klappst
lögen	lögen
pressiert	pressiert
flitzte	flitzte
stillest	stillest
gehöre	gehöre
ersparte	ersparte
Bromidquelle	Bromidquelle
Bushaltestelle	Bushaltestelle
Streich	Streich
hydrolysierend	hydrolysierend
Enden	Enden
merken	merken
Schätze	Schätze
wünschen	wünschen
berücksichtigt	berücksichtigt
reinige	reinige
Abfertigungsschalters	Abfertigungsschalters
hingeht	hingeht
Buchfink	Buchfink
Badezimmer	Badezimmer
analysiere	analysiere
Drohkulissen	Drohkulissen
zerrisset	zerrisset
fladerst	fladerst
Erbse	Erbse
Füllen	Füllen
beleuchteten	beleuchteten
Hainbuche	Hainbuche
wach	wach
verschafft	verschafft
heilet	heilet
Spirale	Spirale
fluppe	fluppe
regelten	regelten
Sitzfleisches	Sitzfleisches
Möbiusbändern	Möbiusbändern
bescherten	bescherten
verringert	verringert
könnest	könnest
alarmieren	alarmieren
überschattete	überschattete
Rhodochrositen	Rhodochrositen
sagtest	sagtest
Schwester	Schwester
grüßend	grüßend
Zain	Zain
gelost	gelost
lockerst	lockerst
replizierten	replizierten
vertäte	vertäte
linken	linken
reformieren	reformieren
besuche	besuche
speisend	speisend
Stierkämpfe	Stierkämpfe
schaffte	schaffte
Beteiligten	Beteiligten
könnt	könnt
Brettspielen	Brettspielen
Kehret	Kehret
gereicht	gereicht
beauftragt	beauftragt
lockerte	lockerte
backt	backt
empörte	empörte
gewarnt	gewarnt
sticke	sticke
denn	denn
Äthern	Äthern
Stadtbezirken	Stadtbezirken
werden	werden
Reinstoffen	Reinstoffen
ortete	ortete
puddelst	puddelst
Massage	Massage
stäupten	stäupten
Kernspaltungen	Kernspaltungen
Asthenosphäre	Asthenosphäre
lauf	lauf
Gründungsprivilegien	Gründungsprivilegien
Schwächungen	Schwächungen
naschst	naschst
freiwillige	freiwillige
dankte	dankte
Buchstabe	Buchstabe
bombardiertet	bombardiertet
koexistierten	koexistierten
Kontraindikationen	Kontraindikationen
Haltepunkten	Haltepunkten
tagen	tagen
nähet	nähet
Automatikgetriebe	Automatikgetriebe
höbest	höbest
Meines	Meines
Gitarrenspieler	Gitarrenspieler
Sternen	Sternen
Wände	Wände
stehet	stehet
Rehbock	Rehbock
pilgert	pilgert
Androiden	Androiden
Elf	Elf
überfällst	überfällst
Hallen	Hallen
glaubend	glaubend
Rechten	Rechten
wallfahrest	wallfahrest
Kommet	Kommet
ärgerte	ärgerte
ungefälschter	ungefälschter
Deckenzapfen	Deckenzapfen
Gerücht	Gerücht
Namen	Namen
verklagt	verklagt
läutetet	läutetet
Schlager	Schlager
scheuchten	scheuchten
Begrenzung	Begrenzung
überweisend	überweisend
Klappertöpfen	Klappertöpfen
Sichelzellenanämien	Sichelzellenanämien
lügst	lügst
Kraftfahrzeuges	Kraftfahrzeuges
Buch	Buch
entwischten	entwischten
hinterzögen	hinterzögen
Schade	Schade
verlöteten	verlöteten
Bombardierungen	Bombardierungen
analysierest	analysierest
Zeitbomben	Zeitbomben
kramst	kramst
Karer	Karer
verdamme	verdamme
schlafe	schlafe
Kerzenfischen	Kerzenfischen
reichtet	reichtet
Sippe	Sippe
Schuhen	Schuhen
Anrufbeantworter	Anrufbeantworter
trügen	trügen
schnitt	schnitt
fragst	fragst
verbitterte	verbitterte
grauten	grauten
bebten	bebten
wünschte	wünschte
Chlorat	Chlorat
mogelest	mogelest
gewärtigt	gewärtigt
Stärke	Stärke
Gläubiger	Gläubiger
bewieset	bewieset
unschuldigen	unschuldigen
heben	heben
Konifere	Konifere
desensibilisierte	desensibilisierte
ermordet	ermordet
wärme	wärme
überweiset	überweiset
Kornnattern	Kornnattern
ermutigt	ermutigt
Sprödmetall	Sprödmetall
Nukleinsäuren	Nukleinsäuren
kugelten	kugelten
Metallspiegel	Metallspiegel
begehrt	begehrt
Telefonnummern	Telefonnummern
Rauten	Rauten
Stufe	Stufe
dunkelt	dunkelt
Kontrollkästchen	Kontrollkästchen
lackieren	lackieren
trotzest	trotzest
begehre	begehre
nähre	nähre
heulte	heulte
Zehnt	Zehnt
transportierten	transportierten
schnüren	schnüren
weichen	weichen
klaget	klaget
Bevölkerungsdichte	Bevölkerungsdichte
musizierte	musizierte
bestellten	bestellten
schenket	schenket
umarbeiten	umarbeiten
Alteritäten	Alteritäten
endlagerten	endlagerten
regierst	regierst
filzen	filzen
Safran	Safran
Heiratsgut	Heiratsgut
verwertete	verwertete
Halbzeiten	Halbzeiten
umhüll	umhüll
Sitz	Sitz
Heiratsgütern	Heiratsgütern
Muhme	Muhme
kehrte	kehrte
Bausch	Bausch
verbüßest	verbüßest
zeugtest	zeugtest
Hornunges	Hornunges
Schuhe	Schuhe
Chlorid	Chlorid
kostet	kostet
Lüste	Lüste
Prophet	Prophet
kaufest	kaufest
Bären	Bären
besprenget	besprenget
übte	übte
Diamantringen	Diamantringen
Fluoratome	Fluoratome
ehrst	ehrst
Cyclodextrinen	Cyclodextrinen
erwachet	erwachet
befestigte	befestigte
verwirfst	verwirfst
Kohlenstoffgehalten	Kohlenstoffgehalten
Kalifeldspat	Kalifeldspat
Aromastoffen	Aromastoffen
lang	lang
betrübte	betrübte
Zeitungsente	Zeitungsente
prangte	prangte
gestikulierst	gestikulierst
finanzieret	finanzieret
erstarre	erstarre
zuppe	zuppe
Halogenatom	Halogenatom
Preisanstieg	Preisanstieg
Fett	Fett
Bienenstöcke	Bienenstöcke
Seil	Seil
Wache	Wache
Dachdecker	Dachdecker
Dithiolane	Dithiolane
pulsiere	pulsiere
versuchen	versuchen
sucht	sucht
fokussierten	fokussierten
verkapselten	verkapselten
raubet	raubet
sedimentieret	sedimentieret
bekennst	bekennst
stützen	stützen
Für	Für
verbarg	verbarg
Wüsten	Wüsten
Adler	Adler
Beten	Beten
pflegst	pflegst
klettert	klettert
begrabt	begrabt
schlag	schlag
sagen	sagen
vermeße	vermeße
Grießen	Grießen
Schaffet	Schaffet
Bärenfelle	Bärenfelle
Charakteristikan	Charakteristikan
rännen	rännen
Pfründe	Pfründe
haltet	haltet
solcher	solcher
verkaufte	verkaufte
Kairiner	Kairiner
harmoniere	harmoniere
tobend	tobend
wachte	wachte
konsolidierend	konsolidierend
machte	machte
erzürnt	erzürnt
Sphäre	Sphäre
schauspieleren	schauspieleren
batest	batest
Dürren	Dürren
separieren	separieren
verbaseln	verbaseln
Bunde	Bunde
weich	weich
Agoraphobien	Agoraphobien
Menschenhandel	Menschenhandel
Briefe	Briefe
Tatsachenbeschönigern	Tatsachenbeschönigern
abweichest	abweichest
belüftet	belüftet
Hardwareentwicklerin	Hardwareentwicklerin
plaziert	plaziert
knackt	knackt
misstrauet	misstrauet
knutschst	knutschst
überwiese	überwiese
Kakao	Kakao
Primärenergie	Primärenergie
verstecken	verstecken
Schote	Schote
verkapselt	verkapselt
dringen	dringen
zerrütteten	zerrütteten
Angaben	Angaben
Finanzministerien	Finanzministerien
Augengläsern	Augengläsern
Ausstiegstüren	Ausstiegstüren
speiest	speiest
hievst	hievst
colorierten	colorierten
grünet	grünet
Ebene	Ebene
lostet	lostet
Küchenmaschine	Küchenmaschine
begruben	begruben
Kurkuma	Kurkuma
bleibet	bleibet
spekulieren	spekulieren
dümpelst	dümpelst
Tut	Tut
Greyerzer	Greyerzer
klemmen	klemmen
verblute	verblute
herrschen	herrschen
sinterte	sinterte
Schneepflügen	Schneepflügen
wohnte	wohnte
Katalanen	Katalanen
stützet	stützet
auflegte	auflegte
begehrest	begehrest
schäumt	schäumt
Bazzit	Bazzit
Nanoteslan	Nanoteslan
Begrenzungen	Begrenzungen
bequemte	bequemte
Berber	Berber
rinnt	rinnt
Arme	Arme
amen	amen
Bluff	Bluff
verstehet	verstehet
fällt	fällt
umgaben	umgaben
Fette	Fette
Recht	Recht
beide	beide
fotzt	fotzt
Zeitungsenten	Zeitungsenten
Stilllegungen	Stilllegungen
revoltierte	revoltierte
steckte	steckte
stärke	stärke
blase	blase
Achsel	Achsel
Verbrechen	Verbrechen
planschest	planschest
Aussätzigen	Aussätzigen
Bajonetten	Bajonetten
ziehst	ziehst
Tust	Tust
Hochsommern	Hochsommern
Geschreis	Geschreis
erlabe	erlabe
zeugt	zeugt
Hackern	Hackern
Gemüseläden	Gemüseläden
sicherst	sicherst
missverstände	missverstände
erhöhest	erhöhest
halle	halle
Hochhäusern	Hochhäusern
besitzet	besitzet
Sinne	Sinne
Landstreichereien	Landstreichereien
trompetete	trompetete
zerstreuest	zerstreuest
knusperten	knusperten
seufzest	seufzest
versagen	versagen
Radfahrer	Radfahrer
schätzte	schätzte
begebe	begebe
beantrage	beantrage
simuliertet	simuliertet
überbewerte	überbewerte
spannt	spannt
kickst	kickst
mobilisieret	mobilisieret
Kalb	Kalb
jeden	jeden
sprecht	sprecht
wirfst	wirfst
überprüftest	überprüftest
Ausbeuterei	Ausbeuterei
täuschte	täuschte
entwaffneten	entwaffneten
vibriere	vibriere
Deuterium	Deuterium
beleuchte	beleuchte
ziehet	ziehet
zwänget	zwänget
Anzeichens	Anzeichens
Brechnuss	Brechnuss
Aller	Aller
zerstreuet	zerstreuet
Radfahrern	Radfahrern
Unserer	Unserer
erhebest	erhebest
Gebeinen	Gebeinen
Mischelementen	Mischelementen
babbelten	babbelten
Akkadierinnen	Akkadierinnen
ärgernd	ärgernd
beneidest	beneidest
zählte	zählte
Däumlings	Däumlings
brillieren	brillieren
Rückumlaute	Rückumlaute
Laubbläsern	Laubbläsern
verwerten	verwerten
Aggressoren	Aggressoren
verreisest	verreisest
Campingplätzen	Campingplätzen
glühten	glühten
grünt	grünt
verwahret	verwahret
Generation	Generation
Einstufung	Einstufung
Neuigkeit	Neuigkeit
Hinterwäldlern	Hinterwäldlern
Weinberge	Weinberge
Rundbriefe	Rundbriefe
Schlüchte	Schlüchte
Öfchens	Öfchens
streutet	streutet
überprüfte	überprüfte
tabuisierten	tabuisierten
vereinigt	vereinigt
überdenkest	überdenkest
tat	tat
stigmatisierest	stigmatisierest
instrumentalisierest	instrumentalisierest
Kupferkiese	Kupferkiese
Katamaranen	Katamaranen
Rotscheitelreiher	Rotscheitelreiher
ärgere	ärgere
beansprucht	beansprucht
ausgeht	ausgeht
Traubenlesen	Traubenlesen
Seetaucher	Seetaucher
Pianos	Pianos
Schuldner	Schuldner
mühe	mühe
haltest	haltest
Messies	Messies
Lebenskraft	Lebenskraft
Mönchen	Mönchen
trägst	trägst
Grizzlybären	Grizzlybären
reich	reich
verwirkliche	verwirkliche
schlabberten	schlabberten
Hast	Hast
Abfertigungsschalter	Abfertigungsschalter
Buchhalterin	Buchhalterin
Herkunft	Herkunft
Seetauchers	Seetauchers
Grönländer	Grönländer
Bilderstürmers	Bilderstürmers
ehren	ehren
grause	grause
Entsetzen	Entsetzen
gelegt	gelegt
Schauet	Schauet
Teufel	Teufel
setzt	setzt
Hektare	Hektare
Felsboden	Felsboden
kämpfte	kämpfte
Bagger	Bagger
wässerten	wässerten
Asteroide	Asteroide
bekehrt	bekehrt
gepuddelt	gepuddelt
kugele	kugele
baggerte	baggerte
Europium	Europium
warst	warst
schubse	schubse
fistet	fistet
zupfte	zupfte
betreten	betreten
predige	predige
arbeiten	arbeiten
saget	saget
destabilisierst	destabilisierst
fragmentiert	fragmentiert
befehlt	befehlt
Leiste	Leiste
Apotheose	Apotheose
Kaliumdichromat	Kaliumdichromat
schließt	schließt
schaffst	schaffst
bedurftest	bedurftest
trompete	trompete
Extrems	Extrems
attestiertet	attestiertet
holte	holte
bezahlt	bezahlt
übrigbleiben	übrigbleiben
könnet	könnet
Neuigkeiten	Neuigkeiten
Meter	Meter
privatisierest	privatisierest
partitionierten	partitionierten
berücksichtiget	berücksichtiget
Weste	Weste
übersiehst	übersiehst
beißet	beißet
Malen	Malen
streite	streite
Fluorkohlenwasserstoffe	Fluorkohlenwasserstoffe
gehetzt	gehetzt
schaue	schaue
Briefen	Briefen
pflügten	pflügten
Schleppern	Schleppern
träumte	träumte
anzeigest	anzeigest
verfinstert	verfinstert
moppte	moppte
Abbildern	Abbildern
Kreisen	Kreisen
gebäret	gebäret
verseucht	verseucht
Myriade	Myriade
Elementen	Elementen
Schnallen	Schnallen
umkäme	umkäme
Würfelspiele	Würfelspiele
erwürgtest	erwürgtest
Finanzministern	Finanzministern
erwürgten	erwürgten
breche	breche
imprägniere	imprägniere
bauten	bauten
Grabbeltischen	Grabbeltischen
verbleibet	verbleibet
gebt	gebt
observiertest	observiertest
Dudelsäcken	Dudelsäcken
zerrüttete	zerrüttete
Sonderberichte	Sonderberichte
Büchereien	Büchereien
den	den
Anwendungsgebiet	Anwendungsgebiet
weise	weise
Bazziten	Bazziten
Blässe	Blässe
Glatteis	Glatteis
Fischotters	Fischotters
tunet	tunet
markiere	markiere
scheiterest	scheiterest
Suche	Suche
nahte	nahte
Fellhandschuhen	Fellhandschuhen
desertierst	desertierst
überwachten	überwachten
Gehirnwellen	Gehirnwellen
Einzelgänger	Einzelgänger
Thioester	Thioester
Taschenwörterbuches	Taschenwörterbuches
Abarten	Abarten
interagiert	interagiert
urbanisiert	urbanisiert
Auguren	Auguren
Einsätzen	Einsätzen
posiert	posiert
beantragt	beantragt
Letzte	Letzte
reglementierte	reglementierte
defragmentierest	defragmentierest
gespeist	gespeist
Ärztin	Ärztin
polymerisier	polymerisier
Neumonde	Neumonde
tränkten	tränkten
bitte	bitte
fluppt	fluppt
Pis	Pis
verewigt	verewigt
War	War
umhüllst	umhüllst
verkürzte	verkürzte
Präservativen	Präservativen
quasselten	quasselten
verdrängen	verdrängen
verfange	verfange
analysiert	analysiert
unterwirft	unterwirft
Handbuch	Handbuch
Orgeln	Orgeln
verschaffte	verschaffte
vertrieben	vertrieben
Türkenbund	Türkenbund
Anwendungsgebiete	Anwendungsgebiete
Gallan	Gallan
heißt	heißt
Klotzes	Klotzes
beliefen	beliefen
betrübten	betrübten
zieren	zieren
überstehst	überstehst
Naturen	Naturen
Einer	Einer
Kerzenlichtern	Kerzenlichtern
bummelet	bummelet
Hubschraubern	Hubschraubern
Tübingern	Tübingern
Zunge	Zunge
rangieret	rangieret
predigt	predigt
befördert	befördert
appellierst	appellierst
unterdrückte	unterdrückte
verpufftest	verpufftest
bombardiert	bombardiert
verschont	verschont
wärst	wärst
Stimme	Stimme
beweist	beweist
jaget	jaget
bewiesen	bewiesen
mißversteht	mißversteht
fasse	fasse
lehren	lehren
rodete	rodete
Kleinodien	Kleinodien
verunzierte	verunzierte
produziert	produziert
teil	teil
Eissteinen	Eissteinen
glaubte	glaubte
inszenierst	inszenierst
Pfahl	Pfahl
Temperaturanstieg	Temperaturanstieg
sabbelt	sabbelt
Großstädter	Großstädter
haarten	haarten
Mobilfunknetze	Mobilfunknetze
Mittelaltermarkt	Mittelaltermarkt
dringst	dringst
Königen	Königen
Ionenaustauscher	Ionenaustauscher
Buche	Buche
ersten	ersten
Gebäcken	Gebäcken
hintertrieben	hintertrieben
fluktuierte	fluktuierte
Apfelbäumen	Apfelbäumen
Suffix	Suffix
übersehest	übersehest
rodet	rodet
Wimpertierchen	Wimpertierchen
knutschest	knutschest
fladern	fladern
Notärztinnen	Notärztinnen
ankern	ankern
hüten	hüten
betonierte	betonierte
Leuchtkäfer	Leuchtkäfer
Zankapfels	Zankapfels
referenzierst	referenzierst
reichte	reichte
Geldautomat	Geldautomat
sinke	sinke
Wehre	Wehre
verbündete	verbündete
Knüppels	Knüppels
Aphasien	Aphasien
protestierest	protestierest
dringt	dringt
verfliegest	verfliegest
Vorstädte	Vorstädte
wachsen	wachsen
Flamme	Flamme
geliebt	geliebt
Haue	Haue
wünschest	wünschest
Reißnagel	Reißnagel
beförderet	beförderet
kristallisierest	kristallisierest
Barschaften	Barschaften
Landesverräterinnen	Landesverräterinnen
endlagern	endlagern
Übertretung	Übertretung
feiert	feiert
erfüllet	erfüllet
verbärgen	verbärgen
all	all
Erstarren	Erstarren
grüßt	grüßt
interagierte	interagierte
arme	arme
nütze	nütze
diversifiziert	diversifiziert
bezahlst	bezahlst
Außenministerium	Außenministerium
fassest	fassest
Biene	Biene
gedenkst	gedenkst
Rotgüssen	Rotgüssen
verseifet	verseifet
kräusle	kräusle
reichen	reichen
Rekursion	Rekursion
fertig	fertig
Mönche	Mönche
Biokraftstoff	Biokraftstoff
Apportierhund	Apportierhund
Dreieinigkeit	Dreieinigkeit
flehte	flehte
brandet	brandet
Gebete	Gebete
filzten	filzten
freuet	freuet
Hypochlorit	Hypochlorit
Rücktritt	Rücktritt
bemächtigte	bemächtigte
defragmentierten	defragmentierten
blitz	blitz
gestatte	gestatte
faltest	faltest
mopst	mopst
äusserst	äusserst
Päckchens	Päckchens
suchst	suchst
verdammtet	verdammtet
reinstitutionalisierten	reinstitutionalisierten
Gammastrahlen	Gammastrahlen
Brechnüssen	Brechnüssen
reicht	reicht
setzten	setzten
lavierte	lavierte
Grufti	Grufti
überreichen	überreichen
Antimustern	Antimustern
schluchzte	schluchzte
Huflattich	Huflattich
Lebenskräften	Lebenskräften
löst	löst
verstrahlten	verstrahlten
webet	webet
verbündest	verbündest
Geldautomaten	Geldautomaten
Abfahrtsliste	Abfahrtsliste
macht	macht
Zerfällen	Zerfällen
schmuggelest	schmuggelest
Inder	Inder
Einöde	Einöde
lancierst	lancierst
regieret	regieret
entmineralisierten	entmineralisierten
Darlehen	Darlehen
Abfahrtslisten	Abfahrtslisten
darfst	darfst
verhörest	verhörest
explodierten	explodierten
reifte	reifte
Ambiguität	Ambiguität
zerfetzt	zerfetzt
Erdkruste	Erdkruste
zürntest	zürntest
Reisebüros	Reisebüros
karikierten	karikierten
aufheben	aufheben
zierte	zierte
bracht	bracht
besitze	besitze
Pfählen	Pfählen
Primärenergien	Primärenergien
Gaschromatographien	Gaschromatographien
füllst	füllst
verdreht	verdreht
finanzierest	finanzierest
regiert	regiert
narren	narren
Urheimaten	Urheimaten
schmierte	schmierte
Boten	Boten
Leuchtkäfern	Leuchtkäfern
wollte	wollte
Wirtschaftswissenschaft	Wirtschaftswissenschaft
beschlaget	beschlaget
Eselsohren	Eselsohren
vernichtest	vernichtest
glawbten	glawbten
schnattert	schnattert
wehrt	wehrt
lachen	lachen
strafst	strafst
balkanisierte	balkanisierte
grausten	grausten
zersetzet	zersetzet
weichst	weichst
Palme	Palme
schwadronierten	schwadronierten
Habe	Habe
Scherzen	Scherzen
Gegebenheiten	Gegebenheiten
Märtyrern	Märtyrern
folgtet	folgtet
zertifiziertest	zertifiziertest
gratuliert	gratuliert
Kacke	Kacke
Rutheniumisotopen	Rutheniumisotopen
ausrufest	ausrufest
reifen	reifen
bräunen	bräunen
enträtselten	enträtselten
zerfielest	zerfielest
zentrifugierst	zentrifugierst
wiederkamen	wiederkamen
Provinz	Provinz
liebt	liebt
stoßt	stoßt
Kompass	Kompass
wälzet	wälzet
bemühst	bemühst
befestigten	befestigten
Wechselstuben	Wechselstuben
rüste	rüste
Uteri	Uteri
Laufring	Laufring
Trägergas	Trägergas
schöpfest	schöpfest
Bedeutung	Bedeutung
massakrierten	massakrierten
Deutung	Deutung
Dorngesträuch	Dorngesträuch
Otavit	Otavit
bequemest	bequemest
zerbrechest	zerbrechest
verunglimpftet	verunglimpftet
rundest	rundest
anzeigt	anzeigt
Euphemismen	Euphemismen
Tausche	Tausche
moppst	moppst
näht	näht
Zur-Schau-Stellen	Zur-Schau-Stellen
Orgel	Orgel
Campingplatzes	Campingplatzes
zerbrechen	zerbrechen
frikassiert	frikassiert
sehn	sehn
verhungert	verhungert
heißest	heißest
Mittelaltermarktes	Mittelaltermarktes
kürzest	kürzest
sei	sei
Kontraindikation	Kontraindikation
Zeitplan	Zeitplan
flieh	flieh
Polyphosphat	Polyphosphat
fluppen	fluppen
schwellen	schwellen
Golfplatz	Golfplatz
gebet	gebet
hoben	hoben
Laib	Laib
Suchet	Suchet
Laken	Laken
entständen	entständen
Zeug	Zeug
dürfe	dürfe
Ecken	Ecken
betrübtest	betrübtest
Prüfbericht	Prüfbericht
schlabbere	schlabbere
langweilst	langweilst
entflieht	entflieht
initiierten	initiierten
versuchest	versuchest
setzet	setzet
Apfelbäume	Apfelbäume
Thioacetal	Thioacetal
lobet	lobet
Sprichwort	Sprichwort
irrte	irrte
privatisiert	privatisiert
teilen	teilen
vergaste	vergaste
Silbersulfidbelag	Silbersulfidbelag
verzieret	verzieret
rekonstruieren	rekonstruieren
hämmerst	hämmerst
Schicksen	Schicksen
entgehe	entgehe
emigrieret	emigrieret
Ausbeuter	Ausbeuter
gehorchst	gehorchst
dolmetschst	dolmetschst
Regenwald	Regenwald
Hände	Hände
Abnahmen	Abnahmen
Mopps	Mopps
Assistentin	Assistentin
Elfen	Elfen
wärmet	wärmet
diskutiere	diskutiere
verließen	verließen
benachrichtiget	benachrichtiget
Mäusespeck	Mäusespeck
grünend	grünend
möchtet	möchtet
Angabe	Angabe
ruhest	ruhest
Übelkeit	Übelkeit
schwangt	schwangt
Fellhandschuh	Fellhandschuh
Vordenkern	Vordenkern
Augur	Augur
Membran	Membran
suchten	suchten
fastetet	fastetet
Büstenhalters	Büstenhalters
speise	speise
Bleigehalten	Bleigehalten
entzweit	entzweit
Effekten	Effekten
Trickbetrüger	Trickbetrüger
Füchsinnen	Füchsinnen
verwechsele	verwechsele
Mensch	Mensch
sponseret	sponseret
zerreißt	zerreißt
knufften	knufften
Recitativen	Recitativen
anhangen	anhangen
Teilnehmerin	Teilnehmerin
koordinieret	koordinieret
Meine	Meine
ackerest	ackerest
erlabet	erlabet
drückte	drückte
Rechte	Rechte
watet	watet
regierte	regierte
Riesen	Riesen
Kompromissen	Kompromissen
entzogen	entzogen
Küchenmaschinen	Küchenmaschinen
losen	losen
seist	seist
glänzen	glänzen
Bleche	Bleche
Lazarette	Lazarette
verzögerten	verzögerten
zensierten	zensierten
bürsten	bürsten
gestaltest	gestaltest
begrübe	begrübe
inspirierest	inspirierest
deponiere	deponiere
Trägergasen	Trägergasen
strullerte	strullerte
schwöre	schwöre
gelobend	gelobend
Ypecaharallen	Ypecaharallen
beschottert	beschottert
hätten	hätten
Schneidern	Schneidern
Gepäckträgern	Gepäckträgern
Kaufleuten	Kaufleuten
herrschte	herrschte
Dolde	Dolde
Abbindebeschleunigern	Abbindebeschleunigern
lügen	lügen
weinte	weinte
deckte	deckte
Domänen	Domänen
Sehne	Sehne
träge	träge
gereichte	gereichte
beißt	beißt
Blattgeweben	Blattgeweben
verschmelze	verschmelze
lege	lege
vertagt	vertagt
Sprachraum	Sprachraum
Provinzen	Provinzen
Kerl	Kerl
drillte	drillte
Anliegen	Anliegen
filteret	filteret
Puffersystem	Puffersystem
Gedicht	Gedicht
beunruhigte	beunruhigte
Remisen	Remisen
Animation	Animation
Katamaran	Katamaran
Inauguration	Inauguration
müsse	müsse
Heptamolybdat	Heptamolybdat
Hüllenelektronen	Hüllenelektronen
kreierten	kreierten
Halbmonden	Halbmonden
Montagmittag	Montagmittag
Ölspuren	Ölspuren
billige	billige
Samstagnachmittag	Samstagnachmittag
frappiere	frappiere
Schotten	Schotten
Pardelkatze	Pardelkatze
Technetate	Technetate
zerstreust	zerstreust
verachte	verachte
Falltürme	Falltürme
Ambiguitäten	Ambiguitäten
bekehret	bekehret
verkürztet	verkürztet
Lunisolarkalender	Lunisolarkalender
fragen	fragen
sterilisierte	sterilisierte
obfuskieren	obfuskieren
verwirklicht	verwirklicht
hättest	hättest
Zahnfleischentzündungen	Zahnfleischentzündungen
kühle	kühle
Sprecher	Sprecher
Untern	Untern
brauchte	brauchte
Hirnstämme	Hirnstämme
Sinnen	Sinnen
Totenglocke	Totenglocke
Unterseite	Unterseite
Ektoplasmen	Ektoplasmen
verführt	verführt
feierte	feierte
Randbemerkung	Randbemerkung
wild	wild
Gangster	Gangster
handhaben	handhaben
imprägnieret	imprägnieret
hebräisch	hebräisch
liebtest	liebtest
entsetzt	entsetzt
Mikrowellenfilter	Mikrowellenfilter
binde	binde
Locken	Locken
Anfechtungen	Anfechtungen
Alkali	Alkali
Vogelscheuchen	Vogelscheuchen
Jüngern	Jüngern
Flammen	Flammen
entdeckst	entdeckst
Gehorchet	Gehorchet
Kurkumen	Kurkumen
Wege	Wege
waren	waren
kabbelet	kabbelet
verkürzt	verkürzt
Zankapfel	Zankapfel
betrübst	betrübst
ertragen	ertragen
Abschußring	Abschußring
erbrütet	erbrütet
bekannt	bekannt
Schwirrvogel	Schwirrvogel
Kissenschlacht	Kissenschlacht
Bajonette	Bajonette
Märchenbuches	Märchenbuches
batet	batet
Landwirt	Landwirt
vernehmest	vernehmest
Sabbaten	Sabbaten
sprüht	sprüht
Citrat	Citrat
blondierten	blondierten
gewinne	gewinne
beleidige	beleidige
ersparten	ersparten
bemächtigest	bemächtigest
Brikette	Brikette
Tiefschutzen	Tiefschutzen
Bleiglanz	Bleiglanz
Glühwürmchen	Glühwürmchen
rüstetest	rüstetest
verkauften	verkauften
Basilisken	Basilisken
Totgeburten	Totgeburten
späht	späht
maximierten	maximierten
Gibst	Gibst
prostituieret	prostituieret
sollst	sollst
vergast	vergast
Kortholt	Kortholt
Zirkelbeweis	Zirkelbeweis
Kompassen	Kompassen
changieren	changieren
plagen	plagen
wehre	wehre
Kerzenlichter	Kerzenlichter
Feierabend	Feierabend
Lehnen	Lehnen
sabbere	sabbere
Gepäckträger	Gepäckträger
Märtyrer	Märtyrer
Silberdrahts	Silberdrahts
umhüllt	umhüllt
extemporieret	extemporieret
Nadelbäume	Nadelbäume
folgte	folgte
assimilierten	assimilierten
Zipfelmützen	Zipfelmützen
mehrte	mehrte
segmentierten	segmentierten
Werkzeuge	Werkzeuge
wichste	wichste
verdrehet	verdrehet
Händen	Händen
Alle	Alle
Aufprall	Aufprall
Nadel	Nadel
abalienierest	abalienierest
Altäre	Altäre
hingehst	hingehst
gelobet	gelobet
Gehör	Gehör
Trinker	Trinker
Omnibusse	Omnibusse
bölkte	bölkte
Monde	Monde
Fettes	Fettes
ehre	ehre
Zapfhähnen	Zapfhähnen
benützt	benützt
begehrten	begehrten
verzeichnete	verzeichnete
Autokraten	Autokraten
verspäte	verspäte
hobt	hobt
mehr	mehr
Rundbriefen	Rundbriefen
zwölften	zwölften
applizirst	applizirst
Nullpunkt	Nullpunkt
Fanmeilen	Fanmeilen
Krume	Krume
Kronsbeeren	Kronsbeeren
möpperst	möpperst
Deutungen	Deutungen
wachset	wachset
entrümpelest	entrümpelest
Bedenken	Bedenken
wollest	wollest
Wiedergutmachung	Wiedergutmachung
Würfen	Würfen
Bertrandite	Bertrandite
buddeln	buddeln
Diethylether	Diethylether
schneidet	schneidet
Gehorsam	Gehorsam
Wasserbades	Wasserbades
Rekursionen	Rekursionen
Adelung	Adelung
frevles	frevles
Gipfeltreffen	Gipfeltreffen
Langschwanzpinguinen	Langschwanzpinguinen
Zitronensaft	Zitronensaft
Mobilfunknetzen	Mobilfunknetzen
Herzchen	Herzchen
malochet	malochet
reifst	reifst
decken	decken
besicheret	besicheret
Apostel	Apostel
Weihe	Weihe
Ding	Ding
verletzte	verletzte
Alkine	Alkine
gabelst	gabelst
Operationssälen	Operationssälen
Speere	Speere
fingiere	fingiere
gebühren	gebühren
Erbsen	Erbsen
Magier	Magier
anrichten	anrichten
Laufringe	Laufringe
bündelest	bündelest
könne	könne
Unrechten	Unrechten
Fußballweltmeisterschaftsqualifikationsspiel	Fußballweltmeisterschaftsqualifikationsspiel
wehe	wehe
elfte	elfte
preiset	preiset
Senkung	Senkung
fladerten	fladerten
eins	eins
Butike	Butike
Sprechers	Sprechers
versteckte	versteckte
unsres	unsres
Elastomer	Elastomer
installiert	installiert
gestikuliere	gestikuliere
Leichname	Leichname
Schreiet	Schreiet
Macht	Macht
Aacheners	Aacheners
strafest	strafest
gratuliere	gratuliere
Polierstahl	Polierstahl
besucht	besucht
wollten	wollten
einst	einst
besorgten	besorgten
Telefonverkäufer	Telefonverkäufer
produzierten	produzierten
Büstenhaltern	Büstenhaltern
touchierte	touchierte
löstet	löstet
sedimentierte	sedimentierte
lauten	lauten
fotzte	fotzte
Markisen	Markisen
verkleide	verkleide
Eisenkraut	Eisenkraut
Elementarzelle	Elementarzelle
Ach	Ach
schnitten	schnitten
verallgemeinerst	verallgemeinerst
Reichweiten	Reichweiten
drifte	drifte
charakterisierend	charakterisierend
Hansen	Hansen
verfolgst	verfolgst
vorn	vorn
wacht	wacht
Verwundete	Verwundete
beanspruchte	beanspruchte
verklärt	verklärt
verfehle	verfehle
verspätest	verspätest
inszeniere	inszeniere
Trichter	Trichter
wurden	wurden
Samstagnachmittagen	Samstagnachmittagen
panaschieren	panaschieren
instanziier	instanziier
Würfelspiel	Würfelspiel
Knüppeln	Knüppeln
amenagiere	amenagiere
stolz	stolz
hieltet	hieltet
Setzet	Setzet
überschatteten	überschatteten
hicksest	hicksest
Gefügen	Gefügen
ölt	ölt
kritzele	kritzele
sterbest	sterbest
motivierten	motivierten
Atommodelle	Atommodelle
brausen	brausen
Solcher	Solcher
Metallquirlen	Metallquirlen
Einbrecher	Einbrecher
fragte	fragte
Binden	Binden
enttäuschtest	enttäuschtest
bezahlest	bezahlest
meinte	meinte
Dobermännern	Dobermännern
klickte	klickte
zeichnest	zeichnest
Langeweile	Langeweile
Schau	Schau
verkehrte	verkehrte
Setzt	Setzt
Lautschriften	Lautschriften
Staatsanleihe	Staatsanleihe
schickte	schickte
feiertest	feiertest
Päckchen	Päckchen
ratschlagen	ratschlagen
flucht	flucht
Anker	Anker
Abflug	Abflug
Abschreckung	Abschreckung
spannen	spannen
achten	achten
dürften	dürften
Aderhaut	Aderhaut
Briten	Briten
feiern	feiern
Flöten	Flöten
dürfest	dürfest
Kehre	Kehre
stigmatisierst	stigmatisierst
Hirnstämmen	Hirnstämmen
Bergen	Bergen
besichtigt	besichtigt
Verwundeten	Verwundeten
alles	alles
beichten	beichten
addieret	addieret
referenziere	referenziere
Schwärmereien	Schwärmereien
opfern	opfern
Dingen	Dingen
Herbstwinden	Herbstwinden
verkündet	verkündet
Forschungen	Forschungen
schaffet	schaffet
inspirierten	inspirierten
auflegt	auflegt
exmatrikuliertet	exmatrikuliertet
verseift	verseift
verjährte	verjährte
füllen	füllen
sinkest	sinkest
sintertest	sintertest
Fetten	Fetten
warnet	warnet
zagest	zagest
lobte	lobte
webte	webte
verbaselt	verbaselt
kooperierst	kooperierst
schnorrtet	schnorrtet
Philerast	Philerast
Mitschuld	Mitschuld
Wirst	Wirst
wohnet	wohnet
Referenzen	Referenzen
klone	klone
graben	graben
strecke	strecke
erlagst	erlagst
Druckfehler	Druckfehler
vertraute	vertraute
löste	löste
Unterseiten	Unterseiten
Kakaos	Kakaos
attackieret	attackieret
Fußboden	Fußboden
höret	höret
entwischtet	entwischtet
Lehrkörpers	Lehrkörpers
Serverzugriffe	Serverzugriffe
verglühest	verglühest
Klärung	Klärung
hegst	hegst
nippst	nippst
folterst	folterst
erlauben	erlauben
harren	harren
Arsenbergwerk	Arsenbergwerk
Lopariten	Lopariten
verbitterten	verbitterten
Götze	Götze
wünsche	wünsche
Bundesgebieten	Bundesgebieten
Isobar	Isobar
Wehret	Wehret
beschwören	beschwören
Lümmeltüten	Lümmeltüten
Ansichtskarte	Ansichtskarte
Dorsche	Dorsche
Rinde	Rinde
einen	einen
Ruße	Ruße
Ranzigkeit	Ranzigkeit
harrtest	harrtest
Abkürzungsverzeichnis	Abkürzungsverzeichnis
Kopfsalat	Kopfsalat
Acetaten	Acetaten
Gaunern	Gaunern
querte	querte
Pudern	Pudern
Polierstählen	Polierstählen
streiften	streiften
verkriechst	verkriechst
wachse	wachse
jappten	jappten
heischten	heischten
erhörst	erhörst
ahne	ahne
überdenkst	überdenkst
Flenser	Flenser
Ächselchen	Ächselchen
zeuge	zeuge
Chelatkomplex	Chelatkomplex
bequemen	bequemen
geahnt	geahnt
grüßest	grüßest
verbaselte	verbaselte
Huren	Huren
erfahrest	erfahrest
Steuerberater	Steuerberater
Geigerzähler	Geigerzähler
vertonten	vertonten
gelobe	gelobe
Sprachräumen	Sprachräumen
Klassenzimmern	Klassenzimmern
sorgte	sorgte
Berylle	Berylle
Innenministerien	Innenministerien
verifizieret	verifizieret
Ingredienzen	Ingredienzen
tage	tage
Kriegen	Kriegen
Gebern	Gebern
schämte	schämte
duschten	duschten
entwendete	entwendete
Technetaten	Technetaten
Fanmeile	Fanmeile
moppen	moppen
egge	egge
Gebäck	Gebäck
heile	heile
Fluoratomen	Fluoratomen
Gesamtmenge	Gesamtmenge
lade	lade
durchzuck	durchzuck
Chasar	Chasar
Tier	Tier
Fischotter	Fischotter
seinem	seinem
winke	winke
bedrücktest	bedrücktest
Moren	Moren
Sprüche	Sprüche
Videoaufzeichnungen	Videoaufzeichnungen
föhnest	föhnest
Crescendo	Crescendo
Pumpellyiten	Pumpellyiten
obfuskierten	obfuskierten
Taufen	Taufen
schenke	schenke
Leitungswegs	Leitungswegs
grüßten	grüßten
Hälsen	Hälsen
Inkarnationen	Inkarnationen
schichteten	schichteten
Anführer	Anführer
begliche	begliche
bekehrten	bekehrten
gelobtet	gelobtet
Gefilden	Gefilden
grüße	grüße
mischt	mischt
vertreiben	vertreiben
Stellen	Stellen
entmineralisieret	entmineralisieret
Hirschen	Hirschen
Halsabschneider	Halsabschneider
Ringe	Ringe
tun	tun
wünscht	wünscht
geschämt	geschämt
Radsatzes	Radsatzes
Schal	Schal
meißelt	meißelt
lösest	lösest
Fanatiker	Fanatiker
schaben	schaben
Junge	Junge
mogelten	mogelten
Falz	Falz
quantisierte	quantisierte
feiere	feiere
leerst	leerst
Rehböcken	Rehböcken
stammeln	stammeln
malten	malten
Bienenstock	Bienenstock
Kirgisin	Kirgisin
verhungerte	verhungerte
spielet	spielet
Frieden	Frieden
beschlug	beschlug
vertreibt	vertreibt
Basiliken	Basiliken
Feierabende	Feierabende
Götzen	Götzen
Könige	Könige
unser	unser
bekehrst	bekehrst
schwebte	schwebte
arrivieren	arrivieren
übersteht	übersteht
Seelöwe	Seelöwe
Schanktischen	Schanktischen
Märchenbüchern	Märchenbüchern
Normdatum	Normdatum
Hure	Hure
Außenministerien	Außenministerien
kaufet	kaufet
Blattgewebe	Blattgewebe
Domäne	Domäne
anzeigte	anzeigte
Schnittlauch	Schnittlauch
Hadithe	Hadithe
Jagdhunden	Jagdhunden
Schreien	Schreien
fünften	fünften
entsündigte	entsündigte
zagt	zagt
zähltet	zähltet
Pentaborat	Pentaborat
ermordetet	ermordetet
Kerfe	Kerfe
hickste	hickste
grau	grau
jedem	jedem
Wolle	Wolle
predigten	predigten
begrabest	begrabest
habe	habe
glänzten	glänzten
trage	trage
peiltest	peiltest
Fieberanfall	Fieberanfall
lobe	lobe
Primatologen	Primatologen
gewinnen	gewinnen
hüte	hüte
lesen	lesen
neiden	neiden
Flöße	Flöße
Antimusters	Antimusters
Kristalle	Kristalle
beschottre	beschottre
verdammen	verdammen
Lümmeltüte	Lümmeltüte
begleicht	begleicht
brandeten	brandeten
Sünders	Sünders
meldeten	meldeten
verführte	verführte
sedimentiertet	sedimentiertet
verkehrten	verkehrten
demütigst	demütigst
trödele	trödele
Genetikerin	Genetikerin
Lammfellhandschuhs	Lammfellhandschuhs
vergrabest	vergrabest
Entmachtungen	Entmachtungen
säumet	säumet
sorge	sorge
Kaufhäuser	Kaufhäuser
Coventrisierung	Coventrisierung
bauest	bauest
dekoriere	dekoriere
überweist	überweist
Zerfall	Zerfall
Puder	Puder
begehrte	begehrte
Bleiglanzes	Bleiglanzes
More	More
wichsten	wichsten
Schlagzeugern	Schlagzeugern
gebührt	gebührt
plärrtest	plärrtest
Gaschromatographie	Gaschromatographie
Gammastrahl	Gammastrahl
verteidigte	verteidigte
Urologe	Urologe
aßet	aßet
schwirrt	schwirrt
parlieren	parlieren
schwelle	schwelle
bestellt	bestellt
Diese	Diese
Kindergeldern	Kindergeldern
kontaktiere	kontaktiere
unterwerfe	unterwerfe
baute	baute
bekehrte	bekehrte
erkennet	erkennet
schwöret	schwöret
besser	besser
Ochs	Ochs
setzte	setzte
behauptest	behauptest
seien	seien
speiset	speiset
deaktiviere	deaktiviere
Nussknackern	Nussknackern
Sündern	Sündern
Epidemien	Epidemien
billigte	billigte
verformen	verformen
filtern	filtern
Leichenschauhäuser	Leichenschauhäuser
Bestechungsgelder	Bestechungsgelder
Kriegsenden	Kriegsenden
bereue	bereue
beeindruckt	beeindruckt
ratschlagten	ratschlagten
respektieren	respektieren
unterbrächen	unterbrächen
Großfürsten	Großfürsten
Hobbys	Hobbys
geleiteten	geleiteten
illustriertet	illustriertet
kitzeln	kitzeln
Stierkämpfen	Stierkämpfen
Eisstein	Eisstein
ringet	ringet
dechiffriere	dechiffriere
schreiet	schreiet
mampfen	mampfen
tyrannisierte	tyrannisierte
erwähnten	erwähnten
fastetest	fastetest
Prostylos	Prostylos
begründetest	begründetest
Heuhaufen	Heuhaufen
Futtermitteln	Futtermitteln
entrümpelst	entrümpelst
rühmte	rühmte
Wollt	Wollt
Hirsche	Hirsche
Freibergit	Freibergit
träumen	träumen
Ankern	Ankern
flirre	flirre
Einrad	Einrad
Feuerteufels	Feuerteufels
parkierten	parkierten
Tritt	Tritt
Deine	Deine
erziehen	erziehen
Kleinode	Kleinode
kichern	kichern
verbrauchte	verbrauchte
Möbelstoff	Möbelstoff
Kruste	Kruste
fegte	fegte
illustriere	illustriere
kennet	kennet
Zeitschlitze	Zeitschlitze
Alten	Alten
Sphären	Sphären
zittertest	zittertest
Gehilfen	Gehilfen
wehrend	wehrend
verlautete	verlautete
Managementsystemen	Managementsystemen
Preis	Preis
Maultieren	Maultieren
egalisiertet	egalisiertet
Ochsen	Ochsen
schäme	schäme
Hallelujas	Hallelujas
Sollst	Sollst
häufte	häufte
gaffest	gaffest
Introjektion	Introjektion
laute	laute
bestrafe	bestrafe
köderet	köderet
Brauhaus	Brauhaus
verspielte	verspielte
Stätten	Stätten
erhebst	erhebst
Martyrologium	Martyrologium
kommet	kommet
ruckelst	ruckelst
Langschwanzpinguin	Langschwanzpinguin
warnt	warnt
liebtet	liebtet
Gummibäumen	Gummibäumen
verblieben	verblieben
Transportwegen	Transportwegen
Erstlingen	Erstlingen
drängten	drängten
unterfordern	unterfordern
Aggressor	Aggressor
Dorsch	Dorsch
Bienenzüchter	Bienenzüchter
zürntet	zürntet
liebst	liebst
geleitet	geleitet
erste	erste
Pflaumen	Pflaumen
stirbst	stirbst
kooperierte	kooperierte
kautest	kautest
Vergeltungen	Vergeltungen
schlaf	schlaf
schnappet	schnappet
Schamentzündung	Schamentzündung
Bildpunkt	Bildpunkt
Kleinod	Kleinod
beklage	beklage
piesacken	piesacken
unterbrächest	unterbrächest
anrufen	anrufen
Erzherzogshüte	Erzherzogshüte
Chronisten	Chronisten
schütze	schütze
versuchte	versuchte
labert	labert
spielen	spielen
wünschtest	wünschtest
Donor	Donor
Tiere	Tiere
Technetiumatom	Technetiumatom
gehorchet	gehorchet
dividiert	dividiert
laut	laut
zwang	zwang
Schlüchten	Schlüchten
gedachtest	gedachtest
buddelten	buddelten
Fischen	Fischen
Verehrer	Verehrer
Füllfedern	Füllfedern
zentrierest	zentrierest
Anfänger	Anfänger
Ausnahmen	Ausnahmen
Gemüt	Gemüt
entgehst	entgehst
verschreibt	verschreibt
Haarshampoos	Haarshampoos
Wadenbeines	Wadenbeines
untersagest	untersagest
grüble	grüble
Fahlflanken-Ameisenwürgern	Fahlflanken-Ameisenwürgern
Laufringen	Laufringen
nehmt	nehmt
Suffixen	Suffixen
lüge	lüge
Almanache	Almanache
ersparen	ersparen
Massenanteil	Massenanteil
überliefere	überliefere
besorg	besorg
merket	merket
Kopfsalaten	Kopfsalaten
entzweiest	entzweiest
befehlen	befehlen
entschleieret	entschleieret
Fülle	Fülle
Blechen	Blechen
verspätete	verspätete
ziere	ziere
zügelten	zügelten
Schläfchen	Schläfchen
brennen	brennen
zuhört	zuhört
Farbstoffe	Farbstoffe
gezählt	gezählt
eggt	eggt
reagierte	reagierte
aufwachte	aufwachte
täuschet	täuschet
griffe	griffe
umkämen	umkämen
prophezeie	prophezeie
flambiert	flambiert
herrschet	herrschet
preisen	preisen
käbbelte	käbbelte
Taschenwörterbuch	Taschenwörterbuch
Rückwege	Rückwege
danket	danket
bewies	bewies
Judenrat	Judenrat
betrieben	betrieben
injizierest	injizierest
ringe	ringe
Galopps	Galopps
wehr	wehr
Essigsäurechlorid	Essigsäurechlorid
kabelst	kabelst
bespracht	bespracht
desensibilisierten	desensibilisierten
Gewinnung	Gewinnung
entkörperlichten	entkörperlichten
erforschest	erforschest
lebet	lebet
kontaktieret	kontaktieret
Toren	Toren
bereitete	bereitete
entstände	entstände
füsilierte	füsilierte
boß	boß
Kernladungszahl	Kernladungszahl
Privatsachen	Privatsachen
gelobt	gelobt
Freitagnachmittagen	Freitagnachmittagen
Pläsieren	Pläsieren
Reststoff	Reststoff
Asylrechten	Asylrechten
amenagieren	amenagieren
Sogen	Sogen
koste	koste
Schönredner	Schönredner
reanimiere	reanimiere
steiget	steiget
Hüfte	Hüfte
analysieret	analysieret
greinet	greinet
bereitend	bereitend
Kompromiss	Kompromiss
käbbelnd	käbbelnd
gewöhnt	gewöhnt
hinterzöge	hinterzöge
dürft	dürft
Maut	Maut
Indianer	Indianer
säumen	säumen
verschärftet	verschärftet
Aspartamen	Aspartamen
entflöhen	entflöhen
schaffen	schaffen
besänftiget	besänftiget
Zwetschge	Zwetschge
öle	öle
Bleigehalt	Bleigehalt
gedächtet	gedächtet
stäupt	stäupt
tastet	tastet
erkälteten	erkälteten
beschotteret	beschotteret
Prostyloi	Prostyloi
Fledermaus	Fledermaus
Erzherzogshüten	Erzherzogshüten
Metallspiegeln	Metallspiegeln
bringet	bringet
Pfarrerinnen	Pfarrerinnen
verludet	verludet
schabst	schabst
ducktest	ducktest
faule	faule
Oberbegriff	Oberbegriff
schlachten	schlachten
Theistin	Theistin
Theistinnen	Theistinnen
kategorisierst	kategorisierst
Zwetschgen	Zwetschgen
Blättchen	Blättchen
Buntspechten	Buntspechten
war	war
begehret	begehret
heparinisiere	heparinisiere
Adventskalender	Adventskalender
sehnet	sehnet
Überziehens	Überziehens
Finanzminister	Finanzminister
leiten	leiten
Letzten	Letzten
feierst	feierst
solchem	solchem
Wiedergutmachungen	Wiedergutmachungen
Geschichtsbücher	Geschichtsbücher
ungefälschtem	ungefälschtem
Düften	Düften
Mikrometern	Mikrometern
Gehorcht	Gehorcht
Flussbett	Flussbett
parkierst	parkierst
mampfte	mampfte
einer	einer
Gästen	Gästen
begrabet	begrabet
lös	lös
suche	suche
verdeckt	verdeckt
Impedanz	Impedanz
schöpfe	schöpfe
verprügelte	verprügelte
Arsenite	Arsenite
Normdaten	Normdaten
Heringe	Heringe
verifizierten	verifizierten
Collagen	Collagen
besichert	besichert
Gehörst	Gehörst
Hehler	Hehler
Eins	Eins
solches	solches
freiwilligen	freiwilligen
erbringen	erbringen
Drillingen	Drillingen
begnadigte	begnadigte
simulierst	simulierst
deaktivierst	deaktivierst
prangest	prangest
Festons	Festons
Spende	Spende
blamierten	blamierten
widerlegest	widerlegest
pflanze	pflanze
besichtiget	besichtiget
duzen	duzen
Ölspur	Ölspur
foppst	foppst
prediget	prediget
zürnten	zürnten
gebieten	gebieten
haderte	haderte
Lehne	Lehne
Petersfischen	Petersfischen
erweckt	erweckt
Futur	Futur
gräbst	gräbst
Bildpunkten	Bildpunkten
baust	baust
Acetat	Acetat
unsere	unsere
entdecket	entdecket
Schwächung	Schwächung
Blaumeise	Blaumeise
gesellt	gesellt
stutzt	stutzt
sitzest	sitzest
Wucher	Wucher
benachrichtige	benachrichtige
beschuldigt	beschuldigt
flenstet	flenstet
liebest	liebest
Flensern	Flensern
sagest	sagest
Möbelstoffen	Möbelstoffen
rekrutiere	rekrutiere
krieget	krieget
aufkommen	aufkommen
Gasgemischen	Gasgemischen
Kommst	Kommst
Schlössern	Schlössern
Platte	Platte
fallest	fallest
erlaube	erlaube
lodert	lodert
Konzentrat	Konzentrat
gelobtest	gelobtest
Laubholz	Laubholz
kommst	kommst
betrübtet	betrübtet
gelobte	gelobte
Sizilianer	Sizilianer
nähte	nähte
emaillieret	emaillieret
dekompilierten	dekompilierten
gestattest	gestattest
Minischweine	Minischweine
zählten	zählten
gehet	gehet
konntet	konntet
überreicht	überreicht
raubest	raubest
Substanz	Substanz
bestimmt	bestimmt
Ösophagospasmus	Ösophagospasmus
zerfielen	zerfielen
Fellachin	Fellachin
Gemurmel	Gemurmel
brauchst	brauchst
unterdrücke	unterdrücke
säuselest	säuselest
zirpe	zirpe
höben	höben
setzest	setzest
hegt	hegt
überqueren	überqueren
stellen	stellen
Herabsetzung	Herabsetzung
pflücke	pflücke
Unsere	Unsere
stimmet	stimmet
Suchanfrage	Suchanfrage
grabest	grabest
widmest	widmest
Steuerwagens	Steuerwagens
Kaufleute	Kaufleute
Erfahrung	Erfahrung
blockiert	blockiert
zerschlaget	zerschlaget
Tintenklecksen	Tintenklecksen
sehest	sehest
erzeigte	erzeigte
idealisierten	idealisierten
Teile	Teile
erhöht	erhöht
fabulierte	fabulierte
legen	legen
Kommoden	Kommoden
Rotzinkerzen	Rotzinkerzen
eurem	eurem
Paradiesapfel	Paradiesapfel
versuche	versuche
Mähnenwölfen	Mähnenwölfen
Marokkanern	Marokkanern
gebäre	gebäre
stapelten	stapelten
Kontrollboxen	Kontrollboxen
räumen	räumen
bekriegtet	bekriegtet
am	am
klappten	klappten
zeigst	zeigst
Kupferkiesen	Kupferkiesen
schauspielert	schauspielert
Trübsale	Trübsale
Bezeugungen	Bezeugungen
Aktienkursen	Aktienkursen
schöpfte	schöpfte
wähnt	wähnt
jaule	jaule
Anfechtung	Anfechtung
deutete	deutete
Landwirte	Landwirte
fraget	fraget
bewährt	bewährt
bereite	bereite
funkeln	funkeln
kabelte	kabelte
Pinguin	Pinguin
warne	warne
oxidierte	oxidierte
plagest	plagest
Tritte	Tritte
privilegiere	privilegiere
injiziert	injiziert
ehrte	ehrte
Almanachen	Almanachen
naschten	naschten
Arsenit	Arsenit
rauben	rauben
Einen	Einen
grübelten	grübelten
verwechseltet	verwechseltet
Dudelsack	Dudelsack
verbrauchet	verbrauchet
Malaysier	Malaysier
wallte	wallte
bemerket	bemerket
Zwangsarbeiterin	Zwangsarbeiterin
kupiert	kupiert
verhören	verhören
reife	reife
knuffend	knuffend
Radiergummis	Radiergummis
Zeitbombe	Zeitbombe
Gegenleistungen	Gegenleistungen
halben	halben
Idolatrien	Idolatrien
holet	holet
desertiertet	desertiertet
Tischen	Tischen
Meerschweinchen	Meerschweinchen
Hubschrauber	Hubschrauber
Portal	Portal
Kräfte	Kräfte
erwärmet	erwärmet
verabschiedeten	verabschiedeten
malen	malen
surre	surre
solch	solch
tanzen	tanzen
reizet	reizet
verglühte	verglühte
speiste	speiste
Kakadu	Kakadu
scheitertet	scheitertet
Kettenraucher	Kettenraucher
pendele	pendele
Gurten	Gurten
möchte	möchte
Exilanten	Exilanten
fluchte	fluchte
entwickelten	entwickelten
gefügt	gefügt
Ölfasses	Ölfasses
Peptid	Peptid
verleumdete	verleumdete
Sauberfrauen	Sauberfrauen
Hinkelstein	Hinkelstein
spanne	spanne
radierte	radierte
emailliert	emailliert
Backpflaumen	Backpflaumen
sponsertest	sponsertest
wurdet	wurdet
Nehmet	Nehmet
verzehrt	verzehrt
Rußen	Rußen
erkannten	erkannten
vergiften	vergiften
schubset	schubset
gähne	gähne
protokollieren	protokollieren
offenbartest	offenbartest
Sagen	Sagen
Satzungen	Satzungen
Pailletten	Pailletten
hievten	hievten
Sei	Sei
erbaust	erbaust
Sprödmetallen	Sprödmetallen
merke	merke
Wahnen	Wahnen
plärrt	plärrt
harmoniert	harmoniert
leite	leite
besänne	besänne
weissagst	weissagst
Aha-Erlebnis	Aha-Erlebnis
Kerls	Kerls
Programmiererinnen	Programmiererinnen
Schaden	Schaden
flitzen	flitzen
Dürre	Dürre
verkauft	verkauft
Banketten	Banketten
Schnittlauche	Schnittlauche
Eutern	Eutern
Eines	Eines
bombardiere	bombardiere
ramme	ramme
bezichtigten	bezichtigten
christianisiere	christianisiere
Petersfisch	Petersfisch
Leitungsweg	Leitungsweg
Schwermetallion	Schwermetallion
Auszügen	Auszügen
eingehest	eingehest
gestatteten	gestatteten
Elstern	Elstern
Stoffwechselwegen	Stoffwechselwegen
Besprechung	Besprechung
Oxalaten	Oxalaten
überweis	überweis
verringerten	verringerten
replizieret	replizieret
Fehden	Fehden
Kaufkraft	Kaufkraft
plissierten	plissierten
unterstützet	unterstützet
Saiblingen	Saiblingen
flense	flense
borgte	borgte
unschuldige	unschuldige
prophezeiet	prophezeiet
pressierten	pressierten
erforschet	erforschet
forschte	forschte
Sexte	Sexte
Dampfschiffen	Dampfschiffen
attackieren	attackieren
Eine	Eine
dividiere	dividiere
legst	legst
Überschüssen	Überschüssen
surrst	surrst
zittere	zittere
bedingten	bedingten
hatten	hatten
denaturieret	denaturieret
zuppen	zuppen
tappst	tappst
handhabest	handhabest
widmet	widmet
missversteht	missversteht
Zehnten	Zehnten
älteste	älteste
überschnitten	überschnitten
Gläubige	Gläubige
verletzt	verletzt
feire	feire
untersagtest	untersagtest
fabulierest	fabulierest
Bauwerken	Bauwerken
Anfängern	Anfängern
warntet	warntet
Dattel	Dattel
Ablösung	Ablösung
Fische	Fische
Stearat	Stearat
Trichtern	Trichtern
verstrahlet	verstrahlet
parametrisierten	parametrisierten
Recitativ	Recitativ
mißverstehet	mißverstehet
Kriegsschauplatz	Kriegsschauplatz
beziehen	beziehen
evaluiert	evaluiert
ärgerst	ärgerst
fabuliert	fabuliert
Gässchen	Gässchen
Argyrodite	Argyrodite
Gurt	Gurt
Durchbruch	Durchbruch
Preisanstiegen	Preisanstiegen
observierst	observierst
verflog	verflog
umarmen	umarmen
erlöst	erlöst
kochte	kochte
evakuieret	evakuieret
Gegenleistung	Gegenleistung
Carbids	Carbids
Gegebenheit	Gegebenheit
Tollkirsche	Tollkirsche
Gicht	Gicht
Tintenklecks	Tintenklecks
tragen	tragen
Regierung	Regierung
bewiest	bewiest
nippend	nippend
foppte	foppte
schmuggelte	schmuggelte
Münzsammlung	Münzsammlung
skypst	skypst
raffinier	raffinier
verabschiedetet	verabschiedetet
Schaffnerin	Schaffnerin
Robe	Robe
rundet	rundet
Drang	Drang
Homodimeren	Homodimeren
vertuest	vertuest
lärmte	lärmte
Lehrkörpern	Lehrkörpern
Laubbaum	Laubbaum
zankte	zankte
Weinbergen	Weinbergen
Schätzen	Schätzen
kehrst	kehrst
scheinen	scheinen
Enthärtungen	Enthärtungen
geschlummert	geschlummert
rollten	rollten
Geschäften	Geschäften
glaubest	glaubest
Eingaben	Eingaben
Meinen	Meinen
stärket	stärket
drosselten	drosselten
Fremdwort	Fremdwort
neige	neige
Maximierung	Maximierung
Begünstigung	Begünstigung
legest	legest
blondieret	blondieret
Atemgas	Atemgas
schwirret	schwirret
Elektronenschale	Elektronenschale
punktest	punktest
Seilen	Seilen
skypet	skypet
Grüßet	Grüßet
plumpsten	plumpsten
Halter	Halter
betrübe	betrübe
Bertrandit	Bertrandit
zuteil	zuteil
entwendet	entwendet
brachen	brachen
gleitest	gleitest
kritzelst	kritzelst
stapele	stapele
gönnst	gönnst
verbasele	verbasele
steinigte	steinigte
verjährest	verjährest
Silbererzen	Silbererzen
kaufst	kaufst
Spiralen	Spiralen
ringelten	ringelten
lauschte	lauschte
chloroformiere	chloroformiere
Türkin	Türkin
sage	sage
mache	mache
Habt	Habt
feierten	feierten
liebet	liebet
Chlorats	Chlorats
grabbelten	grabbelten
Skorpionen	Skorpionen
Lehrbücher	Lehrbücher
Flamen	Flamen
Unterschlagung	Unterschlagung
pflücktet	pflücktet
Sage	Sage
gedenke	gedenke
Wiederauferstehung	Wiederauferstehung
Lenkstange	Lenkstange
ausführte	ausführte
harmonierest	harmonierest
häufen	häufen
Anhänge	Anhänge
lebst	lebst
Hummer	Hummer
reim	reim
hattet	hattet
fegst	fegst
Reinigungsschrittes	Reinigungsschrittes
Silberdrähten	Silberdrähten
Druckfehlern	Druckfehlern
berühret	berühret
heulet	heulet
Gewalttäter	Gewalttäter
begrubt	begrubt
Radsätzen	Radsätzen
stürzte	stürzte
strafe	strafe
oxidierst	oxidierst
überlebest	überlebest
schenkest	schenkest
Streife	Streife
erntete	erntete
deponierte	deponierte
emendieret	emendieret
Rubinen	Rubinen
borgst	borgst
Transportweg	Transportweg
bestimmten	bestimmten
sedimentiere	sedimentiere
verfanget	verfanget
Grenze	Grenze
Rutheniumisotop	Rutheniumisotop
gezügelt	gezügelt
Kopfverletzungen	Kopfverletzungen
restaurieret	restaurieret
mühte	mühte
hadertet	hadertet
Pausbacken	Pausbacken
Ausländern	Ausländern
versüße	versüße
schleimte	schleimte
Arbeitsunfähigkeit	Arbeitsunfähigkeit
Spektroskopie	Spektroskopie
Excimerlasern	Excimerlasern
Spitze	Spitze
füllte	füllte
Beschuldigung	Beschuldigung
griffen	griffen
Anhängseln	Anhängseln
Basilikum	Basilikum
Anmelder	Anmelder
glaubst	glaubst
Buntspechte	Buntspechte
auflegst	auflegst
tendiertet	tendiertet
ziehest	ziehest
schwöllen	schwöllen
Referenz	Referenz
Kassettenrekordern	Kassettenrekordern
verallgemeinerest	verallgemeinerest
unsre	unsre
beherrscht	beherrscht
Charakteristika	Charakteristika
vandalieren	vandalieren
mopsend	mopsend
pharyngalisierst	pharyngalisierst
Merkel-Rauten	Merkel-Rauten
begehren	begehren
kurbelte	kurbelte
Datentypen	Datentypen
Abbindebeschleuniger	Abbindebeschleuniger
Holzquirl	Holzquirl
Europameisters	Europameisters
Assimilationen	Assimilationen
Spannt	Spannt
funktionalisierte	funktionalisierte
designierst	designierst
annektierst	annektierst
Sehnen	Sehnen
verfügten	verfügten
liege	liege
meißeltest	meißeltest
malträtiert	malträtiert
zappten	zappten
absolviertet	absolviertet
Dachdeckerin	Dachdeckerin
schenkst	schenkst
Brüdern	Brüdern
Galoppen	Galoppen
ummantle	ummantle
funkelet	funkelet
Händedruck	Händedruck
halt	halt
dekompiliertest	dekompiliertest
Republikflucht	Republikflucht
Fermium	Fermium
fehlte	fehlte
vernickelte	vernickelte
stiftest	stiftest
höbe	höbe
balkanisierten	balkanisierten
Zwingburgen	Zwingburgen
überschneidet	überschneidet
Anarchisten	Anarchisten
Fluoratom	Fluoratom
hydrogentartrate	hydrogentartrate
offenbarten	offenbarten
Melanteriten	Melanteriten
deklarierten	deklarierten
Ångström	Ångström
Abbild	Abbild
werdet	werdet
Deinem	Deinem
hupet	hupet
Amnestie	Amnestie
stoße	stoße
Wahn	Wahn
grünest	grünest
eingehet	eingehet
prosteten	prosteten
Unglauben	Unglauben
stimmen	stimmen
sorgen	sorgen
dissentierte	dissentierte
extemporiere	extemporiere
Stärkungsmittel	Stärkungsmittel
demütig	demütig
irre	irre
wallet	wallet
bedürft	bedürft
transportierst	transportierst
parametrisierte	parametrisierte
versteigernd	versteigernd
Ärzteblättern	Ärzteblättern
abalieniertest	abalieniertest
vereinigte	vereinigte
Zahnfleischentzündung	Zahnfleischentzündung
Anspielungen	Anspielungen
verschicket	verschicket
kühl	kühl
herrschten	herrschten
zerstreute	zerstreute
Butzemann	Butzemann
Silbergeschirr	Silbergeschirr
Tyrannen	Tyrannen
Rumänin	Rumänin
Autonomien	Autonomien
säet	säet
grüne	grüne
halbierte	halbierte
Adelungen	Adelungen
Aphasie	Aphasie
unterbewertete	unterbewertete
beleidigst	beleidigst
Pflicht	Pflicht
Knöllchen	Knöllchen
Schwänzchen	Schwänzchen
bewässerest	bewässerest
Arm	Arm
frohlockten	frohlockten
meines	meines
Schilden	Schilden
beschert	beschert
Fortsetzungen	Fortsetzungen
bezieht	bezieht
Unwahrheit	Unwahrheit
weiche	weiche
Autonomie	Autonomie
bewiese	bewiese
Ypecaharalle	Ypecaharalle
Palisade	Palisade
dekorieren	dekorieren
Hadith	Hadith
flambierten	flambierten
knistern	knistern
blast	blast
Afrikaner	Afrikaner
Fellachinnen	Fellachinnen
dritte	dritte
Judenräte	Judenräte
Schnitzeljagd	Schnitzeljagd
Zeugen	Zeugen
hebe	hebe
Anhang	Anhang
Kaktusfeige	Kaktusfeige
nähert	nähert
krösest	krösest
Theologien	Theologien
Gewürze	Gewürze
verknüpfet	verknüpfet
nagelest	nagelest
gesagt	gesagt
diskutierst	diskutierst
Krokus	Krokus
Marjellchens	Marjellchens
keulte	keulte
zerfetzte	zerfetzte
Kürass	Kürass
bleibst	bleibst
drängte	drängte
Amtsträger	Amtsträger
Mutagen	Mutagen
Dinge	Dinge
bekennt	bekennt
Tollkirschen	Tollkirschen
Strahlentierchens	Strahlentierchens
blockierten	blockierten
zanket	zanket
Unglaube	Unglaube
blamierte	blamierte
Mops	Mops
Fluorgehalte	Fluorgehalte
Ringeltauben	Ringeltauben
verbündend	verbündend
Eiszapfen	Eiszapfen
Wembley-Tore	Wembley-Tore
ummantelten	ummantelten
Chlorwasserstoffmoleküls	Chlorwasserstoffmoleküls
unterschiede	unterschiede
Paragraphenreitern	Paragraphenreitern
Gläubigen	Gläubigen
pflügest	pflügest
läute	läute
hinterlegt	hinterlegt
duckmäusere	duckmäusere
taufen	taufen
würdet	würdet
imkeret	imkeret
Gemütes	Gemütes
türmt	türmt
querest	querest
verliert	verliert
verfängt	verfängt
substituieren	substituieren
köderte	köderte
Schild	Schild
schlummerte	schlummerte
Amputierten	Amputierten
Kadavergehorsam	Kadavergehorsam
bedrückest	bedrückest
Hode	Hode
Roben	Roben
Zehen	Zehen
erhörest	erhörest
Adhäsionen	Adhäsionen
schießt	schießt
gehorcht	gehorcht
baggerst	baggerst
behütetest	behütetest
verwechselet	verwechselet
fliehe	fliehe
Äquatoren	Äquatoren
anderen	anderen
zwängtet	zwängtet
verstört	verstört
Wir	Wir
Eilande	Eilande
konstatiertest	konstatiertest
fahrt	fahrt
scheinet	scheinet
Alterität	Alterität
bessere	bessere
Luftschiff	Luftschiff
Premieren	Premieren
Ruß	Ruß
ausfuhren	ausfuhren
Abszisse	Abszisse
beanspruchest	beanspruchest
neigte	neigte
Abschußringe	Abschußringe
Männlein	Männlein
zensiere	zensiere
herrschest	herrschest
Stufen	Stufen
zeichnet	zeichnet
tobet	tobet
Bettler	Bettler
verselbständigt	verselbständigt
Panamaer	Panamaer
konjugiere	konjugiere
ärger	ärger
nachwandelte	nachwandelte
Fusselbart	Fusselbart
Freibrief	Freibrief
höhnte	höhnte
Däumlingen	Däumlingen
ausrufen	ausrufen
Großstädtern	Großstädtern
Dithiolan	Dithiolan
stolze	stolze
erbest	erbest
Aas	Aas
erinnre	erinnre
ab	ab
Spielen	Spielen
Mop	Mop
verwiesen	verwiesen
Aspartame	Aspartame
schnappt	schnappt
belauerten	belauerten
Ehren	Ehren
Treibhausgasen	Treibhausgasen
Wehklage	Wehklage
Diesen	Diesen
lieb	lieb
gabelt	gabelt
manövrieret	manövrieret
Spieße	Spieße
heil	heil
demoralisiere	demoralisiere
Fußballweltmeisterschaftsqualifikationsspielen	Fußballweltmeisterschaftsqualifikationsspielen
Gebeten	Gebeten
bediene	bediene
Am	Am
versuchtet	versuchtet
Kriegsschauplätze	Kriegsschauplätze
gehorchte	gehorchte
Gefilde	Gefilde
Haben	Haben
Talisman	Talisman
konvergierest	konvergierest
verliere	verliere
Retter	Retter
lose	lose
schauten	schauten
Westen	Westen
Ösophagospasmen	Ösophagospasmen
gelobst	gelobst
rächte	rächte
log	log
gedenken	gedenken
zersetzte	zersetzte
narret	narret
Lautschrift	Lautschrift
Wert	Wert
flehst	flehst
Autoklaven	Autoklaven
Fussel	Fussel
generalisiere	generalisiere
Playlist	Playlist
Floß	Floß
Seehechten	Seehechten
verkleinern	verkleinern
lohnt	lohnt
bewürben	bewürben
aufwacht	aufwacht
vandaliere	vandaliere
klingt	klingt
bromiertet	bromiertet
opferte	opferte
präsentiere	präsentiere
dresche	dresche
Gedächtnissen	Gedächtnissen
Körpergeruches	Körpergeruches
Kreise	Kreise
erzürnet	erzürnet
Feldbett	Feldbett
Bote	Bote
Euter	Euter
Lazarett	Lazarett
Steuerwagen	Steuerwagen
tränke	tränke
streiten	streiten
verzeigt	verzeigt
sagst	sagst
verschlingt	verschlingt
blenden	blenden
Artischocken	Artischocken
Komponistin	Komponistin
begehrend	begehrend
Teekessel	Teekessel
betrügen	betrügen
unterwerft	unterwerft
tanze	tanze
aber	aber
Geliebte	Geliebte
murmelten	murmelten
Empörung	Empörung
besprächen	besprächen
Seehechte	Seehechte
Homodimere	Homodimere
Borkenkäfer	Borkenkäfer
produzierte	produzierte
Korrosionsschutzen	Korrosionsschutzen
löset	löset
verblutete	verblutete
Gibt	Gibt
begehr	begehr
Bonzen	Bonzen
Flosse	Flosse
Sorget	Sorget
erschütterte	erschütterte
Volltreffer	Volltreffer
wehrte	wehrte
plissieren	plissieren
haben	haben
dirigiert	dirigiert
Germanisten	Germanisten
Zensus	Zensus
Aufträgen	Aufträgen
neidest	neidest
Epoxiden	Epoxiden
geleitest	geleitest
unterrichtet	unterrichtet
zwingst	zwingst
verführtest	verführtest
funktionalisiertest	funktionalisiertest
Seelöwen	Seelöwen
Milzen	Milzen
Schneider	Schneider
Ringeltaube	Ringeltaube
nächste	nächste
spritzt	spritzt
negierest	negierest
gedenkt	gedenkt
schmuste	schmuste
Arreste	Arreste
Blockflöten	Blockflöten
Minimierungen	Minimierungen
Rechnungen	Rechnungen
schreiben	schreiben
kabbelnd	kabbelnd
Mammut	Mammut
Küstenwachen	Küstenwachen
fasset	fasset
strullerst	strullerst
Raucherinnen	Raucherinnen
Pflanzungen	Pflanzungen
beteuerten	beteuerten
raubte	raubte
Aha-Erlebnisse	Aha-Erlebnisse
mußt	mußt
spiele	spiele
trotzt	trotzt
Türme	Türme
versuchet	versuchet
salz	salz
lehre	lehre
Färsen	Färsen
Geflecktheit	Geflecktheit
Signalen	Signalen
explodierst	explodierst
drangen	drangen
Schrei	Schrei
redetet	redetet
gelobest	gelobest
Nahrungsbestandteilen	Nahrungsbestandteilen
Herbstwinde	Herbstwinde
formirte	formirte
Schnipsel	Schnipsel
Bluffs	Bluffs
härte	härte
gedolmetscht	gedolmetscht
Aerosolen	Aerosolen
Gruftis	Gruftis
begründest	begründest
Plüschtier	Plüschtier
beklagte	beklagte
Denkmünzen	Denkmünzen
bebet	bebet
dümpelt	dümpelt
predig	predig
Tyrann	Tyrann
überlieferten	überlieferten
weichest	weichest
vertrieb	vertrieb
Klärungen	Klärungen
Lärchen	Lärchen
beweisen	beweisen
quantisiere	quantisiere
Verbindungsdrähten	Verbindungsdrähten
füsilierten	füsilierten
Wühltischen	Wühltischen
evaluierten	evaluierten
Bevölkerungsdichten	Bevölkerungsdichten
Aromastoffe	Aromastoffe
Zirkelschluss	Zirkelschluss
Hochzeitstorten	Hochzeitstorten
Oheim	Oheim
Pforten	Pforten
löstest	löstest
verglichest	verglichest
Satzung	Satzung
Elementarzellen	Elementarzellen
betrübt	betrübt
eroberte	eroberte
Brieföffners	Brieföffners
lösend	lösend
bölket	bölket
beeindrucket	beeindrucket
überfallen	überfallen
pharyngalisierten	pharyngalisierten
Technikerinnen	Technikerinnen
Sanatoriums	Sanatoriums
sollt	sollt
impfte	impfte
Kaffeelöffel	Kaffeelöffel
reizte	reizte
verspäteten	verspäteten
Stiefmütterchen	Stiefmütterchen
straftet	straftet
zählet	zählet
kräuselten	kräuselten
verdammst	verdammst
prostituierte	prostituierte
Halleluja	Halleluja
kämpfet	kämpfet
Senkungen	Senkungen
rolltet	rolltet
haste	haste
Perle	Perle
verirrt	verirrt
Werkzeugen	Werkzeugen
klonet	klonet
verunreinigt	verunreinigt
sortierte	sortierte
Fromme	Fromme
Geschrei	Geschrei
Palästen	Palästen
Wüste	Wüste
gedachte	gedachte
optimierte	optimierte
plissiere	plissiere
Kraftfahrzeugen	Kraftfahrzeugen
Tiefschutz	Tiefschutz
stille	stille
Füchsin	Füchsin
überwachest	überwachest
verachtet	verachtet
vergleichet	vergleichet
Diagnostik	Diagnostik
misstrauen	misstrauen
Stör	Stör
gafften	gafften
knüpfen	knüpfen
Hehlern	Hehlern
wiederkamt	wiederkamt
reimte	reimte
blitzt	blitzt
mästest	mästest
Teilen	Teilen
dirigieret	dirigieret
Freizeitzentrum	Freizeitzentrum
veranstaltest	veranstaltest
lüg	lüg
Geburtsnamen	Geburtsnamen
Nigger	Nigger
verdunstet	verdunstet
sinnst	sinnst
keines	keines
Stätte	Stätte
misstrauest	misstrauest
Erdboden	Erdboden
ehrest	ehrest
laufe	laufe
Berichterstattungen	Berichterstattungen
Astats	Astats
wilde	wilde
Welteninseln	Welteninseln
helft	helft
hüpfest	hüpfest
hinterlege	hinterlege
knüpfte	knüpfte
Rückweg	Rückweg
Schlöte	Schlöte
Paillette	Paillette
Aderhäuten	Aderhäuten
Ionen	Ionen
Klassenzimmer	Klassenzimmer
ziert	ziert
duckmäuseret	duckmäuseret
betätigtet	betätigtet
Kuttern	Kuttern
kämmt	kämmt
Weißflügelpinguin	Weißflügelpinguin
Bildschirmfotos	Bildschirmfotos
Quellflüssen	Quellflüssen
nehmet	nehmet
mein	mein
Molybdit	Molybdit
verselbstständige	verselbstständige
Bebauungsplänen	Bebauungsplänen
beider	beider
Rechenbrett	Rechenbrett
Linke	Linke
verdammte	verdammte
Fiasko	Fiasko
Sucht	Sucht
labe	labe
brenne	brenne
ausgehst	ausgehst
verteidigt	verteidigt
Handbüchern	Handbüchern
sprühend	sprühend
zerstreut	zerstreut
Trinket	Trinket
Suchanfragen	Suchanfragen
Wachtel	Wachtel
vernichtete	vernichtete
handhabt	handhabt
zeugten	zeugten
wispern	wispern
pflegte	pflegte
Braunrallen	Braunrallen
bejubelte	bejubelte
stimme	stimme
Freizeitzentren	Freizeitzentren
veranstalten	veranstalten
gebären	gebären
erstehet	erstehet
Fingerhüten	Fingerhüten
Nachweisreagenzien	Nachweisreagenzien
Buchfinken	Buchfinken
mischst	mischst
lautete	lautete
tut	tut
eure	eure
frappierte	frappierte
hängen	hängen
rangierst	rangierst
erfüllt	erfüllt
Fiebermitteln	Fiebermitteln
Schläfchens	Schläfchens
scheinest	scheinest
Einfältigkeiten	Einfältigkeiten
Werken	Werken
losest	losest
regelet	regelet
anrichte	anrichte
mußten	mußten
stärkte	stärkte
verstehst	verstehst
verlobt	verlobt
downloadete	downloadete
beteuerest	beteuerest
Krusten	Krusten
föchten	föchten
möppertet	möppertet
trägt	trägt
Treppen	Treppen
beides	beides
Sauberfrau	Sauberfrau
bollerte	bollerte
verlasset	verlasset
erstaunst	erstaunst
Anzeichen	Anzeichen
betrete	betrete
punkteten	punkteten
beneidete	beneidete
schwenkt	schwenkt
wohnst	wohnst
motivierte	motivierte
verzieht	verzieht
stoßest	stoßest
Schreiber	Schreiber
Denunziationen	Denunziationen
panaschieret	panaschieret
Alte	Alte
Denkmünze	Denkmünze
Lüsten	Lüsten
Silbererze	Silbererze
Störe	Störe
formirend	formirend
Lautwandel	Lautwandel
Berufen	Berufen
verschonet	verschonet
Frommen	Frommen
Adamsäpfeln	Adamsäpfeln
Chasaren	Chasaren
frohlockest	frohlockest
legten	legten
vertiefe	vertiefe
reif	reif
tust	tust
Epiker	Epiker
ringele	ringele
Feind	Feind
versuchst	versuchst
Bäusche	Bäusche
wache	wache
weinet	weinet
plagte	plagte
härten	härten
taufe	taufe
tattre	tattre
Arsenolithen	Arsenolithen
versteckten	versteckten
versklavte	versklavte
Blockflöte	Blockflöte
verschmelzen	verschmelzen
Mischelement	Mischelement
Leichtmetalle	Leichtmetalle
heißet	heißet
Halsabschneidern	Halsabschneidern
Chlorwasserstoffmolekül	Chlorwasserstoffmolekül
kauern	kauern
grün	grün
torpedieret	torpedieret
eingeht	eingeht
präsentier	präsentier
Verwaltungsakten	Verwaltungsakten
piesackest	piesackest
argumentierten	argumentierten
Kautschuken	Kautschuken
sehnte	sehnte
Schwarzseherin	Schwarzseherin
schützt	schützt
links	links
verrostet	verrostet
leider	leider
erzwangt	erzwangt
trüb	trüb
NAND-Gatter	NAND-Gatter
stimmte	stimmte
Alkin	Alkin
ermahnt	ermahnt
Trägerwellen	Trägerwellen
Reinelemente	Reinelemente
Älteste	Älteste
speist	speist
jappte	jappte
betätigest	betätigest
Laiben	Laiben
verspielest	verspielest
sterilisiert	sterilisiert
fingieret	fingieret
Donnerstagabenden	Donnerstagabenden
Mischung	Mischung
verfolgt	verfolgt
Gesamtmengen	Gesamtmengen
Drillinge	Drillinge
Kürasse	Kürasse
protestierst	protestierst
Vorstoß	Vorstoß
verbrauchten	verbrauchten
Teufeln	Teufeln
Premierministerinnen	Premierministerinnen
huren	huren
räucheret	räucheret
Feuerteufel	Feuerteufel
Steige	Steige
drücke	drücke
hüpfen	hüpfen
Barbareien	Barbareien
aufsteht	aufsteht
besorgt	besorgt
Nullpunktes	Nullpunktes
Schaffe	Schaffe
repräsentierten	repräsentierten
reglementiert	reglementiert
trödeltest	trödeltest
Version	Version
Solche	Solche
überdächte	überdächte
gewitterte	gewitterte
Bergsteiger	Bergsteiger
werft	werft
belüftete	belüftete
belauere	belauere
gedenket	gedenket
Tasten	Tasten
kürzten	kürzten
Taschendiebe	Taschendiebe
kichert	kichert
frottier	frottier
Pforte	Pforte
wirft	wirft
sabbelten	sabbelten
schmuggle	schmuggle
erbet	erbet
schämst	schämst
Crescendos	Crescendos
Pfandgeld	Pfandgeld
Schreibtischtätern	Schreibtischtätern
Trübsal	Trübsal
Samen	Samen
Abkömmling	Abkömmling
Deinen	Deinen
lehrte	lehrte
tobte	tobte
erpress	erpress
Dünungen	Dünungen
Briketten	Briketten
höbet	höbet
verzehrst	verzehrst
wehrten	wehrten
Germanist	Germanist
Brieftaubenzüchter	Brieftaubenzüchter
liegen	liegen
beschuldiget	beschuldiget
Weg	Weg
blättertet	blättertet
verlieren	verlieren
manövrierte	manövrierte
klingest	klingest
Halbmond	Halbmond
fressen	fressen
Fischer	Fischer
Ludwigsburger	Ludwigsburger
erziehst	erziehst
Kuckucken	Kuckucken
bewahrheitete	bewahrheitete
beanspruchet	beanspruchet
Atombomben	Atombomben
kreieren	kreieren
helfet	helfet
schätze	schätze
Polizeisprecher	Polizeisprecher
initiieret	initiieret
erfahrt	erfahrt
verwaiset	verwaiset
sagtet	sagtet
Schulleiterin	Schulleiterin
pfände	pfände
Karikaturistinnen	Karikaturistinnen
zuppte	zuppte
funktioniertest	funktioniertest
Gedränge	Gedränge
Autoklav	Autoklav
Prügelstrafen	Prügelstrafen
flötete	flötete
denaturierte	denaturierte
schneide	schneide
Brettspiele	Brettspiele
weissagten	weissagten
Strontiumamalgamen	Strontiumamalgamen
werfet	werfet
Brieftaubenzüchters	Brieftaubenzüchters
neigest	neigest
Schwan	Schwan
unseres	unseres
glauben	glauben
Decks	Decks
bündelten	bündelten
rühmst	rühmst
vermutest	vermutest
planschtest	planschtest
eiterten	eiterten
merkte	merkte
Argyroditen	Argyroditen
ihrem	ihrem
enterten	enterten
Tukanen	Tukanen
funzt	funzt
Schneepflug	Schneepflug
Badezimmers	Badezimmers
haarte	haarte
rebellieren	rebellieren
grünten	grünten
entschädigte	entschädigte
orgelt	orgelt
emittiert	emittiert
Krieg	Krieg
Verselbstständigung	Verselbstständigung
kämpfen	kämpfen
amenagier	amenagier
bedürftet	bedürftet
offenbare	offenbare
außen	außen
setzen	setzen
leget	leget
substituierest	substituierest
verrosteten	verrosteten
Unwahrheiten	Unwahrheiten
Rhabarber	Rhabarber
Finanzministerium	Finanzministerium
eskaliert	eskaliert
leset	leset
implodiere	implodiere
grünen	grünen
posierten	posierten
lebte	lebte
grüßen	grüßen
Arbeitskreis	Arbeitskreis
Anlass	Anlass
erlöse	erlöse
Agoraphobie	Agoraphobie
Bärenfellen	Bärenfellen
entschädiget	entschädiget
schummelst	schummelst
regiertest	regiertest
Pflanzung	Pflanzung
zertifizierst	zertifizierst
unterscheide	unterscheide
ausfuhr	ausfuhr
häufe	häufe
Aerosole	Aerosole
Zwingburg	Zwingburg
hadere	hadere
berührt	berührt
Aachener	Aachener
beschwöre	beschwöre
Halbgott	Halbgott
Gleitzeit	Gleitzeit
lostest	lostest
säte	säte
Geschwindigkeitsmessern	Geschwindigkeitsmessern
Bromidquellen	Bromidquellen
kaserniert	kaserniert
Brandbeschleuniger	Brandbeschleuniger
Tiefen	Tiefen
antworte	antworte
beschwindele	beschwindele
erlöset	erlöset
backen	backen
gehorchest	gehorchest
meuternd	meuternd
besprachen	besprachen
Karern	Karern
vierte	vierte
überfischte	überfischte
steigerten	steigerten
Gewicht	Gewicht
verkündigst	verkündigst
amputiere	amputiere
besinnen	besinnen
fritiert	fritiert
folget	folget
schöpfen	schöpfen
schaffe	schaffe
Mageninhalten	Mageninhalten
langweiltest	langweiltest
wurstelten	wurstelten
knurrtet	knurrtet
begraben	begraben
lögest	lögest
verstörte	verstörte
legend	legend
verfehlten	verfehlten
verurteile	verurteile
versteigerest	versteigerest
Schlaraffenlandes	Schlaraffenlandes
Abschirmung	Abschirmung
pensionierten	pensionierten
Talismanen	Talismanen
begrub	begrub
Achseln	Achseln
hastete	hastete
weinen	weinen
nachwandelt	nachwandelt
mineralisierten	mineralisierten
seht	seht
schauend	schauend
kehre	kehre
süsse	süsse
polymerisierte	polymerisierte
Reichweite	Reichweite
rebellieret	rebellieret
pulsiert	pulsiert
Andrologie	Andrologie
Vollkornbrot	Vollkornbrot
Exzentriker	Exzentriker
Begünstigungen	Begünstigungen
tattert	tattert
Krankenscheinen	Krankenscheinen
säusele	säusele
Grenzwert	Grenzwert
Anachronismen	Anachronismen
Fettsäcken	Fettsäcken
bekotete	bekotete
verzögerte	verzögerte
Händedrücken	Händedrücken
Liebchen	Liebchen
Höret	Höret
Strafräume	Strafräume
führst	führst
gedurft	gedurft
respektierten	respektierten
dramatisieren	dramatisieren
verwirft	verwirft
löse	löse
Gymnasien	Gymnasien
Fingerspitze	Fingerspitze
konnotieret	konnotieret
bestellte	bestellte
Hinterwäldler	Hinterwäldler
quatschen	quatschen
Bruchstrich	Bruchstrich
linsten	linsten
Pausbacke	Pausbacke
Basilisk	Basilisk
Herabsetzungen	Herabsetzungen
wurde	wurde
Aluminaten	Aluminaten
erhebet	erhebet
gequasselt	gequasselt
bereiten	bereiten
filzte	filzte
Arsch	Arsch
Taschendieb	Taschendieb
gebietet	gebietet
mästet	mästet
Falzen	Falzen
folge	folge
Stärket	Stärket
Extremen	Extremen
Leugnungen	Leugnungen
reparieret	reparieret
Hörst	Hörst
erfreuen	erfreuen
Verkehrsflugzeug	Verkehrsflugzeug
assimilierte	assimilierte
erzwinget	erzwinget
widmend	widmend
Anachronismus	Anachronismus
Dewargefäße	Dewargefäße
führe	führe
Steuerberatern	Steuerberatern
Irrtumes	Irrtumes
massierend	massierend
Koniferen	Koniferen
Schwebfliegen	Schwebfliegen
Betainen	Betainen
nehmest	nehmest
verunglimpfen	verunglimpfen
pendelt	pendelt
entert	entert
unterstützten	unterstützten
Aase	Aase
alle	alle
Besuchen	Besuchen
Türmen	Türmen
überfischt	überfischt
producieret	producieret
außer	außer
dirigieren	dirigieren
Sorge	Sorge
verscheißert	verscheißert
malet	malet
Planer	Planer
strecken	strecken
Firnisse	Firnisse
verbluteten	verbluteten
schwadroniert	schwadroniert
platz	platz
vermischten	vermischten
Bifurkationen	Bifurkationen
Heringen	Heringen
zentrifugieren	zentrifugieren
Hahnenkämmen	Hahnenkämmen
Warten	Warten
Rücktrittbremse	Rücktrittbremse
habt	habt
immunisiere	immunisiere
schaute	schaute
begnügt	begnügt
WebHook	WebHook
bürsteten	bürsteten
strandend	strandend
Achatschnecken	Achatschnecken
reinigst	reinigst
Funkfeuern	Funkfeuern
schlafest	schlafest
hinterfragst	hinterfragst
dotierst	dotierst
Raucherin	Raucherin
leertet	leertet
Asylrechte	Asylrechte
schämet	schämet
Käsereiben	Käsereiben
Atommodellen	Atommodellen
straften	straften
geherrscht	geherrscht
Atemlüfte	Atemlüfte
Operationssaal	Operationssaal
spezialisierst	spezialisierst
vollendest	vollendest
Flöte	Flöte
besitzest	besitzest
spekuliere	spekuliere
Geringschätzung	Geringschätzung
begrübest	begrübest
Klauen	Klauen
finanziert	finanziert
Molybdite	Molybdite
erklingt	erklingt
Borhydride	Borhydride
Spurensicherung	Spurensicherung
erhöhet	erhöhet
Ackerschachtelhalme	Ackerschachtelhalme
quatschest	quatschest
Metapher	Metapher
fladerest	fladerest
Kirchhof	Kirchhof
Zebrahai	Zebrahai
erscheine	erscheine
bekannte	bekannte
Sexten	Sexten
Raben	Raben
Renegat	Renegat
habet	habet
Uranerzen	Uranerzen
besorgend	besorgend
posiertet	posiertet
Böreks	Böreks
verboten	verboten
Sollte	Sollte
Briefwechsel	Briefwechsel
stürzt	stürzt
falle	falle
liegst	liegst
schlaft	schlaft
glawbte	glawbte
unterschieden	unterschieden
erlösen	erlösen
Putschisten	Putschisten
Entsetzt	Entsetzt
bist	bist
schauet	schauet
drängest	drängest
Loparite	Loparite
verscheißerte	verscheißerte
blitze	blitze
funzen	funzen
erwärmst	erwärmst
Unter	Unter
Meinet	Meinet
begehrtest	begehrtest
Eisenkräutern	Eisenkräutern
schwängen	schwängen
liehe	liehe
Gummibaumes	Gummibaumes
Untiefe	Untiefe
Nanosatellit	Nanosatellit
Wiederauferstehungen	Wiederauferstehungen
Playlists	Playlists
duckt	duckt
koexistierte	koexistierte
steigeret	steigeret
Trockendocks	Trockendocks
Weichseln	Weichseln
tragt	tragt
Flussbetten	Flussbetten
verschickte	verschickte
Somite	Somite
säume	säume
verweise	verweise
Werk	Werk
Gigapascal	Gigapascal
erscheinest	erscheinest
Welpen	Welpen
beschrifte	beschrifte
Äther	Äther
Schaffnerinnen	Schaffnerinnen
platzt	platzt
lüftet	lüftet
Volkslehren	Volkslehren
angehöret	angehöret
baten	baten
Fotosynthese	Fotosynthese
Alles	Alles
Weiblein	Weiblein
radiertest	radiertest
scherze	scherze
haare	haare
gekröst	gekröst
Solchen	Solchen
vertreibe	vertreibe
Ratsherr	Ratsherr
schleißt	schleißt
Skorpione	Skorpione
Mikrometer	Mikrometer
überdenkend	überdenkend
grien	grien
repräsentieret	repräsentieret
Steuerborden	Steuerborden
assimiliertest	assimiliertest
inhalier	inhalier
Beziehung	Beziehung
blaset	blaset
Vorstädten	Vorstädten
Brotkästen	Brotkästen
Armband	Armband
trotze	trotze
Scheißkerlen	Scheißkerlen
Jagdbomber	Jagdbomber
Tore	Tore
begnadigst	begnadigst
zuhörte	zuhörte
Cholesterin	Cholesterin
Beiblättern	Beiblättern
warte	warte
Weichlote	Weichlote
Käsereibe	Käsereibe
rufe	rufe
weine	weine
aasend	aasend
strandeten	strandeten
Abschirmungen	Abschirmungen
Fusseln	Fusseln
dunkelten	dunkelten
Bestecken	Bestecken
werde	werde
verließet	verließet
schimmerst	schimmerst
Nagellackentferner	Nagellackentferner
enttäusche	enttäusche
zeugen	zeugen
bewerbet	bewerbet
blende	blende
möge	möge
strafend	strafend
Krankenschein	Krankenschein
gravierten	gravierten
verführen	verführen
Drehtüren	Drehtüren
glänzte	glänzte
mobilisierten	mobilisierten
Amputierte	Amputierte
diversifiziere	diversifiziere
Siglen	Siglen
zupftet	zupftet
vereinbaren	vereinbaren
Trockendock	Trockendock
ernte	ernte
Lotterien	Lotterien
Würzen	Würzen
bedingst	bedingst
kappten	kappten
WebHooks	WebHooks
Busen	Busen
zuteilte	zuteilte
Binde	Binde
verstecktet	verstecktet
stapfst	stapfst
stellet	stellet
verschlungen	verschlungen
Lautwandeln	Lautwandeln
Grenzen	Grenzen
wehte	wehte
Wasserquellen	Wasserquellen
Tiefe	Tiefe
grünte	grünte
fälle	fälle
Urbaren	Urbaren
leide	leide
bereitet	bereitet
wehren	wehren
grüßet	grüßet
Rutheniumkomplex	Rutheniumkomplex
massierst	massierst
reichst	reichst
klöne	klöne
stellte	stellte
Notständen	Notständen
schreibst	schreibst
Spießen	Spießen
Entsetzet	Entsetzet
Jünger	Jünger
maß	maß
schiesst	schiesst
fluppst	fluppst
Meinem	Meinem
flupptest	flupptest
eures	eures
Selbstversuche	Selbstversuche
Bärte	Bärte
Beobachtung	Beobachtung
Fahrzeugkatalysatoren	Fahrzeugkatalysatoren
Mähnenwolf	Mähnenwolf
schau	schau
erntest	erntest
Industrienation	Industrienation
dramatisiert	dramatisiert
Flossen	Flossen
Futtermittel	Futtermittel
Zapfhahn	Zapfhahn
betrüben	betrüben
Präservativs	Präservativs
Fahrt	Fahrt
Arbeitsbereich	Arbeitsbereich
tätowiertet	tätowiertet
Gewinnungen	Gewinnungen
verbesserten	verbesserten
rede	rede
erlösest	erlösest
durften	durften
bündelet	bündelet
Libelle	Libelle
geloben	geloben
Gefängnisse	Gefängnisse
Schwirrvögel	Schwirrvögel
verhalten	verhalten
klagte	klagte
aufkommt	aufkommt
loste	loste
Energiespeicher	Energiespeicher
räumet	räumet
sterbet	sterbet
Wolfesgrube	Wolfesgrube
begehrst	begehrst
begnügte	begnügte
Uranerz	Uranerz
Katz-und-Maus-Spiele	Katz-und-Maus-Spiele
verführe	verführe
Gedrängen	Gedrängen
Ausländer	Ausländer
verselbstständigest	verselbstständigest
folg	folg
verkündigten	verkündigten
Apostels	Apostels
fehle	fehle
auszieht	auszieht
Shortcut	Shortcut
Maultiere	Maultiere
kritzelet	kritzelet
kabelten	kabelten
mußte	mußte
Galeeren	Galeeren
gewährtest	gewährtest
stammelest	stammelest
velarisiert	velarisiert
Heeren	Heeren
verdunsten	verdunsten
Fadenlauf	Fadenlauf
Hochsommer	Hochsommer
pfänden	pfänden
verdränget	verdränget
dienet	dienet
gestalten	gestalten
Abkömmlingen	Abkömmlingen
Großfürst	Großfürst
optimiert	optimiert
Metaphern	Metaphern
schließe	schließe
erzürnst	erzürnst
frohlocke	frohlocke
zürnst	zürnst
musizieret	musizieret
gehört	gehört
zürnest	zürnest
erforscht	erforscht
herrschst	herrschst
Deck	Deck
liste	liste
verfinstere	verfinstere
imkernd	imkernd
Mache	Mache
Wehklagen	Wehklagen
dritten	dritten
appellierte	appellierte
erinnerest	erinnerest
Zubrötchen	Zubrötchen
zuppst	zuppst
schautest	schautest
Sorgen	Sorgen
Smaragdkehlkolibris	Smaragdkehlkolibris
schnorrest	schnorrest
blondieren	blondieren
Unrecht	Unrecht
Reinelementen	Reinelementen
weichet	weichet
Schnarchralle	Schnarchralle
Apportierhunde	Apportierhunde
weg	weg
verarbeite	verarbeite
Tübinger	Tübinger
föchte	föchte
Isobars	Isobars
Reststoffen	Reststoffen
Gespenstern	Gespenstern
suchen	suchen
häuftet	häuftet
sezierte	sezierte
fritierten	fritierten
zappen	zappen
offenbarest	offenbarest
Kalifeldspate	Kalifeldspate
Uterus	Uterus
notlande	notlande
Blitzableiter	Blitzableiter
verforme	verforme
Temperaturanstiege	Temperaturanstiege
verewiget	verewiget
ärgertest	ärgertest
Golfplätzen	Golfplätzen
beeinflusst	beeinflusst
schlachtet	schlachtet
Tiegel	Tiegel
Reinigungsschritten	Reinigungsschritten
Körpergeruch	Körpergeruch
Pflanzenwachstum	Pflanzenwachstum
Landstreicher	Landstreicher
verdränge	verdränge
Zwergschwan	Zwergschwan
Staatsführungen	Staatsführungen
tatteret	tatteret
Schilde	Schilde
Fallen	Fallen
blätteret	blätteret
Alltag	Alltag
Zehe	Zehe
Radiergummi	Radiergummi
Vorhäute	Vorhäute
Flaschenhälsen	Flaschenhälsen
sezierst	sezierst
besehet	besehet
Pinguinen	Pinguinen
lösen	lösen
kramten	kramten
Deuteriums	Deuteriums
konnten	konnten
hupen	hupen
stickt	stickt
entzögen	entzögen
velarisierend	velarisierend
sponsert	sponsert
Kapitalverkehr	Kapitalverkehr
schnürest	schnürest
Noseans	Noseans
Nussknacker	Nussknacker
beschrifteten	beschrifteten
Atommasse	Atommasse
schmiert	schmiert
listeten	listeten
traueret	traueret
hämmerte	hämmerte
Lehrbüchern	Lehrbüchern
betrübest	betrübest
Zapfen	Zapfen
Ich	Ich
erobern	erobern
Graben	Graben
Schamentzündungen	Schamentzündungen
verklagst	verklagst
demütiget	demütiget
Deckenfarbe	Deckenfarbe
Genkinit	Genkinit
Buchstaben	Buchstaben
schreie	schreie
erwachend	erwachend
Genie	Genie
verhalte	verhalte
entheiligten	entheiligten
absolviere	absolviere
babbeltet	babbeltet
Entrées	Entrées
trübe	trübe
reparierten	reparierten
folgt	folgt
nähernd	nähernd
Schneepflüge	Schneepflüge
bedeckest	bedeckest
Assistentinnen	Assistentinnen
Planern	Planern
Nanokondensatoren	Nanokondensatoren
Signal	Signal
Jungfernflüge	Jungfernflüge
dressieret	dressieret
verzeichne	verzeichne
Ente	Ente
Besprechungen	Besprechungen
drängst	drängst
Lusitaner	Lusitaner
Geber	Geber
Gasgemisch	Gasgemisch
erkennest	erkennest
konnte	konnte
nähe	nähe
Aussätzige	Aussätzige
grienest	grienest
Teekesseln	Teekesseln
Beilen	Beilen
Einwirkungen	Einwirkungen
benütztest	benütztest
protestiere	protestiere
Öfchen	Öfchen
erschüttere	erschüttere
begeben	begeben
Innenschau	Innenschau
belohnten	belohnten
auflöst	auflöst
Konfitüre	Konfitüre
Zeithorizonte	Zeithorizonte
bewässern	bewässern
tabuisiert	tabuisiert
Traggasen	Traggasen
streifte	streifte
Stiefvater	Stiefvater
Notizen	Notizen
verwahrst	verwahrst
heiße	heiße
Riegel	Riegel
bewahrt	bewahrt
Münzsammlungen	Münzsammlungen
ratschlaget	ratschlaget
Graphem	Graphem
Verkehrsflugzeuge	Verkehrsflugzeuge
glaube	glaube
verbluten	verbluten
Samarskit	Samarskit
schaust	schaust
Katz-und-Maus-Spielen	Katz-und-Maus-Spielen
mögest	mögest
designiertet	designiertet
verdeckten	verdeckten
Wänden	Wänden
fallen	fallen
verringeret	verringeret
speichertest	speichertest
Fluorgehalt	Fluorgehalt
kürzt	kürzt
lauft	lauft
Fürst	Fürst
spurtest	spurtest
Versorgungen	Versorgungen
Brieföffner	Brieföffner
grabe	grabe
unsrer	unsrer
Kardinäle	Kardinäle
malt	malt
machet	machet
Android	Android
reanimierten	reanimierten
offenbar	offenbar
revoltieren	revoltieren
verlötest	verlötest
Geliebten	Geliebten
schwächend	schwächend
lösten	lösten
knusperst	knusperst
ermächtigest	ermächtigest
verklärest	verklärest
kupieren	kupieren
greifen	greifen
verlobte	verlobte
Komplexionen	Komplexionen
möchten	möchten
ruhte	ruhte
Prüfberichten	Prüfberichten
liebend	liebend
bereuest	bereuest
versagt	versagt
hantiert	hantiert
Renegaten	Renegaten
brause	brause
fritieret	fritieret
Erzeugungen	Erzeugungen
halbe	halbe
Nachteilen	Nachteilen
segeln	segeln
Garben	Garben
berufen	berufen
googelest	googelest
umhüllend	umhüllend
kollidierten	kollidierten
Selbstversuchen	Selbstversuchen
bückest	bückest
schlabberte	schlabberte
Buntwaschmittel	Buntwaschmittel
freute	freute
Numerus	Numerus
kabeln	kabeln
tendierst	tendierst
Strohhälmchen	Strohhälmchen
sehnst	sehnst
verlasse	verlasse
Eiland	Eiland
verzehre	verzehre
Astat	Astat
verschärfst	verschärfst
Rubine	Rubine
Serverzugriffen	Serverzugriffen
zeugest	zeugest
nötige	nötige
meinen	meinen
Sonnenfinsternis	Sonnenfinsternis
Stoffwechselweg	Stoffwechselweg
Flame	Flame
grüßte	grüßte
bekriegt	bekriegt
Frage	Frage
streckst	streckst
behalte	behalte
entmineralisieren	entmineralisieren
unseren	unseren
Vergrößerungen	Vergrößerungen
Fußbodens	Fußbodens
regieren	regieren
Erfahrungen	Erfahrungen
Noseanen	Noseanen
pustet	pustet
ringen	ringen
argumentierest	argumentierest
hintertreibt	hintertreibt
Funktionalität	Funktionalität
evakuierte	evakuierte
sollten	sollten
Kohlenstoffgehalt	Kohlenstoffgehalt
Geschichtsbüchern	Geschichtsbüchern
Träumer	Träumer
verkürztest	verkürztest
Funkfeuer	Funkfeuer
Lob	Lob
Wer	Wer
sagt	sagt
konstatiere	konstatiere
Galeere	Galeere
Sportlerin	Sportlerin
babbelt	babbelt
berufe	berufe
Rabe	Rabe
schlafet	schlafet
zeug	zeug
Minimierung	Minimierung
fahret	fahret
hänge	hänge
Rotgusses	Rotgusses
besetzen	besetzen
Spektralbereichen	Spektralbereichen
zerrissen	zerrissen
knacktest	knacktest
wischt	wischt
nötig	nötig
drescht	drescht
verknüpft	verknüpft
Beschuldigungen	Beschuldigungen
exmatrikulierte	exmatrikulierte
babbelst	babbelst
gehören	gehören
kritzeln	kritzeln
Patres	Patres
zelte	zelte
Forschung	Forschung
fluche	fluche
motivieren	motivieren
Haarverlust	Haarverlust
Wurzelwachstum	Wurzelwachstum
Einsatz	Einsatz
konvertiere	konvertiere
Küstenwache	Küstenwache
Desserts	Desserts
Arbeitsleistung	Arbeitsleistung
brillierest	brillierest
eiterte	eiterte
seit	seit
kaufe	kaufe
Kandidaturen	Kandidaturen
ersparet	ersparet
erratet	erratet
verlautet	verlautet
fragest	fragest
Sabotagen	Sabotagen
spähet	spähet
Geckos	Geckos
gehst	gehst
Türkenbünden	Türkenbünden
trauerten	trauerten
Mutagenen	Mutagenen
pressiere	pressiere
Telefonnummer	Telefonnummer
Kernspaltung	Kernspaltung
aufstehet	aufstehet
Rutheniumkomplexen	Rutheniumkomplexen
Grüße	Grüße
Omnibus	Omnibus
Puffersystemen	Puffersystemen
Rückumschlages	Rückumschlages
Treppe	Treppe
Gespenst	Gespenst
Tetraiodiden	Tetraiodiden
Zipfelmütze	Zipfelmütze
Stiefvätern	Stiefvätern
Hälmchen	Hälmchen
Dochten	Dochten
Zebrahaies	Zebrahaies
Briefköpfen	Briefköpfen
reformierten	reformierten
schöben	schöben
gönnest	gönnest
Californium	Californium
gehörten	gehörten
Atmosphäre	Atmosphäre
Geflecktheiten	Geflecktheiten
Wollte	Wollte
Tintenfische	Tintenfische
bestimmst	bestimmst
vertonet	vertonet
Falle	Falle
wässerst	wässerst
Euphemismus	Euphemismus
streue	streue
umgäben	umgäben
Metallothionein	Metallothionein
widerriefe	widerriefe
setze	setze
Verdacht	Verdacht
führen	führen
Hobby	Hobby
Imperialismen	Imperialismen
Dienstgrad	Dienstgrad
Zeitschlitzen	Zeitschlitzen
kremieren	kremieren
Trinkgefäßen	Trinkgefäßen
erben	erben
maximiere	maximiere
erhört	erhört
gedächte	gedächte
erweckest	erweckest
zähle	zähle
versuchten	versuchten
scheiterst	scheiterst
regeln	regeln
Arbeitsgruppen	Arbeitsgruppen
beiden	beiden
Antitranspiranten	Antitranspiranten
kauerten	kauerten
Ass	Ass
Safrane	Safrane
verdinglichtest	verdinglichtest
Hummern	Hummern
falteten	falteten
eskalieret	eskalieret
Trickbetrügern	Trickbetrügern
Dödeln	Dödeln
karikieret	karikieret
allem	allem
Ärztinnen	Ärztinnen
binden	binden
Atemgasen	Atemgasen
geselle	geselle
Schlaraffenländern	Schlaraffenländern
sortierest	sortierest
Gallanen	Gallanen
Hummel	Hummel
Tintenfisch	Tintenfisch
wiederholte	wiederholte
versüßtet	versüßtet
Höhe	Höhe
Linguisten	Linguisten
Wanderfalken	Wanderfalken
Riese	Riese
pensionierest	pensionierest
würdest	würdest
arbeit	arbeit
erwache	erwache
grüntet	grüntet
imitiert	imitiert
grübelte	grübelte
Entree	Entree
Führet	Führet
Genkinits	Genkinits
fistete	fistete
meldet	meldet
abweichet	abweichet
Überschüsse	Überschüsse
Schwänzen	Schwänzen
entkörperlichte	entkörperlichte
Wasserbädern	Wasserbädern
gedenk	gedenk
spritzet	spritzet
entsetzet	entsetzet
Nanosatelliten	Nanosatelliten
Wasserquelle	Wasserquelle
Bruchstriches	Bruchstriches
Indianern	Indianern
klage	klage
scheltet	scheltet
Einfältigkeit	Einfältigkeit
verlassen	verlassen
predigte	predigte
Kräften	Kräften
porträtiert	porträtiert
schimmerest	schimmerest
Adeliepinguin	Adeliepinguin
zeiget	zeiget
Literaturen	Literaturen
befehle	befehle
Kindergeld	Kindergeld
zürn	zürn
Bilderstürmereien	Bilderstürmereien
Pentaboraten	Pentaboraten
versteckst	versteckst
steuerte	steuerte
decke	decke
steig	steig
Sanatorien	Sanatorien
deinem	deinem
vertiefet	vertiefet
braust	braust
bedeckst	bedeckst
Machet	Machet
Last	Last
Paralipse	Paralipse
erntet	erntet
Peptids	Peptids
solchen	solchen
speicherten	speicherten
Gar	Gar
konnotierst	konnotierst
Messiassen	Messiassen
keine	keine
revoltiert	revoltiert
erniedrigst	erniedrigst
ausführe	ausführe
Unternehmung	Unternehmung
Blaumeisen	Blaumeisen
Quellen	Quellen
Halogenatomen	Halogenatomen
Lasten	Lasten
imitiertet	imitiertet
fülle	fülle
behaltest	behaltest
generiertet	generiertet
Ion	Ion
Bette	Bette
formulieren	formulieren
steckst	steckst
Iberer	Iberer
boykottierten	boykottierten
rebelliertet	rebelliertet
zweifeln	zweifeln
bescheiße	bescheiße
pilgerte	pilgerte
seufzt	seufzt
malträtierte	malträtierte
zentriert	zentriert
schlängelest	schlängelest
flöteten	flöteten
wünschst	wünschst
Epidemie	Epidemie
halte	halte
verkürze	verkürze
emendierte	emendierte
schmeichelest	schmeichelest
Maß	Maß
Neumonden	Neumonden
anhangt	anhangt
Einrädern	Einrädern
dampfst	dampfst
beweiset	beweiset
hassest	hassest
schluchze	schluchze
Rotzinkerz	Rotzinkerz
schlaget	schlaget
aase	aase
Abgaskatalysatoren	Abgaskatalysatoren
Kerzenfische	Kerzenfische
rechte	rechte
Küsserei	Küsserei
Organistin	Organistin
Höhen	Höhen
henket	henket
Hochhäuser	Hochhäuser
suchte	suchte
Friede	Friede
Gasflaschen	Gasflaschen
entkämen	entkämen
anrührt	anrührt
stoppte	stoppte
Dominicanerinnen	Dominicanerinnen
thematisierten	thematisierten
verdammt	verdammt
anrührte	anrührte
wäre	wäre
Freitagnachmittage	Freitagnachmittage
Trümmersprache	Trümmersprache
angehört	angehört
gründe	gründe
fünfte	fünfte
Gefängnissen	Gefängnissen
lest	lest
zählend	zählend
Atommassen	Atommassen
Leitkegeln	Leitkegeln
Schlagzeuger	Schlagzeuger
klappest	klappest
Selbstsicherheit	Selbstsicherheit
erbringst	erbringst
Entmachtung	Entmachtung
Maße	Maße
verachtend	verachtend
wolle	wolle
Türklingeln	Türklingeln
frohlockte	frohlockte
Soge	Soge
Gasen	Gasen
leben	leben
Bettlers	Bettlers
Schober	Schober
entsetzte	entsetzte
zweifelte	zweifelte
emittierte	emittierte
vermischen	vermischen
Zähnen	Zähnen
Herd	Herd
Same	Same
überquerst	überquerst
kram	kram
Urbare	Urbare
scheucht	scheucht
Trümmersprachen	Trümmersprachen
Harpune	Harpune
nützt	nützt
Darlegungen	Darlegungen
Konzentrate	Konzentrate
Geheimdienst	Geheimdienst
Biokraftstoffes	Biokraftstoffes
Dein	Dein
Beteiligte	Beteiligte
Ehre	Ehre
Drachenblut	Drachenblut
läuten	läuten
Früchtchen	Früchtchen
belohnte	belohnte
verschlimmere	verschlimmere
Grizzlybär	Grizzlybär
Dochte	Dochte
Bademäntel	Bademäntel
Gelobt	Gelobt
unterwerfest	unterwerfest
einigte	einigte
Mäuse	Mäuse
Piratensender	Piratensender
Insulaner	Insulaner
durchwachen	durchwachen
bollerest	bollerest
negierte	negierte
ratschlagte	ratschlagte
Rosinenkuchenmodell	Rosinenkuchenmodell
kauten	kauten
Trinken	Trinken
Ebenen	Ebenen
vibrierend	vibrierend
ertraget	ertraget
Braunralle	Braunralle
Mopp	Mopp
Kautschuke	Kautschuke
Gesetze	Gesetze
Schobern	Schobern
Quelle	Quelle
putzte	putzte
Botokuden	Botokuden
Aktienkurs	Aktienkurs
kapiertet	kapiertet
konntest	konntest
Gewalttätern	Gewalttätern
hantierte	hantierte
Fetzen	Fetzen
unterforderten	unterforderten
holst	holst
Knöllchens	Knöllchens
lieben	lieben
Heide	Heide
erniedrigt	erniedrigt
bemühten	bemühten
ermordeten	ermordeten
speisest	speisest
hure	hure
liebten	liebten
Krumen	Krumen
Beile	Beile
Glauben	Glauben
Gleitzeiten	Gleitzeiten
Arsenbergwerken	Arsenbergwerken
Vipernatter	Vipernatter
Kristallen	Kristallen
prostete	prostete
Spitzen	Spitzen
verselbständigst	verselbständigst
gebot	gebot
wisperten	wisperten
Abfertigungsgebäude	Abfertigungsgebäude
konsolidierest	konsolidierest
Brüder	Brüder
verziehe	verziehe
Obszönität	Obszönität
Beziehungen	Beziehungen
Füllfeder	Füllfeder
scheitern	scheitern
verwirrte	verwirrte
fällst	fällst
Schreiben	Schreiben
vor	vor
standet	standet
stoppten	stoppten
Politologen	Politologen
verzweigt	verzweigt
verschlimmerte	verschlimmerte
Leset	Leset
Wechselstube	Wechselstube
globalisieret	globalisieret
Polizeisprechern	Polizeisprechern
fabuliere	fabuliere
Lärche	Lärche
Untier	Untier
bimmelte	bimmelte
dehydrierte	dehydrierte
Adlerbussard	Adlerbussard
Videoaufzeichnung	Videoaufzeichnung
fette	fette
jauchzt	jauchzt
Wandergesellen	Wandergesellen
wälzt	wälzt
Kryostat	Kryostat
Adlerbussarden	Adlerbussarden
Leichnamen	Leichnamen
entfolgte	entfolgte
überschattet	überschattet
wetzte	wetzte
fragmentierst	fragmentierst
Kriege	Kriege
Wirte	Wirte
Bombardierung	Bombardierung
Kassiterits	Kassiterits
Friedensforscherinnen	Friedensforscherinnen
Schenke	Schenke
steuerst	steuerst
könnten	könnten
gewährte	gewährte
Vesper	Vesper
verdinglichest	verdinglichest
transportierte	transportierte
bemühet	bemühet
bewahrest	bewahrest
privilegierst	privilegierst
föhnten	föhnten
weisest	weisest
unterbewerte	unterbewerte
erriet	erriet
Säcken	Säcken
prostet	prostet
bemerken	bemerken
Chemikerinnen	Chemikerinnen
setztest	setztest
Drohkulisse	Drohkulisse
Nachteile	Nachteile
regiere	regiere
Benzol	Benzol
sehet	sehet
Brite	Brite
filzst	filzst
glaubet	glaubet
spezialisiere	spezialisiere
verringertet	verringertet
reagiert	reagiert
traget	traget
Kost	Kost
stelle	stelle
Rücktrittes	Rücktrittes
Blumensträußen	Blumensträußen
sabbre	sabbre
entfachten	entfachten
lachet	lachet
torpediert	torpediert
rammte	rammte
Saiblinge	Saiblinge
widerrufe	widerrufe
kollidierte	kollidierte
Harpunen	Harpunen
Ochse	Ochse
Strontiumamalgams	Strontiumamalgams
zürnte	zürnte
hintertriebe	hintertriebe
Portale	Portale
verkürzest	verkürzest
wurdest	wurdest
verziehen	verziehen
durchwacht	durchwacht
arm	arm
zwölfte	zwölfte
Zeitüberschreitung	Zeitüberschreitung
Stechpalmen	Stechpalmen
betreibet	betreibet
Carbiden	Carbiden
stillte	stillte
