hnefanum	hnefanum
treysta	treysta
færum	færum
fjöl	fjöl
teiknaðir	teiknaðir
dygðina	dygðina
málar	málar
hýdrat	hýdrat
valdi	valdi
hryggdýrið	hryggdýrið
akademíunum	akademíunum
þrengingunum	þrengingunum
hýstum	hýstum
hrætt	hrætt
samkomulag	samkomulag
jarðarberjum	jarðarberjum
gorminn	gorminn
andlang	andlang
kennd	kennd
hjartar	hjartar
skreytti	skreytti
spörkum	spörkum
tindurinn	tindurinn
ytra	ytra
fimbulvetur	fimbulvetur
undantekið	undantekið
Slíkt	Slíkt
byggðu	byggðu
súrefnisskorturinn	súrefnisskorturinn
kossinn	kossinn
munt	munt
dæmdir	dæmdir
kunna	kunna
glóbrystinginn	glóbrystinginn
guðum	guðum
skýrðum	skýrðum
þessar	þessar
krikkets	krikkets
vettlingum	vettlingum
þinnar	þinnar
hafið	hafið
umfjöllun	umfjöllun
ilmjurtir	ilmjurtir
tyrkneskan	tyrkneskan
klæddi	klæddi
varalit	varalit
minnti	minnti
pipars	pipars
æðarkóngarnir	æðarkóngarnir
klúðrir	klúðrir
dansa	dansa
haginn	haginn
harmurinn	harmurinn
legils	legils
trúna	trúna
logann	logann
þrengdi	þrengdi
leikmannanna	leikmannanna
skírðir	skírðir
Mannssonur	Mannssonur
æðikolls	æðikolls
prúttuðuð	prúttuðuð
yfirheitið	yfirheitið
plóg	plóg
hýstuð	hýstuð
sérhljóðs	sérhljóðs
verðs	verðs
staði	staði
fjóla	fjóla
kosti	kosti
strandlengjum	strandlengjum
höfnun	höfnun
samvistarfalli	samvistarfalli
rigningarnar	rigningarnar
Dauðinn	Dauðinn
undan	undan
flokkunum	flokkunum
múgæsingum	múgæsingum
grasafræði	grasafræði
herstígvéla	herstígvéla
rétt	rétt
skyti	skyti
hinar	hinar
glasi	glasi
strandlengju	strandlengju
mengar	mengar
glóbrystingurinn	glóbrystingurinn
munu	munu
gráðu	gráðu
brekkusnigla	brekkusnigla
tjörnum	tjörnum
rósemi	rósemi
dráps	dráps
afleiðingunum	afleiðingunum
Þessu	Þessu
minnum	minnum
miðgilda	miðgilda
prenta	prenta
kommúnistum	kommúnistum
Suma	Suma
geðshræringin	geðshræringin
byggt	byggt
gæta	gæta
gættum	gættum
stækju	stækju
hreim	hreim
klæðir	klæðir
skjallið	skjallið
skildist	skildist
saurga	saurga
hálsinum	hálsinum
fuglafræðina	fuglafræðina
sig	sig
settir	settir
undantekningu	undantekningu
yfirheitunum	yfirheitunum
skytir	skytir
byggja	byggja
flokk	flokk
greina	greina
gítar	gítar
hryggi	hryggi
guðspjallamaðurinn	guðspjallamaðurinn
trúleysi	trúleysi
æðarblikans	æðarblikans
þinna	þinna
svikurunum	svikurunum
reyrinn	reyrinn
óvirtir	óvirtir
málandi	málandi
lastmælin	lastmælin
burstirnar	burstirnar
krossfara	krossfara
ræni	ræni
nokkra	nokkra
ýfið	ýfið
fjarðanna	fjarðanna
ákærðu	ákærðu
horna	horna
sónatínan	sónatínan
greinarnir	greinarnir
perlanna	perlanna
flokknum	flokknum
fórinta	fórinta
bolir	bolir
klappandi	klappandi
dæmdum	dæmdum
skipa	skipa
meti	meti
borða	borða
Þessi	Þessi
líka	líka
leyfis	leyfis
svæfði	svæfði
líkum	líkum
brögðum	brögðum
tíin	tíin
fyrsti	fyrsti
ættum	ættum
jakanna	jakanna
æfingu	æfingu
selduð	selduð
kjafta	kjafta
þekkingar	þekkingar
færis	færis
norrænu	norrænu
skýrðu	skýrðu
óskir	óskir
fjár	fjár
velur	velur
logni	logni
hávellunum	hávellunum
kommúnistinn	kommúnistinn
græði	græði
brauðin	brauðin
vestranum	vestranum
safnið	safnið
hraktir	hraktir
ættkvíslinni	ættkvíslinni
útibúa	útibúa
iðnaður	iðnaður
saumi	saumi
samfundurinn	samfundurinn
reyndu	reyndu
raulið	raulið
sproki	sproki
spjara	spjara
íþyngir	íþyngir
raðið	raðið
kyrki	kyrki
testósterónið	testósterónið
kostaði	kostaði
peninginn	peninginn
brekkusniglunum	brekkusniglunum
tindur	tindur
kapellunni	kapellunni
fjöldann	fjöldann
aðfaranóttin	aðfaranóttin
talaði	talaði
bólstraskýjum	bólstraskýjum
þerruðum	þerruðum
píla	píla
rauluðuð	rauluðuð
skipin	skipin
hafa	hafa
spilin	spilin
rifrildi	rifrildi
laxins	laxins
minnunum	minnunum
frumbyggja	frumbyggja
fræðimennirnir	fræðimennirnir
komst	komst
hrösuðum	hrösuðum
brunann	brunann
brekkusnigill	brekkusnigill
dauðadóms	dauðadóms
vanheilagur	vanheilagur
sæbjúga	sæbjúga
væru	væru
eðju	eðju
kveikina	kveikina
skinum	skinum
geddanna	geddanna
lofaðir	lofaðir
laggir	laggir
vissum	vissum
ökrunum	ökrunum
skyldu	skyldu
sídd	sídd
málir	málir
sölurnar	sölurnar
betri	betri
tjull	tjull
farsíma	farsíma
leitaði	leitaði
lauguðum	lauguðum
dýralækni	dýralækni
villimönnunum	villimönnunum
afleiðingar	afleiðingar
færa	færa
æðahnútarnir	æðahnútarnir
tölvupóstföngum	tölvupóstföngum
ráðast	ráðast
birtast	birtast
greinirinn	greinirinn
ungmennis	ungmennis
reyndi	reyndi
mund	mund
eðla	eðla
þessum	þessum
sparkar	sparkar
högum	högum
lykkjuna	lykkjuna
fjarlægð	fjarlægð
stjórnandi	stjórnandi
jörð	jörð
bifa	bifa
stórhertoga	stórhertoga
fjórði	fjórði
möluðuð	möluðuð
líkið	líkið
frökkum	frökkum
malbiki	malbiki
forsíðurnar	forsíðurnar
sjálfsmynd	sjálfsmynd
þrælkaði	þrælkaði
stjórnið	stjórnið
minnstur	minnstur
gólfa	gólfa
skrifum	skrifum
erfðafræðina	erfðafræðina
skýra	skýra
flokkum	flokkum
syndum	syndum
erum	erum
báðum	báðum
piparinn	piparinn
brekkusóley	brekkusóley
porti	porti
nöðru	nöðru
sparkið	sparkið
Æðstu	Æðstu
patinu	patinu
vafa	vafa
mína	mína
kunnir	kunnir
veski	veski
skutuð	skutuð
ergir	ergir
missi	missi
óskuðu	óskuðu
hjólhýsi	hjólhýsi
notuðuð	notuðuð
endar	endar
brjóstbeinið	brjóstbeinið
pyntið	pyntið
klædd	klædd
heddunum	heddunum
styrkjum	styrkjum
tignaðir	tignaðir
hlutarins	hlutarins
ugga	ugga
vakir	vakir
ýsu	ýsu
metið	metið
furunum	furunum
huldu	huldu
krossgáturnar	krossgáturnar
engjanna	engjanna
minntu	minntu
síðu	síðu
raula	raula
korpönd	korpönd
sóða	sóða
óperuhúsa	óperuhúsa
pípuhöttunum	pípuhöttunum
hrasar	hrasar
afætuna	afætuna
feta	feta
gildi	gildi
ógleðina	ógleðina
skituna	skituna
sælur	sælur
klæðið	klæðið
upp	upp
hugunum	hugunum
blóðflögum	blóðflögum
lakkað	lakkað
spaðarnir	spaðarnir
fjólu	fjólu
kúfinn	kúfinn
sólunum	sólunum
hirðana	hirðana
gættir	gættir
búninginn	búninginn
hyllið	hyllið
drottnaðir	drottnaðir
notaði	notaði
samkomulagið	samkomulagið
leit	leit
hneyktuð	hneyktuð
mella	mella
höfðu	höfðu
Hvort	Hvort
tjöldunum	tjöldunum
höfum	höfum
Kom	Kom
mala	mala
hópum	hópum
félaga	félaga
sin	sin
faldanna	faldanna
hænsna	hænsna
góluðu	góluðu
greinisins	greinisins
hrákann	hrákann
endurnýja	endurnýja
rymdi	rymdi
gaurarnir	gaurarnir
hræðið	hræðið
klædda	klædda
mínir	mínir
strætisvagna	strætisvagna
fiskum	fiskum
byggir	byggir
svikarar	svikarar
brottfararinnar	brottfararinnar
gildið	gildið
styrkið	styrkið
eðlum	eðlum
spöðum	spöðum
gjaldi	gjaldi
missirinn	missirinn
söfnuðuð	söfnuðuð
testósteróns	testósteróns
guðir	guðir
ráðunum	ráðunum
dans	dans
lakka	lakka
volað	volað
efldu	efldu
lífvörðurinn	lífvörðurinn
vestra	vestra
æptir	æptir
snæris	snæris
kalkúnum	kalkúnum
hljóðfærið	hljóðfærið
markspyrnum	markspyrnum
poka	poka
smjatti	smjatti
helvítið	helvítið
reynir	reynir
beði	beði
leikfangs	leikfangs
fluttu	fluttu
stæra	stæra
smalahundurinn	smalahundurinn
leysti	leysti
rifrildisins	rifrildisins
hengdu	hengdu
heróíninu	heróíninu
fylltir	fylltir
náttúru	náttúru
pókers	pókers
úkraínskan	úkraínskan
aborra	aborra
kastir	kastir
skytuð	skytuð
múslimarnir	múslimarnir
æðstu	æðstu
seldur	seldur
gyldu	gyldu
hryggið	hryggið
dæmast	dæmast
útisundlaug	útisundlaug
spila	spila
hvæstuð	hvæstuð
bumbubúum	bumbubúum
árósa	árósa
forsælu	forsælu
fiskur	fiskur
skýrið	skýrið
vændis	vændis
lík	lík
minnkið	minnkið
standast	standast
sygjum	sygjum
Allt	Allt
byggðum	byggðum
fjölgyðistrúm	fjölgyðistrúm
plastanna	plastanna
skyldum	skyldum
breytt	breytt
mynstrið	mynstrið
drambið	drambið
arfi	arfi
líkin	líkin
metinu	metinu
flett	flett
liðum	liðum
kalkúnana	kalkúnana
tvennuna	tvennuna
kapellu	kapellu
tómstundagamni	tómstundagamni
vindill	vindill
síðasta	síðasta
líkamana	líkamana
boði	boði
gaggaði	gaggaði
formaðurinn	formaðurinn
leyfunum	leyfunum
valdið	valdið
rakið	rakið
þínu	þínu
stoppunar	stoppunar
fé	fé
ónáðuðuð	ónáðuðuð
reglu	reglu
káetunum	káetunum
kom	kom
gefast	gefast
svæfðuð	svæfðuð
stund	stund
fórintu	fórintu
herpi	herpi
kökukeflið	kökukeflið
gorm	gorm
skelfisksins	skelfisksins
hljómlist	hljómlist
ges	ges
reipið	reipið
ljóðlistin	ljóðlistin
átu	átu
gengið	gengið
trúleysið	trúleysið
hýdrötum	hýdrötum
þriðji	þriðji
hlutirnir	hlutirnir
frystiskápar	frystiskápar
gætt	gætt
skírin	skírin
albönskunnar	albönskunnar
stundarinnar	stundarinnar
þögguðu	þögguðu
haltra	haltra
spjótkastinu	spjótkastinu
höfnunum	höfnunum
reiðin	reiðin
Mannssonurinn	Mannssonurinn
lakki	lakki
spítalarnir	spítalarnir
skíri	skíri
vökina	vökina
hræddi	hræddi
hrogns	hrogns
lúkka	lúkka
fagurfræðin	fagurfræðin
sjúkdóma	sjúkdóma
Munum	Munum
frumvörpum	frumvörpum
ærumeiðingum	ærumeiðingum
sífrar	sífrar
snæri	snæri
hræðum	hræðum
meðulunum	meðulunum
áfrýjunar	áfrýjunar
færeysku	færeysku
múgæsingu	múgæsingu
hengdir	hengdir
hraða	hraða
geirfuglinn	geirfuglinn
mistur	mistur
drottnarans	drottnarans
raulaði	raulaði
greinis	greinis
okkarínurnar	okkarínurnar
hvein	hvein
Alla	Alla
kysstuð	kysstuð
þjónustu	þjónustu
nokkurs	nokkurs
fjallgarð	fjallgarð
húsfrúrnar	húsfrúrnar
hvíldunum	hvíldunum
kantinn	kantinn
köstuðuð	köstuðuð
þrassins	þrassins
kontrabassann	kontrabassann
pennavinurinn	pennavinurinn
senduð	senduð
borðið	borðið
granateplunum	granateplunum
hinu	hinu
mellum	mellum
vörina	vörina
aðgreindir	aðgreindir
geymdi	geymdi
kvæntur	kvæntur
frakka	frakka
sellerí	sellerí
vind	vind
lax	lax
Það	Það
meta	meta
undantókum	undantókum
greininum	greininum
sjálfur	sjálfur
kjaltan	kjaltan
skrifuðuð	skrifuðuð
nasisma	nasisma
staða	staða
leyn	leyn
met	met
ráðið	ráðið
stundinni	stundinni
knýir	knýir
ákæru	ákæru
liðið	liðið
hrista	hrista
heddinu	heddinu
afgreiðum	afgreiðum
mynstrum	mynstrum
ættuð	ættuð
Inn	Inn
þolað	þolað
öðlast	öðlast
löstum	löstum
beilum	beilum
verðinu	verðinu
jafnt	jafnt
minni	minni
nærmynda	nærmynda
trompin	trompin
langt	langt
krókusi	krókusi
hagi	hagi
verði	verði
skírðum	skírðum
helt	helt
reka	reka
valið	valið
hagnaðurinn	hagnaðurinn
málaðir	málaðir
klappað	klappað
leikaranna	leikaranna
ákveðin	ákveðin
sjúg	sjúg
huga	huga
naðranna	naðranna
kinnaliturinn	kinnaliturinn
skilinn	skilinn
slíkur	slíkur
menguðu	menguðu
þérum	þérum
smíða	smíða
grunnlinn	grunnlinn
kennir	kennir
magn	magn
lýsið	lýsið
sendur	sendur
æðarkónginn	æðarkónginn
akur	akur
svæfi	svæfi
klekkir	klekkir
flotaforingjann	flotaforingjann
svindlurum	svindlurum
kjöltu	kjöltu
gleði	gleði
sekt	sekt
vitrunum	vitrunum
sættið	sættið
nokkrum	nokkrum
hliðið	hliðið
sleiksins	sleiksins
dæmin	dæmin
leyndin	leyndin
Hin	Hin
frjókorn	frjókorn
sjúgi	sjúgi
góm	góm
kviðunum	kviðunum
málið	málið
klæddu	klæddu
fleygi	fleygi
skaut	skaut
móðunni	móðunni
öðru	öðru
farsímanna	farsímanna
fjalir	fjalir
Æðst	Æðst
sárasóttina	sárasóttina
það	það
tár	tár
sonunum	sonunum
enn	enn
misstuð	misstuð
sættir	sættir
upplestra	upplestra
leikara	leikara
stjórnuðu	stjórnuðu
spikinu	spikinu
hugsunum	hugsunum
lærir	lærir
samfundinn	samfundinn
aldin	aldin
treystir	treystir
hýdrötunum	hýdrötunum
umkringið	umkringið
standa	standa
fljótir	fljótir
lifandann	lifandann
markið	markið
fryst	fryst
missti	missti
skírt	skírt
hneykjandi	hneykjandi
aukaföllin	aukaföllin
annan	annan
völdunum	völdunum
töntu	töntu
endaþarmsmökin	endaþarmsmökin
hnútinn	hnútinn
hneykið	hneykið
þrasið	þrasið
hrifsaðir	hrifsaðir
svikanna	svikanna
skjalla	skjalla
missum	missum
enga	enga
toga	toga
hörmum	hörmum
spörfuglar	spörfuglar
þess	þess
fiska	fiska
viskí	viskí
skipaði	skipaði
þerra	þerra
Jótlandið	Jótlandið
vonunum	vonunum
dögunum	dögunum
burst	burst
tárum	tárum
skrifað	skrifað
endurnýjum	endurnýjum
kenni	kenni
drifta	drifta
vinkonan	vinkonan
velþóknanlegar	velþóknanlegar
hryggdýrin	hryggdýrin
sjússa	sjússa
belgir	belgir
bóndi	bóndi
viki	viki
aliönd	aliönd
söfnum	söfnum
kostuðu	kostuðu
jónirnar	jónirnar
freigátunnar	freigátunnar
hugtak	hugtak
knattspyrnu	knattspyrnu
bandstrik	bandstrik
skytum	skytum
grundina	grundina
byggðir	byggðir
vömbin	vömbin
færist	færist
leitum	leitum
þéraði	þéraði
skipunum	skipunum
sandinn	sandinn
endurnýjuðu	endurnýjuðu
skepnan	skepnan
vinátta	vinátta
kinnaliti	kinnaliti
bögum	bögum
hluti	hluti
kosta	kosta
keyptu	keyptu
byggði	byggði
kjarnakorni	kjarnakorni
róður	róður
unglingur	unglingur
alur	alur
eigna	eigna
byggðin	byggðin
hreinsunareldurinn	hreinsunareldurinn
spá	spá
notar	notar
rithöfund	rithöfund
þreytst	þreytst
múkka	múkka
líki	líki
alls	alls
aukaspyrnunum	aukaspyrnunum
teið	teið
væskla	væskla
nokkur	nokkur
hitti	hitti
horn	horn
miðnættin	miðnættin
borðaðir	borðaðir
sléttsöng	sléttsöng
flokksins	flokksins
líkt	líkt
rífst	rífst
skeifa	skeifa
hátíðina	hátíðina
minnt	minnt
gylturnar	gylturnar
æðikollsins	æðikollsins
fljótt	fljótt
býsn	býsn
skipt	skipt
flestir	flestir
skips	skips
undirfylkinganna	undirfylkinganna
sálmur	sálmur
tvennur	tvennur
musterið	musterið
Innan	Innan
kyssi	kyssi
hverjir	hverjir
krælandi	krælandi
fræðimönnunum	fræðimönnunum
kjörfurstar	kjörfurstar
verðin	verðin
þrælkuðu	þrælkuðu
árósinn	árósinn
organistum	organistum
sátu	sátu
musteranna	musteranna
skán	skán
kristinn	kristinn
flettið	flettið
egnir	egnir
hafði	hafði
kenndina	kenndina
sleða	sleða
trunta	trunta
hverja	hverja
sérhverja	sérhverja
áfrýjuðu	áfrýjuðu
bagli	bagli
afætunum	afætunum
sent	sent
kynkvísla	kynkvísla
fiskinn	fiskinn
þjöl	þjöl
heiman	heiman
þurrísi	þurrísi
kæru	kæru
tréblásturshljóðfæris	tréblásturshljóðfæris
félaganum	félaganum
eindar	eindar
misskilningi	misskilningi
greinum	greinum
anganna	anganna
Asíu	Asíu
sósubletturinn	sósubletturinn
svik	svik
kyssið	kyssið
hreinsunareld	hreinsunareld
lénið	lénið
firði	firði
gagntak	gagntak
karsi	karsi
uggum	uggum
pokir	pokir
ríbónúkleösunum	ríbónúkleösunum
blindum	blindum
flassið	flassið
slíkan	slíkan
heilsaði	heilsaði
svíki	svíki
faldi	faldi
Eru	Eru
vændinu	vændinu
hryggði	hryggði
fleygði	fleygði
safnar	safnar
bílstjórar	bílstjórar
hræddir	hræddir
úthlutum	úthlutum
sjálfsmorðs	sjálfsmorðs
hefjum	hefjum
skipinu	skipinu
vestrinn	vestrinn
sjálfsmorðið	sjálfsmorðið
hvíldina	hvíldina
vonin	vonin
vígvelli	vígvelli
einræktað	einræktað
snuði	snuði
flæmskunni	flæmskunni
auki	auki
kúrdísku	kúrdísku
skepnu	skepnu
leiðir	leiðir
bygg	bygg
kvæntir	kvæntir
hafsins	hafsins
skýr	skýr
sokka	sokka
gaffallinn	gaffallinn
sleðum	sleðum
totta	totta
hátíða	hátíða
vestrar	vestrar
Belgann	Belgann
ofar	ofar
skrifuðum	skrifuðum
væruð	væruð
prómetín	prómetín
aukafalls	aukafalls
bændurnir	bændurnir
freigátunum	freigátunum
umkringdi	umkringdi
Allir	Allir
fóstrunum	fóstrunum
varaliðið	varaliðið
stoð	stoð
brenna	brenna
vögguvísa	vögguvísa
peningi	peningi
safni	safni
flettum	flettum
styrktu	styrktu
drekki	drekki
tali	tali
skyttur	skyttur
hryggðir	hryggðir
undirfylkingu	undirfylkingu
styrki	styrki
hólanna	hólanna
akademíurnar	akademíurnar
geddu	geddu
færðuð	færðuð
leyndum	leyndum
Hvað	Hvað
byggi	byggi
notaðir	notaðir
öslir	öslir
leyndi	leyndi
vanda	vanda
pílu	pílu
neyðir	neyðir
styrktir	styrktir
markmanninn	markmanninn
sjúkdómur	sjúkdómur
fylltu	fylltu
jóna	jóna
kvæntist	kvæntist
myndaði	myndaði
etýðu	etýðu
egnduð	egnduð
umkringja	umkringja
handrit	handrit
skjólanna	skjólanna
blóðboga	blóðboga
gyldi	gyldi
valmyndarinnar	valmyndarinnar
nekt	nekt
tökuorðin	tökuorðin
hnerruðu	hnerruðu
tappatogarana	tappatogarana
guði	guði
pennavinunum	pennavinunum
rek	rek
undur	undur
skyldufræðinni	skyldufræðinni
samkundustjóri	samkundustjóri
eyjarnar	eyjarnar
hagnaðarins	hagnaðarins
geðshræringu	geðshræringu
viðskiptavinunum	viðskiptavinunum
indefinite	indefinite
viskíi	viskíi
byggður	byggður
eyrað	eyrað
stýrðu	stýrðu
Hinir	Hinir
hylja	hylja
græðið	græðið
eflduð	eflduð
tíða	tíða
gengi	gengi
sætti	sætti
vara	vara
félagum	félagum
breytingar	breytingar
fyrstur	fyrstur
æðarblika	æðarblika
völd	völd
vakirnar	vakirnar
lúkks	lúkks
hópur	hópur
galt	galt
ljóðlista	ljóðlista
en	en
fundi	fundi
tengisagnirnar	tengisagnirnar
kæti	kæti
japanskan	japanskan
reynið	reynið
fundanna	fundanna
hin	hin
sjálft	sjálft
sparði	sparði
iðnar	iðnar
fjórum	fjórum
ungmenni	ungmenni
kílóin	kílóin
teflir	teflir
þínir	þínir
stær	stær
vissuð	vissuð
tónfræði	tónfræði
þægindi	þægindi
rökuðuð	rökuðuð
gættu	gættu
smalahundana	smalahundana
keyptir	keyptir
saknir	saknir
plokka	plokka
gramúlfarnir	gramúlfarnir
boðaði	boðaði
endurræsti	endurræsti
skíða	skíða
vísu	vísu
hröðlum	hröðlum
kallir	kallir
reiði	reiði
hýst	hýst
étið	étið
skilin	skilin
kalkspats	kalkspats
akra	akra
grafítið	grafítið
slúttað	slúttað
sendi	sendi
skermurinn	skermurinn
engar	engar
hávellunnar	hávellunnar
vífa	vífa
staðlana	staðlana
notið	notið
fríspark	fríspark
hitamælunum	hitamælunum
hagnýta	hagnýta
þols	þols
rasskinn	rasskinn
engi	engi
mundir	mundir
villimanninn	villimanninn
þakka	þakka
skelfisk	skelfisk
hreima	hreima
slík	slík
of	of
skörð	skörð
hreyfinganna	hreyfinganna
kryfjið	kryfjið
leyndarinnar	leyndarinnar
fyll	fyll
skrifaði	skrifaði
lofið	lofið
tálvonin	tálvonin
safnandi	safnandi
raust	raust
hafs	hafs
vinkill	vinkill
efldi	efldi
skyldufræði	skyldufræði
metanna	metanna
ríbónúkleasann	ríbónúkleasann
mistrið	mistrið
skipsins	skipsins
leyndu	leyndu
lausnin	lausnin
fyrstu	fyrstu
svindlara	svindlara
beltum	beltum
ákveðið	ákveðið
brytinn	brytinn
hvað	hvað
legköku	legköku
klippi	klippi
lesanda	lesanda
dauðadómar	dauðadómar
sinnar	sinnar
skriðsundi	skriðsundi
yrðuð	yrðuð
markspyrnu	markspyrnu
Réttu	Réttu
drýgði	drýgði
lærandi	lærandi
vísur	vísur
hvílir	hvílir
flokks	flokks
bílstjóra	bílstjóra
yrðu	yrðu
klippti	klippti
máluðu	máluðu
Sendu	Sendu
körfubolta	körfubolta
vökin	vökin
viðbjóðs	viðbjóðs
báðir	báðir
þessi	þessi
jörðuðum	jörðuðum
heltir	heltir
fegrað	fegrað
æpa	æpa
tölvupóstfanga	tölvupóstfanga
kysstir	kysstir
hneigið	hneigið
hafanna	hafanna
borði	borði
garðyrkjufræði	garðyrkjufræði
gjóði	gjóði
snerist	snerist
komum	komum
tígrisdýrið	tígrisdýrið
félagsins	félagsins
ráðanna	ráðanna
göfguðu	göfguðu
morgnunum	morgnunum
hálfendarnir	hálfendarnir
ljúkast	ljúkast
skip	skip
öxli	öxli
öxin	öxin
fundunum	fundunum
vakar	vakar
þjónustuna	þjónustuna
aldir	aldir
skírðu	skírðu
tennisboltarnir	tennisboltarnir
vök	vök
gormarnir	gormarnir
kirsuberi	kirsuberi
reykjunum	reykjunum
handboltaþjálfara	handboltaþjálfara
unglingsins	unglingsins
notað	notað
ættkvíslum	ættkvíslum
endurræstu	endurræstu
girni	girni
gagntakið	gagntakið
Alls	Alls
göfguðuð	göfguðuð
skjótandi	skjótandi
spjótkast	spjótkast
vel	vel
skipast	skipast
geimur	geimur
stökkið	stökkið
reyrar	reyrar
mörkunum	mörkunum
gyltuna	gyltuna
hefðuð	hefðuð
kætin	kætin
nasismanum	nasismanum
settur	settur
hryggðu	hryggðu
krossanna	krossanna
leynum	leynum
klæð	klæð
treystu	treystu
æxlunum	æxlunum
fremur	fremur
sleik	sleik
langöfum	langöfum
bruna	bruna
spikum	spikum
æðardúni	æðardúni
sérhljóð	sérhljóð
allan	allan
vekti	vekti
ökuleyfi	ökuleyfi
klæinda	klæinda
kalli	kalli
minnanna	minnanna
japönskunni	japönskunni
bruninn	bruninn
lofuðum	lofuðum
safnaði	safnaði
fána	fána
mynstur	mynstur
yrðum	yrðum
málaði	málaði
haft	haft
blinda	blinda
heiðagæs	heiðagæs
stórhertoginn	stórhertoginn
brögðin	brögðin
klekkti	klekkti
æxlunina	æxlunina
ryðönd	ryðönd
gjaldir	gjaldir
heimta	heimta
ýmiss	ýmiss
koma	koma
skuluð	skuluð
ofurstinn	ofurstinn
sinni	sinni
sakna	sakna
lappa	lappa
dáð	dáð
hinum	hinum
klæðandi	klæðandi
smalahundur	smalahundur
æxlun	æxlun
þín	þín
færð	færð
kross	kross
samtengingin	samtengingin
auka	auka
myndið	myndið
reyndur	reyndur
uxa	uxa
lærði	lærði
missis	missis
sagna	sagna
meltingar	meltingar
portum	portum
sæbjúgu	sæbjúgu
hjartarsaltið	hjartarsaltið
akursins	akursins
gjömmum	gjömmum
markmaðurinn	markmaðurinn
kaupunum	kaupunum
gallínið	gallínið
kvelds	kvelds
sinarnar	sinarnar
markgreifa	markgreifa
skýrðuð	skýrðuð
vátryggðum	vátryggðum
seldu	seldu
skylduð	skylduð
slíkt	slíkt
sett	sett
dúkur	dúkur
lausnarinnar	lausnarinnar
efa	efa
bæjasvölur	bæjasvölur
Þessir	Þessir
heilsu	heilsu
vænt	vænt
fyrstir	fyrstir
hornum	hornum
haltri	haltri
vola	vola
teiknuðuð	teiknuðuð
sköpum	sköpum
fæddir	fæddir
stundina	stundina
mála	mála
styrkjandi	styrkjandi
guðinn	guðinn
sífra	sífra
fær	fær
fyllti	fyllti
vallarmiðju	vallarmiðju
mörkin	mörkin
gjaldið	gjaldið
verð	verð
vambirnar	vambirnar
kristinna	kristinna
sjálfstraustsins	sjálfstraustsins
Send	Send
byggðuð	byggðuð
sendum	sendum
nota	nota
eigendur	eigendur
fram	fram
skytu	skytu
akademíanna	akademíanna
færeyskuna	færeyskuna
spurningarnar	spurningarnar
endaþarmsmökum	endaþarmsmökum
markgreifanna	markgreifanna
öfunduðuð	öfunduðuð
labbið	labbið
Belga	Belga
svörður	svörður
umkringdum	umkringdum
orðskviður	orðskviður
vegasalt	vegasalt
bikkju	bikkju
eigandann	eigandann
Dauði	Dauði
argaðir	argaðir
stjórna	stjórna
kylfurnar	kylfurnar
öskra	öskra
sala	sala
ógleði	ógleði
als	als
eignina	eignina
skír	skír
angann	angann
varirnar	varirnar
hnerri	hnerri
gervitungls	gervitungls
hjakkið	hjakkið
strákar	strákar
agúrku	agúrku
grasafræðin	grasafræðin
kvæn	kvæn
blekbyttu	blekbyttu
sneri	sneri
eiturlyfjanotendum	eiturlyfjanotendum
greinanna	greinanna
skírðuð	skírðuð
freista	freista
allt	allt
leglinum	leglinum
uppfært	uppfært
frjókornanna	frjókornanna
afritunum	afritunum
stoðunum	stoðunum
flaga	flaga
efla	efla
sveikst	sveikst
kefði	kefði
fjórðu	fjórðu
minnstu	minnstu
hillu	hillu
reyni	reyni
drunið	drunið
Hafði	Hafði
skjótt	skjótt
blessi	blessi
væli	væli
þrengdist	þrengdist
kýklópa	kýklópa
smókinn	smókinn
miðnætta	miðnætta
bismútið	bismútið
sjálfstraustið	sjálfstraustið
fósturs	fósturs
svengd	svengd
krakkið	krakkið
breyting	breyting
belgi	belgi
glásirnar	glásirnar
klæðum	klæðum
iðnunum	iðnunum
vanræk	vanræk
freistið	freistið
búningana	búningana
langað	langað
strák	strák
stóra	stóra
sigur	sigur
spurninga	spurninga
minn	minn
dauðinn	dauðinn
vínguðinum	vínguðinum
færu	færu
staðinn	staðinn
trú	trú
hætt	hætt
jörðina	jörðina
vafann	vafann
áhrifi	áhrifi
gervitunglinu	gervitunglinu
skírði	skírði
veikir	veikir
hvítvín	hvítvín
ærumeiðinganna	ærumeiðinganna
miðgildið	miðgildið
tómlæti	tómlæti
óska	óska
slepptu	slepptu
síddum	síddum
vináttuna	vináttuna
minna	minna
gjósta	gjósta
hræddur	hræddur
pípuhatta	pípuhatta
Enginn	Enginn
meir	meir
líkir	líkir
súrefnisskortinum	súrefnisskortinum
vínguðunum	vínguðunum
kveldum	kveldum
drekktum	drekktum
sálma	sálma
skreyta	skreyta
jötunuxa	jötunuxa
hjúkrar	hjúkrar
stigbreytinguna	stigbreytinguna
máluðuð	máluðuð
drápum	drápum
glásum	glásum
hagnýtti	hagnýtti
slöngur	slöngur
öðrum	öðrum
köstuðum	köstuðum
kasta	kasta
varir	varir
kalkspati	kalkspati
sóla	sóla
kantöturnar	kantöturnar
erfir	erfir
morgnanna	morgnanna
Hvorn	Hvorn
eyddi	eyddi
þanka	þanka
reiðum	reiðum
fórnum	fórnum
slíku	slíku
anda	anda
tígrisdýrs	tígrisdýrs
slyppu	slyppu
voruð	voruð
mínum	mínum
þau	þau
hatti	hatti
áfrýjuninni	áfrýjuninni
skutum	skutum
skýtur	skýtur
Komum	Komum
spektu	spektu
bullinu	bullinu
gætið	gætið
flæmingja	flæmingja
þerrir	þerrir
hryggjum	hryggjum
sprokunum	sprokunum
gagntekur	gagntekur
klædduð	klædduð
styrkja	styrkja
jöfnunin	jöfnunin
Haf	Haf
jöfnuninni	jöfnuninni
mengaði	mengaði
fagurfræðina	fagurfræðina
efi	efi
stór	stór
garðyrkjufræðin	garðyrkjufræðin
aðfaranæturnar	aðfaranæturnar
vanadíni	vanadíni
bifreiðirnar	bifreiðirnar
byggð	byggð
óperuhúsið	óperuhúsið
mynstra	mynstra
skýrði	skýrði
skilaði	skilaði
fyllandi	fyllandi
væskill	væskill
vönduðuð	vönduðuð
meiðsli	meiðsli
ungum	ungum
grunnla	grunnla
minntir	minntir
heim	heim
sögn	sögn
tröllkonu	tröllkonu
svengdin	svengdin
hlutum	hlutum
gómunum	gómunum
erfði	erfði
prúttar	prúttar
rasskinna	rasskinna
kysstu	kysstu
allir	allir
þönkum	þönkum
hina	hina
sína	sína
dygðarinnar	dygðarinnar
ást	ást
væla	væla
fórnið	fórnið
skrifið	skrifið
hryggir	hryggir
hjartarins	hjartarins
bíóinu	bíóinu
herpir	herpir
tísku	tísku
drekkja	drekkja
tengisagna	tengisagna
hins	hins
sósublettanna	sósublettanna
sjálfsmyndina	sjálfsmyndina
minnisspili	minnisspili
fýri	fýri
jafnir	jafnir
plokkaði	plokkaði
gafflana	gafflana
áhrifið	áhrifið
hellirinn	hellirinn
undantekningum	undantekningum
uppfærðuð	uppfærðuð
klæði	klæði
eru	eru
sumum	sumum
kastandi	kastandi
fjallgarðs	fjallgarðs
skini	skini
blikum	blikum
öfgi	öfgi
blessuðuð	blessuðuð
vinkils	vinkils
eigi	eigi
ert	ert
grafíts	grafíts
geimar	geimar
stundir	stundir
slíkar	slíkar
kalkspatið	kalkspatið
verða	verða
kölluðu	kölluðu
hafi	hafi
líks	líks
jarðarberin	jarðarberin
sátunni	sátunni
skarði	skarði
feðgin	feðgin
makar	makar
tennisboltann	tennisboltann
albönsku	albönsku
Rétt	Rétt
spils	spils
málum	málum
aðgreindu	aðgreindu
göfgar	göfgar
blóðfrumu	blóðfrumu
fimmti	fimmti
sápur	sápur
mæðraveldis	mæðraveldis
sjálfir	sjálfir
fylli	fylli
þurrísum	þurrísum
dáðu	dáðu
sölum	sölum
Svía	Svía
grísku	grísku
félagshyggju	félagshyggju
skulu	skulu
flöguna	flöguna
skjótir	skjótir
tómstundagamanið	tómstundagamanið
hugi	hugi
safnaðir	safnaðir
berklar	berklar
haf	haf
stunda	stunda
fyllið	fyllið
guð	guð
handrits	handrits
hjökkuðuð	hjökkuðuð
túrista	túrista
borðaði	borðaði
staðalinn	staðalinn
drollinu	drollinu
skildir	skildir
köntunum	köntunum
hengdum	hengdum
helvíti	helvíti
samtengingum	samtengingum
æðsta	æðsta
þessir	þessir
minnsta	minnsta
flugvalla	flugvalla
húsbóndi	húsbóndi
selleríið	selleríið
vísum	vísum
átuð	átuð
andast	andast
hæðir	hæðir
vifta	vifta
köngulónum	köngulónum
komna	komna
græddir	græddir
upplestrar	upplestrar
brennur	brennur
ölum	ölum
véið	véið
skipið	skipið
nokkrir	nokkrir
grundarinnar	grundarinnar
neyðið	neyðið
hersveitirnar	hersveitirnar
krossgátuna	krossgátuna
bismúts	bismúts
aldur	aldur
farsímar	farsímar
grípur	grípur
ónáðaði	ónáðaði
gætu	gætu
velþóknanleg	velþóknanleg
sjálfstraust	sjálfstraust
slúttum	slúttum
öndun	öndun
Komu	Komu
misstir	misstir
kvaks	kvaks
vátryggja	vátryggja
hluta	hluta
efli	efli
brytar	brytar
vanheilagan	vanheilagan
skírn	skírn
lessunum	lessunum
vísindamanni	vísindamanni
settum	settum
færi	færi
siða	siða
vegasalta	vegasalta
köstuðu	köstuðu
engan	engan
ax	ax
fjölmiðlasögur	fjölmiðlasögur
ógleðin	ógleðin
eyru	eyru
kerti	kerti
skyldi	skyldi
folann	folann
matana	matana
múslima	múslima
greini	greini
leyfa	leyfa
lénin	lénin
flokkar	flokkar
gæja	gæja
fundum	fundum
leyni	leyni
gærum	gærum
minninganna	minninganna
blóðflögur	blóðflögur
flokkinn	flokkinn
hljóma	hljóma
skottulæknirinn	skottulæknirinn
brjóstbeins	brjóstbeins
styrkti	styrkti
saltkjöt	saltkjöt
vanadíns	vanadíns
Enga	Enga
vekjum	vekjum
minnir	minnir
fjarveru	fjarveru
munið	munið
hvern	hvern
liðsins	liðsins
glönsum	glönsum
allar	allar
haga	haga
káetu	káetu
káeta	káeta
slepp	slepp
sendið	sendið
búninganna	búninganna
ættu	ættu
gess	gess
vörum	vörum
furu	furu
siðaði	siðaði
lögum	lögum
klæðin	klæðin
böðullinn	böðullinn
trunturnar	trunturnar
málað	málað
prútta	prútta
fimmta	fimmta
nokkrar	nokkrar
flokkurinn	flokkurinn
starfið	starfið
leyst	leyst
ali	ali
sérhljóða	sérhljóða
undu	undu
hnefann	hnefann
hlátur	hlátur
leiðsla	leiðsla
þökkum	þökkum
flokkanna	flokkanna
drekkti	drekkti
kökukeflis	kökukeflis
sendir	sendir
sverði	sverði
suma	suma
breytum	breytum
þína	þína
síst	síst
viðræða	viðræða
slúttir	slúttir
minnandi	minnandi
talsmannsins	talsmannsins
starf	starf
framlengdu	framlengdu
fagga	fagga
fylla	fylla
rannana	rannana
maura	maura
fórnuðuð	fórnuðuð
hitamælinn	hitamælinn
sparðs	sparðs
dæmi	dæmi
saumurinn	saumurinn
grískuna	grískuna
hnéskelin	hnéskelin
korkum	korkum
rigninga	rigninga
undirættbálkunum	undirættbálkunum
sjússunum	sjússunum
æðahnúta	æðahnúta
yrði	yrði
störf	störf
raustin	raustin
umfjöllunin	umfjöllunin
smalahundum	smalahundum
þjálfunin	þjálfunin
mæðraveldi	mæðraveldi
höfunum	höfunum
tunglsjúka	tunglsjúka
kjaftar	kjaftar
fjórir	fjórir
félagi	félagi
úthlutaði	úthlutaði
bjarkar	bjarkar
dæmt	dæmt
þessu	þessu
kameljóns	kameljóns
togi	togi
spektan	spektan
svíkjum	svíkjum
kökukefli	kökukefli
minnið	minnið
skyttuna	skyttuna
frostið	frostið
vés	vés
drekkir	drekkir
skyldir	skyldir
hvar	hvar
hvorum	hvorum
vögguvísunum	vögguvísunum
hneigðuð	hneigðuð
nýtir	nýtir
prúttandi	prúttandi
pókersins	pókersins
klæindi	klæindi
verslið	verslið
eyddist	eyddist
leyfanna	leyfanna
flettu	flettu
tind	tind
páskaeggja	páskaeggja
fisks	fisks
gaurs	gaurs
allur	allur
lastmæla	lastmæla
reiðir	reiðir
láta	láta
fyllum	fyllum
kastaði	kastaði
færir	færir
trega	trega
þerrar	þerrar
óskaði	óskaði
geisladiskur	geisladiskur
karakterinn	karakterinn
stýrði	stýrði
flokkana	flokkana
ættfeðurna	ættfeðurna
eitur	eitur
skapa	skapa
sekta	sekta
fuglafræðin	fuglafræðin
meira	meira
mistilteinum	mistilteinum
þrjósku	þrjósku
suguð	suguð
nafla	nafla
hristi	hristi
pats	pats
þinn	þinn
græðum	græðum
forsíðu	forsíðu
drolls	drolls
símaskrána	símaskrána
klúðraðir	klúðraðir
misst	misst
kontrafagott	kontrafagott
horfum	horfum
Þau	Þau
kýklóparnir	kýklóparnir
kúfi	kúfi
knýði	knýði
akademíu	akademíu
hjartarsalt	hjartarsalt
lið	lið
vísurnar	vísurnar
vettling	vettling
skrifi	skrifi
flokki	flokki
hornið	hornið
kúbein	kúbein
organista	organista
fylltuð	fylltuð
þol	þol
undir	undir
kveikinn	kveikinn
geirfuglsins	geirfuglsins
þínum	þínum
stikann	stikann
skírandi	skírandi
endarnir	endarnir
beð	beð
fundin	fundin
óhamingjunni	óhamingjunni
hittum	hittum
æðikollur	æðikollur
fiskar	fiskar
aðdáandann	aðdáandann
skapinu	skapinu
hringaðir	hringaðir
farsími	farsími
jafna	jafna
framlengdi	framlengdi
send	send
íþyngi	íþyngi
ríkdóminn	ríkdóminn
lífstykkjanna	lífstykkjanna
afklæðum	afklæðum
samkundustjóra	samkundustjóra
kostum	kostum
sérhver	sérhver
kostandi	kostandi
sokk	sokk
þakkirnar	þakkirnar
skjöllum	skjöllum
sjálfan	sjálfan
svita	svita
korkunum	korkunum
bols	bols
fetinu	fetinu
hulda	hulda
staðurinn	staðurinn
gæra	gæra
leyndir	leyndir
hjólhýsunum	hjólhýsunum
flettuð	flettuð
aukafallsliðina	aukafallsliðina
fórnir	fórnir
bikkjurnar	bikkjurnar
skýrandi	skýrandi
flokkarnir	flokkarnir
björkum	björkum
feðginin	feðginin
trompið	trompið
keypti	keypti
gæti	gæti
endurnýjuðuð	endurnýjuðuð
aldinin	aldinin
skjóla	skjóla
treysti	treysti
hengið	hengið
brauð	brauð
mínu	mínu
vindum	vindum
teiknaði	teiknaði
bæjasvöluna	bæjasvöluna
samkundustjórinn	samkundustjórinn
birtist	birtist
byggið	byggið
dauða	dauða
tóninum	tóninum
vitrað	vitrað
líkunum	líkunum
verslaði	verslaði
vælið	vælið
minnisspilið	minnisspilið
minnkaðir	minnkaðir
hirðin	hirðin
skírir	skírir
bliku	bliku
hryggja	hryggja
skrifa	skrifa
hreyfir	hreyfir
kantötum	kantötum
hengjum	hengjum
heimtuð	heimtuð
laggaðir	laggaðir
víddunum	víddunum
sjöunda	sjöunda
eigist	eigist
rakað	rakað
hvítvíni	hvítvíni
raustu	raustu
siðuðum	siðuðum
kjarnakorn	kjarnakorn
viðbjóðirnir	viðbjóðirnir
efaði	efaði
kærðu	kærðu
kvíða	kvíða
settaugin	settaugin
látna	látna
kok	kok
fjörður	fjörður
félaganna	félaganna
settuð	settuð
mætti	mætti
spáðu	spáðu
óhamingju	óhamingju
dúksins	dúksins
tæfunum	tæfunum
stigbreytingu	stigbreytingu
stoppanirnar	stoppanirnar
stýri	stýri
gjóstarnir	gjóstarnir
goldið	goldið
kinn	kinn
samkundustjórunum	samkundustjórunum
fældu	fældu
berklanna	berklanna
dæmdu	dæmdu
bumbubúa	bumbubúa
glas	glas
huldir	huldir
veikt	veikt
maka	maka
róðra	róðra
blóðfrumunum	blóðfrumunum
spítalinn	spítalinn
hrifsuðuð	hrifsuðuð
kvíði	kvíði
misskilnings	misskilnings
hólminn	hólminn
hreyfðum	hreyfðum
skýrir	skýrir
dissið	dissið
styrkir	styrkir
spáð	spáð
etýðunnar	etýðunnar
missið	missið
ytri	ytri
læst	læst
sviti	sviti
hólmi	hólmi
líkinu	líkinu
tálvon	tálvon
skírið	skírið
folunum	folunum
brekkusóleyjunum	brekkusóleyjunum
hálfendum	hálfendum
perlunum	perlunum
kvarsinu	kvarsinu
kvænti	kvænti
herpti	herpti
áhugamálið	áhugamálið
tómlætinu	tómlætinu
víka	víka
kvikmyndanna	kvikmyndanna
stoppana	stoppana
sérhljóðum	sérhljóðum
þökkunum	þökkunum
reyndir	reyndir
eign	eign
lífvarðarins	lífvarðarins
bjórvömbunum	bjórvömbunum
sæbjúgað	sæbjúgað
brjálæðið	brjálæðið
mín	mín
leiddir	leiddir
Jótlandinu	Jótlandinu
sinna	sinna
blindir	blindir
drottnið	drottnið
klætt	klætt
iðnað	iðnað
góla	góla
leiðslu	leiðslu
köstum	köstum
þoli	þoli
köfðu	köfðu
fluttur	fluttur
sumir	sumir
köngulóm	köngulóm
dreif	dreif
hug	hug
gilt	gilt
kvars	kvars
vífið	vífið
skil	skil
skapanna	skapanna
ýmist	ýmist
ýfðuð	ýfðuð
vor	vor
kefja	kefja
drekktu	drekktu
krydda	krydda
er	er
konuna	konuna
tíi	tíi
vanrækja	vanrækja
æxlununum	æxlununum
hlátrinum	hlátrinum
úkraínsku	úkraínsku
lofandi	lofandi
settaug	settaug
værum	værum
búnings	búnings
bíóið	bíóið
jarða	jarða
hefli	hefli
gramúlfinn	gramúlfinn
hrap	hrap
hliðin	hliðin
sjöundi	sjöundi
almættið	almættið
orðskviða	orðskviða
gjalda	gjalda
ranns	ranns
fjörðunum	fjörðunum
tottaði	tottaði
lýsingarorð	lýsingarorð
reiðhjólunum	reiðhjólunum
hnéskel	hnéskel
frystiskápum	frystiskápum
komist	komist
veldu	veldu
kastaðir	kastaðir
setti	setti
unga	unga
afrit	afrit
hvíl	hvíl
aðvöruðuð	aðvöruðuð
hráka	hráka
fórnuðu	fórnuðu
varst	varst
fimbulvetrunum	fimbulvetrunum
þátíð	þátíð
skapaði	skapaði
hálfleikurinn	hálfleikurinn
jarðir	jarðir
eyra	eyra
kenndin	kenndin
hellum	hellum
treystuð	treystuð
hræætu	hræætu
samvistarfallinu	samvistarfallinu
rakaði	rakaði
hugsun	hugsun
borðar	borðar
kasti	kasti
ríkdóms	ríkdóms
fiskanna	fiskanna
ferming	ferming
dansinn	dansinn
geisladiskurinn	geisladiskurinn
framlengt	framlengt
kúrdískan	kúrdískan
slíkum	slíkum
körtum	körtum
flettir	flettir
gefin	gefin
bagall	bagall
rymur	rymur
éti	éti
erfðafræði	erfðafræði
meðalið	meðalið
stökkum	stökkum
Hafi	Hafi
trúarjátningin	trúarjátningin
þolinu	þolinu
dæmið	dæmið
afgreiddi	afgreiddi
arga	arga
samfund	samfund
stikana	stikana
míns	míns
karsinn	karsinn
nærmyndin	nærmyndin
prentaði	prentaði
laukst	laukst
koka	koka
hneigði	hneigði
hefðu	hefðu
samfundi	samfundi
afklæddir	afklæddir
þessa	þessa
áhugamáli	áhugamáli
hatursins	hatursins
engir	engir
baginn	baginn
misstum	misstum
agúrkuna	agúrkuna
sléttsöngur	sléttsöngur
vitrir	vitrir
drýgi	drýgi
meiðslunum	meiðslunum
sektir	sektir
lessum	lessum
báðar	báðar
hæsinnar	hæsinnar
kanti	kanti
fremst	fremst
færðir	færðir
fermingu	fermingu
slíka	slíka
hatur	hatur
flæmskuna	flæmskuna
hóllinn	hóllinn
trúarjátningunni	trúarjátningunni
fyrsta	fyrsta
framan	framan
metum	metum
annir	annir
risa	risa
miða	miða
koki	koki
lastmælir	lastmælir
flokka	flokka
gramúlfunum	gramúlfunum
aukafalla	aukafalla
teikna	teikna
nei	nei
eiginmönnum	eiginmönnum
hnúts	hnúts
skírum	skírum
yfirheitin	yfirheitin
hreppa	hreppa
æxlanirnar	æxlanirnar
vísindamönnunum	vísindamönnunum
leynið	leynið
skaflinn	skaflinn
furunni	furunni
Þessa	Þessa
árós	árós
hef	hef
hryggt	hryggt
reyknum	reyknum
bjórvömb	bjórvömb
leyfinu	leyfinu
herstígvél	herstígvél
ættfeðurnir	ættfeðurnir
hvorir	hvorir
vendir	vendir
kastað	kastað
beini	beini
langöfunum	langöfunum
veskjunum	veskjunum
skíðaði	skíðaði
lungnaberklarnir	lungnaberklarnir
settu	settu
strikin	strikin
tæfu	tæfu
viðskiptavinarins	viðskiptavinarins
kryfði	kryfði
söndunum	söndunum
hagann	hagann
æfingunum	æfingunum
fóðrunum	fóðrunum
blik	blik
annast	annast
aukafallsliðinn	aukafallsliðinn
þátíðina	þátíðina
hreyfingum	hreyfingum
aukaspyrnu	aukaspyrnu
skipi	skipi
þandi	þandi
loft	loft
liðanna	liðanna
frumvörpunum	frumvörpunum
önnunum	önnunum
vanadínið	vanadínið
hlutunum	hlutunum
hjakka	hjakka
sonur	sonur
þöggum	þöggum
definite	definite
leynduð	leynduð
eyranu	eyranu
sælunum	sælunum
færðu	færðu
rekur	rekur
hristu	hristu
mets	mets
köngull	köngull
drepur	drepur
sæbjúgna	sæbjúgna
net	net
þérað	þérað
gráða	gráða
kristni	kristni
fyllt	fyllt
þjálfun	þjálfun
böðla	böðla
æðardúninn	æðardúninn
laugaði	laugaði
skrifir	skrifir
belti	belti
engum	engum
diskur	diskur
skírnir	skírnir
þarfaþingið	þarfaþingið
skafls	skafls
diski	diski
báða	báða
jötunuxi	jötunuxi
sápa	sápa
konu	konu
skýrðir	skýrðir
hefjir	hefjir
skerma	skerma
hengduð	hengduð
háls	háls
menga	menga
handboltanum	handboltanum
vorum	vorum
dæma	dæma
bifreið	bifreið
spörfugl	spörfugl
kaupi	kaupi
klæddum	klæddum
fýrum	fýrum
skjótast	skjótast
hringar	hringar
straumarnir	straumarnir
kafði	kafði
ilmjurtunum	ilmjurtunum
horfðu	horfðu
gallín	gallín
Erum	Erum
byggjum	byggjum
tónninn	tónninn
hylli	hylli
skottulækni	skottulækni
vindlunum	vindlunum
smjattið	smjattið
steikinni	steikinni
kylfu	kylfu
öslaði	öslaði
brekkusnigli	brekkusnigli
kyssti	kyssti
máluðum	máluðum
móðunum	móðunum
plasta	plasta
efuðuð	efuðuð
dæmanna	dæmanna
korpöndunum	korpöndunum
arfur	arfur
skitur	skitur
leikfangi	leikfangi
tjarnar	tjarnar
öfunda	öfunda
sjálfu	sjálfu
endi	endi
þenjum	þenjum
þarfaþing	þarfaþing
líkur	líkur
liði	liði
hneigðu	hneigðu
prentuðuð	prentuðuð
sumt	sumt
étum	étum
ríkdómi	ríkdómi
fletti	fletti
hross	hross
einstaklinginn	einstaklinginn
stöðunum	stöðunum
melting	melting
straumurinn	straumurinn
þurrís	þurrís
trjóna	trjóna
kirsuber	kirsuber
kokið	kokið
gaggið	gaggið
synjaði	synjaði
blikunum	blikunum
græddur	græddur
kryddi	kryddi
svertuð	svertuð
leiða	leiða
lessan	lessan
guðspjallamenn	guðspjallamenn
bifaði	bifaði
sérhvern	sérhvern
Ert	Ert
sektuðu	sektuðu
kvikmyndin	kvikmyndin
þolið	þolið
hugtaks	hugtaks
skrifuðu	skrifuðu
hlutanna	hlutanna
fyrstum	fyrstum
skýrum	skýrum
gengist	gengist
sess	sess
fjölmiðlasögu	fjölmiðlasögu
kvöldunum	kvöldunum
maur	maur
hefur	hefur
bifar	bifar
þvörguðuð	þvörguðuð
körtunnar	körtunnar
byggjandi	byggjandi
hrapsins	hrapsins
lungnaberkla	lungnaberkla
skerið	skerið
tregi	tregi
skammar	skammar
prómetínið	prómetínið
síðastir	síðastir
Mannssoninn	Mannssoninn
loga	loga
höf	höf
tunglsjúkur	tunglsjúkur
rændi	rændi
leyfi	leyfi
líkaminn	líkaminn
klæddir	klæddir
þéruðu	þéruðu
munir	munir
át	át
hrek	hrek
uppi	uppi
kjörfurstann	kjörfurstann
gjammar	gjammar
missir	missir
löppunum	löppunum
læsti	læsti
minningin	minningin
hálfleikur	hálfleikur
strika	strika
fæddur	fæddur
heflaði	heflaði
hvæstu	hvæstu
hinir	hinir
félag	félag
verið	verið
hænsnunum	hænsnunum
synir	synir
gætum	gætum
styrktuð	styrktuð
gormsins	gormsins
lífstykkið	lífstykkið
velji	velji
iðnanna	iðnanna
flass	flass
tes	tes
útisundlaugar	útisundlaugar
leiddi	leiddi
drepir	drepir
búning	búning
íveru	íveru
glansi	glansi
vökunum	vökunum
fegrið	fegrið
brjálæði	brjálæði
liðinn	liðinn
aborranna	aborranna
færði	færði
vald	vald
iðnina	iðnina
komu	komu
værir	værir
fundinn	fundinn
hefjið	hefjið
tappatogara	tappatogara
skeifum	skeifum
hjúkruðum	hjúkruðum
hlátri	hlátri
efldir	efldir
denara	denara
enginn	enginn
þinni	þinni
spáði	spáði
minnkaði	minnkaði
gjörðu	gjörðu
plógs	plógs
muni	muni
gröftum	gröftum
flugvellirnir	flugvellirnir
granatepli	granatepli
hálsum	hálsum
meðal	meðal
póker	póker
húsfrúna	húsfrúna
reið	reið
fundið	fundið
gætti	gætti
spjarir	spjarir
kúturinn	kúturinn
flokkur	flokkur
tindana	tindana
valmynda	valmynda
hneigir	hneigir
ljúka	ljúka
víst	víst
engjum	engjum
útibúið	útibúið
aðdáendurna	aðdáendurna
kvakið	kvakið
þreytast	þreytast
handbolta	handbolta
líksins	líksins
lofa	lofa
plokki	plokki
raustar	raustar
hefðum	hefðum
krókus	krókus
klæðast	klæðast
öðlaðist	öðlaðist
drekkið	drekkið
sleppir	sleppir
uppfærið	uppfærið
Slíkar	Slíkar
leynir	leynir
flesta	flesta
fjöldanum	fjöldanum
kontrafagottið	kontrafagottið
engu	engu
þakkað	þakkað
krældi	krældi
frumbyggjann	frumbyggjann
eiturlyfjanotendurnir	eiturlyfjanotendurnir
eðjan	eðjan
ráðsins	ráðsins
denar	denar
grískunni	grískunni
metin	metin
hverju	hverju
fylltum	fylltum
óskar	óskar
varaliði	varaliði
mínar	mínar
tréblásturshljóðfærið	tréblásturshljóðfærið
slangan	slangan
þerraði	þerraði
þriðja	þriðja
gjörir	gjörir
stæri	stæri
hersveitina	hersveitina
Hvar	Hvar
skammir	skammir
betrir	betrir
eitt	eitt
skjóti	skjóti
kalksteininum	kalksteininum
hirða	hirða
leyfið	leyfið
verðsins	verðsins
verðið	verðið
lesandann	lesandann
skýt	skýt
malbikið	malbikið
birtur	birtur
fiskana	fiskana
græddum	græddum
treyst	treyst
ráð	ráð
kontrabassinn	kontrabassinn
tröllkonurnar	tröllkonurnar
fórintum	fórintum
tyrkneskunnar	tyrkneskunnar
símaskrá	símaskrá
tíðir	tíðir
þvargaði	þvargaði
kúts	kúts
jafnað	jafnað
notuðum	notuðum
Fyrst	Fyrst
kossarnir	kossarnir
körfuboltar	körfuboltar
klæða	klæða
tefldir	tefldir
rottuna	rottuna
öxla	öxla
rífist	rífist
lofaði	lofaði
styrkt	styrkt
kílói	kílói
gripið	gripið
mistilteins	mistilteins
tískurnar	tískurnar
fisk	fisk
kastar	kastar
lýsir	lýsir
dagurinn	dagurinn
færanna	færanna
eyrunum	eyrunum
spil	spil
nokkru	nokkru
Allur	Allur
tárin	tárin
beila	beila
öðluðumst	öðluðumst
köngla	köngla
fæddu	fæddu
oft	oft
hóll	hóll
svertir	svertir
zetu	zetu
ökuleyfið	ökuleyfið
smóka	smóka
skrifar	skrifar
labba	labba
kalksteinn	kalksteinn
sparka	sparka
ofan	ofan
jötunuxann	jötunuxann
tárið	tárið
hreyfi	hreyfi
teiknið	teiknið
óvirti	óvirti
formönnunum	formönnunum
æxlanir	æxlanir
kær	kær
félögin	félögin
skjóta	skjóta
svæfið	svæfið
klæðinu	klæðinu
varalitanna	varalitanna
fjölgyðistrúarinnar	fjölgyðistrúarinnar
rusls	rusls
var	var
dreifst	dreifst
synda	synda
lessa	lessa
synið	synið
legkaka	legkaka
kjólföt	kjólföt
strætisvagninn	strætisvagninn
enda	enda
kvænir	kvænir
alda	alda
græddi	græddi
drottnara	drottnara
lauk	lauk
voru	voru
nýtti	nýtti
leiðin	leiðin
kúbeinunum	kúbeinunum
frystinn	frystinn
mögnum	mögnum
brottfara	brottfara
flotaforingja	flotaforingja
heiðagæsum	heiðagæsum
rithöfundurinn	rithöfundurinn
Engum	Engum
tökuorð	tökuorð
frísparkið	frísparkið
ofursta	ofursta
sendu	sendu
uppfærum	uppfærum
pyntuðu	pyntuðu
tignað	tignað
sóunin	sóunin
Fyrir	Fyrir
raðað	raðað
húsbóndanum	húsbóndanum
fært	fært
vonirnar	vonirnar
maurs	maurs
máli	máli
sumu	sumu
gólfið	gólfið
gagntaka	gagntaka
ráðin	ráðin
okkarínu	okkarínu
kallað	kallað
rithöfundum	rithöfundum
beinana	beinana
sleppt	sleppt
minntuð	minntuð
bullið	bullið
höttum	höttum
saurgi	saurgi
kviðunni	kviðunni
sona	sona
gramúlf	gramúlf
drekk	drekk
skýri	skýri
dryn	dryn
jaka	jaka
aðvöruðu	aðvöruðu
minntum	minntum
Þess	Þess
kastið	kastið
Munu	Munu
hvína	hvína
hrææta	hrææta
aliandarinnar	aliandarinnar
káetan	káetan
tiggja	tiggja
mættuð	mættuð
leiddu	leiddu
heróínið	heróínið
abbadís	abbadís
læra	læra
ergið	ergið
sónatína	sónatína
Asía	Asía
Hinar	Hinar
fæla	fæla
slútta	slútta
stækjunnar	stækjunnar
hræddum	hræddum
trúa	trúa
páskaeggsins	páskaeggsins
fæddi	fæddi
þægindum	þægindum
fjarlægt	fjarlægt
talsmaðurinn	talsmaðurinn
mættum	mættum
ris	ris
hýdratið	hýdratið
kyrkti	kyrkti
fældir	fældir
yfirheita	yfirheita
drift	drift
göfga	göfga
vælir	vælir
Sumir	Sumir
skamma	skamma
safna	safna
sendandi	sendandi
Allan	Allan
bólstraskýs	bólstraskýs
engin	engin
almætti	almætti
fóður	fóður
hæsi	hæsi
þrengingin	þrengingin
hryggðuð	hryggðuð
vinkonurnar	vinkonurnar
senda	senda
stundanna	stundanna
skjótum	skjótum
undirættbálkur	undirættbálkur
öðlist	öðlist
hornsins	hornsins
iðnum	iðnum
fisksins	fisksins
áfrýjandi	áfrýjandi
dýralæknar	dýralæknar
steikunum	steikunum
afklæða	afklæða
alla	alla
lýsingarorða	lýsingarorða
eyjar	eyjar
guðina	guðina
eldpipar	eldpipar
langi	langi
sinn	sinn
ruslinu	ruslinu
reglurnar	reglurnar
dissar	dissar
hljóðfæri	hljóðfæri
geymduð	geymduð
lifanda	lifanda
fæl	fæl
dramb	dramb
hafna	hafna
fyllir	fyllir
stýrið	stýrið
þíns	þíns
gyldir	gyldir
einstaklingurinn	einstaklingurinn
leitt	leitt
þakkaði	þakkaði
þurríssins	þurríssins
iðn	iðn
ryðöndin	ryðöndin
eiginmanninn	eiginmanninn
girninu	girninu
styrktum	styrktum
leikmönnum	leikmönnum
